year_month,export_amount,import_amount,trade_balance,country_name,year_month
2000-01-31,2609787984,2217024691,392763293,미국,2000-01
2000-01-31,1551722070,2357231460,-805509390,일본,2000-01
2000-01-31,1235215271,1008165662,227049609,중국,2000-01
2000-01-31,782348732,110604480,671744252,홍콩,2000-01
2000-01-31,589666805,329642679,260024126,대만,2000-01
2000-01-31,464550050,318807419,145742631,싱가포르,2000-01
2000-01-31,362333456,176783277,185550179,영국,2000-01
2000-01-31,334995876,380840674,-45844798,독일,2000-01
2000-01-31,270838573,486990054,-216151481,말레이시아,2000-01
2000-01-31,269739954,154427644,115312310,필리핀,2000-01
2000-01-31,221774078,561263610,-339489532,인도네시아,2000-01
2000-01-31,175771744,85636967,90134777,네덜란드,2000-01
2000-01-31,174353921,52682422,121671499,멕시코,2000-01
2000-01-31,168965826,418330113,-249364287,호주,2000-01
2000-01-31,158803099,166710480,-7907381,캐나다,2000-01
2000-01-31,151251746,104524187,46727559,태국,2000-01
2000-01-31,138379320,118412877,19966443,이탈리아,2000-01
2000-01-31,135057110,184264280,-49207170,프랑스,2000-01
2000-01-31,131167077,276245575,-145078498,아랍에미리트 연합,2000-01
2000-01-31,126874433,74035396,52839037,인도,2000-01
2000-01-31,120631261,18571309,102059952,스페인,2000-01
2000-01-31,115190095,82492178,32697917,브라질,2000-01
2000-01-31,110436502,302377409,-191940907,이란,2000-01
2000-01-31,109742698,27847239,81895459,베트남,2000-01
2000-01-31,86407458,834623132,-748215674,사우디아라비아,2000-01
2000-01-31,79500511,43670324,35830187,벨기에,2000-01
2000-01-31,78650249,2628318,76021931,튀르키예,2000-01
2000-01-31,67679853,3471994,64207859,파나마,2000-01
2000-01-31,61962385,4904433,57057952,폴란드,2000-01
2000-01-31,50465627,47265125,3200502,아일랜드,2000-01
2000-01-31,48135486,22594975,25540511,핀란드,2000-01
2000-01-31,47906237,110231336,-62325099,러시아 연방,2000-01
2000-01-31,47746808,2043272,45703536,기타국,2000-01
2000-01-31,45531814,39641973,5889841,이스라엘,2000-01
2000-01-31,45333496,1057526,44275970,라이베리아,2000-01
2000-01-31,39674043,69412883,-29738840,칠레,2000-01
2000-01-31,38402974,1511909,36891065,방글라데시,2000-01
2000-01-31,37797278,71677952,-33880674,남아프리카공화국,2000-01
2000-01-31,33883449,22800,33860649,바하마,2000-01
2000-01-31,33342555,3303707,30038848,몰타,2000-01
2000-01-31,32820114,1086639,31733475,포루투갈,2000-01
2000-01-31,32076371,17331231,14745140,아르헨티나,2000-01
2000-01-31,31629560,852596,30776964,베네주엘라,2000-01
2000-01-31,31562613,21476221,10086392,파키스탄,2000-01
2000-01-31,30025174,43905122,-13879948,스웨덴,2000-01
2000-01-31,29328311,4456584,24871727,스리랑카,2000-01
2000-01-31,29187396,70061796,-40874400,스위스,2000-01
2000-01-31,28288456,0,28288456,리비아,2000-01
2000-01-31,28133613,43236,28090377,과테말라,2000-01
2000-01-31,27005818,11702713,15303105,이집트,2000-01
2000-01-31,26736736,1715287,25021449,그리스,2000-01
2000-01-31,24479014,1465208,23013806,미얀마,2000-01
2000-01-31,22223493,17513454,4710039,오스트리아,2000-01
2000-01-31,21250040,5674618,15575422,페루,2000-01
2000-01-31,20602645,55119843,-34517198,뉴질랜드,2000-01
2000-01-31,20066058,2169104,17896954,루마니아,2000-01
2000-01-31,15275493,29002789,-13727296,덴마크,2000-01
2000-01-31,15035457,52013,14983444,나이지리아,2000-01
2000-01-31,14701725,11887873,2813852,우즈베키스탄,2000-01
2000-01-31,13840504,103,13840401,알제리,2000-01
2000-01-31,13465116,436813,13028303,시리아,2000-01
2000-01-31,13310844,4834603,8476241,콜롬비아,2000-01
2000-01-31,13247576,21802385,-8554809,노르웨이,2000-01
2000-01-31,13226554,7138979,6087575,헝가리,2000-01
2000-01-31,13224460,235193153,-221968693,쿠웨이트,2000-01
2000-01-31,13202128,4705674,8496454,요르단,2000-01
2000-01-31,11619174,930088,10689086,우루과이,2000-01
2000-01-31,10992372,3785490,7206882,도미니카 공화국,2000-01
2000-01-31,10646873,30174660,-19527787,우크라이나,2000-01
2000-01-31,10388070,4050,10384020,온두라스,2000-01
2000-01-31,9393435,89591461,-80198026,오만,2000-01
2000-01-31,9345029,593015,8752014,슬로베니아,2000-01
2000-01-31,8823770,20564841,-11741071,괌,2000-01
2000-01-31,8239273,3170776,5068497,코스타리카,2000-01
2000-01-31,7613076,0,7613076,아프카니스탄,2000-01
2000-01-31,7268578,122447,7146131,레바논,2000-01
2000-01-31,6072040,91991,5980049,튀니지,2000-01
2000-01-31,5952744,138882,5813862,캄보디아,2000-01
2000-01-31,5755011,6337463,-582452,체코공화국,2000-01
2000-01-31,5719270,1785890,3933380,푸에르토리코,2000-01
2000-01-31,5652716,1006898,4645818,모로코,2000-01
2000-01-31,5259833,31191,5228642,엘살바도르,2000-01
2000-01-31,4835644,43846,4791798,북마리아나 군도,2000-01
2000-01-31,4804274,111936,4692338,수단,2000-01
2000-01-31,4018717,8,4018709,에티오피아,2000-01
2000-01-31,3898516,58567290,-54668774,예맨,2000-01
2000-01-31,3739536,130139191,-126399655,카타르,2000-01
2000-01-31,3645901,532000,3113901,가나,2000-01
2000-01-31,3528141,6070416,-2542275,카자흐스탄,2000-01
2000-01-31,3222028,27570,3194458,니카라과,2000-01
2000-01-31,2813338,13857,2799481,사이프러스,2000-01
2000-01-31,2705222,10872771,-8167549,바레인,2000-01
2000-01-31,2664093,75087,2589006,마카오,2000-01
2000-01-31,2646720,473253,2173467,에쿠아도르,2000-01
2000-01-31,2579877,66868,2513009,크로아티아,2000-01
2000-01-31,2527760,121654,2406106,몽골,2000-01
2000-01-31,2244348,21679,2222669,투르크멘,2000-01
2000-01-31,2223404,60,2223344,파라과이,2000-01
2000-01-31,2202781,108997,2093784,케냐,2000-01
2000-01-31,2078063,0,2078063,트리니다드 토바고,2000-01
2000-01-31,2057527,137115,1920412,코트디봐르,2000-01
2000-01-31,1909069,103730,1805339,세네갈,2000-01
2000-01-31,1886744,28884,1857860,팔라우,2000-01
2000-01-31,1867732,858440,1009292,불가리아,2000-01
2000-01-31,1772615,286,1772329,자마이카,2000-01
2000-01-31,1742004,0,1742004,지부티,2000-01
2000-01-31,1638440,31847,1606593,네팔,2000-01
2000-01-31,1557608,0,1557608,토고,2000-01
2000-01-31,1479554,449319,1030235,모리셔스,2000-01
2000-01-31,1434509,108754,1325755,유고,2000-01
2000-01-31,1399214,1649219,-250005,볼리비아,2000-01
2000-01-31,1377739,124593,1253146,탄자니아,2000-01
2000-01-31,1301848,872059,429789,슬로바키아,2000-01
2000-01-31,1272667,430690,841977,적도 기니,2000-01
2000-01-31,1271413,0,1271413,불령 리유니온 코모도 제도,2000-01
2000-01-31,1075659,0,1075659,아이티,2000-01
2000-01-31,1042142,121800,920342,짐바브웨,2000-01
2000-01-31,1031445,0,1031445,레소토,2000-01
2000-01-31,973563,446987,526576,에스토니아,2000-01
2000-01-31,944638,4008100,-3063462,피지,2000-01
2000-01-31,921479,126609960,-125688481,앙골라,2000-01
2000-01-31,891312,0,891312,마세도니아,2000-01
2000-01-31,827145,0,827145,베닝,2000-01
2000-01-31,814414,18630,795784,도미니카,2000-01
2000-01-31,798269,0,798269,팔레스타인 해방기구(구),2000-01
2000-01-31,747460,1911091,-1163631,스와질랜드,2000-01
2000-01-31,726958,115,726843,라트비아,2000-01
2000-01-31,679431,40766095,-40086664,브루나이,2000-01
2000-01-31,671026,6288526,-5617500,뉴 칼레도니아,2000-01
2000-01-31,614480,0,614480,마티니크,2000-01
2000-01-31,596502,1037317,-440815,리투아니아,2000-01
2000-01-31,567620,16370,551250,마다카스카르,2000-01
2000-01-31,559609,408249,151360,아이슬란드,2000-01
2000-01-31,521534,0,521534,아메리칸 사모아,2000-01
2000-01-31,521442,27601939,-27080497,콩고,2000-01
2000-01-31,517385,18866547,-18349162,파푸아 뉴기니,2000-01
2000-01-31,502724,0,502724,버뮤다,2000-01
2000-01-31,488470,0,488470,불령 폴리네시아,2000-01
2000-01-31,463252,2125,461127,마이크로네시아,2000-01
2000-01-31,398743,75227452,-74828709,니제르,2000-01
2000-01-31,396425,0,396425,아루바,2000-01
2000-01-31,376695,95473,281222,라오스,2000-01
2000-01-31,372902,574,372328,에리트리아,2000-01
2000-01-31,370386,235335,135051,카메룬,2000-01
2000-01-31,367133,9500,357633,보츠와나,2000-01
2000-01-31,366452,118366,248086,모잠비크,2000-01
2000-01-31,358396,0,358396,부르키나 파소,2000-01
2000-01-31,357513,0,357513,과델로프,2000-01
2000-01-31,343106,0,343106,바베이도스,2000-01
2000-01-31,337372,0,337372,키르기스스탄,2000-01
2000-01-31,322223,303188,19035,조지아,2000-01
2000-01-31,307707,0,307707,아제르바이잔,2000-01
2000-01-31,293894,0,293894,마샬군도,2000-01
2000-01-31,277812,176,277636,사모아,2000-01
2000-01-31,274527,0,274527,몰도바,2000-01
2000-01-31,268525,27746696,-27478171,기니,2000-01
2000-01-31,259299,0,259299,수리남,2000-01
2000-01-31,247891,0,247891,르완다,2000-01
2000-01-31,242565,0,242565,소말리아,2000-01
2000-01-31,212394,13347,199047,시에라 리온,2000-01
2000-01-31,203239,263688,-60449,타지크,2000-01
2000-01-31,203006,85505,117501,모리타니,2000-01
2000-01-31,194611,0,194611,나미비아,2000-01
2000-01-31,181902,105022,76880,벨리제,2000-01
2000-01-31,178817,0,178817,알바니아,2000-01
2000-01-31,170961,6141620,-5970659,룩셈부르그,2000-01
2000-01-31,147632,6048,141584,네덜란드 열도,2000-01
2000-01-31,144509,1906011,-1761502,벨라루스,2000-01
2000-01-31,136048,0,136048,말라위,2000-01
2000-01-31,133144,1172948,-1039804,가봉,2000-01
2000-01-31,131929,26384,105545,우간다,2000-01
2000-01-31,123968,0,123968,영령 캐이맨 군도,2000-01
2000-01-31,122600,0,122600,앙귈라,2000-01
2000-01-31,108017,0,108017,몰디브,2000-01
2000-01-31,97452,156473,-59021,바누아투,2000-01
2000-01-31,96485,0,96485,부탄,2000-01
2000-01-31,77894,0,77894,불령 가이아나,2000-01
2000-01-31,76627,14674,61953,안티가 바부다,2000-01
2000-01-31,64755,47951,16804,잠비아,2000-01
2000-01-31,60729,0,60729,콩고민주공화국,2000-01
2000-01-31,57736,0,57736,존스톤 아일랜드,2000-01
2000-01-31,54409,0,54409,보스니아-헤르체고비나,2000-01
2000-01-31,40009,160943,-120934,말리,2000-01
2000-01-31,39441,0,39441,아르메니아,2000-01
2000-01-31,38756,200316,-161560,모나코,2000-01
2000-01-31,25456,0,25456,키리바티,2000-01
2000-01-31,24823,924813,-899990,솔로몬 군도,2000-01
2000-01-31,24050,0,24050,투발루,2000-01
2000-01-31,23647,0,23647,통가,2000-01
2000-01-31,22499,0,22499,가이아나,2000-01
2000-01-31,21980,47000,-25020,크리스마스 아일랜드,2000-01
2000-01-31,19260,0,19260,상토메 프린스페,2000-01
2000-01-31,19055,0,19055,미령 버진군도,2000-01
2000-01-31,17709,62830,-45121,감비아,2000-01
2000-01-31,10600,0,10600,부룬디,2000-01
2000-01-31,8418,0,8418,중앙아프리카공화국,2000-01
2000-01-31,7123,0,7123,웨이크 아일랜드,2000-01
2000-01-31,5921,0,5921,그레나다,2000-01
2000-01-31,3405,0,3405,티모르,2000-01
2000-01-31,2982,0,2982,안타티카,2000-01
2000-01-31,1257,0,1257,세인트 루시아,2000-01
2000-01-31,244,0,244,산마리노,2000-01
2000-01-31,125,0,125,세인트 빈센트 그레나딘,2000-01
2000-01-31,0,25978,-25978,안도라,2000-01
2000-01-31,0,11433255,-11433255,중립지대,2000-01
2000-01-31,0,246,-246,세인트 피레 미켈론,2000-01
2000-01-31,0,74301,-74301,챠드,2000-01
2000-01-31,0,25924,-25924,리히텐슈타인,2000-01
2000-01-31,0,4962,-4962,세인트 키츠 네비스,2000-01
2000-01-31,0,256913,-256913,세인트 헬레나,2000-01
2000-01-31,0,78272,-78272,그린랜드,2000-01
2000-01-31,0,8,-8,코모로스,2000-01
2000-01-31,0,32416,-32416,프랑스 메트로폴리탄,2000-01
2000-01-31,0,326235,-326235,기네비소,2000-01
2000-01-31,0,27215917,-27215917,이라크,2000-01
2000-02-29,2554309883,2241520169,312789714,미국,2000-02
2000-02-29,1518844843,2430090719,-911245876,일본,2000-02
2000-02-29,1273117309,834290694,438826615,중국,2000-02
2000-02-29,823990122,103088602,720901520,홍콩,2000-02
2000-02-29,642399550,296743339,345656211,대만,2000-02
2000-02-29,445771449,178621230,267150219,영국,2000-02
2000-02-29,379588145,265066095,114522050,싱가포르,2000-02
2000-02-29,333962577,4673387,329289190,파나마,2000-02
2000-02-29,325467100,169200890,156266210,캐나다,2000-02
2000-02-29,277001360,330405082,-53403722,독일,2000-02
2000-02-29,263161464,392270024,-129108560,말레이시아,2000-02
2000-02-29,247368307,443698411,-196330104,인도네시아,2000-02
2000-02-29,242372242,137891531,104480711,필리핀,2000-02
2000-02-29,182842730,90031338,92811392,네덜란드,2000-02
2000-02-29,170502544,494499929,-323997385,호주,2000-02
2000-02-29,163487486,20522644,142964842,스페인,2000-02
2000-02-29,161399497,352742801,-191343304,아랍에미리트 연합,2000-02
2000-02-29,158955171,29093834,129861337,멕시코,2000-02
2000-02-29,152783517,112195486,40588031,이탈리아,2000-02
2000-02-29,145677486,107497245,38180241,태국,2000-02
2000-02-29,144710779,62395253,82315526,인도,2000-02
2000-02-29,133044404,180935806,-47891402,프랑스,2000-02
2000-02-29,115646935,82207031,33439904,브라질,2000-02
2000-02-29,112395157,20890101,91505056,베트남,2000-02
2000-02-29,107201285,145570126,-38368841,이란,2000-02
2000-02-29,85390460,747849244,-662458784,사우디아라비아,2000-02
2000-02-29,83138987,62129936,21009051,벨기에,2000-02
2000-02-29,66151073,19788494,46362579,노르웨이,2000-02
2000-02-29,65540694,4004921,61535773,튀르키예,2000-02
2000-02-29,63186843,2845553,60341290,그리스,2000-02
2000-02-29,59719131,0,59719131,마샬군도,2000-02
2000-02-29,56932874,131812536,-74879662,러시아 연방,2000-02
2000-02-29,52707365,45589983,7117382,핀란드,2000-02
2000-02-29,48040896,82554467,-34513571,스위스,2000-02
2000-02-29,47888735,1402233,46486502,방글라데시,2000-02
2000-02-29,45090838,74449942,-29359104,칠레,2000-02
2000-02-29,42338082,5704541,36633541,폴란드,2000-02
2000-02-29,41734092,961428,40772664,베네주엘라,2000-02
2000-02-29,40541574,35271389,5270185,이스라엘,2000-02
2000-02-29,37411114,10789586,26621528,이집트,2000-02
2000-02-29,37128923,66198109,-29069186,남아프리카공화국,2000-02
2000-02-29,34976044,50863073,-15887029,아일랜드,2000-02
2000-02-29,33206882,21698589,11508293,파키스탄,2000-02
2000-02-29,31749646,3985757,27763889,스리랑카,2000-02
2000-02-29,31146061,1229964,29916097,포루투갈,2000-02
2000-02-29,29786687,2346308,27440379,과테말라,2000-02
2000-02-29,29429039,14786251,14642788,아르헨티나,2000-02
2000-02-29,27358318,1987961,25370357,미얀마,2000-02
2000-02-29,25779658,111243,25668415,알제리,2000-02
2000-02-29,24813896,39674060,-14860164,스웨덴,2000-02
2000-02-29,21444055,49984394,-28540339,뉴질랜드,2000-02
2000-02-29,18189262,10049300,8139962,우즈베키스탄,2000-02
2000-02-29,17779102,14558940,3220162,오스트리아,2000-02
2000-02-29,15747288,88145486,-72398198,오만,2000-02
2000-02-29,15527231,27293906,-11766675,덴마크,2000-02
2000-02-29,15168658,175597876,-160429218,카타르,2000-02
2000-02-29,15135722,7191508,7944214,헝가리,2000-02
2000-02-29,15076482,1573607,13502875,기타국,2000-02
2000-02-29,14424036,22371124,-7947088,나이지리아,2000-02
2000-02-29,13786001,4532409,9253592,페루,2000-02
2000-02-29,13424392,72879,13351513,도미니카 공화국,2000-02
2000-02-29,12959966,121559,12838407,요르단,2000-02
2000-02-29,12781953,167391717,-154609764,쿠웨이트,2000-02
2000-02-29,12123434,4758484,7364950,콜롬비아,2000-02
2000-02-29,12041275,2015479,10025796,루마니아,2000-02
2000-02-29,11786329,29968222,-18181893,우크라이나,2000-02
2000-02-29,11704356,174209,11530147,시리아,2000-02
2000-02-29,10289137,377348,9911789,우루과이,2000-02
2000-02-29,10284634,2097826,8186808,온두라스,2000-02
2000-02-29,8776895,8091989,684906,코스타리카,2000-02
2000-02-29,8442077,100310,8341767,캄보디아,2000-02
2000-02-29,7975796,230829,7744967,레바논,2000-02
2000-02-29,7392607,106230,7286377,튀니지,2000-02
2000-02-29,7340973,5624,7335349,리비아,2000-02
2000-02-29,6758391,7569988,-811597,체코공화국,2000-02
2000-02-29,6562370,35712,6526658,엘살바도르,2000-02
2000-02-29,6535462,4175271,2360191,모로코,2000-02
2000-02-29,6366423,163936,6202487,북마리아나 군도,2000-02
2000-02-29,6181808,778256,5403552,슬로베니아,2000-02
2000-02-29,5837086,1281835,4555251,푸에르토리코,2000-02
2000-02-29,5069495,0,5069495,아프카니스탄,2000-02
2000-02-29,4579117,758,4578359,가나,2000-02
2000-02-29,4265774,54682,4211092,마카오,2000-02
2000-02-29,4209611,164287,4045324,케냐,2000-02
2000-02-29,4204102,53646554,-49442452,예맨,2000-02
2000-02-29,3494684,13443,3481241,파라과이,2000-02
2000-02-29,3421298,276818,3144480,몽골,2000-02
2000-02-29,3346096,2635649,710447,카자흐스탄,2000-02
2000-02-29,3293582,83490586,-80197004,에쿠아도르,2000-02
2000-02-29,2826499,993,2825506,지부티,2000-02
2000-02-29,2822155,0,2822155,니카라과,2000-02
2000-02-29,2667139,20189159,-17522020,수단,2000-02
2000-02-29,2600311,51656,2548655,사이프러스,2000-02
2000-02-29,2309619,2117713,191906,몰타,2000-02
2000-02-29,2264114,14022200,-11758086,바레인,2000-02
2000-02-29,2203218,1066374,1136844,괌,2000-02
2000-02-29,1881026,15664,1865362,모리셔스,2000-02
2000-02-29,1878990,101881,1777109,에티오피아,2000-02
2000-02-29,1845312,0,1845312,코트디봐르,2000-02
2000-02-29,1806076,129306,1676770,탄자니아,2000-02
2000-02-29,1549597,211952,1337645,바하마,2000-02
2000-02-29,1512965,0,1512965,불령 리유니온 코모도 제도,2000-02
2000-02-29,1471488,4878022,-3406534,뉴 칼레도니아,2000-02
2000-02-29,1446810,205643,1241167,짐바브웨,2000-02
2000-02-29,1341646,72914,1268732,네팔,2000-02
2000-02-29,1334649,1067504,267145,리투아니아,2000-02
2000-02-29,1327527,31259,1296268,크로아티아,2000-02
2000-02-29,1296911,565229,731682,불가리아,2000-02
2000-02-29,1263498,0,1263498,키르기스스탄,2000-02
2000-02-29,1259220,0,1259220,베닝,2000-02
2000-02-29,1250928,0,1250928,토고,2000-02
2000-02-29,1248371,273102,975269,아이슬란드,2000-02
2000-02-29,1233905,0,1233905,트리니다드 토바고,2000-02
2000-02-29,1233191,23988,1209203,마다카스카르,2000-02
2000-02-29,1196135,0,1196135,레소토,2000-02
2000-02-29,1190851,0,1190851,챠드,2000-02
2000-02-29,1150213,29401,1120812,모잠비크,2000-02
2000-02-29,1119826,15328439,-14208613,파푸아 뉴기니,2000-02
2000-02-29,1098738,19969,1078769,자마이카,2000-02
2000-02-29,1087462,0,1087462,라트비아,2000-02
2000-02-29,1035936,93376,942560,유고,2000-02
2000-02-29,989559,0,989559,투르크멘,2000-02
2000-02-29,936827,282421,654406,피지,2000-02
2000-02-29,930774,47598,883176,볼리비아,2000-02
2000-02-29,881348,628014,253334,슬로바키아,2000-02
2000-02-29,866092,0,866092,마세도니아,2000-02
2000-02-29,859098,57094,802004,팔레스타인 해방기구(구),2000-02
2000-02-29,848939,0,848939,아이티,2000-02
2000-02-29,809948,0,809948,마티니크,2000-02
2000-02-29,753456,93405,660051,도미니카,2000-02
2000-02-29,617519,0,617519,과델로프,2000-02
2000-02-29,616911,4416245,-3799334,에스토니아,2000-02
2000-02-29,609812,0,609812,팔라우,2000-02
2000-02-29,591929,0,591929,몰도바,2000-02
2000-02-29,564849,13689,551160,카메룬,2000-02
2000-02-29,539625,32060573,-31520948,브루나이,2000-02
2000-02-29,534263,58,534205,말리,2000-02
2000-02-29,524843,99951,424892,세네갈,2000-02
2000-02-29,445301,76870943,-76425642,앙골라,2000-02
2000-02-29,437398,0,437398,에리트리아,2000-02
2000-02-29,433773,0,433773,버뮤다,2000-02
2000-02-29,429522,35145162,-34715640,콩고,2000-02
2000-02-29,422456,3151700,-2729244,벨라루스,2000-02
2000-02-29,416229,0,416229,마이크로네시아,2000-02
2000-02-29,383608,0,383608,시에라 리온,2000-02
2000-02-29,356472,1755064,-1398592,스와질랜드,2000-02
2000-02-29,334186,0,334186,아제르바이잔,2000-02
2000-02-29,332233,29042,303191,우간다,2000-02
2000-02-29,332105,0,332105,보츠와나,2000-02
2000-02-29,332081,11650,320431,아메리칸 사모아,2000-02
2000-02-29,307568,0,307568,불령 폴리네시아,2000-02
2000-02-29,302307,185,302122,라오스,2000-02
2000-02-29,298686,0,298686,모리타니,2000-02
2000-02-29,287307,3363,283944,르완다,2000-02
2000-02-29,278381,65,278316,아루바,2000-02
2000-02-29,267723,0,267723,말라위,2000-02
2000-02-29,254280,2844946,-2590666,룩셈부르그,2000-02
2000-02-29,248383,35795,212588,벨리제,2000-02
2000-02-29,239617,3734,235883,수리남,2000-02
2000-02-29,214052,3335,210717,라이베리아,2000-02
2000-02-29,210225,376329,-166104,조지아,2000-02
2000-02-29,202036,0,202036,사모아,2000-02
2000-02-29,185574,0,185574,부탄,2000-02
2000-02-29,161029,0,161029,영령 캐이맨 군도,2000-02
2000-02-29,157708,0,157708,바베이도스,2000-02
2000-02-29,152949,0,152949,안티가 바부다,2000-02
2000-02-29,151751,0,151751,알바니아,2000-02
2000-02-29,145314,321264,-175950,기니,2000-02
2000-02-29,143519,0,143519,세인트 피레 미켈론,2000-02
2000-02-29,135635,0,135635,불령 가이아나,2000-02
2000-02-29,114236,0,114236,감비아,2000-02
2000-02-29,113433,0,113433,바누아투,2000-02
2000-02-29,111746,26393126,-26281380,니제르,2000-02
2000-02-29,105649,342816,-237167,잠비아,2000-02
2000-02-29,103760,680617,-576857,타지크,2000-02
2000-02-29,102689,286862,-184173,나미비아,2000-02
2000-02-29,93187,0,93187,부룬디,2000-02
2000-02-29,84721,24783629,-24698908,가봉,2000-02
2000-02-29,81165,0,81165,부르키나 파소,2000-02
2000-02-29,78796,0,78796,아르메니아,2000-02
2000-02-29,77271,0,77271,캔톤아일랜드,2000-02
2000-02-29,75814,0,75814,가이아나,2000-02
2000-02-29,67900,0,67900,앙귈라,2000-02
2000-02-29,66404,0,66404,통가,2000-02
2000-02-29,65657,0,65657,네덜란드 열도,2000-02
2000-02-29,65596,1967783,-1902187,솔로몬 군도,2000-02
2000-02-29,57558,0,57558,세이쉘,2000-02
2000-02-29,54953,24214385,-24159432,이라크,2000-02
2000-02-29,52171,0,52171,프랑스 메트로폴리탄,2000-02
2000-02-29,45620,0,45620,카보 베르데,2000-02
2000-02-29,45595,1304,44291,소말리아,2000-02
2000-02-29,42726,0,42726,쿡 아일랜드,2000-02
2000-02-29,42407,31281,11126,리히텐슈타인,2000-02
2000-02-29,23290,276,23014,콩고민주공화국,2000-02
2000-02-29,21846,0,21846,보스니아-헤르체고비나,2000-02
2000-02-29,18901,0,18901,세인트 키츠 네비스,2000-02
2000-02-29,17095,0,17095,그레나다,2000-02
2000-02-29,15686,0,15686,세인트 루시아,2000-02
2000-02-29,15059,0,15059,몰디브,2000-02
2000-02-29,14861,0,14861,키리바티,2000-02
2000-02-29,10892,0,10892,투르크 & 카이코스 군도,2000-02
2000-02-29,6192,287379,-281187,모나코,2000-02
2000-02-29,2822,0,2822,안타티카,2000-02
2000-02-29,866,0,866,산마리노,2000-02
2000-02-29,0,112673,-112673,안도라,2000-02
2000-02-29,0,29885,-29885,중앙아프리카공화국,2000-02
2000-02-29,0,42055,-42055,세인트 헬레나,2000-02
2000-02-29,0,407135,-407135,기네비소,2000-02
2000-02-29,0,47400,-47400,크리스마스 아일랜드,2000-02
2000-03-31,2946820669,2607379655,339441014,미국,2000-03
2000-03-31,1783564618,2935699338,-1152134720,일본,2000-03
2000-03-31,1437377223,1125347788,312029435,중국,2000-03
2000-03-31,911648256,130960612,780687644,홍콩,2000-03
2000-03-31,661293635,386854883,274438752,대만,2000-03
2000-03-31,611323359,364766724,246556635,싱가포르,2000-03
2000-03-31,446075966,197211321,248864645,영국,2000-03
2000-03-31,369060780,463624077,-94563297,독일,2000-03
2000-03-31,322705179,177377474,145327705,필리핀,2000-03
2000-03-31,304832891,469488507,-164655616,말레이시아,2000-03
2000-03-31,286076356,505112523,-219036167,인도네시아,2000-03
2000-03-31,216938730,534156841,-317218111,호주,2000-03
2000-03-31,201226055,106670931,94555124,네덜란드,2000-03
2000-03-31,185639150,24451932,161187218,멕시코,2000-03
2000-03-31,179761398,24890270,154871128,스페인,2000-03
2000-03-31,179502797,225344290,-45841493,캐나다,2000-03
2000-03-31,176500937,148271592,28229345,이탈리아,2000-03
2000-03-31,176318317,144303286,32015031,태국,2000-03
2000-03-31,166633887,5174850,161459037,그리스,2000-03
2000-03-31,162266614,396813726,-234547112,아랍에미리트 연합,2000-03
2000-03-31,150134562,25743356,124391206,베트남,2000-03
2000-03-31,143326537,84936455,58390082,인도,2000-03
2000-03-31,138431945,61940159,76491786,브라질,2000-03
2000-03-31,135953541,226686383,-90732842,프랑스,2000-03
2000-03-31,119437515,3100737,116336778,튀르키예,2000-03
2000-03-31,119318845,113793,119205052,파나마,2000-03
2000-03-31,108105228,783323648,-675218420,사우디아라비아,2000-03
2000-03-31,101155679,227832857,-126677178,이란,2000-03
2000-03-31,90945328,60895984,30049344,벨기에,2000-03
2000-03-31,90351123,26333487,64017636,노르웨이,2000-03
2000-03-31,70535573,122250,70413323,사이프러스,2000-03
2000-03-31,64969159,0,64969159,라이베리아,2000-03
2000-03-31,62270341,133983708,-71713367,러시아 연방,2000-03
2000-03-31,61937113,1591980,60345133,방글라데시,2000-03
2000-03-31,59488120,6020854,53467266,폴란드,2000-03
2000-03-31,54954800,648022,54306778,베네주엘라,2000-03
2000-03-31,48804325,62340665,-13536340,아일랜드,2000-03
2000-03-31,47420129,78625764,-31205635,칠레,2000-03
2000-03-31,45188187,9141203,36046984,과테말라,2000-03
2000-03-31,43876069,150215043,-106338974,카타르,2000-03
2000-03-31,43826984,46624100,-2797116,이스라엘,2000-03
2000-03-31,41608447,6559911,35048536,스리랑카,2000-03
2000-03-31,40546411,43406138,-2859727,핀란드,2000-03
2000-03-31,40265186,19057614,21207572,아르헨티나,2000-03
2000-03-31,36747527,67355685,-30608158,남아프리카공화국,2000-03
2000-03-31,34092562,2048208,32044354,이집트,2000-03
2000-03-31,31239910,1762346,29477564,포루투갈,2000-03
2000-03-31,31078254,26517335,4560919,파키스탄,2000-03
2000-03-31,28624790,64979441,-36354651,뉴질랜드,2000-03
2000-03-31,26123430,56953767,-30830337,스웨덴,2000-03
2000-03-31,25564305,32579207,-7014902,덴마크,2000-03
2000-03-31,24768868,2500940,22267928,몰타,2000-03
2000-03-31,24682816,70826,24611990,나이지리아,2000-03
2000-03-31,23586396,2538088,21048308,기타국,2000-03
2000-03-31,21987355,76376702,-54389347,스위스,2000-03
2000-03-31,21511083,2390780,19120303,미얀마,2000-03
2000-03-31,20918553,18738970,2179583,오스트리아,2000-03
2000-03-31,20031080,3005224,17025856,루마니아,2000-03
2000-03-31,19010567,5216922,13793645,콜롬비아,2000-03
2000-03-31,18877712,11776687,7101025,헝가리,2000-03
2000-03-31,17977074,1232034,16745040,푸에르토리코,2000-03
2000-03-31,17660053,193,17659860,알제리,2000-03
2000-03-31,17224280,6960881,10263399,페루,2000-03
2000-03-31,15958978,269449,15689529,도미니카 공화국,2000-03
2000-03-31,14474685,419,14474266,시리아,2000-03
2000-03-31,13990083,1844109,12145974,요르단,2000-03
2000-03-31,12887558,2413,12885145,리비아,2000-03
2000-03-31,12678964,30501885,-17822921,우크라이나,2000-03
2000-03-31,11909752,2115552,9794200,온두라스,2000-03
2000-03-31,11375403,222128734,-210753331,쿠웨이트,2000-03
2000-03-31,10594795,3436537,7158258,코스타리카,2000-03
2000-03-31,10272583,80124345,-69851762,오만,2000-03
2000-03-31,10097278,13917793,-3820515,우즈베키스탄,2000-03
2000-03-31,9842307,633294,9209013,우루과이,2000-03
2000-03-31,8974584,108374,8866210,캄보디아,2000-03
2000-03-31,8470209,3393615,5076594,모로코,2000-03
2000-03-31,8269992,690068,7579924,레바논,2000-03
2000-03-31,8196413,357285,7839128,튀니지,2000-03
2000-03-31,7586082,11588807,-4002725,카자흐스탄,2000-03
2000-03-31,7227242,58226,7169016,엘살바도르,2000-03
2000-03-31,6812055,11560728,-4748673,체코공화국,2000-03
2000-03-31,6512967,211162,6301805,북마리아나 군도,2000-03
2000-03-31,6359486,1080609,5278877,슬로베니아,2000-03
2000-03-31,6075906,19225,6056681,아프카니스탄,2000-03
2000-03-31,5950713,120901,5829812,마카오,2000-03
2000-03-31,5024744,2856,5021888,니카라과,2000-03
2000-03-31,4988212,403444,4584768,가나,2000-03
2000-03-31,4738513,34731777,-29993264,에쿠아도르,2000-03
2000-03-31,4709875,201496,4508379,유고,2000-03
2000-03-31,4671314,176824,4494490,몽골,2000-03
2000-03-31,3816520,3678,3812842,모리셔스,2000-03
2000-03-31,3759065,2416516,1342549,수단,2000-03
2000-03-31,3454665,34381626,-30926961,바레인,2000-03
2000-03-31,3272951,225231,3047720,케냐,2000-03
2000-03-31,2948580,63379,2885201,크로아티아,2000-03
2000-03-31,2499641,46633145,-44133504,예맨,2000-03
2000-03-31,2103772,0,2103772,파라과이,2000-03
2000-03-31,1985952,710558,1275394,불가리아,2000-03
2000-03-31,1922093,29150,1892943,탄자니아,2000-03
2000-03-31,1804048,17391,1786657,키르기스스탄,2000-03
2000-03-31,1798540,17669,1780871,지부티,2000-03
2000-03-31,1725077,2266949,-541872,파푸아 뉴기니,2000-03
2000-03-31,1679137,0,1679137,불령 리유니온 코모도 제도,2000-03
2000-03-31,1469826,0,1469826,코트디봐르,2000-03
2000-03-31,1455761,1895549,-439788,트리니다드 토바고,2000-03
2000-03-31,1439559,1394317,45242,괌,2000-03
2000-03-31,1438843,0,1438843,토고,2000-03
2000-03-31,1424710,95000,1329710,바하마,2000-03
2000-03-31,1404357,0,1404357,아이티,2000-03
2000-03-31,1355212,1231,1353981,과델로프,2000-03
2000-03-31,1302685,20726,1281959,자마이카,2000-03
2000-03-31,1233724,98,1233626,사모아,2000-03
2000-03-31,1206405,60780026,-59573621,브루나이,2000-03
2000-03-31,1204416,55332208,-54127792,앙골라,2000-03
2000-03-31,1180545,4431790,-3251245,도미니카,2000-03
2000-03-31,1166295,360342,805953,리투아니아,2000-03
2000-03-31,1153319,61547,1091772,라트비아,2000-03
2000-03-31,1094348,8590,1085758,마세도니아,2000-03
2000-03-31,1093130,269975,823155,짐바브웨,2000-03
2000-03-31,1084190,53187,1031003,에티오피아,2000-03
2000-03-31,986159,42102,944057,투르크멘,2000-03
2000-03-31,964660,0,964660,마티니크,2000-03
2000-03-31,936584,0,936584,베닝,2000-03
2000-03-31,930793,88675,842118,네팔,2000-03
2000-03-31,912409,19931,892478,마다카스카르,2000-03
2000-03-31,906355,1941467,-1035112,스와질랜드,2000-03
2000-03-31,844189,3919219,-3075030,벨라루스,2000-03
2000-03-31,841172,0,841172,모잠비크,2000-03
2000-03-31,777003,124568,652435,볼리비아,2000-03
2000-03-31,773280,0,773280,보츠와나,2000-03
2000-03-31,722983,14700,708283,팔라우,2000-03
2000-03-31,708469,215253,493216,아이슬란드,2000-03
2000-03-31,666090,272738,393352,기니,2000-03
2000-03-31,642170,19820,622350,세네갈,2000-03
2000-03-31,636336,326916,309420,카메룬,2000-03
2000-03-31,592783,0,592783,라오스,2000-03
2000-03-31,589339,27769714,-27180375,니제르,2000-03
2000-03-31,582550,0,582550,레소토,2000-03
2000-03-31,577105,0,577105,마이크로네시아,2000-03
2000-03-31,576442,594071,-17629,슬로바키아,2000-03
2000-03-31,573545,39674,533871,피지,2000-03
2000-03-31,507585,0,507585,아루바,2000-03
2000-03-31,476905,0,476905,안티가 바부다,2000-03
2000-03-31,476491,3307760,-2831269,뉴 칼레도니아,2000-03
2000-03-31,465752,73641,392111,바누아투,2000-03
2000-03-31,450593,0,450593,불령 폴리네시아,2000-03
2000-03-31,417926,74540405,-74122479,콩고,2000-03
2000-03-31,410928,27230112,-26819184,가봉,2000-03
2000-03-31,380060,176947,203113,에스토니아,2000-03
2000-03-31,358630,27657,330973,우간다,2000-03
2000-03-31,351416,0,351416,이라크,2000-03
2000-03-31,338046,0,338046,아메리칸 사모아,2000-03
2000-03-31,328521,0,328521,몰도바,2000-03
2000-03-31,286353,138285,148068,타지크,2000-03
2000-03-31,275564,0,275564,영령 캐이맨 군도,2000-03
2000-03-31,274675,8174978,-7900303,룩셈부르그,2000-03
2000-03-31,274532,0,274532,불령 가이아나,2000-03
2000-03-31,271118,2441,268677,수리남,2000-03
2000-03-31,261509,21000,240509,마샬군도,2000-03
2000-03-31,258864,174640,84224,팔레스타인 해방기구(구),2000-03
2000-03-31,245597,0,245597,바베이도스,2000-03
2000-03-31,240231,1633,238598,아제르바이잔,2000-03
2000-03-31,221186,0,221186,보스니아-헤르체고비나,2000-03
2000-03-31,214679,0,214679,버뮤다,2000-03
2000-03-31,213717,0,213717,챠드,2000-03
2000-03-31,192042,0,192042,에리트리아,2000-03
2000-03-31,182668,183305,-637,조지아,2000-03
2000-03-31,172857,280145,-107288,잠비아,2000-03
2000-03-31,152708,0,152708,감비아,2000-03
2000-03-31,150266,0,150266,몰디브,2000-03
2000-03-31,144378,1560,142818,시에라 리온,2000-03
2000-03-31,143239,0,143239,콩고민주공화국,2000-03
2000-03-31,137499,0,137499,가이아나,2000-03
2000-03-31,129409,0,129409,말라위,2000-03
2000-03-31,124228,0,124228,알바니아,2000-03
2000-03-31,108105,94100,14005,벨리제,2000-03
2000-03-31,91873,0,91873,투르크 & 카이코스 군도,2000-03
2000-03-31,88348,43242,45106,세이쉘,2000-03
2000-03-31,86486,844,85642,네덜란드 열도,2000-03
2000-03-31,86315,0,86315,그레나다,2000-03
2000-03-31,71785,0,71785,부탄,2000-03
2000-03-31,68238,0,68238,부룬디,2000-03
2000-03-31,66263,23837,42426,모리타니,2000-03
2000-03-31,48299,0,48299,서사하라,2000-03
2000-03-31,46545,1396383,-1349838,솔로몬 군도,2000-03
2000-03-31,45595,0,45595,소말리아,2000-03
2000-03-31,43403,268334,-224931,나미비아,2000-03
2000-03-31,42557,0,42557,프랑스 메트로폴리탄,2000-03
2000-03-31,34423,223680,-189257,모나코,2000-03
2000-03-31,31804,634065,-602261,말리,2000-03
2000-03-31,26123,0,26123,통가,2000-03
2000-03-31,22811,0,22811,세인트 루시아,2000-03
2000-03-31,21918,0,21918,포클랜드 군도,2000-03
2000-03-31,21700,0,21700,중앙아프리카공화국,2000-03
2000-03-31,21238,4376,16862,부르키나 파소,2000-03
2000-03-31,20840,0,20840,영령 버진군도,2000-03
2000-03-31,16158,0,16158,왈라스 & 퓨투나 군도,2000-03
2000-03-31,15084,128,14956,아르메니아,2000-03
2000-03-31,13170,23643,-10473,안도라,2000-03
2000-03-31,12475,0,12475,세인트 빈센트 그레나딘,2000-03
2000-03-31,8400,33994,-25594,리히텐슈타인,2000-03
2000-03-31,6288,0,6288,노폴크 아일랜드,2000-03
2000-03-31,3734,0,3734,지브랄타,2000-03
2000-03-31,3070,0,3070,그린랜드,2000-03
2000-03-31,2600,0,2600,미령 버진군도,2000-03
2000-03-31,2118,11772994,-11770876,중립지대,2000-03
2000-03-31,1590,0,1590,산마리노,2000-03
2000-03-31,464,0,464,세인트 키츠 네비스,2000-03
2000-03-31,40,0,40,르완다,2000-03
2000-03-31,0,50739,-50739,카보 베르데,2000-03
2000-03-31,0,218060,-218060,기네비소,2000-03
2000-03-31,0,326,-326,세인트 헬레나,2000-03
2000-03-31,0,48830,-48830,크리스마스 아일랜드,2000-03
2000-03-31,0,19745,-19745,상토메 프린스페,2000-03
2000-03-31,0,2002,-2002,허드 앤 맥도날드 군도,2000-03
2000-03-31,0,3421,-3421,마이너 아우틀링 합중국 군도,2000-03
2000-03-31,0,126078,-126078,적도 기니,2000-03
2000-04-30,2698029849,2570157793,127872056,미국,2000-04
2000-04-30,1582707525,2814894617,-1232187092,일본,2000-04
2000-04-30,1366876604,1032362221,334514383,중국,2000-04
2000-04-30,863243219,106338194,756905025,홍콩,2000-04
2000-04-30,696679828,356101217,340578611,대만,2000-04
2000-04-30,430096932,295696888,134400044,싱가포르,2000-04
2000-04-30,409155260,273900911,135254349,영국,2000-04
2000-04-30,402004142,364714691,37289451,독일,2000-04
2000-04-30,292020687,423919354,-131898667,말레이시아,2000-04
2000-04-30,275060291,466718622,-191658331,인도네시아,2000-04
2000-04-30,261545517,126002298,135543219,필리핀,2000-04
2000-04-30,212267475,112464966,99802509,네덜란드,2000-04
2000-04-30,199714256,0,199714256,바하마,2000-04
2000-04-30,183799281,30489023,153310258,멕시코,2000-04
2000-04-30,174105904,511114470,-337008566,호주,2000-04
2000-04-30,169516512,123506099,46010413,이탈리아,2000-04
2000-04-30,169146208,27232782,141913426,베트남,2000-04
2000-04-30,162737790,360622193,-197884403,아랍에미리트 연합,2000-04
2000-04-30,159046566,213230766,-54184200,캐나다,2000-04
2000-04-30,153279635,125065048,28214587,태국,2000-04
2000-04-30,134338557,66762630,67575927,브라질,2000-04
2000-04-30,133976015,146861083,-12885068,이란,2000-04
2000-04-30,129952946,22158392,107794554,스페인,2000-04
2000-04-30,125249724,39420,125210304,라이베리아,2000-04
2000-04-30,121366468,162341151,-40974683,프랑스,2000-04
2000-04-30,109408163,721280741,-611872578,사우디아라비아,2000-04
2000-04-30,108783828,0,108783828,마샬군도,2000-04
2000-04-30,100740761,91854847,8885914,인도,2000-04
2000-04-30,98805840,63335643,35470197,벨기에,2000-04
2000-04-30,97701641,2294393,95407248,튀르키예,2000-04
2000-04-30,74703673,4013993,70689680,이집트,2000-04
2000-04-30,63469405,265948,63203457,파나마,2000-04
2000-04-30,58366192,1389341,56976851,방글라데시,2000-04
2000-04-30,58015108,5754764,52260344,폴란드,2000-04
2000-04-30,56471931,137921588,-81449657,러시아 연방,2000-04
2000-04-30,51044128,2729622,48314506,기타국,2000-04
2000-04-30,48593480,26191836,22401644,핀란드,2000-04
2000-04-30,48420398,64350760,-15930362,아일랜드,2000-04
2000-04-30,47462304,5693816,41768488,과테말라,2000-04
2000-04-30,45046085,415242,44630843,베네주엘라,2000-04
2000-04-30,44761467,34388406,10373061,이스라엘,2000-04
2000-04-30,39411008,70794905,-31383897,칠레,2000-04
2000-04-30,39150392,2335739,36814653,미얀마,2000-04
2000-04-30,39120458,3842501,35277957,스리랑카,2000-04
2000-04-30,38566406,20497857,18068549,파키스탄,2000-04
2000-04-30,34581396,0,34581396,영령 캐이맨 군도,2000-04
2000-04-30,33986341,66748929,-32762588,남아프리카공화국,2000-04
2000-04-30,31044379,2100936,28943443,그리스,2000-04
2000-04-30,28741396,1706053,27035343,아르헨티나,2000-04
2000-04-30,27128871,77490387,-50361516,스위스,2000-04
2000-04-30,26681947,1433317,25248630,포루투갈,2000-04
2000-04-30,26637023,46009521,-19372498,스웨덴,2000-04
2000-04-30,24635656,2759341,21876315,몰타,2000-04
2000-04-30,24507324,56880635,-32373311,뉴질랜드,2000-04
2000-04-30,22608306,8209595,14398711,우즈베키스탄,2000-04
2000-04-30,20414528,20276041,138487,오스트리아,2000-04
2000-04-30,19946428,260,19946168,나이지리아,2000-04
2000-04-30,17785360,4796699,12988661,페루,2000-04
2000-04-30,17671598,8203426,9468172,헝가리,2000-04
2000-04-30,16645462,1444010,15201452,푸에르토리코,2000-04
2000-04-30,16396520,4092440,12304080,도미니카 공화국,2000-04
2000-04-30,16191921,184969,16006952,괌,2000-04
2000-04-30,14904555,553937,14350618,시리아,2000-04
2000-04-30,14473163,3084480,11388683,콜롬비아,2000-04
2000-04-30,14307620,225725314,-211417694,쿠웨이트,2000-04
2000-04-30,13623655,3047913,10575742,온두라스,2000-04
2000-04-30,13352333,33739682,-20387349,덴마크,2000-04
2000-04-30,12284849,452871,11831978,우루과이,2000-04
2000-04-30,11310046,169327,11140719,요르단,2000-04
2000-04-30,10756684,3054161,7702523,루마니아,2000-04
2000-04-30,10513092,0,10513092,알제리,2000-04
2000-04-30,10183806,204012903,-193829097,오만,2000-04
2000-04-30,9563412,3580821,5982591,코스타리카,2000-04
2000-04-30,9317446,13402867,-4085421,노르웨이,2000-04
2000-04-30,8540554,154233,8386321,캄보디아,2000-04
2000-04-30,8469903,27068956,-18599053,우크라이나,2000-04
2000-04-30,8328457,497795,7830662,레바논,2000-04
2000-04-30,8232967,244339,7988628,튀니지,2000-04
2000-04-30,8110256,169,8110087,북마리아나 군도,2000-04
2000-04-30,7978749,183656,7795093,엘살바도르,2000-04
2000-04-30,7450447,178714,7271733,몽골,2000-04
2000-04-30,7368932,9477735,-2108803,체코공화국,2000-04
2000-04-30,6557574,624478,5933096,모로코,2000-04
2000-04-30,6000874,53269198,-47268324,에쿠아도르,2000-04
2000-04-30,5878126,432,5877694,리비아,2000-04
2000-04-30,5283885,53079,5230806,마카오,2000-04
2000-04-30,5197476,0,5197476,니카라과,2000-04
2000-04-30,4794604,1637795,3156809,슬로베니아,2000-04
2000-04-30,4696795,2540963,2155832,카자흐스탄,2000-04
2000-04-30,4312820,2144,4310676,사이프러스,2000-04
2000-04-30,4261167,29790,4231377,앙골라,2000-04
2000-04-30,3985368,176606200,-172620832,카타르,2000-04
2000-04-30,3761650,133231,3628419,케냐,2000-04
2000-04-30,3697124,1935,3695189,아프카니스탄,2000-04
2000-04-30,3440156,55608984,-52168828,예맨,2000-04
2000-04-30,3168177,42063698,-38895521,바레인,2000-04
2000-04-30,3068275,8285322,-5217047,수단,2000-04
2000-04-30,3032374,24724,3007650,니제르,2000-04
2000-04-30,2873953,262312,2611641,가나,2000-04
2000-04-30,2714949,6271,2708678,크로아티아,2000-04
2000-04-30,2599049,6171,2592878,모리셔스,2000-04
2000-04-30,2038061,18283,2019778,파라과이,2000-04
2000-04-30,1972079,2773197,-801118,트리니다드 토바고,2000-04
2000-04-30,1831120,63454,1767666,자마이카,2000-04
2000-04-30,1788004,3460397,-1672393,도미니카,2000-04
2000-04-30,1716061,0,1716061,세인트 빈센트 그레나딘,2000-04
2000-04-30,1708054,28200,1679854,탄자니아,2000-04
2000-04-30,1461757,238428,1223329,네팔,2000-04
2000-04-30,1459975,4811,1455164,토고,2000-04
2000-04-30,1415028,263623,1151405,유고,2000-04
2000-04-30,1384924,0,1384924,코트디봐르,2000-04
2000-04-30,1309340,174177,1135163,짐바브웨,2000-04
2000-04-30,1183550,0,1183550,아이티,2000-04
2000-04-30,1149990,298547,851443,리투아니아,2000-04
2000-04-30,1119592,0,1119592,몰도바,2000-04
2000-04-30,1073740,0,1073740,투르크멘,2000-04
2000-04-30,1061360,233054,828306,아이슬란드,2000-04
2000-04-30,1060076,800418,259658,불가리아,2000-04
2000-04-30,1019194,5137345,-4118151,파푸아 뉴기니,2000-04
2000-04-30,1005243,0,1005243,지부티,2000-04
2000-04-30,945233,0,945233,팔레스타인 해방기구(구),2000-04
2000-04-30,923495,0,923495,팔라우,2000-04
2000-04-30,919315,7646,911669,슬로바키아,2000-04
2000-04-30,916618,1099,915519,과델로프,2000-04
2000-04-30,896701,39538,857163,마다카스카르,2000-04
2000-04-30,857860,103512,754348,에리트리아,2000-04
2000-04-30,849364,0,849364,베닝,2000-04
2000-04-30,846857,149097,697760,카메룬,2000-04
2000-04-30,820402,642604,177798,에스토니아,2000-04
2000-04-30,785119,121703,663416,라트비아,2000-04
2000-04-30,781442,32093,749349,에티오피아,2000-04
2000-04-30,776625,722616,54009,뉴 칼레도니아,2000-04
2000-04-30,737199,0,737199,마세도니아,2000-04
2000-04-30,731913,7138,724775,레소토,2000-04
2000-04-30,701625,2915511,-2213886,스와질랜드,2000-04
2000-04-30,697512,243397,454115,나미비아,2000-04
2000-04-30,680239,70727725,-70047486,브루나이,2000-04
2000-04-30,643782,0,643782,불령 리유니온 코모도 제도,2000-04
2000-04-30,586963,0,586963,모잠비크,2000-04
2000-04-30,582221,0,582221,마티니크,2000-04
2000-04-30,565679,42390226,-41824547,콩고,2000-04
2000-04-30,563475,0,563475,키르기스스탄,2000-04
2000-04-30,537024,10674,526350,세네갈,2000-04
2000-04-30,528939,20461,508478,라오스,2000-04
2000-04-30,525261,46805,478456,피지,2000-04
2000-04-30,524230,0,524230,말라위,2000-04
2000-04-30,511151,832015,-320864,벨라루스,2000-04
2000-04-30,510356,110,510246,바베이도스,2000-04
2000-04-30,496783,0,496783,가봉,2000-04
2000-04-30,493948,42426,451522,우간다,2000-04
2000-04-30,390318,0,390318,아루바,2000-04
2000-04-30,372301,11111,361190,버뮤다,2000-04
2000-04-30,360947,637,360310,아제르바이잔,2000-04
2000-04-30,357477,341476,16001,기니,2000-04
2000-04-30,330482,0,330482,사모아,2000-04
2000-04-30,308606,2205,306401,마이크로네시아,2000-04
2000-04-30,285100,0,285100,안티가 바부다,2000-04
2000-04-30,274502,8265,266237,아메리칸 사모아,2000-04
2000-04-30,274065,2710,271355,볼리비아,2000-04
2000-04-30,188880,0,188880,보츠와나,2000-04
2000-04-30,187743,5401192,-5213449,룩셈부르그,2000-04
2000-04-30,178285,0,178285,불령 폴리네시아,2000-04
2000-04-30,167850,0,167850,수리남,2000-04
2000-04-30,159961,0,159961,모리타니,2000-04
2000-04-30,146990,0,146990,보스니아-헤르체고비나,2000-04
2000-04-30,141690,0,141690,시에라 리온,2000-04
2000-04-30,138018,0,138018,허드 앤 맥도날드 군도,2000-04
2000-04-30,134135,121842,12293,조지아,2000-04
2000-04-30,127819,183635,-55816,가이아나,2000-04
2000-04-30,127420,660893,-533473,벨리제,2000-04
2000-04-30,114957,467466,-352509,타지크,2000-04
2000-04-30,110064,99420,10644,바누아투,2000-04
2000-04-30,109382,1214979,-1105597,솔로몬 군도,2000-04
2000-04-30,106172,222665,-116493,잠비아,2000-04
2000-04-30,96637,0,96637,키리바티,2000-04
2000-04-30,91190,0,91190,소말리아,2000-04
2000-04-30,90232,21300,68932,감비아,2000-04
2000-04-30,82626,0,82626,티모르,2000-04
2000-04-30,67022,0,67022,웨이크 아일랜드,2000-04
2000-04-30,63886,0,63886,아르메니아,2000-04
2000-04-30,63433,0,63433,알바니아,2000-04
2000-04-30,63122,0,63122,부르키나 파소,2000-04
2000-04-30,57146,0,57146,중앙아프리카공화국,2000-04
2000-04-30,56027,0,56027,쿡 아일랜드,2000-04
2000-04-30,52679,0,52679,세인트 루시아,2000-04
2000-04-30,50116,0,50116,네덜란드 열도,2000-04
2000-04-30,47277,25239656,-25192379,이라크,2000-04
2000-04-30,46723,602445,-555722,말리,2000-04
2000-04-30,46646,0,46646,몰디브,2000-04
2000-04-30,45253,176496,-131243,콩고민주공화국,2000-04
2000-04-30,42859,0,42859,파나마운하지역,2000-04
2000-04-30,35702,0,35702,그레나다,2000-04
2000-04-30,32964,0,32964,통가,2000-04
2000-04-30,26160,0,26160,투발루,2000-04
2000-04-30,25420,124675,-99255,모나코,2000-04
2000-04-30,23115,0,23115,불령 가이아나,2000-04
2000-04-30,22141,0,22141,부탄,2000-04
2000-04-30,19756,0,19756,세이쉘,2000-04
2000-04-30,10600,0,10600,부룬디,2000-04
2000-04-30,10311,87004,-76693,안도라,2000-04
2000-04-30,9295,0,9295,그린랜드,2000-04
2000-04-30,8002,0,8002,포클랜드 군도,2000-04
2000-04-30,3027,0,3027,세인트 키츠 네비스,2000-04
2000-04-30,1255,41201,-39946,리히텐슈타인,2000-04
2000-04-30,870,0,870,앙귈라,2000-04
2000-04-30,481,0,481,영령 버진군도,2000-04
2000-04-30,420,39671,-39251,산마리노,2000-04
2000-04-30,300,0,300,지브랄타,2000-04
2000-04-30,44,0,44,코모로스,2000-04
2000-04-30,0,32708,-32708,미드웨이 군도,2000-04
2000-04-30,0,281174,-281174,기네비소,2000-04
2000-04-30,0,54,-54,크리스마스 아일랜드,2000-04
2000-04-30,0,559,-559,토켈라우,2000-04
2000-04-30,0,247657,-247657,적도 기니,2000-04
2000-04-30,0,12171246,-12171246,중립지대,2000-04
2000-04-30,0,5128,-5128,세인트 헬레나,2000-04
2000-04-30,0,1200,-1200,미령 버진군도,2000-04
2000-04-30,0,1431,-1431,존스톤 아일랜드,2000-04
2000-05-31,3167181403,2634242706,532938697,미국,2000-05
2000-05-31,1671039709,2627641918,-956602209,일본,2000-05
2000-05-31,1663240667,1066610443,596630224,중국,2000-05
2000-05-31,887081090,107307351,779773739,홍콩,2000-05
2000-05-31,703823036,408133854,295689182,대만,2000-05
2000-05-31,551510356,345096424,206413932,싱가포르,2000-05
2000-05-31,445961310,391221608,54739702,독일,2000-05
2000-05-31,420343382,250938063,169405319,영국,2000-05
2000-05-31,286446602,122444880,164001722,필리핀,2000-05
2000-05-31,284427204,449999352,-165572148,인도네시아,2000-05
2000-05-31,278838901,421161573,-142322672,말레이시아,2000-05
2000-05-31,267246421,565160709,-297914288,호주,2000-05
2000-05-31,233149708,105587369,127562339,네덜란드,2000-05
2000-05-31,200054374,22360158,177694216,멕시코,2000-05
2000-05-31,191308770,128169902,63138868,이탈리아,2000-05
2000-05-31,179182813,4919321,174263492,그리스,2000-05
2000-05-31,169698056,280521614,-110823558,아랍에미리트 연합,2000-05
2000-05-31,169411680,29491232,139920448,베트남,2000-05
2000-05-31,164186191,125800443,38385748,태국,2000-05
2000-05-31,144334669,84267818,60066851,브라질,2000-05
2000-05-31,144253428,21613777,122639651,스페인,2000-05
2000-05-31,142969674,196601039,-53631365,캐나다,2000-05
2000-05-31,130970605,196545191,-65574586,프랑스,2000-05
2000-05-31,119535485,722474516,-602939031,사우디아라비아,2000-05
2000-05-31,117302101,3671161,113630940,튀르키예,2000-05
2000-05-31,112818006,145878645,-33060639,이란,2000-05
2000-05-31,111326359,35236,111291123,라이베리아,2000-05
2000-05-31,106458010,82600423,23857587,인도,2000-05
2000-05-31,104999854,56663707,48336147,벨기에,2000-05
2000-05-31,98327571,3355214,94972357,파나마,2000-05
2000-05-31,59440471,158599744,-99159273,러시아 연방,2000-05
2000-05-31,58526890,1960708,56566182,방글라데시,2000-05
2000-05-31,58378330,82286823,-23908493,칠레,2000-05
2000-05-31,53678680,33762950,19915730,이스라엘,2000-05
2000-05-31,50946228,73922933,-22976705,스위스,2000-05
2000-05-31,48851637,69554354,-20702717,아일랜드,2000-05
2000-05-31,48437589,6754571,41683018,폴란드,2000-05
2000-05-31,48434897,27433427,21001470,핀란드,2000-05
2000-05-31,43332348,18061163,25271185,아르헨티나,2000-05
2000-05-31,41001048,13170924,27830124,이집트,2000-05
2000-05-31,40660647,80584290,-39923643,남아프리카공화국,2000-05
2000-05-31,35935681,3086360,32849321,과테말라,2000-05
2000-05-31,35808895,19747231,16061664,파키스탄,2000-05
2000-05-31,35208928,43364917,-8155989,노르웨이,2000-05
2000-05-31,34339608,46596857,-12257249,스웨덴,2000-05
2000-05-31,34257604,3552465,30705139,스리랑카,2000-05
2000-05-31,34100734,1227863,32872871,포루투갈,2000-05
2000-05-31,29420486,332712,29087774,베네주엘라,2000-05
2000-05-31,29251412,1538079,27713333,미얀마,2000-05
2000-05-31,24742258,28548953,-3806695,덴마크,2000-05
2000-05-31,22966817,64363009,-41396192,뉴질랜드,2000-05
2000-05-31,22136557,11762042,10374515,우즈베키스탄,2000-05
2000-05-31,20516472,21369122,-852650,오스트리아,2000-05
2000-05-31,20500309,2872707,17627602,기타국,2000-05
2000-05-31,19456619,4511423,14945196,콜롬비아,2000-05
2000-05-31,18917173,19816028,-898855,페루,2000-05
2000-05-31,17553846,77762,17476084,나이지리아,2000-05
2000-05-31,15777426,1296158,14481268,우루과이,2000-05
2000-05-31,15139188,169136661,-153997473,쿠웨이트,2000-05
2000-05-31,15008558,64676,14943882,시리아,2000-05
2000-05-31,14793151,8021491,6771660,알제리,2000-05
2000-05-31,14710628,5572,14705056,리비아,2000-05
2000-05-31,14473156,1256598,13216558,루마니아,2000-05
2000-05-31,14308082,4635479,9672603,요르단,2000-05
2000-05-31,13342589,9235396,4107193,도미니카 공화국,2000-05
2000-05-31,13150600,2450711,10699889,온두라스,2000-05
2000-05-31,11994468,2538114,9456354,푸에르토리코,2000-05
2000-05-31,10693239,7951868,2741371,헝가리,2000-05
2000-05-31,9700955,9929126,-228171,코스타리카,2000-05
2000-05-31,9528474,1441,9527033,북마리아나 군도,2000-05
2000-05-31,9325253,128639413,-119314160,오만,2000-05
2000-05-31,9243385,553700,8689685,모로코,2000-05
2000-05-31,8280000,163709068,-155429068,카타르,2000-05
2000-05-31,8258218,9510169,-1251951,우크라이나,2000-05
2000-05-31,7825239,10101268,-2276029,체코공화국,2000-05
2000-05-31,7673337,173810,7499527,엘살바도르,2000-05
2000-05-31,7453739,370810,7082929,캄보디아,2000-05
2000-05-31,7419991,732119,6687872,레바논,2000-05
2000-05-31,6498038,3427779,3070259,카자흐스탄,2000-05
2000-05-31,6138536,16889126,-10750590,에쿠아도르,2000-05
2000-05-31,5936063,103918,5832145,마카오,2000-05
2000-05-31,5501335,635931,4865404,슬로베니아,2000-05
2000-05-31,5499328,220947,5278381,사이프러스,2000-05
2000-05-31,5399825,21721112,-16321287,바레인,2000-05
2000-05-31,5136242,65565,5070677,몽골,2000-05
2000-05-31,4822225,46061,4776164,모리셔스,2000-05
2000-05-31,4745228,246821,4498407,케냐,2000-05
2000-05-31,4700242,47390,4652852,니카라과,2000-05
2000-05-31,4572575,438150,4134425,튀니지,2000-05
2000-05-31,4245610,18905,4226705,크로아티아,2000-05
2000-05-31,3730122,271995,3458127,가나,2000-05
2000-05-31,3198932,17310,3181622,아프카니스탄,2000-05
2000-05-31,3140683,0,3140683,트리니다드 토바고,2000-05
2000-05-31,3039795,53991744,-50951949,예맨,2000-05
2000-05-31,2853191,52300206,-49447015,수단,2000-05
2000-05-31,2522087,44035,2478052,파라과이,2000-05
2000-05-31,2320254,2171175,149079,몰타,2000-05
2000-05-31,2204483,0,2204483,키르기스스탄,2000-05
2000-05-31,2115728,214815,1900913,도미니카,2000-05
2000-05-31,2115048,0,2115048,토고,2000-05
2000-05-31,2065305,817697,1247608,슬로바키아,2000-05
2000-05-31,2051038,0,2051038,지부티,2000-05
2000-05-31,2023686,39846,1983840,코트디봐르,2000-05
2000-05-31,1887016,441251,1445765,불가리아,2000-05
2000-05-31,1846068,30824,1815244,괌,2000-05
2000-05-31,1708863,39900,1668963,바하마,2000-05
2000-05-31,1695487,202188,1493299,리투아니아,2000-05
2000-05-31,1678733,9834,1668899,투르크멘,2000-05
2000-05-31,1617942,9346864,-7728922,파푸아 뉴기니,2000-05
2000-05-31,1494528,33507,1461021,자마이카,2000-05
2000-05-31,1475894,2143208,-667314,스와질랜드,2000-05
2000-05-31,1461923,0,1461923,베닝,2000-05
2000-05-31,1428062,1011755,416307,탄자니아,2000-05
2000-05-31,1391365,620104,771261,아이슬란드,2000-05
2000-05-31,1353122,0,1353122,과델로프,2000-05
2000-05-31,1344010,109288,1234722,네팔,2000-05
2000-05-31,1236657,0,1236657,불령 리유니온 코모도 제도,2000-05
2000-05-31,1094188,154970,939218,세네갈,2000-05
2000-05-31,938326,5949980,-5011654,뉴 칼레도니아,2000-05
2000-05-31,924176,41419,882757,에티오피아,2000-05
2000-05-31,879949,0,879949,마세도니아,2000-05
2000-05-31,871193,150,871043,아이티,2000-05
2000-05-31,864278,861529,2749,에스토니아,2000-05
2000-05-31,854113,42859741,-42005628,브루나이,2000-05
2000-05-31,849475,0,849475,레소토,2000-05
2000-05-31,843247,178627,664620,짐바브웨,2000-05
2000-05-31,835038,61662,773376,마다카스카르,2000-05
2000-05-31,800680,113916,686764,팔레스타인 해방기구(구),2000-05
2000-05-31,767972,47355,720617,피지,2000-05
2000-05-31,703511,0,703511,이라크,2000-05
2000-05-31,634750,912015,-277265,룩셈부르그,2000-05
2000-05-31,630096,16562,613534,라트비아,2000-05
2000-05-31,612872,22876510,-22263638,앙골라,2000-05
2000-05-31,581278,0,581278,아루바,2000-05
2000-05-31,545001,0,545001,마이크로네시아,2000-05
2000-05-31,541022,0,541022,바베이도스,2000-05
2000-05-31,519686,41008847,-40489161,콩고,2000-05
2000-05-31,508168,0,508168,마티니크,2000-05
2000-05-31,489913,0,489913,팔라우,2000-05
2000-05-31,486669,168558,318111,볼리비아,2000-05
2000-05-31,466294,39062,427232,유고,2000-05
2000-05-31,434196,0,434196,말라위,2000-05
2000-05-31,433631,0,433631,라오스,2000-05
2000-05-31,394622,0,394622,안티가 바부다,2000-05
2000-05-31,390655,0,390655,모잠비크,2000-05
2000-05-31,377963,215236,162727,조지아,2000-05
2000-05-31,366173,9973324,-9607151,카메룬,2000-05
2000-05-31,318993,0,318993,수리남,2000-05
2000-05-31,306181,0,306181,사모아,2000-05
2000-05-31,300614,116437,184177,기니,2000-05
2000-05-31,269210,0,269210,불령 가이아나,2000-05
2000-05-31,255539,0,255539,아메리칸 사모아,2000-05
2000-05-31,254690,23266,231424,불령 폴리네시아,2000-05
2000-05-31,229676,876873,-647197,벨라루스,2000-05
2000-05-31,228792,163735,65057,벨리제,2000-05
2000-05-31,228391,0,228391,에리트리아,2000-05
2000-05-31,225403,350396,-124993,가이아나,2000-05
2000-05-31,224470,0,224470,모리타니,2000-05
2000-05-31,215263,32011,183252,잠비아,2000-05
2000-05-31,210536,39000,171536,바누아투,2000-05
2000-05-31,200575,597403,-396828,가봉,2000-05
2000-05-31,199348,0,199348,마샬군도,2000-05
2000-05-31,196889,0,196889,영령 캐이맨 군도,2000-05
2000-05-31,184104,0,184104,우간다,2000-05
2000-05-31,179752,1039087,-859335,타지크,2000-05
2000-05-31,172929,0,172929,니제르,2000-05
2000-05-31,150427,18130,132297,네덜란드 열도,2000-05
2000-05-31,149138,0,149138,알바니아,2000-05
2000-05-31,138678,5021,133657,보츠와나,2000-05
2000-05-31,114183,166659,-52476,모나코,2000-05
2000-05-31,113841,0,113841,세인트 루시아,2000-05
2000-05-31,112402,0,112402,버뮤다,2000-05
2000-05-31,108710,0,108710,부르키나 파소,2000-05
2000-05-31,91190,0,91190,소말리아,2000-05
2000-05-31,90375,0,90375,보스니아-헤르체고비나,2000-05
2000-05-31,82485,0,82485,부탄,2000-05
2000-05-31,81895,0,81895,앙귈라,2000-05
2000-05-31,80142,0,80142,아제르바이잔,2000-05
2000-05-31,74199,7475,66724,시에라 리온,2000-05
2000-05-31,73829,18977,54852,감비아,2000-05
2000-05-31,72477,0,72477,그레나다,2000-05
2000-05-31,68058,0,68058,몰도바,2000-05
2000-05-31,61902,1678,60224,산마리노,2000-05
2000-05-31,58069,0,58069,세인트 키츠 네비스,2000-05
2000-05-31,54478,353994,-299516,나미비아,2000-05
2000-05-31,48306,350,47956,아르메니아,2000-05
2000-05-31,40543,0,40543,몰디브,2000-05
2000-05-31,38258,0,38258,세이쉘,2000-05
2000-05-31,34567,0,34567,쿡 아일랜드,2000-05
2000-05-31,33798,5546,28252,통가,2000-05
2000-05-31,32742,22772,9970,중앙아프리카공화국,2000-05
2000-05-31,30307,0,30307,메요트,2000-05
2000-05-31,29092,0,29092,부룬디,2000-05
2000-05-31,28486,1826508,-1798022,솔로몬 군도,2000-05
2000-05-31,27623,158469,-130846,콩고민주공화국,2000-05
2000-05-31,20073,487155,-467082,안도라,2000-05
2000-05-31,17470,0,17470,코모로스,2000-05
2000-05-31,6760,0,6760,투르크 & 카이코스 군도,2000-05
2000-05-31,5983,1202132,-1196149,말리,2000-05
2000-05-31,4381,11080977,-11076596,중립지대,2000-05
2000-05-31,4155,12220,-8065,존스톤 아일랜드,2000-05
2000-05-31,3930,3803,127,포클랜드 군도,2000-05
2000-05-31,2200,0,2200,투발루,2000-05
2000-05-31,1482,0,1482,크리스마스 아일랜드,2000-05
2000-05-31,1209,0,1209,지브랄타,2000-05
2000-05-31,1037,3123,-2086,프랑스 메트로폴리탄,2000-05
2000-05-31,854,25185,-24331,리히텐슈타인,2000-05
2000-05-31,203,0,203,미령 버진군도,2000-05
2000-05-31,0,452652,-452652,기네비소,2000-05
2000-05-31,0,1208541,-1208541,나우루,2000-05
2000-05-31,0,67200,-67200,파로에 군도,2000-05
2000-05-31,0,101607,-101607,미드웨이 군도,2000-05
2000-05-31,0,60,-60,적도 기니,2000-05
2000-06-30,3214982843,2482260100,732722743,미국,2000-06
2000-06-30,1670427579,2720275941,-1049848362,일본,2000-06
2000-06-30,1636969297,1083629551,553339746,중국,2000-06
2000-06-30,883530139,118252613,765277526,홍콩,2000-06
2000-06-30,756051975,375311644,380740331,대만,2000-06
2000-06-30,503155427,207359793,295795634,영국,2000-06
2000-06-30,489091812,369358231,119733581,독일,2000-06
2000-06-30,447583372,286102854,161480518,싱가포르,2000-06
2000-06-30,307514780,355709116,-48194336,말레이시아,2000-06
2000-06-30,304034925,135755507,168279418,필리핀,2000-06
2000-06-30,299207816,294140403,5067413,인도네시아,2000-06
2000-06-30,251287456,512317281,-261029825,호주,2000-06
2000-06-30,218961921,49947833,169014088,멕시코,2000-06
2000-06-30,215834528,138150243,77684285,네덜란드,2000-06
2000-06-30,215760811,157422714,58338097,캐나다,2000-06
2000-06-30,202393454,154875048,47518406,이탈리아,2000-06
2000-06-30,190097075,300958408,-110861333,아랍에미리트 연합,2000-06
2000-06-30,185611223,50,185611173,라이베리아,2000-06
2000-06-30,185566934,5889894,179677040,그리스,2000-06
2000-06-30,182814657,125609419,57205238,태국,2000-06
2000-06-30,158821333,6752701,152068632,튀르키예,2000-06
2000-06-30,158148200,63316361,94831839,브라질,2000-06
2000-06-30,156502370,28533650,127968720,베트남,2000-06
2000-06-30,139830311,192185179,-52354868,프랑스,2000-06
2000-06-30,131697238,25848253,105848985,스페인,2000-06
2000-06-30,122951252,171882012,-48930760,이란,2000-06
2000-06-30,121636824,86538864,35097960,인도,2000-06
2000-06-30,105808492,717115321,-611306829,사우디아라비아,2000-06
2000-06-30,98273635,82521465,15752170,노르웨이,2000-06
2000-06-30,94679814,54184797,40495017,벨기에,2000-06
2000-06-30,73722714,35463112,38259602,이스라엘,2000-06
2000-06-30,70224868,4310,70220558,마샬군도,2000-06
2000-06-30,69808942,75032587,-5223645,칠레,2000-06
2000-06-30,67442198,41813,67400385,사이프러스,2000-06
2000-06-30,67306979,77753466,-10446487,스위스,2000-06
2000-06-30,66475735,176959031,-110483296,러시아 연방,2000-06
2000-06-30,48701720,1532355,47169365,방글라데시,2000-06
2000-06-30,48462462,61706122,-13243660,핀란드,2000-06
2000-06-30,47621846,73959561,-26337715,남아프리카공화국,2000-06
2000-06-30,46082584,85603359,-39520775,아일랜드,2000-06
2000-06-30,45609038,2903157,42705881,아르헨티나,2000-06
2000-06-30,44156955,4095981,40060974,이집트,2000-06
2000-06-30,39454310,2370608,37083702,과테말라,2000-06
2000-06-30,39113145,21214094,17899051,파키스탄,2000-06
2000-06-30,38489460,4532389,33957071,폴란드,2000-06
2000-06-30,37413486,44360410,-6946924,스웨덴,2000-06
2000-06-30,33400313,3849339,29550974,스리랑카,2000-06
2000-06-30,30631393,24253314,6378079,오스트리아,2000-06
2000-06-30,29546429,1286831,28259598,포루투갈,2000-06
2000-06-30,29198904,4710601,24488303,베네주엘라,2000-06
2000-06-30,27650432,237288,27413144,파나마,2000-06
2000-06-30,26578748,66771704,-40192956,뉴질랜드,2000-06
2000-06-30,25446245,59754,25386491,나이지리아,2000-06
2000-06-30,25171545,2023996,23147549,미얀마,2000-06
2000-06-30,24854748,5862529,18992219,우즈베키스탄,2000-06
2000-06-30,24377014,99197,24277817,시리아,2000-06
2000-06-30,22445850,6205971,16239879,콜롬비아,2000-06
2000-06-30,17734368,11707824,6026544,페루,2000-06
2000-06-30,17216299,751554,16464745,괌,2000-06
2000-06-30,17009051,25096523,-8087472,알제리,2000-06
2000-06-30,16865379,4555057,12310322,루마니아,2000-06
2000-06-30,16377807,175458695,-159080888,쿠웨이트,2000-06
2000-06-30,15907691,2103798,13803893,기타국,2000-06
2000-06-30,15868377,1570228,14298149,푸에르토리코,2000-06
2000-06-30,15623153,33497368,-17874215,덴마크,2000-06
2000-06-30,13945018,1150302,12794716,우루과이,2000-06
2000-06-30,13883110,10693070,3190040,헝가리,2000-06
2000-06-30,13694869,26444219,-12749350,바레인,2000-06
2000-06-30,12778102,382247,12395855,도미니카 공화국,2000-06
2000-06-30,12656543,2150258,10506285,온두라스,2000-06
2000-06-30,12279106,85377,12193729,요르단,2000-06
2000-06-30,11579191,11700828,-121637,우크라이나,2000-06
2000-06-30,11168028,155383274,-144215246,오만,2000-06
2000-06-30,10475809,335438,10140371,튀니지,2000-06
2000-06-30,10087493,183695474,-173607981,카타르,2000-06
2000-06-30,9903659,18080201,-8176542,에쿠아도르,2000-06
2000-06-30,9217056,9859695,-642639,코스타리카,2000-06
2000-06-30,8752676,189654,8563022,캄보디아,2000-06
2000-06-30,8396853,94216,8302637,엘살바도르,2000-06
2000-06-30,7503941,5863434,1640507,모로코,2000-06
2000-06-30,6846690,13651756,-6805066,체코공화국,2000-06
2000-06-30,6841029,19284553,-12443524,수단,2000-06
2000-06-30,6830608,283094,6547514,레바논,2000-06
2000-06-30,6514129,47821,6466308,북마리아나 군도,2000-06
2000-06-30,6494892,7257922,-763030,카자흐스탄,2000-06
2000-06-30,5657857,128139,5529718,리비아,2000-06
2000-06-30,5318810,0,5318810,니카라과,2000-06
2000-06-30,5307278,225325,5081953,가나,2000-06
2000-06-30,5085906,121197,4964709,마카오,2000-06
2000-06-30,4657321,2271,4655050,아프카니스탄,2000-06
2000-06-30,4652491,923037,3729454,슬로베니아,2000-06
2000-06-30,4305765,28631503,-24325738,예맨,2000-06
2000-06-30,4029671,19735,4009936,파라과이,2000-06
2000-06-30,3839145,63695,3775450,몽골,2000-06
2000-06-30,3824852,32026,3792826,코트디봐르,2000-06
2000-06-30,3493974,68854,3425120,크로아티아,2000-06
2000-06-30,3469812,9864,3459948,투르크멘,2000-06
2000-06-30,3279853,69317424,-66037571,이라크,2000-06
2000-06-30,3100177,100436,2999741,케냐,2000-06
2000-06-30,2426697,11264,2415433,모리셔스,2000-06
2000-06-30,2266896,10584,2256312,키르기스스탄,2000-06
2000-06-30,2177695,541130,1636565,에스토니아,2000-06
2000-06-30,2161800,176,2161624,토고,2000-06
2000-06-30,1990964,1670405,320559,몰타,2000-06
2000-06-30,1968828,114000,1854828,바하마,2000-06
2000-06-30,1750204,17380,1732824,지부티,2000-06
2000-06-30,1717098,465114,1251984,불가리아,2000-06
2000-06-30,1469169,96621,1372548,유고,2000-06
2000-06-30,1439713,4177,1435536,레소토,2000-06
2000-06-30,1407977,178497,1229480,네팔,2000-06
2000-06-30,1404370,12500,1391870,자마이카,2000-06
2000-06-30,1401094,804909,596185,슬로바키아,2000-06
2000-06-30,1340632,488670,851962,리투아니아,2000-06
2000-06-30,1316801,0,1316801,트리니다드 토바고,2000-06
2000-06-30,1306277,239354,1066923,아이슬란드,2000-06
2000-06-30,1256989,484704,772285,짐바브웨,2000-06
2000-06-30,1170819,0,1170819,불령 리유니온 코모도 제도,2000-06
2000-06-30,1166105,1596223,-430118,탄자니아,2000-06
2000-06-30,1158299,17933614,-16775315,파푸아 뉴기니,2000-06
2000-06-30,1145274,0,1145274,베닝,2000-06
2000-06-30,1124011,0,1124011,과델로프,2000-06
2000-06-30,1007153,42899,964254,에티오피아,2000-06
2000-06-30,1006220,460,1005760,아이티,2000-06
2000-06-30,969346,0,969346,마티니크,2000-06
2000-06-30,966595,2563,964032,사모아,2000-06
2000-06-30,924282,1122,923160,뉴 칼레도니아,2000-06
2000-06-30,893672,4383,889289,마다카스카르,2000-06
2000-06-30,857556,104898234,-104040678,앙골라,2000-06
2000-06-30,833219,0,833219,불령 폴리네시아,2000-06
2000-06-30,789270,36122,753148,볼리비아,2000-06
2000-06-30,769814,2255,767559,세네갈,2000-06
2000-06-30,741736,766,740970,니제르,2000-06
2000-06-30,720420,33928262,-33207842,콩고,2000-06
2000-06-30,710641,22000836,-21290195,브루나이,2000-06
2000-06-30,640429,0,640429,마세도니아,2000-06
2000-06-30,619226,2726275,-2107049,스와질랜드,2000-06
2000-06-30,572307,42778,529529,피지,2000-06
2000-06-30,568804,0,568804,마이크로네시아,2000-06
2000-06-30,513530,4832,508698,라트비아,2000-06
2000-06-30,511989,125124,386865,도미니카,2000-06
2000-06-30,455274,0,455274,바베이도스,2000-06
2000-06-30,434110,1232044,-797934,타지크,2000-06
2000-06-30,420362,14044,406318,팔레스타인 해방기구(구),2000-06
2000-06-30,416952,1913957,-1497005,솔로몬 군도,2000-06
2000-06-30,405386,637175,-231789,벨라루스,2000-06
2000-06-30,387371,0,387371,아제르바이잔,2000-06
2000-06-30,368335,80,368255,모잠비크,2000-06
2000-06-30,365402,0,365402,알바니아,2000-06
2000-06-30,332990,0,332990,소말리아,2000-06
2000-06-30,328249,3771068,-3442819,룩셈부르그,2000-06
2000-06-30,322863,0,322863,감비아,2000-06
2000-06-30,319485,0,319485,보스니아-헤르체고비나,2000-06
2000-06-30,311561,9334,302227,티모르,2000-06
2000-06-30,306420,176279,130141,카메룬,2000-06
2000-06-30,294780,0,294780,버뮤다,2000-06
2000-06-30,288620,0,288620,투르크 & 카이코스 군도,2000-06
2000-06-30,284340,169,284171,우간다,2000-06
2000-06-30,280682,0,280682,에리트리아,2000-06
2000-06-30,269359,0,269359,말라위,2000-06
2000-06-30,251404,58600818,-58349414,가봉,2000-06
2000-06-30,243852,0,243852,아루바,2000-06
2000-06-30,242955,1645,241310,라오스,2000-06
2000-06-30,235000,6259,228741,팔라우,2000-06
2000-06-30,229572,3373,226199,안티가 바부다,2000-06
2000-06-30,223065,11613,211452,조지아,2000-06
2000-06-30,212019,203372,8647,기니,2000-06
2000-06-30,180984,42375,138609,가이아나,2000-06
2000-06-30,178922,0,178922,몰디브,2000-06
2000-06-30,172222,8317,163905,몰도바,2000-06
2000-06-30,163135,2402,160733,벨리제,2000-06
2000-06-30,139640,8651,130989,아메리칸 사모아,2000-06
2000-06-30,132590,0,132590,불령 가이아나,2000-06
2000-06-30,127645,84977,42668,바누아투,2000-06
2000-06-30,122130,0,122130,수리남,2000-06
2000-06-30,121260,0,121260,네덜란드 열도,2000-06
2000-06-30,121089,4661,116428,잠비아,2000-06
2000-06-30,120163,0,120163,콩고민주공화국,2000-06
2000-06-30,107546,87024,20522,영령 버진군도,2000-06
2000-06-30,104620,0,104620,모리타니,2000-06
2000-06-30,71684,0,71684,보츠와나,2000-06
2000-06-30,70896,0,70896,세이쉘,2000-06
2000-06-30,65317,0,65317,그레나다,2000-06
2000-06-30,49341,0,49341,영령 캐이맨 군도,2000-06
2000-06-30,42630,51630,-9000,부탄,2000-06
2000-06-30,37267,0,37267,쿡 아일랜드,2000-06
2000-06-30,37236,0,37236,시에라 리온,2000-06
2000-06-30,35506,1050,34456,아르메니아,2000-06
2000-06-30,33516,248118,-214602,안도라,2000-06
2000-06-30,29782,0,29782,포클랜드 군도,2000-06
2000-06-30,26486,38344,-11858,르완다,2000-06
2000-06-30,24232,278897,-254665,나미비아,2000-06
2000-06-30,22610,536978,-514368,말리,2000-06
2000-06-30,20293,0,20293,세인트 루시아,2000-06
2000-06-30,18971,1718,17253,통가,2000-06
2000-06-30,18274,0,18274,중앙아프리카공화국,2000-06
2000-06-30,10755,8775,1980,미령 버진군도,2000-06
2000-06-30,9000,0,9000,파로에 군도,2000-06
2000-06-30,6170,0,6170,세인트 빈센트 그레나딘,2000-06
2000-06-30,4228,0,4228,불령 남부지역,2000-06
2000-06-30,4210,0,4210,크리스마스 아일랜드,2000-06
2000-06-30,2583,0,2583,카보 베르데,2000-06
2000-06-30,951,0,951,챠드,2000-06
2000-06-30,700,214675,-213975,모나코,2000-06
2000-06-30,538,0,538,산마리노,2000-06
2000-06-30,436,391,45,지브랄타,2000-06
2000-06-30,374,0,374,세인트 키츠 네비스,2000-06
2000-06-30,0,25590,-25590,리히텐슈타인,2000-06
2000-06-30,0,33400,-33400,미드웨이 군도,2000-06
2000-06-30,0,13515761,-13515761,중립지대,2000-06
2000-06-30,0,92375,-92375,프랑스 메트로폴리탄,2000-06
2000-06-30,0,138838,-138838,부르키나 파소,2000-06
2000-06-30,0,226830,-226830,기네비소,2000-06
2000-06-30,0,40522,-40522,세인트 헬레나,2000-06
2000-06-30,0,525342,-525342,적도 기니,2000-06
2000-06-30,0,982,-982,존스톤 아일랜드,2000-06
2000-06-30,0,65763,-65763,상토메 프린스페,2000-06
2000-06-30,0,41929,-41929,그린랜드,2000-06
2000-06-30,0,2057,-2057,교황청,2000-06
2000-07-31,3255804253,2424238666,831565587,미국,2000-07
2000-07-31,1645587937,2684791704,-1039203767,일본,2000-07
2000-07-31,1606725442,1054369747,552355695,중국,2000-07
2000-07-31,870993704,109996839,760996865,홍콩,2000-07
2000-07-31,685114613,401203473,283911140,대만,2000-07
2000-07-31,481162292,229096879,252065413,영국,2000-07
2000-07-31,468117000,355035903,113081097,독일,2000-07
2000-07-31,451699699,311969806,139729893,싱가포르,2000-07
2000-07-31,316838593,359969427,-43130834,말레이시아,2000-07
2000-07-31,304907672,151685230,153222442,필리핀,2000-07
2000-07-31,261219635,391021718,-129802083,인도네시아,2000-07
2000-07-31,251004444,105278516,145725928,네덜란드,2000-07
2000-07-31,228269302,490397453,-262128151,호주,2000-07
2000-07-31,223013663,34872722,188140941,멕시코,2000-07
2000-07-31,191977342,170131986,21845356,이탈리아,2000-07
2000-07-31,183031239,202775031,-19743792,이란,2000-07
2000-07-31,180638016,152576910,28061106,캐나다,2000-07
2000-07-31,179021866,401115030,-222093164,아랍에미리트 연합,2000-07
2000-07-31,170003460,141543922,28459538,태국,2000-07
2000-07-31,152661555,86399017,66262538,브라질,2000-07
2000-07-31,137391132,24664196,112726936,베트남,2000-07
2000-07-31,135002414,198329849,-63327435,프랑스,2000-07
2000-07-31,131384426,2487550,128896876,튀르키예,2000-07
2000-07-31,125029183,28289236,96739947,스페인,2000-07
2000-07-31,97464989,57966688,39498301,벨기에,2000-07
2000-07-31,89116395,94049062,-4932667,인도,2000-07
2000-07-31,82072525,963874062,-881801537,사우디아라비아,2000-07
2000-07-31,65453956,47878176,17575780,이스라엘,2000-07
2000-07-31,63059530,88325993,-25266463,스위스,2000-07
2000-07-31,57263415,1606162,55657253,방글라데시,2000-07
2000-07-31,56275861,1150206,55125655,파나마,2000-07
2000-07-31,55068043,180294639,-125226596,러시아 연방,2000-07
2000-07-31,54618193,2886377,51731816,폴란드,2000-07
2000-07-31,51804835,72444729,-20639894,칠레,2000-07
2000-07-31,49932675,7301047,42631628,아르헨티나,2000-07
2000-07-31,45491484,25706036,19785448,덴마크,2000-07
2000-07-31,44818936,3346027,41472909,몰타,2000-07
2000-07-31,44613631,274863234,-230249603,쿠웨이트,2000-07
2000-07-31,42777554,88230663,-45453109,남아프리카공화국,2000-07
2000-07-31,42383445,115085486,-72702041,카타르,2000-07
2000-07-31,42256747,44312,42212435,과테말라,2000-07
2000-07-31,41693533,31761263,9932270,핀란드,2000-07
2000-07-31,41054062,112933899,-71879837,아일랜드,2000-07
2000-07-31,39825678,5240141,34585537,이집트,2000-07
2000-07-31,33532557,40932774,-7400217,스웨덴,2000-07
2000-07-31,28871313,22409255,6462058,오스트리아,2000-07
2000-07-31,27458102,4322967,23135135,스리랑카,2000-07
2000-07-31,26878916,2065582,24813334,포루투갈,2000-07
2000-07-31,25557928,195536,25362392,베네주엘라,2000-07
2000-07-31,25397089,22763722,2633367,파키스탄,2000-07
2000-07-31,23323230,31871327,-8548097,나이지리아,2000-07
2000-07-31,23290932,1216575,22074357,그리스,2000-07
2000-07-31,23155171,443,23154728,라이베리아,2000-07
2000-07-31,22633381,61621797,-38988416,뉴질랜드,2000-07
2000-07-31,21835929,1486457,20349472,미얀마,2000-07
2000-07-31,19972306,612970,19359336,시리아,2000-07
2000-07-31,17935567,183386026,-165450459,오만,2000-07
2000-07-31,17122865,180052,16942813,괌,2000-07
2000-07-31,16760505,5599250,11161255,푸에르토리코,2000-07
2000-07-31,16672161,3328349,13343812,기타국,2000-07
2000-07-31,16416034,7549147,8866887,우즈베키스탄,2000-07
2000-07-31,16336712,5909976,10426736,페루,2000-07
2000-07-31,14452712,7922779,6529933,알제리,2000-07
2000-07-31,14307411,4738500,9568911,도미니카 공화국,2000-07
2000-07-31,14036709,2993074,11043635,콜롬비아,2000-07
2000-07-31,13998275,10651291,3346984,헝가리,2000-07
2000-07-31,13297512,1270030,12027482,우루과이,2000-07
2000-07-31,12751835,90625791,-77873956,노르웨이,2000-07
2000-07-31,12677403,31547289,-18869886,우크라이나,2000-07
2000-07-31,11377115,1619752,9757363,온두라스,2000-07
2000-07-31,10809123,336736,10472387,요르단,2000-07
2000-07-31,10747341,2718268,8029073,루마니아,2000-07
2000-07-31,9578599,309102,9269497,레바논,2000-07
2000-07-31,8508476,20664813,-12156337,코스타리카,2000-07
2000-07-31,7527858,116990,7410868,캄보디아,2000-07
2000-07-31,6747602,707305,6040297,에쿠아도르,2000-07
2000-07-31,6656248,2611548,4044700,카자흐스탄,2000-07
2000-07-31,6384906,1498722,4886184,모로코,2000-07
2000-07-31,5982592,0,5982592,아프카니스탄,2000-07
2000-07-31,5737695,1905556,3832139,튀니지,2000-07
2000-07-31,5726993,42474,5684519,마카오,2000-07
2000-07-31,5366809,65118,5301691,엘살바도르,2000-07
2000-07-31,5007316,30146,4977170,북마리아나 군도,2000-07
2000-07-31,4982630,1338198,3644432,슬로베니아,2000-07
2000-07-31,4775282,156087,4619195,몽골,2000-07
2000-07-31,4575525,3085984,1489541,수단,2000-07
2000-07-31,4272085,97365,4174720,사이프러스,2000-07
2000-07-31,4031311,112,4031199,니카라과,2000-07
2000-07-31,3595144,185750,3409394,가나,2000-07
2000-07-31,3445438,92279477,-88834039,예맨,2000-07
2000-07-31,3410998,1458234,1952764,불가리아,2000-07
2000-07-31,3366405,32019700,-28653295,바레인,2000-07
2000-07-31,3233716,10955509,-7721793,체코공화국,2000-07
2000-07-31,2779203,106378,2672825,모리셔스,2000-07
2000-07-31,2738095,119481,2618614,크로아티아,2000-07
2000-07-31,2561414,153942,2407472,케냐,2000-07
2000-07-31,2487834,28157,2459677,토고,2000-07
2000-07-31,2392793,12014,2380779,파라과이,2000-07
2000-07-31,2088908,87665786,-85576878,앙골라,2000-07
2000-07-31,2014336,14637,1999699,코트디봐르,2000-07
2000-07-31,1957356,29002928,-27045572,브루나이,2000-07
2000-07-31,1831850,11968954,-10137104,이라크,2000-07
2000-07-31,1694961,0,1694961,지부티,2000-07
2000-07-31,1687618,9502,1678116,팔레스타인 해방기구(구),2000-07
2000-07-31,1631336,157228,1474108,유고,2000-07
2000-07-31,1540217,0,1540217,트리니다드 토바고,2000-07
2000-07-31,1497066,620406,876660,에스토니아,2000-07
2000-07-31,1435118,430898,1004220,네팔,2000-07
2000-07-31,1424860,123,1424737,리비아,2000-07
2000-07-31,1348423,101138,1247285,레소토,2000-07
2000-07-31,1334585,44211389,-42876804,콩고,2000-07
2000-07-31,1272182,0,1272182,불령 리유니온 코모도 제도,2000-07
2000-07-31,1232569,122172,1110397,키르기스스탄,2000-07
2000-07-31,1204383,461230,743153,슬로바키아,2000-07
2000-07-31,1161089,65845,1095244,세네갈,2000-07
2000-07-31,1148005,16105,1131900,자마이카,2000-07
2000-07-31,1116886,5296,1111590,바하마,2000-07
2000-07-31,1064013,96040,967973,에티오피아,2000-07
2000-07-31,1007429,64740,942689,탄자니아,2000-07
2000-07-31,994438,43042,951396,마다카스카르,2000-07
2000-07-31,936181,347002,589179,카메룬,2000-07
2000-07-31,933514,0,933514,사모아,2000-07
2000-07-31,880707,2611080,-1730373,벨라루스,2000-07
2000-07-31,838067,4686794,-3848727,리투아니아,2000-07
2000-07-31,811870,57080,754790,도미니카,2000-07
2000-07-31,804059,255956,548103,아이슬란드,2000-07
2000-07-31,764419,0,764419,아이티,2000-07
2000-07-31,718693,41267,677426,짐바브웨,2000-07
2000-07-31,707460,0,707460,베닝,2000-07
2000-07-31,692598,5709044,-5016446,스와질랜드,2000-07
2000-07-31,690954,0,690954,투르크멘,2000-07
2000-07-31,687776,0,687776,과델로프,2000-07
2000-07-31,627000,278369,348631,니제르,2000-07
2000-07-31,613768,0,613768,마세도니아,2000-07
2000-07-31,552268,4151,548117,마이크로네시아,2000-07
2000-07-31,537917,0,537917,마티니크,2000-07
2000-07-31,531475,0,531475,모잠비크,2000-07
2000-07-31,526354,212533,313821,라트비아,2000-07
2000-07-31,482197,0,482197,아루바,2000-07
2000-07-31,452250,1136,451114,바베이도스,2000-07
2000-07-31,442559,12324661,-11882102,뉴 칼레도니아,2000-07
2000-07-31,416826,89652,327174,잠비아,2000-07
2000-07-31,395527,47984,347543,피지,2000-07
2000-07-31,370899,1732791,-1361892,볼리비아,2000-07
2000-07-31,367838,8501435,-8133597,파푸아 뉴기니,2000-07
2000-07-31,362356,200952,161404,벨리제,2000-07
2000-07-31,353637,1228609,-874972,룩셈부르그,2000-07
2000-07-31,338229,41270,296959,우간다,2000-07
2000-07-31,310611,0,310611,불령 폴리네시아,2000-07
2000-07-31,287210,335,286875,말라위,2000-07
2000-07-31,282639,0,282639,아르메니아,2000-07
2000-07-31,278095,118,277977,안티가 바부다,2000-07
2000-07-31,274664,1462676,-1188012,타지크,2000-07
2000-07-31,269353,0,269353,아제르바이잔,2000-07
2000-07-31,260557,39082,221475,바누아투,2000-07
2000-07-31,244690,0,244690,르완다,2000-07
2000-07-31,233106,0,233106,라오스,2000-07
2000-07-31,223663,442884,-219221,몰도바,2000-07
2000-07-31,208039,2090117,-1882078,말리,2000-07
2000-07-31,207911,0,207911,마샬군도,2000-07
2000-07-31,202459,0,202459,알바니아,2000-07
2000-07-31,191195,973781,-782586,가봉,2000-07
2000-07-31,180750,28986470,-28805720,기니,2000-07
2000-07-31,179992,0,179992,수리남,2000-07
2000-07-31,167379,5709,161670,아메리칸 사모아,2000-07
2000-07-31,158873,0,158873,보스니아-헤르체고비나,2000-07
2000-07-31,140324,827599,-687275,나미비아,2000-07
2000-07-31,129985,0,129985,부탄,2000-07
2000-07-31,126111,185963,-59852,조지아,2000-07
2000-07-31,113366,1334195,-1220829,가이아나,2000-07
2000-07-31,103454,0,103454,팔라우,2000-07
2000-07-31,98743,58,98685,에리트리아,2000-07
2000-07-31,89002,0,89002,그레나다,2000-07
2000-07-31,86443,0,86443,시에라 리온,2000-07
2000-07-31,73736,166447,-92711,모나코,2000-07
2000-07-31,71650,2930,68720,투르크 & 카이코스 군도,2000-07
2000-07-31,71506,0,71506,부룬디,2000-07
2000-07-31,65369,0,65369,모리타니,2000-07
2000-07-31,54345,48422,5923,미령 버진군도,2000-07
2000-07-31,53628,7857,45771,보츠와나,2000-07
2000-07-31,53213,0,53213,버뮤다,2000-07
2000-07-31,49993,137251,-87258,부르키나 파소,2000-07
2000-07-31,48422,6224,42198,소말리아,2000-07
2000-07-31,48124,0,48124,세인트 루시아,2000-07
2000-07-31,47928,0,47928,영령 캐이맨 군도,2000-07
2000-07-31,46793,0,46793,콩고민주공화국,2000-07
2000-07-31,42506,0,42506,몰디브,2000-07
2000-07-31,37082,0,37082,통가,2000-07
2000-07-31,33353,20077,13276,안도라,2000-07
2000-07-31,26778,0,26778,네덜란드 열도,2000-07
2000-07-31,22367,0,22367,캔톤아일랜드,2000-07
2000-07-31,22154,0,22154,투발루,2000-07
2000-07-31,17022,0,17022,불령 가이아나,2000-07
2000-07-31,14339,0,14339,세인트 빈센트 그레나딘,2000-07
2000-07-31,11700,0,11700,세이쉘,2000-07
2000-07-31,11100,2064,9036,영령 버진군도,2000-07
2000-07-31,10702,0,10702,세인트 키츠 네비스,2000-07
2000-07-31,10647,13706615,-13695968,중립지대,2000-07
2000-07-31,7340,0,7340,코모로스,2000-07
2000-07-31,3931,343373,-339442,솔로몬 군도,2000-07
2000-07-31,1524,4113,-2589,감비아,2000-07
2000-07-31,1044,0,1044,지브랄타,2000-07
2000-07-31,300,45560,-45260,크리스마스 아일랜드,2000-07
2000-07-31,118,1805,-1687,코스 군도,2000-07
2000-07-31,30,0,30,챠드,2000-07
2000-07-31,0,224480,-224480,적도 기니,2000-07
2000-07-31,0,1409,-1409,토켈라우,2000-07
2000-07-31,0,1613,-1613,프랑스 메트로폴리탄,2000-07
2000-07-31,0,23784,-23784,리히텐슈타인,2000-07
2000-07-31,0,843,-843,피트카이른,2000-07
2000-07-31,0,7452,-7452,존스톤 아일랜드,2000-07
2000-07-31,0,162162,-162162,기네비소,2000-07
2000-07-31,0,120,-120,앙귈라,2000-07
2000-07-31,0,36959,-36959,산마리노,2000-07
2000-07-31,0,27312,-27312,쿡 아일랜드,2000-07
2000-07-31,0,65044,-65044,그린랜드,2000-07
2000-07-31,0,957,-957,세인트 헬레나,2000-07
2000-08-31,3267078390,2653137852,613940538,미국,2000-08
2000-08-31,1685673813,1101617829,584055984,중국,2000-08
2000-08-31,1678044413,2695205041,-1017160628,일본,2000-08
2000-08-31,923675716,114348303,809327413,홍콩,2000-08
2000-08-31,718918319,400599818,318318501,대만,2000-08
2000-08-31,542076455,293440778,248635677,싱가포르,2000-08
2000-08-31,456787803,229558335,227229468,영국,2000-08
2000-08-31,404548782,412353552,-7804770,독일,2000-08
2000-08-31,357854247,369846269,-11992022,인도네시아,2000-08
2000-08-31,342819644,391866690,-49047046,말레이시아,2000-08
2000-08-31,309890892,153639650,156251242,필리핀,2000-08
2000-08-31,275907699,179903605,96004094,캐나다,2000-08
2000-08-31,249081309,2182653,246898656,파나마,2000-08
2000-08-31,216891589,545873154,-328981565,호주,2000-08
2000-08-31,208115281,74921047,133194234,네덜란드,2000-08
2000-08-31,207190674,24983050,182207624,멕시코,2000-08
2000-08-31,168470634,400884957,-232414323,아랍에미리트 연합,2000-08
2000-08-31,160114974,133704019,26410955,태국,2000-08
2000-08-31,152972624,99178079,53794545,브라질,2000-08
2000-08-31,123184067,229207407,-106023340,프랑스,2000-08
2000-08-31,121056169,25932812,95123357,베트남,2000-08
2000-08-31,117209276,183045222,-65835946,이란,2000-08
2000-08-31,114015251,28302706,85712545,스페인,2000-08
2000-08-31,112952708,166800832,-53848124,이탈리아,2000-08
2000-08-31,98737408,0,98737408,라이베리아,2000-08
2000-08-31,94958995,7073693,87885302,튀르키예,2000-08
2000-08-31,94870555,598699527,-503828972,사우디아라비아,2000-08
2000-08-31,89908660,85455975,4452685,인도,2000-08
2000-08-31,80283516,58685213,21598303,벨기에,2000-08
2000-08-31,75000909,1315202,73685707,그리스,2000-08
2000-08-31,71846039,197606881,-125760842,러시아 연방,2000-08
2000-08-31,59566073,32331373,27234700,이스라엘,2000-08
2000-08-31,51132843,29996,51102847,바하마,2000-08
2000-08-31,48583319,2017525,46565794,방글라데시,2000-08
2000-08-31,48027715,113094550,-65066835,아일랜드,2000-08
2000-08-31,47252035,3771616,43480419,이집트,2000-08
2000-08-31,44434563,4560037,39874526,폴란드,2000-08
2000-08-31,42096419,75961666,-33865247,스위스,2000-08
2000-08-31,41830014,25652154,16177860,아르헨티나,2000-08
2000-08-31,41645577,83772176,-42126599,남아프리카공화국,2000-08
2000-08-31,41011642,92417331,-51405689,칠레,2000-08
2000-08-31,39638169,49650878,-10012709,스웨덴,2000-08
2000-08-31,39466139,30629020,8837119,핀란드,2000-08
2000-08-31,39213991,125468,39088523,과테말라,2000-08
2000-08-31,29202130,2092968,27109162,포루투갈,2000-08
2000-08-31,27833081,3482403,24350678,스리랑카,2000-08
2000-08-31,27567497,294421,27273076,괌,2000-08
2000-08-31,25403827,22719972,2683855,파키스탄,2000-08
2000-08-31,21072826,4814,21068012,마샬군도,2000-08
2000-08-31,20963197,190533372,-169570175,쿠웨이트,2000-08
2000-08-31,20636229,111899084,-91262855,오만,2000-08
2000-08-31,20455614,52769475,-32313861,뉴질랜드,2000-08
2000-08-31,19827263,6569638,13257625,콜롬비아,2000-08
2000-08-31,19521197,52494,19468703,나이지리아,2000-08
2000-08-31,19194294,4112108,15082186,베네주엘라,2000-08
2000-08-31,18879424,1191887,17687537,시리아,2000-08
2000-08-31,18385479,18241604,143875,페루,2000-08
2000-08-31,17017572,30024895,-13007323,덴마크,2000-08
2000-08-31,14931376,18514452,-3583076,오스트리아,2000-08
2000-08-31,14922292,6678257,8244035,우즈베키스탄,2000-08
2000-08-31,14748349,2389505,12358844,푸에르토리코,2000-08
2000-08-31,14482576,3091920,11390656,기타국,2000-08
2000-08-31,14325460,2516000,11809460,알제리,2000-08
2000-08-31,14278388,7300669,6977719,헝가리,2000-08
2000-08-31,14268273,44190484,-29922211,우크라이나,2000-08
2000-08-31,11950857,25611014,-13660157,노르웨이,2000-08
2000-08-31,11579084,4751211,6827873,도미니카 공화국,2000-08
2000-08-31,11026532,4806866,6219666,온두라스,2000-08
2000-08-31,10463590,69853,10393737,요르단,2000-08
2000-08-31,10089052,2130456,7958596,우루과이,2000-08
2000-08-31,9659875,1484802,8175073,미얀마,2000-08
2000-08-31,9053452,2723550,6329902,루마니아,2000-08
2000-08-31,8885054,1496800,7388254,카자흐스탄,2000-08
2000-08-31,8171050,8818411,-647361,코스타리카,2000-08
2000-08-31,7862618,37529,7825089,캄보디아,2000-08
2000-08-31,7753382,46959,7706423,북마리아나 군도,2000-08
2000-08-31,7132505,0,7132505,아프카니스탄,2000-08
2000-08-31,7062383,33319,7029064,엘살바도르,2000-08
2000-08-31,6887622,145276612,-138388990,카타르,2000-08
2000-08-31,6845018,461726,6383292,레바논,2000-08
2000-08-31,6500236,1535317,4964919,수단,2000-08
2000-08-31,6296598,352517,5944081,가나,2000-08
2000-08-31,5985635,1401406,4584229,모로코,2000-08
2000-08-31,5922014,37416077,-31494063,에쿠아도르,2000-08
2000-08-31,5236488,6712,5229776,니카라과,2000-08
2000-08-31,5058623,932142,4126481,에스토니아,2000-08
2000-08-31,4846737,1178171,3668566,슬로베니아,2000-08
2000-08-31,4660333,11123163,-6462830,체코공화국,2000-08
2000-08-31,4515197,209178,4306019,튀니지,2000-08
2000-08-31,4476874,133888,4342986,사이프러스,2000-08
2000-08-31,4111872,9641653,-5529781,바레인,2000-08
2000-08-31,4002486,0,4002486,파라과이,2000-08
2000-08-31,3896253,240019,3656234,마카오,2000-08
2000-08-31,3582802,135036,3447766,몽골,2000-08
2000-08-31,3227153,16388,3210765,크로아티아,2000-08
2000-08-31,3123179,35872,3087307,탄자니아,2000-08
2000-08-31,3070092,137718,2932374,케냐,2000-08
2000-08-31,2950543,610868,2339675,모리셔스,2000-08
2000-08-31,2942883,37334034,-34391151,예맨,2000-08
2000-08-31,2528257,6224,2522033,토고,2000-08
2000-08-31,2285338,0,2285338,트리니다드 토바고,2000-08
2000-08-31,2193463,29823,2163640,자마이카,2000-08
2000-08-31,1910144,0,1910144,리비아,2000-08
2000-08-31,1856037,1226565,629472,리투아니아,2000-08
2000-08-31,1782986,760218,1022768,네팔,2000-08
2000-08-31,1770668,6516,1764152,키르기스스탄,2000-08
2000-08-31,1586853,51476,1535377,에티오피아,2000-08
2000-08-31,1511613,0,1511613,지부티,2000-08
2000-08-31,1494072,48098,1445974,도미니카,2000-08
2000-08-31,1421151,0,1421151,시에라 리온,2000-08
2000-08-31,1350672,23705216,-22354544,브루나이,2000-08
2000-08-31,1323018,94,1322924,코트디봐르,2000-08
2000-08-31,1312762,3374949,-2062187,몰타,2000-08
2000-08-31,1204059,61602309,-60398250,앙골라,2000-08
2000-08-31,1170888,484134,686754,불가리아,2000-08
2000-08-31,1157179,0,1157179,보츠와나,2000-08
2000-08-31,1056936,36335,1020601,세네갈,2000-08
2000-08-31,1040431,0,1040431,투르크멘,2000-08
2000-08-31,986454,1387,985067,과델로프,2000-08
2000-08-31,904329,0,904329,베닝,2000-08
2000-08-31,901866,0,901866,사모아,2000-08
2000-08-31,893051,106251283,-105358232,이라크,2000-08
2000-08-31,872449,0,872449,아루바,2000-08
2000-08-31,836469,2336,834133,아이티,2000-08
2000-08-31,815491,1865300,-1049809,스와질랜드,2000-08
2000-08-31,783229,0,783229,불령 폴리네시아,2000-08
2000-08-31,776416,68184,708232,레소토,2000-08
2000-08-31,773698,0,773698,불령 리유니온 코모도 제도,2000-08
2000-08-31,732239,0,732239,모잠비크,2000-08
2000-08-31,723230,1555648,-832418,룩셈부르그,2000-08
2000-08-31,695178,53075,642103,마다카스카르,2000-08
2000-08-31,678094,95686,582408,팔레스타인 해방기구(구),2000-08
2000-08-31,655756,180850,474906,볼리비아,2000-08
2000-08-31,644319,935736,-291417,슬로바키아,2000-08
2000-08-31,634417,7024099,-6389682,파푸아 뉴기니,2000-08
2000-08-31,607893,471113,136780,라트비아,2000-08
2000-08-31,571035,5284336,-4713301,뉴 칼레도니아,2000-08
2000-08-31,537038,0,537038,바베이도스,2000-08
2000-08-31,533189,42447,490742,피지,2000-08
2000-08-31,531148,158450,372698,기니,2000-08
2000-08-31,517500,0,517500,마이너 아우틀링 합중국 군도,2000-08
2000-08-31,500888,540696,-39808,아이슬란드,2000-08
2000-08-31,499781,515103,-15322,짐바브웨,2000-08
2000-08-31,496118,118262,377856,팔라우,2000-08
2000-08-31,352905,80066,272839,콩고,2000-08
2000-08-31,336453,70177,266276,우간다,2000-08
2000-08-31,331024,388720,-57696,유고,2000-08
2000-08-31,315032,256371,58661,벨리제,2000-08
2000-08-31,309144,0,309144,부룬디,2000-08
2000-08-31,293370,1949183,-1655813,벨라루스,2000-08
2000-08-31,287081,0,287081,안티가 바부다,2000-08
2000-08-31,279451,0,279451,에리트리아,2000-08
2000-08-31,275746,73743,202003,마이크로네시아,2000-08
2000-08-31,268476,30158,238318,카메룬,2000-08
2000-08-31,236048,0,236048,마세도니아,2000-08
2000-08-31,234528,2400,232128,네덜란드 열도,2000-08
2000-08-31,232851,741086,-508235,가봉,2000-08
2000-08-31,218582,0,218582,마티니크,2000-08
2000-08-31,207844,48418,159426,아제르바이잔,2000-08
2000-08-31,207386,0,207386,알바니아,2000-08
2000-08-31,191686,0,191686,몰도바,2000-08
2000-08-31,187060,0,187060,챠드,2000-08
2000-08-31,186992,0,186992,가이아나,2000-08
2000-08-31,177874,0,177874,수리남,2000-08
2000-08-31,177140,5581,171559,말라위,2000-08
2000-08-31,176451,64892,111559,니제르,2000-08
2000-08-31,170605,0,170605,아르메니아,2000-08
2000-08-31,166805,1842,164963,아메리칸 사모아,2000-08
2000-08-31,157112,150371,6741,바누아투,2000-08
2000-08-31,148260,0,148260,라오스,2000-08
2000-08-31,132031,435325,-303294,조지아,2000-08
2000-08-31,132000,0,132000,투르크 & 카이코스 군도,2000-08
2000-08-31,130827,0,130827,영령 캐이맨 군도,2000-08
2000-08-31,121573,159281,-37708,나미비아,2000-08
2000-08-31,116147,92717,23430,잠비아,2000-08
2000-08-31,111238,213639,-102401,안도라,2000-08
2000-08-31,85085,0,85085,세이쉘,2000-08
2000-08-31,84585,0,84585,미령 버진군도,2000-08
2000-08-31,78936,0,78936,몰디브,2000-08
2000-08-31,70927,0,70927,키리바티,2000-08
2000-08-31,70550,789198,-718648,말리,2000-08
2000-08-31,69239,1200850,-1131611,타지크,2000-08
2000-08-31,68981,1453,67528,그레나다,2000-08
2000-08-31,68237,34356,33881,감비아,2000-08
2000-08-31,62064,0,62064,버뮤다,2000-08
2000-08-31,57500,0,57500,세인트 루시아,2000-08
2000-08-31,50829,0,50829,불령 가이아나,2000-08
2000-08-31,47627,1723,45904,모리타니,2000-08
2000-08-31,44683,0,44683,소말리아,2000-08
2000-08-31,41021,0,41021,콩고민주공화국,2000-08
2000-08-31,41002,0,41002,쿡 아일랜드,2000-08
2000-08-31,38334,3314,35020,보스니아-헤르체고비나,2000-08
2000-08-31,33848,138750,-104902,부르키나 파소,2000-08
2000-08-31,29504,0,29504,부탄,2000-08
2000-08-31,26010,0,26010,중앙아프리카공화국,2000-08
2000-08-31,25480,0,25480,세인트 빈센트 그레나딘,2000-08
2000-08-31,23030,184082,-161052,모나코,2000-08
2000-08-31,14800,851,13949,적도 기니,2000-08
2000-08-31,14658,0,14658,카보 베르데,2000-08
2000-08-31,8690,0,8690,파로에 군도,2000-08
2000-08-31,8262,332,7930,르완다,2000-08
2000-08-31,3359,1618898,-1615539,솔로몬 군도,2000-08
2000-08-31,2426,165,2261,프랑스 메트로폴리탄,2000-08
2000-08-31,1092,106159,-105067,리히텐슈타인,2000-08
2000-08-31,880,0,880,팔레스타인 해방기구,2000-08
2000-08-31,679,0,679,토켈라우,2000-08
2000-08-31,506,0,506,상토메 프린스페,2000-08
2000-08-31,170,18321,-18151,포클랜드 군도,2000-08
2000-08-31,0,127400,-127400,지브랄타,2000-08
2000-08-31,0,69526,-69526,그린랜드,2000-08
2000-08-31,0,197706,-197706,기네비소,2000-08
2000-08-31,0,13129788,-13129788,중립지대,2000-08
2000-08-31,0,12526,-12526,불령 남부지역,2000-08
2000-08-31,0,208,-208,노폴크 아일랜드,2000-08
2000-09-30,3510988785,2415664337,1095324448,미국,2000-09
2000-09-30,1900124085,2616615454,-716491369,일본,2000-09
2000-09-30,1592373209,1079237580,513135629,중국,2000-09
2000-09-30,943856029,87975703,855880326,홍콩,2000-09
2000-09-30,707361147,428338143,279023004,대만,2000-09
2000-09-30,505635621,313242429,192393192,싱가포르,2000-09
2000-09-30,467753123,246131718,221621405,영국,2000-09
2000-09-30,357737696,398550083,-40812387,독일,2000-09
2000-09-30,347461547,400271300,-52809753,인도네시아,2000-09
2000-09-30,299303655,342937264,-43633609,말레이시아,2000-09
2000-09-30,275053121,168226470,106826651,필리핀,2000-09
2000-09-30,228462721,33688190,194774531,멕시코,2000-09
2000-09-30,208806041,165031581,43774460,캐나다,2000-09
2000-09-30,208163437,413359942,-205196505,호주,2000-09
2000-09-30,206332864,88352213,117980651,네덜란드,2000-09
2000-09-30,176539650,136802999,39736651,태국,2000-09
2000-09-30,175932444,88232554,87699890,브라질,2000-09
2000-09-30,160712504,404624975,-243912471,아랍에미리트 연합,2000-09
2000-09-30,133096306,1204485,131891821,그리스,2000-09
2000-09-30,133096049,127932786,5163263,이탈리아,2000-09
2000-09-30,127921283,27394257,100527026,베트남,2000-09
2000-09-30,127473725,195610970,-68137245,프랑스,2000-09
2000-09-30,111878421,12663543,99214878,노르웨이,2000-09
2000-09-30,106313190,7732128,98581062,파나마,2000-09
2000-09-30,101781801,23673215,78108586,덴마크,2000-09
2000-09-30,100594730,4446,100590284,라이베리아,2000-09
2000-09-30,98298591,26802854,71495737,스페인,2000-09
2000-09-30,98184155,846542067,-748357912,사우디아라비아,2000-09
2000-09-30,94733210,207778405,-113045195,이란,2000-09
2000-09-30,92730815,71893140,20837675,인도,2000-09
2000-09-30,85297687,54155193,31142494,벨기에,2000-09
2000-09-30,79124086,3529176,75594910,튀르키예,2000-09
2000-09-30,70824357,238266848,-167442491,러시아 연방,2000-09
2000-09-30,60171283,22468705,37702578,이스라엘,2000-09
2000-09-30,53903149,1668046,52235103,방글라데시,2000-09
2000-09-30,46103394,96289377,-50185983,아일랜드,2000-09
2000-09-30,45256012,31037468,14218544,핀란드,2000-09
2000-09-30,44914797,3064356,41850441,이집트,2000-09
2000-09-30,44700243,87775649,-43075406,남아프리카공화국,2000-09
2000-09-30,43772473,63277433,-19504960,칠레,2000-09
2000-09-30,43586226,82494775,-38908549,스위스,2000-09
2000-09-30,42206450,182879,42023571,과테말라,2000-09
2000-09-30,41456078,220320856,-178864778,쿠웨이트,2000-09
2000-09-30,40284558,45658644,-5374086,스웨덴,2000-09
2000-09-30,39632261,4321053,35311208,폴란드,2000-09
2000-09-30,35043204,2052,35041152,영령 캐이맨 군도,2000-09
2000-09-30,33669372,15480959,18188413,아르헨티나,2000-09
2000-09-30,33364398,0,33364398,리비아,2000-09
2000-09-30,32369348,20365020,12004328,파키스탄,2000-09
2000-09-30,30968892,1523337,29445555,포루투갈,2000-09
2000-09-30,29609877,3736940,25872937,스리랑카,2000-09
2000-09-30,25578930,57567092,-31988162,뉴질랜드,2000-09
2000-09-30,24342434,4385491,19956943,우즈베키스탄,2000-09
2000-09-30,23359838,4096856,19262982,베네주엘라,2000-09
2000-09-30,20373048,274372,20098676,나이지리아,2000-09
2000-09-30,19486093,20879764,-1393671,오스트리아,2000-09
2000-09-30,17701649,154363093,-136661444,오만,2000-09
2000-09-30,17561554,1945683,15615871,미얀마,2000-09
2000-09-30,16802643,2475510,14327133,콜롬비아,2000-09
2000-09-30,16738710,406648,16332062,시리아,2000-09
2000-09-30,16299048,8858798,7440250,헝가리,2000-09
2000-09-30,15745998,4093582,11652416,페루,2000-09
2000-09-30,15734648,3682340,12052308,푸에르토리코,2000-09
2000-09-30,15542012,689867,14852145,알제리,2000-09
2000-09-30,15407870,36014499,-20606629,우크라이나,2000-09
2000-09-30,15098887,6014099,9084788,기타국,2000-09
2000-09-30,13512940,3488633,10024307,루마니아,2000-09
2000-09-30,13048868,3992550,9056318,도미니카 공화국,2000-09
2000-09-30,11217598,1734650,9482948,온두라스,2000-09
2000-09-30,10954355,2591914,8362441,요르단,2000-09
2000-09-30,10474557,253070985,-242596428,카타르,2000-09
2000-09-30,9865712,3674763,6190949,몰타,2000-09
2000-09-30,9479193,0,9479193,아프카니스탄,2000-09
2000-09-30,8812844,3022158,5790686,코스타리카,2000-09
2000-09-30,8694933,128128,8566805,캄보디아,2000-09
2000-09-30,8052462,2163046,5889416,우루과이,2000-09
2000-09-30,7874293,4191367,3682926,모로코,2000-09
2000-09-30,7771090,6093726,1677364,카자흐스탄,2000-09
2000-09-30,7753813,68317,7685496,엘살바도르,2000-09
2000-09-30,6996384,474632,6521752,레바논,2000-09
2000-09-30,6712201,36352690,-29640489,에쿠아도르,2000-09
2000-09-30,6594849,19753,6575096,북마리아나 군도,2000-09
2000-09-30,5411705,3604996,1806709,수단,2000-09
2000-09-30,5348541,162650,5185891,케냐,2000-09
2000-09-30,5182712,336448,4846264,튀니지,2000-09
2000-09-30,4511841,5918,4505923,니카라과,2000-09
2000-09-30,3939113,55819222,-51880109,이라크,2000-09
2000-09-30,3717166,176906,3540260,가나,2000-09
2000-09-30,3624463,16276,3608187,토고,2000-09
2000-09-30,3614328,59241,3555087,마카오,2000-09
2000-09-30,3571261,26716538,-23145277,바레인,2000-09
2000-09-30,3401682,12458084,-9056402,체코공화국,2000-09
2000-09-30,3400621,219406,3181215,몽골,2000-09
2000-09-30,3201869,464374,2737495,에스토니아,2000-09
2000-09-30,3140892,24848,3116044,트리니다드 토바고,2000-09
2000-09-30,3118335,47024,3071311,파라과이,2000-09
2000-09-30,3052603,80500,2972103,유고,2000-09
2000-09-30,2983457,49312126,-46328669,예맨,2000-09
2000-09-30,2907732,102477,2805255,사이프러스,2000-09
2000-09-30,2870556,0,2870556,모리셔스,2000-09
2000-09-30,2605920,1351466,1254454,슬로베니아,2000-09
2000-09-30,2494388,41744,2452644,크로아티아,2000-09
2000-09-30,2457090,14309481,-11852391,브루나이,2000-09
2000-09-30,2179336,55061,2124275,에티오피아,2000-09
2000-09-30,2176048,176815,1999233,벨리제,2000-09
2000-09-30,2063165,22327,2040838,괌,2000-09
2000-09-30,1962295,578447,1383848,리투아니아,2000-09
2000-09-30,1949326,39638,1909688,도미니카,2000-09
2000-09-30,1937485,918232,1019253,탄자니아,2000-09
2000-09-30,1835669,652032,1183637,불가리아,2000-09
2000-09-30,1757471,0,1757471,베닝,2000-09
2000-09-30,1632591,46078,1586513,키르기스스탄,2000-09
2000-09-30,1616140,47813,1568327,라트비아,2000-09
2000-09-30,1567402,0,1567402,아이티,2000-09
2000-09-30,1554317,547,1553770,코트디봐르,2000-09
2000-09-30,1551825,386503,1165322,자마이카,2000-09
2000-09-30,1537246,910990,626256,네팔,2000-09
2000-09-30,1533948,0,1533948,지부티,2000-09
2000-09-30,1464463,0,1464463,불령 리유니온 코모도 제도,2000-09
2000-09-30,1340863,79475,1261388,팔레스타인 해방기구(구),2000-09
2000-09-30,1226417,9900,1216517,레소토,2000-09
2000-09-30,1135871,51551840,-50415969,앙골라,2000-09
2000-09-30,1095190,576632,518558,슬로바키아,2000-09
2000-09-30,1074739,4674,1070065,과델로프,2000-09
2000-09-30,1069208,32500,1036708,바하마,2000-09
2000-09-30,1066887,35232,1031655,아루바,2000-09
2000-09-30,1029055,13913,1015142,마다카스카르,2000-09
2000-09-30,989252,67128,922124,세네갈,2000-09
2000-09-30,966287,0,966287,마티니크,2000-09
2000-09-30,913477,0,913477,티모르,2000-09
2000-09-30,886674,442279,444395,아이슬란드,2000-09
2000-09-30,865537,18360,847177,시에라 리온,2000-09
2000-09-30,840382,0,840382,마세도니아,2000-09
2000-09-30,838561,123645,714916,짐바브웨,2000-09
2000-09-30,793063,14199,778864,모잠비크,2000-09
2000-09-30,788144,26056732,-25268588,콩고,2000-09
2000-09-30,734335,15698,718637,마이크로네시아,2000-09
2000-09-30,680747,844556,-163809,스와질랜드,2000-09
2000-09-30,656343,8399266,-7742923,파푸아 뉴기니,2000-09
2000-09-30,640125,208000,432125,라오스,2000-09
2000-09-30,546851,62778,484073,피지,2000-09
2000-09-30,533049,103640,429409,카메룬,2000-09
2000-09-30,517049,0,517049,보스니아-헤르체고비나,2000-09
2000-09-30,499843,5127617,-4627774,뉴 칼레도니아,2000-09
2000-09-30,496335,805,495530,바베이도스,2000-09
2000-09-30,490382,98744,391638,나미비아,2000-09
2000-09-30,453614,76746,376868,볼리비아,2000-09
2000-09-30,446109,184747,261362,기니,2000-09
2000-09-30,444901,44387,400514,우간다,2000-09
2000-09-30,417763,1010,416753,팔라우,2000-09
2000-09-30,391862,1407245,-1015383,룩셈부르그,2000-09
2000-09-30,373296,11558,361738,투르크멘,2000-09
2000-09-30,366085,0,366085,말라위,2000-09
2000-09-30,335651,0,335651,안티가 바부다,2000-09
2000-09-30,331151,0,331151,불령 폴리네시아,2000-09
2000-09-30,312875,2795913,-2483038,벨라루스,2000-09
2000-09-30,294568,1769821,-1475253,가봉,2000-09
2000-09-30,289210,0,289210,에리트리아,2000-09
2000-09-30,279444,31290,248154,감비아,2000-09
2000-09-30,276565,0,276565,버뮤다,2000-09
2000-09-30,265856,0,265856,보츠와나,2000-09
2000-09-30,248035,126142,121893,조지아,2000-09
2000-09-30,245091,3516,241575,네덜란드 열도,2000-09
2000-09-30,214928,0,214928,몬트세라트,2000-09
2000-09-30,212614,0,212614,수리남,2000-09
2000-09-30,207115,598,206517,사모아,2000-09
2000-09-30,200717,0,200717,아메리칸 사모아,2000-09
2000-09-30,197419,5822642,-5625223,바누아투,2000-09
2000-09-30,184222,0,184222,마샬군도,2000-09
2000-09-30,154833,609743,-454910,타지크,2000-09
2000-09-30,138458,0,138458,부탄,2000-09
2000-09-30,132234,32123,100111,가이아나,2000-09
2000-09-30,113053,0,113053,알바니아,2000-09
2000-09-30,111145,967,110178,미령 버진군도,2000-09
2000-09-30,108140,0,108140,불령 가이아나,2000-09
2000-09-30,106092,13940,92152,아제르바이잔,2000-09
2000-09-30,103779,0,103779,몰도바,2000-09
2000-09-30,101072,0,101072,부룬디,2000-09
2000-09-30,99243,0,99243,챠드,2000-09
2000-09-30,92022,0,92022,소말리아,2000-09
2000-09-30,88020,21,87999,르완다,2000-09
2000-09-30,86201,0,86201,그레나다,2000-09
2000-09-30,84919,127,84792,통가,2000-09
2000-09-30,78361,149,78212,포클랜드 군도,2000-09
2000-09-30,72711,1674222,-1601511,솔로몬 군도,2000-09
2000-09-30,64538,138655,-74117,부르키나 파소,2000-09
2000-09-30,64473,10759,53714,리히텐슈타인,2000-09
2000-09-30,60573,0,60573,몰디브,2000-09
2000-09-30,51190,2060,49130,잠비아,2000-09
2000-09-30,44608,0,44608,중앙아프리카공화국,2000-09
2000-09-30,42489,0,42489,세인트 빈센트 그레나딘,2000-09
2000-09-30,35169,34883,286,니제르,2000-09
2000-09-30,28765,0,28765,세인트 루시아,2000-09
2000-09-30,28114,11550,16564,모리타니,2000-09
2000-09-30,24478,0,24478,세이쉘,2000-09
2000-09-30,23899,0,23899,투발루,2000-09
2000-09-30,19744,0,19744,세인트 키츠 네비스,2000-09
2000-09-30,17317,0,17317,왈라스 & 퓨투나 군도,2000-09
2000-09-30,13499,0,13499,코모로스,2000-09
2000-09-30,11750,579,11171,앙귈라,2000-09
2000-09-30,10536,13849219,-13838683,중립지대,2000-09
2000-09-30,10140,17414,-7274,아르메니아,2000-09
2000-09-30,7872,21503,-13631,쿡 아일랜드,2000-09
2000-09-30,5796,131301,-125505,말리,2000-09
2000-09-30,5100,134372,-129272,모나코,2000-09
2000-09-30,2564,4995,-2431,코스 군도,2000-09
2000-09-30,2440,27291,-24851,세인트 헬레나,2000-09
2000-09-30,2268,0,2268,투르크 & 카이코스 군도,2000-09
2000-09-30,1919,0,1919,카보 베르데,2000-09
2000-09-30,1616,0,1616,키리바티,2000-09
2000-09-30,1495,10409,-8914,프랑스 메트로폴리탄,2000-09
2000-09-30,500,0,500,지브랄타,2000-09
2000-09-30,0,510793,-510793,기네비소,2000-09
2000-09-30,0,3990,-3990,크리스마스 아일랜드,2000-09
2000-09-30,0,268034,-268034,안도라,2000-09
2000-09-30,0,37315,-37315,콩고민주공화국,2000-09
2000-10-31,3471764548,2529401324,942363224,미국,2000-10
2000-10-31,1773514357,2670216936,-896702579,일본,2000-10
2000-10-31,1619740904,1152945751,466795153,중국,2000-10
2000-10-31,981958017,98381422,883576595,홍콩,2000-10
2000-10-31,651669333,474694060,176975273,대만,2000-10
2000-10-31,482167430,393204753,88962677,독일,2000-10
2000-10-31,468881821,198384032,270497789,영국,2000-10
2000-10-31,446435168,315409749,131025419,싱가포르,2000-10
2000-10-31,359396431,443490125,-84093694,인도네시아,2000-10
2000-10-31,293786319,376613557,-82827238,말레이시아,2000-10
2000-10-31,262104232,484708378,-222604146,호주,2000-10
2000-10-31,248815918,31605975,217209943,멕시코,2000-10
2000-10-31,245454924,157878703,87576221,필리핀,2000-10
2000-10-31,238794655,96416175,142378480,네덜란드,2000-10
2000-10-31,218886199,166714606,52171593,캐나다,2000-10
2000-10-31,198203702,1099293,197104409,그리스,2000-10
2000-10-31,192657192,34038,192623154,라이베리아,2000-10
2000-10-31,181623272,159483903,22139369,태국,2000-10
2000-10-31,172034337,552094362,-380060025,아랍에미리트 연합,2000-10
2000-10-31,145016681,154877912,-9861231,프랑스,2000-10
2000-10-31,134758899,127504601,7254298,이탈리아,2000-10
2000-10-31,134477647,84450153,50027494,브라질,2000-10
2000-10-31,126551005,28398239,98152766,베트남,2000-10
2000-10-31,124357304,3576537,120780767,튀르키예,2000-10
2000-10-31,120136262,24246719,95889543,스페인,2000-10
2000-10-31,112123301,966533248,-854409947,사우디아라비아,2000-10
2000-10-31,100992394,89317440,11674954,인도,2000-10
2000-10-31,81494634,57099184,24395450,벨기에,2000-10
2000-10-31,75170257,189502554,-114332297,러시아 연방,2000-10
2000-10-31,70043890,0,70043890,마샬군도,2000-10
2000-10-31,67127035,36447313,30679722,핀란드,2000-10
2000-10-31,65058358,28758384,36299974,이스라엘,2000-10
2000-10-31,55771526,3554680,52216846,방글라데시,2000-10
2000-10-31,53317296,86051734,-32734438,아일랜드,2000-10
2000-10-31,51357724,123248786,-71891062,스위스,2000-10
2000-10-31,49645832,178696363,-129050531,이란,2000-10
2000-10-31,49151784,77675,49074109,과테말라,2000-10
2000-10-31,44767040,88339358,-43572318,남아프리카공화국,2000-10
2000-10-31,43915354,22851790,21063564,이집트,2000-10
2000-10-31,42629872,49003144,-6373272,스웨덴,2000-10
2000-10-31,42483518,33321960,9161558,덴마크,2000-10
2000-10-31,41705234,2019743,39685491,미얀마,2000-10
2000-10-31,40782032,73942168,-33160136,칠레,2000-10
2000-10-31,40530220,23158811,17371409,파키스탄,2000-10
2000-10-31,34346275,20608,34325667,괌,2000-10
2000-10-31,34286372,15062341,19224031,아르헨티나,2000-10
2000-10-31,32716562,1281850,31434712,포루투갈,2000-10
2000-10-31,32061764,5549810,26511954,우즈베키스탄,2000-10
2000-10-31,29087405,4641671,24445734,폴란드,2000-10
2000-10-31,28907365,4151821,24755544,스리랑카,2000-10
2000-10-31,27472783,721309,26751474,베네주엘라,2000-10
2000-10-31,24018304,62551691,-38533387,뉴질랜드,2000-10
2000-10-31,22768908,7833248,14935660,푸에르토리코,2000-10
2000-10-31,22108374,2812704,19295670,기타국,2000-10
2000-10-31,21810784,467313,21343471,아이슬란드,2000-10
2000-10-31,21319581,72658,21246923,나이지리아,2000-10
2000-10-31,20755062,1130436,19624626,파나마,2000-10
2000-10-31,20144453,21539501,-1395048,알제리,2000-10
2000-10-31,19797317,159116670,-139319353,오만,2000-10
2000-10-31,19260753,21707157,-2446404,오스트리아,2000-10
2000-10-31,18145180,275376,17869804,리비아,2000-10
2000-10-31,16771319,299237765,-282466446,쿠웨이트,2000-10
2000-10-31,16496936,7312482,9184454,헝가리,2000-10
2000-10-31,15403746,25279939,-9876193,페루,2000-10
2000-10-31,14865422,443188,14422234,시리아,2000-10
2000-10-31,14801379,3055768,11745611,콜롬비아,2000-10
2000-10-31,14608594,42574951,-27966357,우크라이나,2000-10
2000-10-31,14398784,3051019,11347765,루마니아,2000-10
2000-10-31,13736388,267045590,-253309202,카타르,2000-10
2000-10-31,12414115,613334,11800781,온두라스,2000-10
2000-10-31,11876806,269625,11607181,요르단,2000-10
2000-10-31,11633707,5970671,5663036,도미니카 공화국,2000-10
2000-10-31,11509142,1853601,9655541,코스타리카,2000-10
2000-10-31,9921496,2153404,7768092,우루과이,2000-10
2000-10-31,9752200,26600507,-16848307,노르웨이,2000-10
2000-10-31,9574465,2532378,7042087,몰타,2000-10
2000-10-31,9323293,1291811,8031482,모로코,2000-10
2000-10-31,9086492,1565728,7520764,카자흐스탄,2000-10
2000-10-31,9062372,0,9062372,아프카니스탄,2000-10
2000-10-31,7984094,0,7984094,영령 인도양,2000-10
2000-10-31,7921098,449235,7471863,캄보디아,2000-10
2000-10-31,7887563,1134,7886429,북마리아나 군도,2000-10
2000-10-31,7685704,662113,7023591,레바논,2000-10
2000-10-31,7474710,89096,7385614,엘살바도르,2000-10
2000-10-31,7278656,463953,6814703,에쿠아도르,2000-10
2000-10-31,6679057,6465201,213856,수단,2000-10
2000-10-31,6549137,31829837,-25280700,예맨,2000-10
2000-10-31,5005607,13282665,-8277058,체코공화국,2000-10
2000-10-31,4706561,272276,4434285,튀니지,2000-10
2000-10-31,4514992,62856,4452136,마카오,2000-10
2000-10-31,4463289,8749946,-4286657,바레인,2000-10
2000-10-31,4239295,199896,4039399,케냐,2000-10
2000-10-31,4192588,405823,3786765,몽골,2000-10
2000-10-31,4060156,521457,3538699,가나,2000-10
2000-10-31,3888343,6263,3882080,니카라과,2000-10
2000-10-31,3679912,0,3679912,토고,2000-10
2000-10-31,3361343,787674,2573669,슬로베니아,2000-10
2000-10-31,2950856,4757702,-1806846,에스토니아,2000-10
2000-10-31,2946665,10302,2936363,크로아티아,2000-10
2000-10-31,2899436,119467,2779969,사이프러스,2000-10
2000-10-31,2808513,37898264,-35089751,브루나이,2000-10
2000-10-31,2580244,786980,1793264,불가리아,2000-10
2000-10-31,2352846,47093,2305753,파라과이,2000-10
2000-10-31,2288589,32595572,-30306983,이라크,2000-10
2000-10-31,2164218,676346,1487872,네팔,2000-10
2000-10-31,2076798,65190,2011608,모리셔스,2000-10
2000-10-31,1965124,677,1964447,에티오피아,2000-10
2000-10-31,1907345,1520,1905825,키르기스스탄,2000-10
2000-10-31,1798142,2210,1795932,트리니다드 토바고,2000-10
2000-10-31,1794460,119288,1675172,유고,2000-10
2000-10-31,1625226,0,1625226,베닝,2000-10
2000-10-31,1520786,0,1520786,지부티,2000-10
2000-10-31,1518279,27526,1490753,자마이카,2000-10
2000-10-31,1414145,0,1414145,불령 리유니온 코모도 제도,2000-10
2000-10-31,1386504,129207,1257297,리투아니아,2000-10
2000-10-31,1325514,65200,1260314,마다카스카르,2000-10
2000-10-31,1268784,210427,1058357,시에라 리온,2000-10
2000-10-31,1220246,0,1220246,투르크멘,2000-10
2000-10-31,1219711,0,1219711,아이티,2000-10
2000-10-31,1132647,40074,1092573,탄자니아,2000-10
2000-10-31,1057612,36248785,-35191173,앙골라,2000-10
2000-10-31,1023125,3376136,-2353011,뉴 칼레도니아,2000-10
2000-10-31,991947,27910,964037,라트비아,2000-10
2000-10-31,981347,926048,55299,피지,2000-10
2000-10-31,975040,388538,586502,짐바브웨,2000-10
2000-10-31,964024,12178767,-11214743,파푸아 뉴기니,2000-10
2000-10-31,941008,65921872,-64980864,콩고,2000-10
2000-10-31,901095,808877,92218,슬로바키아,2000-10
2000-10-31,797155,0,797155,마세도니아,2000-10
2000-10-31,796482,0,796482,아루바,2000-10
2000-10-31,791068,26600,764468,바하마,2000-10
2000-10-31,784520,0,784520,레소토,2000-10
2000-10-31,768662,32032,736630,코트디봐르,2000-10
2000-10-31,743404,66899,676505,세네갈,2000-10
2000-10-31,711989,119361,592628,카메룬,2000-10
2000-10-31,669272,2886,666386,과델로프,2000-10
2000-10-31,665741,45900,619841,감비아,2000-10
2000-10-31,620359,578276,42083,벨라루스,2000-10
2000-10-31,593869,1221,592648,마이크로네시아,2000-10
2000-10-31,554770,2159875,-1605105,룩셈부르그,2000-10
2000-10-31,541778,1485605,-943827,볼리비아,2000-10
2000-10-31,529783,0,529783,마티니크,2000-10
2000-10-31,482018,25199,456819,불령 폴리네시아,2000-10
2000-10-31,473977,8012,465965,바베이도스,2000-10
2000-10-31,473083,3924,469159,안티가 바부다,2000-10
2000-10-31,460397,11819,448578,팔레스타인 해방기구(구),2000-10
2000-10-31,449604,167389,282215,라오스,2000-10
2000-10-31,403846,2129428,-1725582,가봉,2000-10
2000-10-31,395461,87367,308094,도미니카,2000-10
2000-10-31,380310,8332,371978,아메리칸 사모아,2000-10
2000-10-31,359664,49969,309695,기니,2000-10
2000-10-31,352937,0,352937,보츠와나,2000-10
2000-10-31,342060,2909710,-2567650,스와질랜드,2000-10
2000-10-31,337335,654030,-316695,타지크,2000-10
2000-10-31,296700,0,296700,팔라우,2000-10
2000-10-31,292785,255636,37149,벨리제,2000-10
2000-10-31,259319,0,259319,모잠비크,2000-10
2000-10-31,257919,32492,225427,우간다,2000-10
2000-10-31,213908,0,213908,알바니아,2000-10
2000-10-31,204691,0,204691,보스니아-헤르체고비나,2000-10
2000-10-31,196994,0,196994,사모아,2000-10
2000-10-31,189272,1429196,-1239924,나미비아,2000-10
2000-10-31,184613,89312,95301,조지아,2000-10
2000-10-31,179889,1386,178503,버뮤다,2000-10
2000-10-31,152201,0,152201,소말리아,2000-10
2000-10-31,150086,229,149857,부탄,2000-10
2000-10-31,121559,0,121559,몰도바,2000-10
2000-10-31,117032,0,117032,수리남,2000-10
2000-10-31,111311,0,111311,부룬디,2000-10
2000-10-31,109715,0,109715,영령 캐이맨 군도,2000-10
2000-10-31,104578,0,104578,에리트리아,2000-10
2000-10-31,100840,476912,-376072,말리,2000-10
2000-10-31,99679,70885,28794,잠비아,2000-10
2000-10-31,99521,0,99521,말라위,2000-10
2000-10-31,90878,14290439,-14199561,중립지대,2000-10
2000-10-31,90224,0,90224,세인트 루시아,2000-10
2000-10-31,84700,170899,-86199,기네비소,2000-10
2000-10-31,60424,133986,-73562,바누아투,2000-10
2000-10-31,58824,0,58824,세인트 빈센트 그레나딘,2000-10
2000-10-31,55988,0,55988,모리타니,2000-10
2000-10-31,53210,0,53210,불령 가이아나,2000-10
2000-10-31,46320,0,46320,투르크 & 카이코스 군도,2000-10
2000-10-31,40428,3705,36723,몰디브,2000-10
2000-10-31,38589,17648,20941,콩고민주공화국,2000-10
2000-10-31,38234,29662,8572,네덜란드 열도,2000-10
2000-10-31,38127,0,38127,가이아나,2000-10
2000-10-31,37426,0,37426,교황청,2000-10
2000-10-31,35925,0,35925,부르키나 파소,2000-10
2000-10-31,35107,0,35107,그레나다,2000-10
2000-10-31,33381,0,33381,아제르바이잔,2000-10
2000-10-31,32124,0,32124,키리바티,2000-10
2000-10-31,29062,0,29062,통가,2000-10
2000-10-31,26681,0,26681,쿡 아일랜드,2000-10
2000-10-31,22890,18144,4746,세인트 키츠 네비스,2000-10
2000-10-31,21304,1579501,-1558197,솔로몬 군도,2000-10
2000-10-31,18525,2640,15885,중앙아프리카공화국,2000-10
2000-10-31,18111,34104,-15993,아르메니아,2000-10
2000-10-31,16407,33029508,-33013101,니제르,2000-10
2000-10-31,13814,0,13814,챠드,2000-10
2000-10-31,10781,342331,-331550,모나코,2000-10
2000-10-31,8964,0,8964,지브랄타,2000-10
2000-10-31,8310,0,8310,티모르,2000-10
2000-10-31,3840,718331,-714491,안도라,2000-10
2000-10-31,3737,0,3737,캔톤아일랜드,2000-10
2000-10-31,1593,3533,-1940,리히텐슈타인,2000-10
2000-10-31,1186,3543,-2357,미령 버진군도,2000-10
2000-10-31,328,0,328,산마리노,2000-10
2000-10-31,0,5172,-5172,존스톤 아일랜드,2000-10
2000-10-31,0,7603,-7603,앙귈라,2000-10
2000-10-31,0,1043,-1043,포클랜드 군도,2000-10
2000-10-31,0,2590,-2590,노폴크 아일랜드,2000-10
2000-10-31,0,83761,-83761,미드웨이 군도,2000-10
2000-10-31,0,80387,-80387,남조지아 & 남샌드위치 군도,2000-10
2000-10-31,0,78400,-78400,르완다,2000-10
2000-10-31,0,92844,-92844,파로에 군도,2000-10
2000-10-31,0,1316457,-1316457,나우루,2000-10
2000-10-31,0,8586,-8586,세인트 헬레나,2000-10
2000-10-31,0,4795,-4795,프랑스 메트로폴리탄,2000-10
2000-11-30,3331334272,2325280117,1006054155,미국,2000-11
2000-11-30,1877923709,2684022588,-806098879,일본,2000-11
2000-11-30,1728475871,1177717950,550757921,중국,2000-11
2000-11-30,944141978,94403379,849738599,홍콩,2000-11
2000-11-30,622968134,462792359,160175775,대만,2000-11
2000-11-30,580440952,364973942,215467010,독일,2000-11
2000-11-30,482127244,195730166,286397078,영국,2000-11
2000-11-30,437759689,330639211,107120478,싱가포르,2000-11
2000-11-30,301248722,474747632,-173498910,인도네시아,2000-11
2000-11-30,276854146,423422569,-146568423,말레이시아,2000-11
2000-11-30,260888904,166161799,94727105,필리핀,2000-11
2000-11-30,228859935,95096247,133763688,네덜란드,2000-11
2000-11-30,220012391,463377488,-243365097,호주,2000-11
2000-11-30,193371136,163793272,29577864,태국,2000-11
2000-11-30,192385599,21694736,170690863,멕시코,2000-11
2000-11-30,191241029,0,191241029,바하마,2000-11
2000-11-30,174287424,467055014,-292767590,아랍에미리트 연합,2000-11
2000-11-30,168073370,161583926,6489444,캐나다,2000-11
2000-11-30,159754473,136304095,23450378,이탈리아,2000-11
2000-11-30,153872035,303867480,-149995445,이란,2000-11
2000-11-30,150756897,32237388,118519509,베트남,2000-11
2000-11-30,143275690,66670757,76604933,브라질,2000-11
2000-11-30,137428493,960494347,-823065854,사우디아라비아,2000-11
2000-11-30,129204118,161948834,-32744716,프랑스,2000-11
2000-11-30,103632162,24545150,79087012,스페인,2000-11
2000-11-30,100937912,88016331,12921581,인도,2000-11
2000-11-30,82844799,215303757,-132458958,러시아 연방,2000-11
2000-11-30,81176233,1246853,79929380,그리스,2000-11
2000-11-30,77113754,55057272,22056482,벨기에,2000-11
2000-11-30,71665231,2210573,69454658,파나마,2000-11
2000-11-30,71210238,2320437,68889801,튀르키예,2000-11
2000-11-30,70198234,7500105,62698129,라이베리아,2000-11
2000-11-30,67436897,33836694,33600203,핀란드,2000-11
2000-11-30,60359209,84920531,-24561322,칠레,2000-11
2000-11-30,56713003,72370782,-15657779,아일랜드,2000-11
2000-11-30,52414060,32950923,19463137,이스라엘,2000-11
2000-11-30,49127315,46061376,3065939,스웨덴,2000-11
2000-11-30,47731946,2035711,45696235,방글라데시,2000-11
2000-11-30,43121020,89592358,-46471338,남아프리카공화국,2000-11
2000-11-30,41391014,125877,41265137,과테말라,2000-11
2000-11-30,41166293,77605318,-36439025,스위스,2000-11
2000-11-30,36251654,1004086,35247568,포루투갈,2000-11
2000-11-30,33814018,31009822,2804196,아르헨티나,2000-11
2000-11-30,32303249,55290663,-22987414,이집트,2000-11
2000-11-30,29013781,22848150,6165631,파키스탄,2000-11
2000-11-30,27925155,13082727,14842428,스리랑카,2000-11
2000-11-30,26685644,5743903,20941741,몰타,2000-11
2000-11-30,23318125,276191654,-252873529,카타르,2000-11
2000-11-30,23249734,54403442,-31153708,뉴질랜드,2000-11
2000-11-30,22576135,1433949,21142186,기타국,2000-11
2000-11-30,21609333,32121202,-10511869,나이지리아,2000-11
2000-11-30,21370253,7908549,13461704,푸에르토리코,2000-11
2000-11-30,20476988,23104802,-2627814,오스트리아,2000-11
2000-11-30,19129846,162535,18967311,리비아,2000-11
2000-11-30,18888120,277909733,-259021613,쿠웨이트,2000-11
2000-11-30,18670621,4591612,14079009,콜롬비아,2000-11
2000-11-30,16687497,8403305,8284192,베네주엘라,2000-11
2000-11-30,16656838,2150609,14506229,폴란드,2000-11
2000-11-30,15942845,8634524,7308321,우즈베키스탄,2000-11
2000-11-30,15417837,30555147,-15137310,페루,2000-11
2000-11-30,14635968,2008798,12627170,미얀마,2000-11
2000-11-30,14195845,690343,13505502,온두라스,2000-11
2000-11-30,13295019,49222,13245797,요르단,2000-11
2000-11-30,12905705,1032422,11873283,우루과이,2000-11
2000-11-30,12900873,213408349,-200507476,오만,2000-11
2000-11-30,12539134,15305785,-2766651,우크라이나,2000-11
2000-11-30,12458716,9712309,2746407,헝가리,2000-11
2000-11-30,11747734,269810,11477924,시리아,2000-11
2000-11-30,10992641,21407806,-10415165,노르웨이,2000-11
2000-11-30,10886690,25277163,-14390473,덴마크,2000-11
2000-11-30,10683430,19068,10664362,아프카니스탄,2000-11
2000-11-30,9397332,3758477,5638855,도미니카 공화국,2000-11
2000-11-30,8863482,768367,8095115,코스타리카,2000-11
2000-11-30,8497545,2490711,6006834,카자흐스탄,2000-11
2000-11-30,8291864,96579,8195285,엘살바도르,2000-11
2000-11-30,8097781,113798,7983983,북마리아나 군도,2000-11
2000-11-30,8011019,0,8011019,알제리,2000-11
2000-11-30,7301353,200400,7100953,수단,2000-11
2000-11-30,6958009,368167,6589842,캄보디아,2000-11
2000-11-30,6931805,1842905,5088900,모로코,2000-11
2000-11-30,6790378,21070998,-14280620,에쿠아도르,2000-11
2000-11-30,6574789,185513,6389276,튀니지,2000-11
2000-11-30,6545183,2762361,3782822,루마니아,2000-11
2000-11-30,6036812,1438635,4598177,슬로베니아,2000-11
2000-11-30,5222300,490524,4731776,레바논,2000-11
2000-11-30,4722248,165806,4556442,마카오,2000-11
2000-11-30,4546805,90859,4455946,몽골,2000-11
2000-11-30,4249678,3195686,1053992,바레인,2000-11
2000-11-30,4199501,532594,3666907,가나,2000-11
2000-11-30,3934352,3993365,-59013,스와질랜드,2000-11
2000-11-30,3885235,9943070,-6057835,체코공화국,2000-11
2000-11-30,3744331,31524615,-27780284,예맨,2000-11
2000-11-30,3702388,51139,3651249,파라과이,2000-11
2000-11-30,3468488,179171,3289317,케냐,2000-11
2000-11-30,3182559,0,3182559,니카라과,2000-11
2000-11-30,3027721,25945,3001776,괌,2000-11
2000-11-30,2893102,28938,2864164,토고,2000-11
2000-11-30,2805307,0,2805307,지부티,2000-11
2000-11-30,2558674,980757,1577917,불가리아,2000-11
2000-11-30,2494080,92363446,-89869366,이라크,2000-11
2000-11-30,2465582,24396,2441186,안도라,2000-11
2000-11-30,2120911,43230,2077681,사이프러스,2000-11
2000-11-30,2019759,33701,1986058,트리니다드 토바고,2000-11
2000-11-30,1713060,305431,1407629,네팔,2000-11
2000-11-30,1699868,720960,978908,에스토니아,2000-11
2000-11-30,1651210,17177,1634033,코트디봐르,2000-11
2000-11-30,1630314,64387990,-62757676,브루나이,2000-11
2000-11-30,1569240,30362,1538878,라트비아,2000-11
2000-11-30,1504523,453061,1051462,크로아티아,2000-11
2000-11-30,1478720,220758,1257962,리투아니아,2000-11
2000-11-30,1468155,43112,1425043,탄자니아,2000-11
2000-11-30,1419903,0,1419903,불령 리유니온 코모도 제도,2000-11
2000-11-30,1352961,61367,1291594,모리셔스,2000-11
2000-11-30,1295084,42227,1252857,키르기스스탄,2000-11
2000-11-30,1255042,30643802,-29388760,앙골라,2000-11
2000-11-30,1191031,245167,945864,짐바브웨,2000-11
2000-11-30,1085021,0,1085021,베닝,2000-11
2000-11-30,1047099,126988,920111,에티오피아,2000-11
2000-11-30,969360,0,969360,마티니크,2000-11
2000-11-30,935088,3847,931241,자마이카,2000-11
2000-11-30,932813,0,932813,마이크로네시아,2000-11
2000-11-30,871643,3092348,-2220705,파푸아 뉴기니,2000-11
2000-11-30,766259,785567,-19308,피지,2000-11
2000-11-30,700845,82965,617880,벨리제,2000-11
2000-11-30,699162,7724,691438,바베이도스,2000-11
2000-11-30,688875,1448,687427,팔레스타인 해방기구(구),2000-11
2000-11-30,657447,0,657447,투르크멘,2000-11
2000-11-30,607390,0,607390,유고,2000-11
2000-11-30,604600,15982,588618,세네갈,2000-11
2000-11-30,575324,39759,535565,마다카스카르,2000-11
2000-11-30,519524,0,519524,불령 폴리네시아,2000-11
2000-11-30,492143,58352664,-57860521,가봉,2000-11
2000-11-30,488615,4975583,-4486968,뉴 칼레도니아,2000-11
2000-11-30,474801,171386,303415,아이슬란드,2000-11
2000-11-30,474026,123549,350477,볼리비아,2000-11
2000-11-30,470280,58609093,-58138813,콩고,2000-11
2000-11-30,465571,290109,175462,조지아,2000-11
2000-11-30,459314,843375,-384061,룩셈부르그,2000-11
2000-11-30,448555,61870,386685,우간다,2000-11
2000-11-30,418446,750126,-331680,벨라루스,2000-11
2000-11-30,414282,78484,335798,도미니카,2000-11
2000-11-30,412054,34760,377294,모잠비크,2000-11
2000-11-30,411800,0,411800,아이티,2000-11
2000-11-30,387537,2178,385359,아루바,2000-11
2000-11-30,382352,0,382352,과델로프,2000-11
2000-11-30,358779,323150,35629,기니,2000-11
2000-11-30,348487,0,348487,에리트리아,2000-11
2000-11-30,313576,0,313576,팔라우,2000-11
2000-11-30,302308,233705,68603,카메룬,2000-11
2000-11-30,296220,7110,289110,몰도바,2000-11
2000-11-30,289144,0,289144,마세도니아,2000-11
2000-11-30,288271,578227,-289956,슬로바키아,2000-11
2000-11-30,276236,0,276236,버뮤다,2000-11
2000-11-30,274968,0,274968,사모아,2000-11
2000-11-30,270828,35000,235828,라오스,2000-11
2000-11-30,200521,0,200521,말라위,2000-11
2000-11-30,176310,769001,-592691,타지크,2000-11
2000-11-30,176278,0,176278,모리타니,2000-11
2000-11-30,171757,0,171757,알바니아,2000-11
2000-11-30,165427,366684,-201257,아제르바이잔,2000-11
2000-11-30,156021,0,156021,불령 가이아나,2000-11
2000-11-30,137569,7392,130177,감비아,2000-11
2000-11-30,135786,0,135786,소말리아,2000-11
2000-11-30,133379,6900,126479,시에라 리온,2000-11
2000-11-30,128146,0,128146,안티가 바부다,2000-11
2000-11-30,127438,32266780,-32139342,니제르,2000-11
2000-11-30,120287,0,120287,아메리칸 사모아,2000-11
2000-11-30,120082,0,120082,보츠와나,2000-11
2000-11-30,108287,12175,96112,가이아나,2000-11
2000-11-30,100813,0,100813,세인트 루시아,2000-11
2000-11-30,99839,0,99839,보스니아-헤르체고비나,2000-11
2000-11-30,94839,3702,91137,나미비아,2000-11
2000-11-30,82312,49496,32816,잠비아,2000-11
2000-11-30,78896,0,78896,영령 캐이맨 군도,2000-11
2000-11-30,73160,55254,17906,바누아투,2000-11
2000-11-30,72463,0,72463,수리남,2000-11
2000-11-30,70834,15623,55211,콩고민주공화국,2000-11
2000-11-30,70439,0,70439,아르메니아,2000-11
2000-11-30,68917,0,68917,네덜란드 열도,2000-11
2000-11-30,59725,0,59725,몰디브,2000-11
2000-11-30,53632,0,53632,통가,2000-11
2000-11-30,42896,0,42896,중앙아프리카공화국,2000-11
2000-11-30,34406,0,34406,그레나다,2000-11
2000-11-30,32096,0,32096,부탄,2000-11
2000-11-30,30488,0,30488,부룬디,2000-11
2000-11-30,28400,0,28400,쿡 아일랜드,2000-11
2000-11-30,27423,0,27423,세이쉘,2000-11
2000-11-30,24481,0,24481,투발루,2000-11
2000-11-30,14072,0,14072,지브랄타,2000-11
2000-11-30,13944,0,13944,마샬군도,2000-11
2000-11-30,10761,187102,-176341,모나코,2000-11
2000-11-30,8974,371,8603,르완다,2000-11
2000-11-30,6110,0,6110,코모로스,2000-11
2000-11-30,2200,0,2200,프랑스 메트로폴리탄,2000-11
2000-11-30,1709,0,1709,크리스마스 아일랜드,2000-11
2000-11-30,1426,0,1426,챠드,2000-11
2000-11-30,1026,1960632,-1959606,솔로몬 군도,2000-11
2000-11-30,719,0,719,세인트 키츠 네비스,2000-11
2000-11-30,0,75280,-75280,상토메 프린스페,2000-11
2000-11-30,0,900977,-900977,말리,2000-11
2000-11-30,0,104,-104,앙귈라,2000-11
2000-11-30,0,1323461,-1323461,나우루,2000-11
2000-11-30,0,68173,-68173,미드웨이 군도,2000-11
2000-11-30,0,0,0,키리바티,2000-11
2000-11-30,0,17777,-17777,리히텐슈타인,2000-11
2000-11-30,0,139011,-139011,부르키나 파소,2000-11
2000-11-30,0,87200,-87200,토켈라우,2000-11
2000-11-30,0,76758,-76758,미령 버진군도,2000-11
2000-11-30,0,2173,-2173,세인트 헬레나,2000-11
2000-11-30,0,61646,-61646,그린랜드,2000-11
2000-11-30,0,1320,-1320,레소토,2000-11
2000-11-30,0,831224,-831224,적도 기니,2000-11
2000-11-30,0,1035,-1035,니우에,2000-11
2000-11-30,0,6754,-6754,마이너 아우틀링 합중국 군도,2000-11
2000-11-30,0,114133,-114133,기네비소,2000-11
2000-12-31,3582547249,2141320823,1441226426,미국,2000-12
2000-12-31,1812514974,2591257555,-778742581,일본,2000-12
2000-12-31,1608753969,1082432308,526321661,중국,2000-12
2000-12-31,891627321,79063770,812563551,홍콩,2000-12
2000-12-31,590678973,380324867,210354106,대만,2000-12
2000-12-31,542705437,400372622,142332815,독일,2000-12
2000-12-31,436285765,191985445,244300320,영국,2000-12
2000-12-31,379930347,282628473,97301874,싱가포르,2000-12
2000-12-31,303738531,72444428,231294103,네덜란드,2000-12
2000-12-31,293114918,2270630,290844288,그리스,2000-12
2000-12-31,276733730,163257268,113476462,필리핀,2000-12
2000-12-31,267882995,433609440,-165726445,말레이시아,2000-12
2000-12-31,262941037,486597844,-223656807,인도네시아,2000-12
2000-12-31,257232400,160855441,96376959,프랑스,2000-12
2000-12-31,221756645,525403907,-303647262,호주,2000-12
2000-12-31,192870813,153468689,39402124,캐나다,2000-12
2000-12-31,169727465,22077258,147650207,멕시코,2000-12
2000-12-31,159977240,162789354,-2812114,태국,2000-12
2000-12-31,159647571,508919284,-349271713,아랍에미리트 연합,2000-12
2000-12-31,158719484,69393387,89326097,브라질,2000-12
2000-12-31,155015425,24076006,130939419,베트남,2000-12
2000-12-31,145862984,123671459,22191525,이탈리아,2000-12
2000-12-31,123060995,778682085,-655621090,사우디아라비아,2000-12
2000-12-31,108732034,73612664,35119370,인도,2000-12
2000-12-31,102202954,25688867,76514087,스페인,2000-12
2000-12-31,88331715,176193499,-87861784,이란,2000-12
2000-12-31,82875721,187782149,-104906428,러시아 연방,2000-12
2000-12-31,75146005,42497508,32648497,벨기에,2000-12
2000-12-31,68050774,9371255,58679519,튀르키예,2000-12
2000-12-31,55603513,62355149,-6751636,아일랜드,2000-12
2000-12-31,55533941,64411767,-8877826,칠레,2000-12
2000-12-31,52934826,16,52934810,라이베리아,2000-12
2000-12-31,50499799,14568566,35931233,바레인,2000-12
2000-12-31,49352975,2189869,47163106,이집트,2000-12
2000-12-31,49117630,1787209,47330421,방글라데시,2000-12
2000-12-31,46431712,37702174,8729538,노르웨이,2000-12
2000-12-31,45346471,22377,45324094,과테말라,2000-12
2000-12-31,43918691,75942858,-32024167,남아프리카공화국,2000-12
2000-12-31,42362502,23637193,18725309,핀란드,2000-12
2000-12-31,42277643,35142346,7135297,이스라엘,2000-12
2000-12-31,41527539,19537831,21989708,파키스탄,2000-12
2000-12-31,40914398,49087917,-8173519,스웨덴,2000-12
2000-12-31,36020775,96924,35923851,베네주엘라,2000-12
2000-12-31,35288597,4202400,31086197,폴란드,2000-12
2000-12-31,34531561,22961934,11569627,아르헨티나,2000-12
2000-12-31,32486201,1941197,30545004,파나마,2000-12
2000-12-31,29978990,69678080,-39699090,스위스,2000-12
2000-12-31,29739257,6980853,22758404,푸에르토리코,2000-12
2000-12-31,29235384,2951401,26283983,스리랑카,2000-12
2000-12-31,28660602,3966369,24694233,포루투갈,2000-12
2000-12-31,25432107,54810934,-29378827,뉴질랜드,2000-12
2000-12-31,25425286,5359383,20065903,페루,2000-12
2000-12-31,24963362,36075,24927287,나이지리아,2000-12
2000-12-31,20248817,258094586,-237845769,쿠웨이트,2000-12
2000-12-31,20089532,487006,19602526,괌,2000-12
2000-12-31,19936052,176648177,-156712125,오만,2000-12
2000-12-31,19757391,21538481,-1781090,오스트리아,2000-12
2000-12-31,19104329,28486019,-9381690,덴마크,2000-12
2000-12-31,18226697,255496418,-237269721,카타르,2000-12
2000-12-31,17591347,20877914,-3286567,에쿠아도르,2000-12
2000-12-31,17105603,913315,16192288,시리아,2000-12
2000-12-31,17043689,10310604,6733085,헝가리,2000-12
2000-12-31,16995410,1998412,14996998,미얀마,2000-12
2000-12-31,16184867,4596359,11588508,콜롬비아,2000-12
2000-12-31,14801023,1125770,13675253,기타국,2000-12
2000-12-31,14140117,9502941,4637176,우즈베키스탄,2000-12
2000-12-31,13446262,944060,12502202,요르단,2000-12
2000-12-31,12969227,4033192,8936035,도미니카 공화국,2000-12
2000-12-31,12027835,11467892,559943,우크라이나,2000-12
2000-12-31,11446179,14859,11431320,아프카니스탄,2000-12
2000-12-31,10310064,733343,9576721,우루과이,2000-12
2000-12-31,9673891,149754,9524137,온두라스,2000-12
2000-12-31,9338194,1601307,7736887,카자흐스탄,2000-12
2000-12-31,8895395,3093079,5802316,모로코,2000-12
2000-12-31,8839317,148335,8690982,캄보디아,2000-12
2000-12-31,8723205,687467,8035738,레바논,2000-12
2000-12-31,8412219,0,8412219,알제리,2000-12
2000-12-31,8184286,68233,8116053,엘살바도르,2000-12
2000-12-31,8008769,1641613,6367156,코스타리카,2000-12
2000-12-31,7498758,1333108,6165650,루마니아,2000-12
2000-12-31,7243506,470,7243036,북마리아나 군도,2000-12
2000-12-31,7128065,186373,6941692,몽골,2000-12
2000-12-31,7099421,162222,6937199,케냐,2000-12
2000-12-31,7083480,63521178,-56437698,이라크,2000-12
2000-12-31,6991691,21879639,-14887948,수단,2000-12
2000-12-31,6908045,261122,6646923,가나,2000-12
2000-12-31,5955316,419249,5536067,튀니지,2000-12
2000-12-31,4564001,1250782,3313219,슬로베니아,2000-12
2000-12-31,4378900,3369,4375531,토고,2000-12
2000-12-31,4375125,48398,4326727,니카라과,2000-12
2000-12-31,4111803,10422087,-6310284,체코공화국,2000-12
2000-12-31,3546765,391210,3155555,크로아티아,2000-12
2000-12-31,3138028,65720662,-62582634,예맨,2000-12
2000-12-31,3085364,185117,2900247,리비아,2000-12
2000-12-31,3055408,91630,2963778,파라과이,2000-12
2000-12-31,2836889,204688,2632201,마카오,2000-12
2000-12-31,2655455,65246,2590209,사이프러스,2000-12
2000-12-31,2369718,31256,2338462,트리니다드 토바고,2000-12
2000-12-31,2291834,243505,2048329,네팔,2000-12
2000-12-31,2280922,4065439,-1784517,몰타,2000-12
2000-12-31,1826393,28500,1797893,바하마,2000-12
2000-12-31,1773990,0,1773990,불령 리유니온 코모도 제도,2000-12
2000-12-31,1696007,95681,1600326,에티오피아,2000-12
2000-12-31,1593042,0,1593042,앙골라,2000-12
2000-12-31,1550403,0,1550403,코트디봐르,2000-12
2000-12-31,1470391,123378,1347013,모리셔스,2000-12
2000-12-31,1461868,406329,1055539,리투아니아,2000-12
2000-12-31,1408430,597191,811239,에스토니아,2000-12
2000-12-31,1386131,35020,1351111,자마이카,2000-12
2000-12-31,1379757,39451,1340306,지부티,2000-12
2000-12-31,1344426,53529526,-52185100,브루나이,2000-12
2000-12-31,1326516,873737,452779,불가리아,2000-12
2000-12-31,1301080,0,1301080,베닝,2000-12
2000-12-31,1289546,25324,1264222,유고,2000-12
2000-12-31,1161052,42268,1118784,레소토,2000-12
2000-12-31,1138913,6273448,-5134535,스와질랜드,2000-12
2000-12-31,1093947,6549,1087398,라트비아,2000-12
2000-12-31,1008861,355244,653617,짐바브웨,2000-12
2000-12-31,996520,15893,980627,아이티,2000-12
2000-12-31,955516,2320,953196,마다카스카르,2000-12
2000-12-31,914815,10493,904322,탄자니아,2000-12
2000-12-31,911422,209115,702307,나미비아,2000-12
2000-12-31,882858,9412588,-8529730,파푸아 뉴기니,2000-12
2000-12-31,850609,0,850609,투르크멘,2000-12
2000-12-31,849163,810992,38171,벨라루스,2000-12
2000-12-31,785529,0,785529,마티니크,2000-12
2000-12-31,778797,981,777816,키르기스스탄,2000-12
2000-12-31,741881,217004,524877,도미니카,2000-12
2000-12-31,734951,110318,624633,과델로프,2000-12
2000-12-31,733785,3825,729960,세네갈,2000-12
2000-12-31,717727,1055907,-338180,피지,2000-12
2000-12-31,624422,0,624422,마이크로네시아,2000-12
2000-12-31,613191,0,613191,모잠비크,2000-12
2000-12-31,607386,5360632,-4753246,뉴 칼레도니아,2000-12
2000-12-31,590315,17000,573315,불령 폴리네시아,2000-12
2000-12-31,561195,6901,554294,바베이도스,2000-12
2000-12-31,493756,25279,468477,볼리비아,2000-12
2000-12-31,465137,100279,364858,우간다,2000-12
2000-12-31,452110,1560160,-1108050,아제르바이잔,2000-12
2000-12-31,445652,785895,-340243,룩셈부르그,2000-12
2000-12-31,437127,205723,231404,조지아,2000-12
2000-12-31,428823,0,428823,에리트리아,2000-12
2000-12-31,379085,7752,371333,아메리칸 사모아,2000-12
2000-12-31,374046,1127033,-752987,타지크,2000-12
2000-12-31,369192,118096,251096,카메룬,2000-12
2000-12-31,368138,0,368138,소말리아,2000-12
2000-12-31,330804,896145,-565341,슬로바키아,2000-12
2000-12-31,309784,208157,101627,기니,2000-12
2000-12-31,309310,31498887,-31189577,안티가 바부다,2000-12
2000-12-31,306487,0,306487,아루바,2000-12
2000-12-31,302914,1120760,-817846,아이슬란드,2000-12
2000-12-31,288765,903693,-614928,가봉,2000-12
2000-12-31,284616,0,284616,마세도니아,2000-12
2000-12-31,244376,91349385,-91105009,콩고,2000-12
2000-12-31,238218,44298,193920,라오스,2000-12
2000-12-31,225523,0,225523,감비아,2000-12
2000-12-31,221353,0,221353,몰도바,2000-12
2000-12-31,220693,0,220693,보스니아-헤르체고비나,2000-12
2000-12-31,193306,118962,74344,바누아투,2000-12
2000-12-31,182400,0,182400,사모아,2000-12
2000-12-31,175013,0,175013,수리남,2000-12
2000-12-31,167839,41260,126579,팔레스타인 해방기구(구),2000-12
2000-12-31,164329,0,164329,말라위,2000-12
2000-12-31,158923,0,158923,보츠와나,2000-12
2000-12-31,149594,76159,73435,콩고민주공화국,2000-12
2000-12-31,146199,86118,60081,모리타니,2000-12
2000-12-31,145965,1219,144746,팔라우,2000-12
2000-12-31,144730,1028,143702,그레나다,2000-12
2000-12-31,139174,86048,53126,잠비아,2000-12
2000-12-31,136016,144847,-8831,벨리제,2000-12
2000-12-31,133938,209,133729,알바니아,2000-12
2000-12-31,133128,0,133128,불령 가이아나,2000-12
2000-12-31,129540,0,129540,투르크 & 카이코스 군도,2000-12
2000-12-31,127298,0,127298,마샬군도,2000-12
2000-12-31,114173,0,114173,세인트 루시아,2000-12
2000-12-31,96885,33167,63718,네덜란드 열도,2000-12
2000-12-31,87523,685180,-597657,말리,2000-12
2000-12-31,82335,65622289,-65539954,니제르,2000-12
2000-12-31,77765,0,77765,아르메니아,2000-12
2000-12-31,72735,138976,-66241,부르키나 파소,2000-12
2000-12-31,72604,0,72604,부룬디,2000-12
2000-12-31,65825,0,65825,시에라 리온,2000-12
2000-12-31,55820,0,55820,영령 캐이맨 군도,2000-12
2000-12-31,51630,28834,22796,토켈라우,2000-12
2000-12-31,50237,0,50237,챠드,2000-12
2000-12-31,49065,12218,36847,가이아나,2000-12
2000-12-31,43978,0,43978,중앙아프리카공화국,2000-12
2000-12-31,40559,0,40559,버뮤다,2000-12
2000-12-31,37537,34156,3381,안도라,2000-12
2000-12-31,33510,72781,-39271,리히텐슈타인,2000-12
2000-12-31,30093,0,30093,통가,2000-12
2000-12-31,29848,0,29848,키리바티,2000-12
2000-12-31,29681,0,29681,부탄,2000-12
2000-12-31,23830,1674721,-1650891,솔로몬 군도,2000-12
2000-12-31,17138,0,17138,세이쉘,2000-12
2000-12-31,13951,345732,-331781,모나코,2000-12
2000-12-31,12972,0,12972,적도 기니,2000-12
2000-12-31,11149,0,11149,몰디브,2000-12
2000-12-31,10639,0,10639,투발루,2000-12
2000-12-31,4385,0,4385,지브랄타,2000-12
2000-12-31,2624,0,2624,르완다,2000-12
2000-12-31,2215,0,2215,존스톤 아일랜드,2000-12
2000-12-31,2000,0,2000,미령 버진군도,2000-12
2000-12-31,186,0,186,크리스마스 아일랜드,2000-12
2000-12-31,120,0,120,쿡 아일랜드,2000-12
2000-12-31,0,263,-263,마이너 아우틀링 합중국 군도,2000-12
2000-12-31,0,173,-173,세인트 키츠 네비스,2000-12
2000-12-31,0,73680,-73680,미드웨이 군도,2000-12
2000-12-31,0,209046,-209046,기네비소,2000-12
2000-12-31,0,14370,-14370,노폴크 아일랜드,2000-12
2000-12-31,0,2595,-2595,프랑스 메트로폴리탄,2000-12
2000-12-31,0,19735,-19735,메요트,2000-12
2000-12-31,0,32625,-32625,팔레스타인 해방기구,2000-12
2000-12-31,0,2987,-2987,피트카이른,2000-12
2000-12-31,0,120164,-120164,앙귈라,2000-12
2000-12-31,0,493,-493,세인트 헬레나,2000-12
2000-12-31,0,22320,-22320,티모르,2000-12
2001-01-31,2703366934,2235579105,467787829,미국,2001-01
2001-01-31,1616072581,2109163730,-493091149,일본,2001-01
2001-01-31,1239083390,999762947,239320443,중국,2001-01
2001-01-31,702872420,84124523,618747897,홍콩,2001-01
2001-01-31,492340788,354970643,137370145,대만,2001-01
2001-01-31,418412954,365682661,52730293,독일,2001-01
2001-01-31,414710148,285108244,129601904,싱가포르,2001-01
2001-01-31,308167094,158898190,149268904,영국,2001-01
2001-01-31,284123554,106853057,177270497,네덜란드,2001-01
2001-01-31,214932811,432170624,-217237813,인도네시아,2001-01
2001-01-31,214251095,421658157,-207407062,말레이시아,2001-01
2001-01-31,213452549,112499806,100952743,인도,2001-01
2001-01-31,200232797,9176253,191056544,파나마,2001-01
2001-01-31,199348173,159862523,39485650,필리핀,2001-01
2001-01-31,183761863,19324091,164437772,멕시코,2001-01
2001-01-31,174266267,29865223,144401044,앙골라,2001-01
2001-01-31,170891593,141189295,29702298,태국,2001-01
2001-01-31,167354370,3174174,164180196,바하마,2001-01
2001-01-31,154964375,76210220,78754155,브라질,2001-01
2001-01-31,145060430,142144686,2915744,이탈리아,2001-01
2001-01-31,140854338,136810760,4043578,캐나다,2001-01
2001-01-31,137431558,410687616,-273256058,호주,2001-01
2001-01-31,133138417,402089185,-268950768,아랍에미리트 연합,2001-01
2001-01-31,119950246,16443301,103506945,노르웨이,2001-01
2001-01-31,119444673,237542448,-118097775,프랑스,2001-01
2001-01-31,114089986,28808876,85281110,스페인,2001-01
2001-01-31,94830841,24559167,70271674,베트남,2001-01
2001-01-31,91651487,829071793,-737420306,사우디아라비아,2001-01
2001-01-31,86557274,45094992,41462282,벨기에,2001-01
2001-01-31,64397226,70648276,-6251050,아일랜드,2001-01
2001-01-31,59611331,175233753,-115622422,러시아 연방,2001-01
2001-01-31,53251663,78117090,-24865427,칠레,2001-01
2001-01-31,48306901,198844895,-150537994,이란,2001-01
2001-01-31,47563156,2565236,44997920,튀르키예,2001-01
2001-01-31,44406559,36098614,8307945,이스라엘,2001-01
2001-01-31,43633421,0,43633421,영령 캐이맨 군도,2001-01
2001-01-31,40992854,29529465,11463389,핀란드,2001-01
2001-01-31,40186411,1555141,38631270,방글라데시,2001-01
2001-01-31,35755675,60609365,-24853690,스위스,2001-01
2001-01-31,34779632,10535568,24244064,우즈베키스탄,2001-01
2001-01-31,33812438,294114046,-260301608,카타르,2001-01
2001-01-31,33176519,41728198,-8551679,스웨덴,2001-01
2001-01-31,32849017,3535191,29313826,몰타,2001-01
2001-01-31,32783872,124393,32659479,마샬군도,2001-01
2001-01-31,32746844,1769599,30977245,이집트,2001-01
2001-01-31,31010845,7904489,23106356,과테말라,2001-01
2001-01-31,29125880,3878541,25247339,베네주엘라,2001-01
2001-01-31,28736894,3015695,25721199,라이베리아,2001-01
2001-01-31,27635521,7371563,20263958,폴란드,2001-01
2001-01-31,25731192,3605696,22125496,스리랑카,2001-01
2001-01-31,25198419,84126765,-58928346,남아프리카공화국,2001-01
2001-01-31,25113275,4324063,20789212,아르헨티나,2001-01
2001-01-31,24651073,19292749,5358324,파키스탄,2001-01
2001-01-31,23040848,1434224,21606624,그리스,2001-01
2001-01-31,21407090,394009,21013081,나이지리아,2001-01
2001-01-31,21375108,548531,20826577,아이슬란드,2001-01
2001-01-31,20908009,1583635,19324374,미얀마,2001-01
2001-01-31,18596021,213386401,-194790380,오만,2001-01
2001-01-31,16725058,4272141,12452917,콜롬비아,2001-01
2001-01-31,15964237,18632031,-2667794,오스트리아,2001-01
2001-01-31,15869609,9125885,6743724,헝가리,2001-01
2001-01-31,15869519,23430986,-7561467,덴마크,2001-01
2001-01-31,15687001,3443061,12243940,기타국,2001-01
2001-01-31,15403148,52658387,-37255239,뉴질랜드,2001-01
2001-01-31,14884714,211971911,-197087197,쿠웨이트,2001-01
2001-01-31,14069171,439372,13629799,시리아,2001-01
2001-01-31,13899748,3596709,10303039,도미니카 공화국,2001-01
2001-01-31,12844947,1333538,11511409,포루투갈,2001-01
2001-01-31,12519269,5419533,7099736,페루,2001-01
2001-01-31,11616538,2332657,9283881,푸에르토리코,2001-01
2001-01-31,10612019,4996302,5615717,알제리,2001-01
2001-01-31,8288263,2735584,5552679,요르단,2001-01
2001-01-31,8251305,2600007,5651298,온두라스,2001-01
2001-01-31,8130795,17440339,-9309544,우크라이나,2001-01
2001-01-31,7926362,0,7926362,리비아,2001-01
2001-01-31,7867771,40396903,-32529132,에쿠아도르,2001-01
2001-01-31,7305403,5701705,1603698,루마니아,2001-01
2001-01-31,7292697,260319,7032378,가나,2001-01
2001-01-31,6922259,0,6922259,아프카니스탄,2001-01
2001-01-31,6701359,2491252,4210107,코스타리카,2001-01
2001-01-31,6473114,1208149,5264965,우루과이,2001-01
2001-01-31,6367237,73380,6293857,엘살바도르,2001-01
2001-01-31,5935087,731651,5203436,카자흐스탄,2001-01
2001-01-31,5723707,295105,5428602,레바논,2001-01
2001-01-31,5475065,123211,5351854,몽골,2001-01
2001-01-31,5396254,901237,4495017,슬로베니아,2001-01
2001-01-31,5361801,195449,5166352,캄보디아,2001-01
2001-01-31,5233528,2354710,2878818,모로코,2001-01
2001-01-31,5132607,11609,5120998,북마리아나 군도,2001-01
2001-01-31,4949075,1081899,3867176,튀니지,2001-01
2001-01-31,4422763,50906083,-46483320,예맨,2001-01
2001-01-31,4268838,0,4268838,토고,2001-01
2001-01-31,4117955,183269,3934686,마카오,2001-01
2001-01-31,3465918,8811163,-5345245,바레인,2001-01
2001-01-31,3410326,71057,3339269,수단,2001-01
2001-01-31,3227144,85211,3141933,케냐,2001-01
2001-01-31,3028000,0,3028000,이라크,2001-01
2001-01-31,2908407,5709,2902698,크로아티아,2001-01
2001-01-31,2904653,8205090,-5300437,체코공화국,2001-01
2001-01-31,2876078,127,2875951,니카라과,2001-01
2001-01-31,2237241,16179,2221062,사이프러스,2001-01
2001-01-31,2111393,75177,2036216,에티오피아,2001-01
2001-01-31,1884330,1663128,221202,에스토니아,2001-01
2001-01-31,1880193,788851,1091342,불가리아,2001-01
2001-01-31,1653694,2052131,-398437,스와질랜드,2001-01
2001-01-31,1644575,119164,1525411,코트디봐르,2001-01
2001-01-31,1593763,50548,1543215,파라과이,2001-01
2001-01-31,1445309,455733,989576,모리셔스,2001-01
2001-01-31,1443882,481623,962259,도미니카,2001-01
2001-01-31,1329907,215794,1114113,괌,2001-01
2001-01-31,1307024,0,1307024,베닝,2001-01
2001-01-31,1174814,635,1174179,유고,2001-01
2001-01-31,1162012,9365,1152647,트리니다드 토바고,2001-01
2001-01-31,1097017,493051,603966,짐바브웨,2001-01
2001-01-31,1054554,75756,978798,네팔,2001-01
2001-01-31,965745,271054,694691,리투아니아,2001-01
2001-01-31,935472,19436,916036,라트비아,2001-01
2001-01-31,876763,36611,840152,탄자니아,2001-01
2001-01-31,872352,0,872352,키르기스스탄,2001-01
2001-01-31,871086,867,870219,지부티,2001-01
2001-01-31,863779,91433,772346,자마이카,2001-01
2001-01-31,685108,0,685108,불령 리유니온 코모도 제도,2001-01
2001-01-31,660851,17506,643345,세네갈,2001-01
2001-01-31,583017,0,583017,마티니크,2001-01
2001-01-31,539668,197293,342375,라오스,2001-01
2001-01-31,518774,14976,503798,카메룬,2001-01
2001-01-31,507209,19570,487639,피지,2001-01
2001-01-31,471118,1410467,-939349,볼리비아,2001-01
2001-01-31,450562,0,450562,몰도바,2001-01
2001-01-31,447594,33060505,-32612911,브루나이,2001-01
2001-01-31,428051,1456436,-1028385,슬로바키아,2001-01
2001-01-31,404983,0,404983,아메리칸 사모아,2001-01
2001-01-31,397934,10520150,-10122216,파푸아 뉴기니,2001-01
2001-01-31,366841,50895983,-50529142,가봉,2001-01
2001-01-31,359226,4742084,-4382858,뉴 칼레도니아,2001-01
2001-01-31,358203,0,358203,마세도니아,2001-01
2001-01-31,355637,0,355637,과델로프,2001-01
2001-01-31,345000,145,344855,마이너 아우틀링 합중국 군도,2001-01
2001-01-31,339916,710324,-370408,룩셈부르그,2001-01
2001-01-31,332379,0,332379,아이티,2001-01
2001-01-31,316034,21258,294776,마다카스카르,2001-01
2001-01-31,309489,1204,308285,투르크멘,2001-01
2001-01-31,307803,0,307803,마이크로네시아,2001-01
2001-01-31,296051,0,296051,네덜란드 열도,2001-01
2001-01-31,272816,0,272816,아루바,2001-01
2001-01-31,254610,9140,245470,바베이도스,2001-01
2001-01-31,238981,0,238981,모잠비크,2001-01
2001-01-31,238141,1503929,-1265788,벨라루스,2001-01
2001-01-31,224599,0,224599,팔라우,2001-01
2001-01-31,211019,276,210743,사모아,2001-01
2001-01-31,198241,0,198241,불령 폴리네시아,2001-01
2001-01-31,198114,0,198114,소말리아,2001-01
2001-01-31,190540,0,190540,보츠와나,2001-01
2001-01-31,189321,436961,-247640,타지크,2001-01
2001-01-31,185977,1642,184335,에리트리아,2001-01
2001-01-31,178858,49383,129475,잠비아,2001-01
2001-01-31,177486,0,177486,불령 가이아나,2001-01
2001-01-31,175119,7523,167596,안티가 바부다,2001-01
2001-01-31,149597,0,149597,수리남,2001-01
2001-01-31,145927,963,144964,우간다,2001-01
2001-01-31,129721,0,129721,모리타니,2001-01
2001-01-31,120836,0,120836,버뮤다,2001-01
2001-01-31,115499,0,115499,알바니아,2001-01
2001-01-31,114223,12007,102216,바누아투,2001-01
2001-01-31,109173,1317514,-1208341,나미비아,2001-01
2001-01-31,98297,156802,-58505,벨리제,2001-01
2001-01-31,97317,10730,86587,니제르,2001-01
2001-01-31,94042,0,94042,가이아나,2001-01
2001-01-31,81090,0,81090,시에라 리온,2001-01
2001-01-31,79234,32726098,-32646864,기니,2001-01
2001-01-31,74805,260343,-185538,조지아,2001-01
2001-01-31,72478,21372,51106,콩고민주공화국,2001-01
2001-01-31,71430,0,71430,말라위,2001-01
2001-01-31,67144,45951311,-45884167,콩고,2001-01
2001-01-31,64040,0,64040,미령 버진군도,2001-01
2001-01-31,50700,0,50700,쿡 아일랜드,2001-01
2001-01-31,42412,0,42412,그레나다,2001-01
2001-01-31,37097,0,37097,세인트 루시아,2001-01
2001-01-31,33384,0,33384,티모르,2001-01
2001-01-31,32141,3280,28861,아제르바이잔,2001-01
2001-01-31,30406,0,30406,중앙아프리카공화국,2001-01
2001-01-31,29432,98302,-68870,리히텐슈타인,2001-01
2001-01-31,24234,0,24234,부탄,2001-01
2001-01-31,23185,724468,-701283,말리,2001-01
2001-01-31,20186,0,20186,르완다,2001-01
2001-01-31,12603,949,11654,보스니아-헤르체고비나,2001-01
2001-01-31,10076,0,10076,부르키나 파소,2001-01
2001-01-31,9596,0,9596,세이쉘,2001-01
2001-01-31,9280,911576,-902296,안도라,2001-01
2001-01-31,8277,0,8277,아르메니아,2001-01
2001-01-31,7295,0,7295,몰디브,2001-01
2001-01-31,4575,0,4575,상토메 프린스페,2001-01
2001-01-31,4514,0,4514,부룬디,2001-01
2001-01-31,3119,0,3119,투발루,2001-01
2001-01-31,1800,356979,-355179,프랑스 메트로폴리탄,2001-01
2001-01-31,1784,2360,-576,감비아,2001-01
2001-01-31,444,1542147,-1541703,솔로몬 군도,2001-01
2001-01-31,0,112014,-112014,미드웨이 군도,2001-01
2001-01-31,0,113642,-113642,그린랜드,2001-01
2001-01-31,0,131027,-131027,모나코,2001-01
2001-01-31,0,23447,-23447,산마리노,2001-01
2001-01-31,0,77,-77,카보 베르데,2001-01
2001-01-31,0,18742,-18742,파나마운하지역,2001-01
2001-01-31,0,113,-113,토켈라우,2001-01
2001-01-31,0,38108,-38108,기네비소,2001-01
2001-01-31,0,389,-389,세인트 헬레나,2001-01
2001-01-31,0,54115,-54115,크리스마스 아일랜드,2001-01
2001-01-31,0,115057,-115057,팔레스타인 해방기구(구),2001-01
2001-01-31,0,11401830,-11401830,중립지대,2001-01
2001-02-28,2502468673,2123376648,379092025,미국,2001-02
2001-02-28,1546804634,2355441568,-808636934,일본,2001-02
2001-02-28,1513732501,874454968,639277533,중국,2001-02
2001-02-28,802615931,81848522,720767409,홍콩,2001-02
2001-02-28,531637905,375508710,156129195,대만,2001-02
2001-02-28,491246242,23853163,467393079,앙골라,2001-02
2001-02-28,389789606,283462528,106327078,싱가포르,2001-02
2001-02-28,349658854,205891031,143767823,영국,2001-02
2001-02-28,342215826,383569330,-41353504,독일,2001-02
2001-02-28,271052292,488004109,-216951817,인도네시아,2001-02
2001-02-28,235111617,79649192,155462425,네덜란드,2001-02
2001-02-28,216252279,443939637,-227687358,말레이시아,2001-02
2001-02-28,209872946,441470111,-231597165,아랍에미리트 연합,2001-02
2001-02-28,206522097,77370445,129151652,브라질,2001-02
2001-02-28,197952769,2488277,195464492,파나마,2001-02
2001-02-28,194194281,17386305,176807976,멕시코,2001-02
2001-02-28,193235844,128857344,64378500,필리핀,2001-02
2001-02-28,180863919,560674202,-379810283,호주,2001-02
2001-02-28,170625257,141350161,29275096,이탈리아,2001-02
2001-02-28,162055051,125969115,36085936,태국,2001-02
2001-02-28,157681678,148752533,8929145,캐나다,2001-02
2001-02-28,138773677,7496601,131277076,바하마,2001-02
2001-02-28,135284913,26764959,108519954,베트남,2001-02
2001-02-28,130391751,5374646,125017105,그리스,2001-02
2001-02-28,120251013,157066947,-36815934,프랑스,2001-02
2001-02-28,117803885,26204790,91599095,스페인,2001-02
2001-02-28,98096757,89973591,8123166,인도,2001-02
2001-02-28,94443257,876792796,-782349539,사우디아라비아,2001-02
2001-02-28,77096149,205552093,-128455944,이란,2001-02
2001-02-28,73375157,42878271,30496886,벨기에,2001-02
2001-02-28,65129503,122429018,-57299515,러시아 연방,2001-02
2001-02-28,63154743,66313609,-3158866,스위스,2001-02
2001-02-28,60661475,51779171,8882304,아일랜드,2001-02
2001-02-28,56954788,5776281,51178507,튀르키예,2001-02
2001-02-28,54600862,1366325,53234537,방글라데시,2001-02
2001-02-28,52627806,366804004,-314176198,카타르,2001-02
2001-02-28,48615529,29304622,19310907,노르웨이,2001-02
2001-02-28,48512788,49344313,-831525,이스라엘,2001-02
2001-02-28,47636191,1334822,46301369,미얀마,2001-02
2001-02-28,46047654,4567910,41479744,스리랑카,2001-02
2001-02-28,42993065,23690182,19302883,파키스탄,2001-02
2001-02-28,42917204,67219709,-24302505,칠레,2001-02
2001-02-28,42615067,22745039,19870028,과테말라,2001-02
2001-02-28,42611943,100885,42511058,베네주엘라,2001-02
2001-02-28,41000110,23527235,17472875,핀란드,2001-02
2001-02-28,35244620,53813953,-18569333,남아프리카공화국,2001-02
2001-02-28,32886759,18837922,14048837,이집트,2001-02
2001-02-28,32813953,0,32813953,마샬군도,2001-02
2001-02-28,32707303,4743268,27964035,아르헨티나,2001-02
2001-02-28,30182386,3338534,26843852,폴란드,2001-02
2001-02-28,30138238,34421789,-4283551,스웨덴,2001-02
2001-02-28,23231179,263436,22967743,나이지리아,2001-02
2001-02-28,21916001,11238482,10677519,우즈베키스탄,2001-02
2001-02-28,20661492,1542756,19118736,포루투갈,2001-02
2001-02-28,20446793,24355052,-3908259,덴마크,2001-02
2001-02-28,20187336,5269,20182067,시리아,2001-02
2001-02-28,20080551,4776848,15303703,콜롬비아,2001-02
2001-02-28,19141007,52136417,-32995410,뉴질랜드,2001-02
2001-02-28,16971410,6901571,10069839,헝가리,2001-02
2001-02-28,16947703,239471343,-222523640,쿠웨이트,2001-02
2001-02-28,16443332,17284763,-841431,오스트리아,2001-02
2001-02-28,16267983,544835,15723148,기타국,2001-02
2001-02-28,16156081,6298753,9857328,페루,2001-02
2001-02-28,14799343,0,14799343,알제리,2001-02
2001-02-28,13954537,3349047,10605490,푸에르토리코,2001-02
2001-02-28,13891844,2217778,11674066,요르단,2001-02
2001-02-28,12850571,2379037,10471534,카자흐스탄,2001-02
2001-02-28,12333249,378355,11954894,리비아,2001-02
2001-02-28,12275138,902849,11372289,온두라스,2001-02
2001-02-28,12175724,3410037,8765687,도미니카 공화국,2001-02
2001-02-28,11656436,44847584,-33191148,에쿠아도르,2001-02
2001-02-28,11036585,278282824,-267246239,오만,2001-02
2001-02-28,9837956,11544912,-1706956,우크라이나,2001-02
2001-02-28,9555120,64695,9490425,괌,2001-02
2001-02-28,9424881,1164457,8260424,루마니아,2001-02
2001-02-28,8803435,187348,8616087,캄보디아,2001-02
2001-02-28,8561378,5233634,3327744,코스타리카,2001-02
2001-02-28,8007714,231238,7776476,레바논,2001-02
2001-02-28,7592023,282018,7310005,튀니지,2001-02
2001-02-28,7532339,831561,6700778,우루과이,2001-02
2001-02-28,7467636,0,7467636,아프카니스탄,2001-02
2001-02-28,7384904,119634,7265270,엘살바도르,2001-02
2001-02-28,7377726,5545597,1832129,모로코,2001-02
2001-02-28,6516992,0,6516992,영령 인도양,2001-02
2001-02-28,5721349,382317,5339032,가나,2001-02
2001-02-28,5630424,0,5630424,토고,2001-02
2001-02-28,5003683,13946147,-8942464,바레인,2001-02
2001-02-28,4389803,93,4389710,니카라과,2001-02
2001-02-28,4251313,193147,4058166,몽골,2001-02
2001-02-28,4245124,18421764,-14176640,수단,2001-02
2001-02-28,4232059,110898,4121161,북마리아나 군도,2001-02
2001-02-28,4186963,6714216,-2527253,체코공화국,2001-02
2001-02-28,4073625,324675,3748950,마카오,2001-02
2001-02-28,3863558,904449,2959109,슬로베니아,2001-02
2001-02-28,3682941,159674,3523267,사이프러스,2001-02
2001-02-28,3488814,37488572,-33999758,예맨,2001-02
2001-02-28,3280591,24972,3255619,파라과이,2001-02
2001-02-28,2580321,105906,2474415,케냐,2001-02
2001-02-28,2107326,13621,2093705,키르기스스탄,2001-02
2001-02-28,1916804,14804,1902000,크로아티아,2001-02
2001-02-28,1907307,14303,1893004,마다카스카르,2001-02
2001-02-28,1695179,28202,1666977,탄자니아,2001-02
2001-02-28,1674497,22067,1652430,모리셔스,2001-02
2001-02-28,1636036,1786017,-149981,몰타,2001-02
2001-02-28,1606298,32783,1573515,에티오피아,2001-02
2001-02-28,1585807,534777,1051030,짐바브웨,2001-02
2001-02-28,1556615,0,1556615,지부티,2001-02
2001-02-28,1548933,27984275,-26435342,이라크,2001-02
2001-02-28,1445244,835731,609513,에스토니아,2001-02
2001-02-28,1441716,54026,1387690,자마이카,2001-02
2001-02-28,1387689,162,1387527,트리니다드 토바고,2001-02
2001-02-28,1368861,184600,1184261,리투아니아,2001-02
2001-02-28,1306548,0,1306548,불령 리유니온 코모도 제도,2001-02
2001-02-28,1262182,0,1262182,코트디봐르,2001-02
2001-02-28,1252756,52754,1200002,네팔,2001-02
2001-02-28,1175059,1729,1173330,유고,2001-02
2001-02-28,1155919,1100383,55536,불가리아,2001-02
2001-02-28,1148741,81274254,-80125513,브루나이,2001-02
2001-02-28,1119276,0,1119276,마티니크,2001-02
2001-02-28,1096995,0,1096995,과델로프,2001-02
2001-02-28,1056359,1440964,-384605,벨라루스,2001-02
2001-02-28,1043814,2287037,-1243223,스와질랜드,2001-02
2001-02-28,863642,20,863622,베닝,2001-02
2001-02-28,861493,31726,829767,라트비아,2001-02
2001-02-28,700153,0,700153,에리트리아,2001-02
2001-02-28,646927,729303,-82376,슬로바키아,2001-02
2001-02-28,607577,0,607577,마이크로네시아,2001-02
2001-02-28,598900,47956,550944,도미니카,2001-02
2001-02-28,589132,30000,559132,라오스,2001-02
2001-02-28,578278,13559247,-12980969,파푸아 뉴기니,2001-02
2001-02-28,572585,79486,493099,피지,2001-02
2001-02-28,555251,0,555251,아루바,2001-02
2001-02-28,551718,36141,515577,벨리제,2001-02
2001-02-28,530578,1888620,-1358042,가봉,2001-02
2001-02-28,517534,0,517534,마세도니아,2001-02
2001-02-28,466512,473054,-6542,아이슬란드,2001-02
2001-02-28,451423,0,451423,세네갈,2001-02
2001-02-28,426992,8140955,-7713963,콩고,2001-02
2001-02-28,397386,18450,378936,가이아나,2001-02
2001-02-28,388016,78691,309325,카메룬,2001-02
2001-02-28,377116,3103942,-2726826,볼리비아,2001-02
2001-02-28,371414,346,371068,바베이도스,2001-02
2001-02-28,365719,806659,-440940,타지크,2001-02
2001-02-28,361657,0,361657,불령 폴리네시아,2001-02
2001-02-28,346267,268770,77497,기니,2001-02
2001-02-28,344042,2736,341306,수리남,2001-02
2001-02-28,327317,0,327317,투르크멘,2001-02
2001-02-28,311850,207,311643,모잠비크,2001-02
2001-02-28,296663,0,296663,뉴 칼레도니아,2001-02
2001-02-28,275667,0,275667,소말리아,2001-02
2001-02-28,271558,0,271558,아이티,2001-02
2001-02-28,246988,12143,234845,우간다,2001-02
2001-02-28,239302,661547,-422245,룩셈부르그,2001-02
2001-02-28,227369,0,227369,레소토,2001-02
2001-02-28,226751,161090,65661,팔레스타인 해방기구(구),2001-02
2001-02-28,213700,0,213700,알바니아,2001-02
2001-02-28,207561,32150,175411,나미비아,2001-02
2001-02-28,195182,0,195182,아메리칸 사모아,2001-02
2001-02-28,169702,0,169702,보츠와나,2001-02
2001-02-28,167856,0,167856,보스니아-헤르체고비나,2001-02
2001-02-28,133893,0,133893,미령 버진군도,2001-02
2001-02-28,128914,59976,68938,잠비아,2001-02
2001-02-28,127613,5412,122201,몰디브,2001-02
2001-02-28,126770,0,126770,네덜란드 열도,2001-02
2001-02-28,122100,0,122100,시에라 리온,2001-02
2001-02-28,114922,0,114922,불령 가이아나,2001-02
2001-02-28,110972,0,110972,버뮤다,2001-02
2001-02-28,106785,344919,-238134,조지아,2001-02
2001-02-28,106347,3541,102806,토켈라우,2001-02
2001-02-28,105801,0,105801,부탄,2001-02
2001-02-28,102504,0,102504,사모아,2001-02
2001-02-28,101930,510,101420,부르키나 파소,2001-02
2001-02-28,76499,0,76499,모리타니,2001-02
2001-02-28,74701,0,74701,통가,2001-02
2001-02-28,73447,0,73447,팔라우,2001-02
2001-02-28,68602,0,68602,말라위,2001-02
2001-02-28,66635,0,66635,아르메니아,2001-02
2001-02-28,65438,0,65438,감비아,2001-02
2001-02-28,63607,23207,40400,바누아투,2001-02
2001-02-28,60206,0,60206,부룬디,2001-02
2001-02-28,50288,0,50288,세인트 키츠 네비스,2001-02
2001-02-28,48100,23864017,-23815917,니제르,2001-02
2001-02-28,43497,0,43497,영령 캐이맨 군도,2001-02
2001-02-28,36796,0,36796,코스 군도,2001-02
2001-02-28,36505,0,36505,아제르바이잔,2001-02
2001-02-28,36351,0,36351,키리바티,2001-02
2001-02-28,31994,0,31994,세이쉘,2001-02
2001-02-28,29357,0,29357,안티가 바부다,2001-02
2001-02-28,28252,0,28252,몰도바,2001-02
2001-02-28,27612,0,27612,세인트 루시아,2001-02
2001-02-28,25639,0,25639,쿡 아일랜드,2001-02
2001-02-28,15920,0,15920,챠드,2001-02
2001-02-28,15408,0,15408,그레나다,2001-02
2001-02-28,15094,0,15094,왈라스 & 퓨투나 군도,2001-02
2001-02-28,14496,206,14290,영령 버진군도,2001-02
2001-02-28,12605,12498,107,콩고민주공화국,2001-02
2001-02-28,11589,0,11589,카보 베르데,2001-02
2001-02-28,10400,0,10400,세인트 빈센트 그레나딘,2001-02
2001-02-28,6449,129577,-123128,말리,2001-02
2001-02-28,5390,0,5390,중앙아프리카공화국,2001-02
2001-02-28,4912,260455,-255543,안도라,2001-02
2001-02-28,4004,200501,-196497,라이베리아,2001-02
2001-02-28,2297,182476,-180179,리히텐슈타인,2001-02
2001-02-28,2000,1177,823,포클랜드 군도,2001-02
2001-02-28,996,0,996,앙귈라,2001-02
2001-02-28,349,1461872,-1461523,솔로몬 군도,2001-02
2001-02-28,322,0,322,지브랄타,2001-02
2001-02-28,0,7304,-7304,팔레스타인 해방기구,2001-02
2001-02-28,0,37829,-37829,투르크 & 카이코스 군도,2001-02
2001-02-28,0,241581,-241581,모나코,2001-02
2001-02-28,0,15,-15,프랑스 메트로폴리탄,2001-02
2001-02-28,0,126408,-126408,그린랜드,2001-02
2001-02-28,0,18338,-18338,보네르 신트외스타티위스,2001-02
2001-02-28,0,61,-61,남조지아 & 남샌드위치 군도,2001-02
2001-03-31,2855151093,2108802312,746348781,미국,2001-03
2001-03-31,1637434941,2529111989,-891677048,일본,2001-03
2001-03-31,1607051165,1141029492,466021673,중국,2001-03
2001-03-31,852738239,105955948,746782291,홍콩,2001-03
2001-03-31,593500667,387812640,205688027,대만,2001-03
2001-03-31,446054295,540497695,-94443400,인도네시아,2001-03
2001-03-31,401896887,251265890,150630997,싱가포르,2001-03
2001-03-31,357335976,403126723,-45790747,독일,2001-03
2001-03-31,341536340,222698658,118837682,영국,2001-03
2001-03-31,292138342,88590615,203547727,네덜란드,2001-03
2001-03-31,269751280,155549367,114201913,이탈리아,2001-03
2001-03-31,224067332,424338576,-200271244,말레이시아,2001-03
2001-03-31,218212166,492622009,-274409843,아랍에미리트 연합,2001-03
2001-03-31,215522814,177507847,38014967,필리핀,2001-03
2001-03-31,200593683,21761310,178832373,멕시코,2001-03
2001-03-31,199691625,56925398,142766227,브라질,2001-03
2001-03-31,197183179,492400549,-295217370,호주,2001-03
2001-03-31,187328590,0,187328590,라이베리아,2001-03
2001-03-31,184247623,26755324,157492299,스페인,2001-03
2001-03-31,169675521,500086,169175435,파나마,2001-03
2001-03-31,159595798,28467434,131128364,베트남,2001-03
2001-03-31,157362475,136142833,21219642,태국,2001-03
2001-03-31,145905218,161069842,-15164624,캐나다,2001-03
2001-03-31,142667633,6895614,135772019,그리스,2001-03
2001-03-31,128923788,605187119,-476263331,사우디아라비아,2001-03
2001-03-31,122944752,189706895,-66762143,프랑스,2001-03
2001-03-31,111844296,99106253,12738043,인도,2001-03
2001-03-31,80996964,60701375,20295589,벨기에,2001-03
2001-03-31,78845449,120340332,-41494883,러시아 연방,2001-03
2001-03-31,63155305,70767526,-7612221,칠레,2001-03
2001-03-31,62797498,170782,62626716,사이프러스,2001-03
2001-03-31,61398953,202712546,-141313593,이란,2001-03
2001-03-31,61135090,1777732,59357358,방글라데시,2001-03
2001-03-31,57508094,62782159,-5274065,아일랜드,2001-03
2001-03-31,52520225,29811331,22708894,과테말라,2001-03
2001-03-31,48119923,77966853,-29846930,스위스,2001-03
2001-03-31,44638959,2529377,42109582,튀르키예,2001-03
2001-03-31,44243702,239625,44004077,베네주엘라,2001-03
2001-03-31,41893219,26400028,15493191,이스라엘,2001-03
2001-03-31,40027449,2986909,37040540,스리랑카,2001-03
2001-03-31,38821230,36512161,2309069,핀란드,2001-03
2001-03-31,38020038,10650160,27369878,우즈베키스탄,2001-03
2001-03-31,37518956,3916297,33602659,이집트,2001-03
2001-03-31,35651684,23831385,11820299,파키스탄,2001-03
2001-03-31,35619466,53022994,-17403528,남아프리카공화국,2001-03
2001-03-31,31504628,35874128,-4369500,스웨덴,2001-03
2001-03-31,31189462,4348137,26841325,폴란드,2001-03
2001-03-31,28817974,11297449,17520525,나이지리아,2001-03
2001-03-31,28273893,5089469,23184424,아르헨티나,2001-03
2001-03-31,27495903,305643822,-278147919,카타르,2001-03
2001-03-31,26350996,9411332,16939664,헝가리,2001-03
2001-03-31,25566165,2327591,23238574,콜롬비아,2001-03
2001-03-31,25226549,1409044,23817505,포루투갈,2001-03
2001-03-31,25061900,136387,24925513,시리아,2001-03
2001-03-31,21440097,1447039,19993058,루마니아,2001-03
2001-03-31,20807178,68664734,-47857556,뉴질랜드,2001-03
2001-03-31,18333150,24786280,-6453130,오스트리아,2001-03
2001-03-31,18258307,5521,18252786,알제리,2001-03
2001-03-31,18200741,363483,17837258,요르단,2001-03
2001-03-31,17881109,31472537,-13591428,덴마크,2001-03
2001-03-31,17069682,26962236,-9892554,페루,2001-03
2001-03-31,16371040,201666503,-185295463,쿠웨이트,2001-03
2001-03-31,16289762,324543,15965219,리비아,2001-03
2001-03-31,15727511,1914970,13812541,기타국,2001-03
2001-03-31,14666349,3296919,11369430,도미니카 공화국,2001-03
2001-03-31,13935106,265459197,-251524091,오만,2001-03
2001-03-31,13361796,1710864,11650932,온두라스,2001-03
2001-03-31,13280474,1705936,11574538,미얀마,2001-03
2001-03-31,12862024,45014090,-32152066,에쿠아도르,2001-03
2001-03-31,12486351,5780706,6705645,푸에르토리코,2001-03
2001-03-31,11864701,128241,11736460,엘살바도르,2001-03
2001-03-31,11324418,15103121,-3778703,우크라이나,2001-03
2001-03-31,10894342,25073917,-14179575,노르웨이,2001-03
2001-03-31,10447403,0,10447403,이라크,2001-03
2001-03-31,10224943,338375,9886568,캄보디아,2001-03
2001-03-31,10065089,582854,9482235,레바논,2001-03
2001-03-31,9919563,2061347,7858216,카자흐스탄,2001-03
2001-03-31,9185327,597770,8587557,튀니지,2001-03
2001-03-31,8620366,7904,8612462,아프카니스탄,2001-03
2001-03-31,8410062,1432394,6977668,모로코,2001-03
2001-03-31,8286735,465153,7821582,가나,2001-03
2001-03-31,8119051,28981,8090070,괌,2001-03
2001-03-31,7906266,16005,7890261,북마리아나 군도,2001-03
2001-03-31,7865096,3223996,4641100,바레인,2001-03
2001-03-31,7702266,1177678,6524588,코스타리카,2001-03
2001-03-31,6656409,15976724,-9320315,수단,2001-03
2001-03-31,6563576,409371,6154205,마카오,2001-03
2001-03-31,6537956,403725,6134231,몽골,2001-03
2001-03-31,5956474,163,5956311,니카라과,2001-03
2001-03-31,5728985,236732,5492253,우루과이,2001-03
2001-03-31,5620012,9415957,-3795945,체코공화국,2001-03
2001-03-31,5149743,817825,4331918,슬로베니아,2001-03
2001-03-31,4354338,28004,4326334,크로아티아,2001-03
2001-03-31,4273011,23623,4249388,파라과이,2001-03
2001-03-31,3972400,74549155,-70576755,예맨,2001-03
2001-03-31,3510718,113436,3397282,케냐,2001-03
2001-03-31,2995466,0,2995466,앙골라,2001-03
2001-03-31,2811030,200572,2610458,에티오피아,2001-03
2001-03-31,2660794,0,2660794,토고,2001-03
2001-03-31,2569712,0,2569712,투르크멘,2001-03
2001-03-31,2315736,8364,2307372,유고,2001-03
2001-03-31,2195449,2645,2192804,모리셔스,2001-03
2001-03-31,1970551,145897,1824654,자마이카,2001-03
2001-03-31,1926180,37035,1889145,키르기스스탄,2001-03
2001-03-31,1787801,1027299,760502,불가리아,2001-03
2001-03-31,1706198,39923,1666275,트리니다드 토바고,2001-03
2001-03-31,1700959,78241,1622718,도미니카,2001-03
2001-03-31,1573755,0,1573755,지부티,2001-03
2001-03-31,1533096,493169,1039927,슬로바키아,2001-03
2001-03-31,1506638,1504478,2160,리투아니아,2001-03
2001-03-31,1490010,4703730,-3213720,몰타,2001-03
2001-03-31,1449040,186815,1262225,탄자니아,2001-03
2001-03-31,1423062,46358,1376704,피지,2001-03
2001-03-31,1394602,23376,1371226,코트디봐르,2001-03
2001-03-31,1362971,1817,1361154,바하마,2001-03
2001-03-31,1337387,1232277,105110,에스토니아,2001-03
2001-03-31,1281924,18263,1263661,라트비아,2001-03
2001-03-31,1252400,0,1252400,마티니크,2001-03
2001-03-31,1229914,16433,1213481,과델로프,2001-03
2001-03-31,1227752,0,1227752,사모아,2001-03
2001-03-31,1217164,35000,1182164,라오스,2001-03
2001-03-31,1190308,42002,1148306,마다카스카르,2001-03
2001-03-31,1146991,57821768,-56674777,브루나이,2001-03
2001-03-31,1130277,30108,1100169,모잠비크,2001-03
2001-03-31,1108669,174,1108495,불령 리유니온 코모도 제도,2001-03
2001-03-31,1097051,744608,352443,벨라루스,2001-03
2001-03-31,1088175,0,1088175,세네갈,2001-03
2001-03-31,977835,0,977835,베닝,2001-03
2001-03-31,955000,0,955000,아이티,2001-03
2001-03-31,911696,35543,876153,뉴 칼레도니아,2001-03
2001-03-31,903057,448727,454330,짐바브웨,2001-03
2001-03-31,902476,102074,800402,잠비아,2001-03
2001-03-31,871778,2307421,-1435643,스와질랜드,2001-03
2001-03-31,857826,1023549,-165723,룩셈부르그,2001-03
2001-03-31,768956,156645,612311,네팔,2001-03
2001-03-31,756174,524882,231292,아이슬란드,2001-03
2001-03-31,745280,0,745280,마세도니아,2001-03
2001-03-31,716030,0,716030,마샬군도,2001-03
2001-03-31,679124,0,679124,마이크로네시아,2001-03
2001-03-31,619636,5254893,-4635257,파푸아 뉴기니,2001-03
2001-03-31,612811,0,612811,보츠와나,2001-03
2001-03-31,575650,70390,505260,벨리제,2001-03
2001-03-31,559002,79032,479970,볼리비아,2001-03
2001-03-31,536184,38144,498040,콩고,2001-03
2001-03-31,466900,0,466900,불령 폴리네시아,2001-03
2001-03-31,435496,0,435496,팔라우,2001-03
2001-03-31,428600,0,428600,버뮤다,2001-03
2001-03-31,425070,16304,408766,바베이도스,2001-03
2001-03-31,399609,315,399294,아루바,2001-03
2001-03-31,370371,0,370371,아메리칸 사모아,2001-03
2001-03-31,342437,501918,-159481,기니,2001-03
2001-03-31,319985,0,319985,소말리아,2001-03
2001-03-31,284326,23293,261033,카메룬,2001-03
2001-03-31,273011,87142,185869,우간다,2001-03
2001-03-31,269642,2356,267286,아제르바이잔,2001-03
2001-03-31,267626,362724,-95098,말리,2001-03
2001-03-31,259354,0,259354,영령 캐이맨 군도,2001-03
2001-03-31,247867,1107,246760,보스니아-헤르체고비나,2001-03
2001-03-31,240381,1152963,-912582,가봉,2001-03
2001-03-31,228623,0,228623,수리남,2001-03
2001-03-31,219219,0,219219,에리트리아,2001-03
2001-03-31,186593,0,186593,감비아,2001-03
2001-03-31,184190,0,184190,르완다,2001-03
2001-03-31,169864,626,169238,알바니아,2001-03
2001-03-31,160607,39184,121423,아르메니아,2001-03
2001-03-31,152647,30819,121828,나미비아,2001-03
2001-03-31,143471,0,143471,세인트 루시아,2001-03
2001-03-31,142044,0,142044,모리타니,2001-03
2001-03-31,139272,0,139272,몰도바,2001-03
2001-03-31,134991,0,134991,그레나다,2001-03
2001-03-31,134836,87915,46921,콩고민주공화국,2001-03
2001-03-31,132864,150281,-17417,팔레스타인 해방기구(구),2001-03
2001-03-31,126424,0,126424,부르키나 파소,2001-03
2001-03-31,125783,20136,105647,시에라 리온,2001-03
2001-03-31,109298,1438112,-1328814,가이아나,2001-03
2001-03-31,100964,708722,-607758,타지크,2001-03
2001-03-31,94880,308272,-213392,조지아,2001-03
2001-03-31,79132,63,79069,말라위,2001-03
2001-03-31,64647,110,64537,미령 버진군도,2001-03
2001-03-31,59317,0,59317,안티가 바부다,2001-03
2001-03-31,57413,0,57413,네덜란드 열도,2001-03
2001-03-31,56740,814,55926,몰디브,2001-03
2001-03-31,51174,0,51174,불령 가이아나,2001-03
2001-03-31,49680,0,49680,부탄,2001-03
2001-03-31,44618,1036558,-991940,솔로몬 군도,2001-03
2001-03-31,31404,0,31404,세인트 빈센트 그레나딘,2001-03
2001-03-31,26551,0,26551,투발루,2001-03
2001-03-31,25354,0,25354,쿡 아일랜드,2001-03
2001-03-31,21036,0,21036,세이쉘,2001-03
2001-03-31,20513,11274,9239,니제르,2001-03
2001-03-31,16063,0,16063,중앙아프리카공화국,2001-03
2001-03-31,15602,78200,-62598,리히텐슈타인,2001-03
2001-03-31,9113,54802,-45689,바누아투,2001-03
2001-03-31,8930,0,8930,포클랜드 군도,2001-03
2001-03-31,6953,0,6953,레소토,2001-03
2001-03-31,6484,0,6484,부룬디,2001-03
2001-03-31,3791,0,3791,카보 베르데,2001-03
2001-03-31,2000,0,2000,팔레스타인 해방기구,2001-03
2001-03-31,1166,0,1166,프랑스 메트로폴리탄,2001-03
2001-03-31,1048,0,1048,지브랄타,2001-03
2001-03-31,456,0,456,파로에 군도,2001-03
2001-03-31,0,262392,-262392,모나코,2001-03
2001-03-31,0,104505,-104505,미드웨이 군도,2001-03
2001-03-31,0,18222,-18222,마이너 아우틀링 합중국 군도,2001-03
2001-03-31,0,748644,-748644,티모르,2001-03
2001-03-31,0,115681,-115681,그린랜드,2001-03
2001-03-31,0,55,-55,영령 버진군도,2001-03
2001-03-31,0,4533131,-4533131,안도라,2001-03
2001-03-31,0,12231602,-12231602,중립지대,2001-03
2001-03-31,0,0,0,코모로스,2001-03
2001-03-31,0,2232,-2232,세인트 헬레나,2001-03
2001-03-31,0,436,-436,존스톤 아일랜드,2001-03
2001-04-30,2427541727,1791502639,636039088,미국,2001-04
2001-04-30,1540004834,1040240002,499764832,중국,2001-04
2001-04-30,1365516173,2239856886,-874340713,일본,2001-04
2001-04-30,858202241,89375527,768826714,홍콩,2001-04
2001-04-30,497828150,343505772,154322378,대만,2001-04
2001-04-30,329790685,362251092,-32460407,독일,2001-04
2001-04-30,302987714,199793202,103194512,싱가포르,2001-04
2001-04-30,289637319,209848882,79788437,영국,2001-04
2001-04-30,250182199,351378324,-101196125,인도네시아,2001-04
2001-04-30,219299015,408936907,-189637892,말레이시아,2001-04
2001-04-30,185562002,353847105,-168285103,아랍에미리트 연합,2001-04
2001-04-30,179228564,14868996,164359568,멕시코,2001-04
2001-04-30,177500726,155822862,21677864,필리핀,2001-04
2001-04-30,171622358,72182966,99439392,네덜란드,2001-04
2001-04-30,165996377,6610269,159386108,그리스,2001-04
2001-04-30,162685498,67330609,95354889,브라질,2001-04
2001-04-30,161374128,382833779,-221459651,호주,2001-04
2001-04-30,158882377,131793787,27088590,이탈리아,2001-04
2001-04-30,158568640,149959599,8609041,캐나다,2001-04
2001-04-30,158361600,41833171,116528429,베트남,2001-04
2001-04-30,135523279,116652629,18870650,태국,2001-04
2001-04-30,121641607,23500017,98141590,스페인,2001-04
2001-04-30,103771133,155455866,-51684733,프랑스,2001-04
2001-04-30,101540023,125037949,-23497926,인도,2001-04
2001-04-30,96729007,646037208,-549308201,사우디아라비아,2001-04
2001-04-30,96405292,56219540,40185752,튀르키예,2001-04
2001-04-30,91445057,76554,91368503,라이베리아,2001-04
2001-04-30,85783629,110207885,-24424256,러시아 연방,2001-04
2001-04-30,84343636,126201,84217435,파나마,2001-04
2001-04-30,83794155,132113909,-48319754,이란,2001-04
2001-04-30,64123231,40538911,23584320,벨기에,2001-04
2001-04-30,51462633,2726704,48735929,방글라데시,2001-04
2001-04-30,49359350,51931427,-2572077,칠레,2001-04
2001-04-30,48864413,25744022,23120391,이스라엘,2001-04
2001-04-30,43427084,64407674,-20980590,스위스,2001-04
2001-04-30,42704691,242,42704449,바하마,2001-04
2001-04-30,40301390,15021984,25279406,과테말라,2001-04
2001-04-30,39214620,30924129,8290491,핀란드,2001-04
2001-04-30,39007259,79796035,-40788776,아일랜드,2001-04
2001-04-30,37954905,12902297,25052608,미얀마,2001-04
2001-04-30,37688702,21373871,16314831,이집트,2001-04
2001-04-30,36259983,170757,36089226,베네주엘라,2001-04
2001-04-30,36164340,54226742,-18062402,남아프리카공화국,2001-04
2001-04-30,35715848,11736589,23979259,우즈베키스탄,2001-04
2001-04-30,31857192,4460417,27396775,스리랑카,2001-04
2001-04-30,29260255,62080792,-32820537,뉴질랜드,2001-04
2001-04-30,28963449,13530886,15432563,아르헨티나,2001-04
2001-04-30,28728137,5846446,22881691,폴란드,2001-04
2001-04-30,27707506,158163,27549343,시리아,2001-04
2001-04-30,27100426,16357942,10742484,나이지리아,2001-04
2001-04-30,24843388,28068663,-3225275,파키스탄,2001-04
2001-04-30,23601786,45596,23556190,사이프러스,2001-04
2001-04-30,23188043,36613325,-13425282,스웨덴,2001-04
2001-04-30,20378667,3736496,16642171,콜롬비아,2001-04
2001-04-30,19365962,17627507,1738455,오스트리아,2001-04
2001-04-30,19153324,1105344,18047980,포루투갈,2001-04
2001-04-30,18038302,24093036,-6054734,덴마크,2001-04
2001-04-30,17992448,9299520,8692928,페루,2001-04
2001-04-30,17834250,194262,17639988,리비아,2001-04
2001-04-30,16722054,5098213,11623841,루마니아,2001-04
2001-04-30,14663685,7611286,7052399,헝가리,2001-04
2001-04-30,14522252,14442734,79518,에쿠아도르,2001-04
2001-04-30,14251834,3137256,11114578,알제리,2001-04
2001-04-30,14195838,18109727,-3913889,우크라이나,2001-04
2001-04-30,13630350,229002,13401348,요르단,2001-04
2001-04-30,13551957,0,13551957,앙골라,2001-04
2001-04-30,13478068,3599912,9878156,도미니카 공화국,2001-04
2001-04-30,13199052,1430171,11768881,기타국,2001-04
2001-04-30,13128299,2278783,10849516,푸에르토리코,2001-04
2001-04-30,12477987,80242477,-67764490,쿠웨이트,2001-04
2001-04-30,12444325,193076723,-180632398,카타르,2001-04
2001-04-30,11849139,1340415,10508724,온두라스,2001-04
2001-04-30,9852583,16410,9836173,북마리아나 군도,2001-04
2001-04-30,9566514,97178,9469336,엘살바도르,2001-04
2001-04-30,9548274,216387409,-206839135,오만,2001-04
2001-04-30,8831110,13583,8817527,아프카니스탄,2001-04
2001-04-30,8717367,530691,8186676,레바논,2001-04
2001-04-30,8689013,1062062,7626951,코스타리카,2001-04
2001-04-30,8439298,602802,7836496,캄보디아,2001-04
2001-04-30,7699117,974184,6724933,모로코,2001-04
2001-04-30,7374721,234734,7139987,가나,2001-04
2001-04-30,7163388,1951300,5212088,카자흐스탄,2001-04
2001-04-30,7028451,0,7028451,이라크,2001-04
2001-04-30,6963294,812402,6150892,슬로베니아,2001-04
2001-04-30,6820827,638880,6181947,몽골,2001-04
2001-04-30,6714777,435402,6279375,우루과이,2001-04
2001-04-30,5820695,240405,5580290,튀니지,2001-04
2001-04-30,5805333,4090360,1714973,바레인,2001-04
2001-04-30,5644660,0,5644660,니카라과,2001-04
2001-04-30,5419920,133109,5286811,마카오,2001-04
2001-04-30,5243710,18821741,-13578031,노르웨이,2001-04
2001-04-30,4855496,17038803,-12183307,수단,2001-04
2001-04-30,3674214,24344,3649870,케냐,2001-04
2001-04-30,3663397,9843987,-6180590,체코공화국,2001-04
2001-04-30,3472355,75135967,-71663612,예맨,2001-04
2001-04-30,3375952,25963,3349989,크로아티아,2001-04
2001-04-30,2955977,29242,2926735,코트디봐르,2001-04
2001-04-30,2761494,25662,2735832,파라과이,2001-04
2001-04-30,2312088,21694,2290394,트리니다드 토바고,2001-04
2001-04-30,2217477,0,2217477,토고,2001-04
2001-04-30,2027414,34681,1992733,키르기스스탄,2001-04
2001-04-30,1922661,66860793,-64938132,브루나이,2001-04
2001-04-30,1677239,2493450,-816211,몰타,2001-04
2001-04-30,1618246,87455,1530791,에티오피아,2001-04
2001-04-30,1598328,0,1598328,베닝,2001-04
2001-04-30,1571498,129,1571369,모리셔스,2001-04
2001-04-30,1412404,92464,1319940,라트비아,2001-04
2001-04-30,1410022,87122,1322900,자마이카,2001-04
2001-04-30,1337207,88740,1248467,탄자니아,2001-04
2001-04-30,1164819,2677180,-1512361,파푸아 뉴기니,2001-04
2001-04-30,1164270,79671,1084599,도미니카,2001-04
2001-04-30,1149011,1633493,-484482,스와질랜드,2001-04
2001-04-30,1136059,1424102,-288043,리투아니아,2001-04
2001-04-30,1117723,18720,1099003,괌,2001-04
2001-04-30,1105942,538080,567862,짐바브웨,2001-04
2001-04-30,1033298,145076,888222,벨리제,2001-04
2001-04-30,1026350,0,1026350,팔라우,2001-04
2001-04-30,1021421,0,1021421,과델로프,2001-04
2001-04-30,995346,1022864,-27518,불가리아,2001-04
2001-04-30,963824,0,963824,투르크멘,2001-04
2001-04-30,957988,63051,894937,네팔,2001-04
2001-04-30,937213,1898579,-961366,룩셈부르그,2001-04
2001-04-30,922255,264955,657300,아이슬란드,2001-04
2001-04-30,904426,112614,791812,카메룬,2001-04
2001-04-30,866102,624594,241508,벨라루스,2001-04
2001-04-30,834972,2301284,-1466312,볼리비아,2001-04
2001-04-30,832802,13707,819095,지부티,2001-04
2001-04-30,799917,1410,798507,유고,2001-04
2001-04-30,755015,4782,750233,피지,2001-04
2001-04-30,754444,757065,-2621,슬로바키아,2001-04
2001-04-30,728560,0,728560,마티니크,2001-04
2001-04-30,712489,463,712026,불령 리유니온 코모도 제도,2001-04
2001-04-30,678278,826196,-147918,에스토니아,2001-04
2001-04-30,663383,9835,653548,마다카스카르,2001-04
2001-04-30,653348,2327527,-1674179,뉴 칼레도니아,2001-04
2001-04-30,632208,0,632208,아이티,2001-04
2001-04-30,607402,21217,586185,세네갈,2001-04
2001-04-30,577877,29055,548822,모잠비크,2001-04
2001-04-30,528289,320183,208106,기니,2001-04
2001-04-30,435245,23537333,-23102088,콩고,2001-04
2001-04-30,429343,328,429015,시에라 리온,2001-04
2001-04-30,422881,0,422881,안티가 바부다,2001-04
2001-04-30,367497,30000,337497,라오스,2001-04
2001-04-30,365896,0,365896,보스니아-헤르체고비나,2001-04
2001-04-30,354446,71204,283242,잠비아,2001-04
2001-04-30,344978,0,344978,에리트리아,2001-04
2001-04-30,341376,0,341376,아루바,2001-04
2001-04-30,329697,20617,309080,바베이도스,2001-04
2001-04-30,310492,7272,303220,마세도니아,2001-04
2001-04-30,287542,3887,283655,나미비아,2001-04
2001-04-30,265938,811186,-545248,타지크,2001-04
2001-04-30,261655,0,261655,불령 폴리네시아,2001-04
2001-04-30,248703,0,248703,말라위,2001-04
2001-04-30,235544,0,235544,감비아,2001-04
2001-04-30,234306,0,234306,마이크로네시아,2001-04
2001-04-30,229793,173845,55948,가봉,2001-04
2001-04-30,228440,598,227842,아메리칸 사모아,2001-04
2001-04-30,209580,0,209580,사모아,2001-04
2001-04-30,189456,146907,42549,안도라,2001-04
2001-04-30,183448,0,183448,보츠와나,2001-04
2001-04-30,173319,817,172502,중립지대,2001-04
2001-04-30,170912,21117,149795,아제르바이잔,2001-04
2001-04-30,170226,0,170226,알바니아,2001-04
2001-04-30,169526,98477,71049,우간다,2001-04
2001-04-30,167615,0,167615,가이아나,2001-04
2001-04-30,161000,0,161000,노폴크 아일랜드,2001-04
2001-04-30,157453,19314,138139,네덜란드 열도,2001-04
2001-04-30,152018,89948,62070,바누아투,2001-04
2001-04-30,134540,0,134540,수리남,2001-04
2001-04-30,130540,94708,35832,콩고민주공화국,2001-04
2001-04-30,126870,0,126870,버뮤다,2001-04
2001-04-30,119235,548,118687,티모르,2001-04
2001-04-30,116398,0,116398,영령 캐이맨 군도,2001-04
2001-04-30,113062,360804,-247742,조지아,2001-04
2001-04-30,111770,0,111770,아르메니아,2001-04
2001-04-30,101221,0,101221,소말리아,2001-04
2001-04-30,83957,1485,82472,몰디브,2001-04
2001-04-30,82411,0,82411,마샬군도,2001-04
2001-04-30,67988,2807,65181,르완다,2001-04
2001-04-30,56920,0,56920,레소토,2001-04
2001-04-30,55392,0,55392,포클랜드 군도,2001-04
2001-04-30,54659,44126,10533,모리타니,2001-04
2001-04-30,52861,0,52861,그레나다,2001-04
2001-04-30,51222,0,51222,메요트,2001-04
2001-04-30,42329,0,42329,키리바티,2001-04
2001-04-30,38926,0,38926,세인트 빈센트 그레나딘,2001-04
2001-04-30,34625,0,34625,부탄,2001-04
2001-04-30,34465,25270,9195,팔레스타인 해방기구(구),2001-04
2001-04-30,32330,0,32330,세인트 루시아,2001-04
2001-04-30,31769,6437,25332,니제르,2001-04
2001-04-30,28655,277241,-248586,부르키나 파소,2001-04
2001-04-30,28129,0,28129,통가,2001-04
2001-04-30,27165,269,26896,미령 버진군도,2001-04
2001-04-30,25575,0,25575,쿡 아일랜드,2001-04
2001-04-30,23457,0,23457,투발루,2001-04
2001-04-30,21570,0,21570,허드 앤 맥도날드 군도,2001-04
2001-04-30,21402,0,21402,몰도바,2001-04
2001-04-30,20028,849984,-829956,말리,2001-04
2001-04-30,19292,2811705,-2792413,솔로몬 군도,2001-04
2001-04-30,19263,602711,-583448,모나코,2001-04
2001-04-30,13750,0,13750,부룬디,2001-04
2001-04-30,9919,0,9919,앙귈라,2001-04
2001-04-30,9405,0,9405,세인트 키츠 네비스,2001-04
2001-04-30,6880,0,6880,세이쉘,2001-04
2001-04-30,5305,39136,-33831,리히텐슈타인,2001-04
2001-04-30,651,0,651,영령 인도양,2001-04
2001-04-30,359,0,359,지브랄타,2001-04
2001-04-30,30,0,30,몬트세라트,2001-04
2001-04-30,0,1703,-1703,프랑스 메트로폴리탄,2001-04
2001-04-30,0,37680,-37680,보네르 신트외스타티위스,2001-04
2001-04-30,0,1198936,-1198936,나우루,2001-04
2001-04-30,0,43005,-43005,크리스마스 아일랜드,2001-04
2001-04-30,0,285,-285,코스 군도,2001-04
2001-04-30,0,82500,-82500,토켈라우,2001-04
2001-04-30,0,439,-439,세인트 헬레나,2001-04
2001-04-30,0,37175,-37175,존스톤 아일랜드,2001-04
2001-04-30,0,74336,-74336,미드웨이 군도,2001-04
2001-05-31,2511513054,1800273579,711239475,미국,2001-05
2001-05-31,1600296077,1102178666,498117411,중국,2001-05
2001-05-31,1479760006,2100010652,-620250646,일본,2001-05
2001-05-31,936811601,120267615,816543986,홍콩,2001-05
2001-05-31,476946616,364775520,112171096,대만,2001-05
2001-05-31,382063007,399024581,-16961574,독일,2001-05
2001-05-31,374818691,223934225,150884466,싱가포르,2001-05
2001-05-31,296965419,342017629,-45052210,인도네시아,2001-05
2001-05-31,277386527,194965969,82420558,영국,2001-05
2001-05-31,253727822,80634521,173093301,네덜란드,2001-05
2001-05-31,248924479,3041896,245882583,그리스,2001-05
2001-05-31,237168135,133824937,103343198,필리핀,2001-05
2001-05-31,213652143,143512435,70139708,이탈리아,2001-05
2001-05-31,209456150,284422854,-74966704,말레이시아,2001-05
2001-05-31,191033697,200044107,-9010410,캐나다,2001-05
2001-05-31,166476164,0,166476164,라이베리아,2001-05
2001-05-31,163293890,33407101,129886789,베트남,2001-05
2001-05-31,162372155,73563067,88809088,브라질,2001-05
2001-05-31,161634416,454989318,-293354902,호주,2001-05
2001-05-31,160312660,135326566,24986094,태국,2001-05
2001-05-31,158655472,69793,158585679,파나마,2001-05
2001-05-31,154919801,19515869,135403932,멕시코,2001-05
2001-05-31,154103338,3384786,150718552,방글라데시,2001-05
2001-05-31,153822136,338202024,-184379888,아랍에미리트 연합,2001-05
2001-05-31,122475195,26554560,95920635,스페인,2001-05
2001-05-31,112205049,106388080,5816969,인도,2001-05
2001-05-31,106476964,171687058,-65210094,프랑스,2001-05
2001-05-31,97763955,755562174,-657798219,사우디아라비아,2001-05
2001-05-31,85673358,249198170,-163524812,이란,2001-05
2001-05-31,81710357,132666,81577691,괌,2001-05
2001-05-31,78173392,129451508,-51278116,러시아 연방,2001-05
2001-05-31,60808571,52450218,8358353,벨기에,2001-05
2001-05-31,58106602,56616662,1489940,칠레,2001-05
2001-05-31,57891716,70870937,-12979221,스위스,2001-05
2001-05-31,51501197,38379550,13121647,아일랜드,2001-05
2001-05-31,51164002,203331044,-152167042,카타르,2001-05
2001-05-31,46586231,0,46586231,영령 캐이맨 군도,2001-05
2001-05-31,41253722,7851776,33401946,우즈베키스탄,2001-05
2001-05-31,39906479,23389318,16517161,과테말라,2001-05
2001-05-31,39879747,55420785,-15541038,남아프리카공화국,2001-05
2001-05-31,38582556,11824065,26758491,튀르키예,2001-05
2001-05-31,38345308,44626057,-6280749,스웨덴,2001-05
2001-05-31,37960943,30587370,7373573,이집트,2001-05
2001-05-31,37753815,19206938,18546877,이스라엘,2001-05
2001-05-31,37409888,36160168,1249720,파키스탄,2001-05
2001-05-31,35939174,323188,35615986,베네주엘라,2001-05
2001-05-31,32724430,37923,32686507,바하마,2001-05
2001-05-31,32610869,27007063,5603806,핀란드,2001-05
2001-05-31,32197387,3138094,29059293,스리랑카,2001-05
2001-05-31,31596463,10329817,21266646,아르헨티나,2001-05
2001-05-31,29067178,6807519,22259659,나이지리아,2001-05
2001-05-31,28012990,1801723,26211267,미얀마,2001-05
2001-05-31,27364534,562741,26801793,시리아,2001-05
2001-05-31,25520371,12122375,13397996,기타국,2001-05
2001-05-31,23828087,3860882,19967205,폴란드,2001-05
2001-05-31,23769562,45043,23724519,리비아,2001-05
2001-05-31,23505985,0,23505985,마샬군도,2001-05
2001-05-31,23092635,2005188,21087447,포루투갈,2001-05
2001-05-31,22694942,111899,22583043,사이프러스,2001-05
2001-05-31,22239702,60545349,-38305647,뉴질랜드,2001-05
2001-05-31,21074259,2231883,18842376,콜롬비아,2001-05
2001-05-31,16934290,234059492,-217125202,쿠웨이트,2001-05
2001-05-31,16664114,20124858,-3460744,오스트리아,2001-05
2001-05-31,16574599,3679836,12894763,알제리,2001-05
2001-05-31,16207753,5463291,10744462,페루,2001-05
2001-05-31,15060782,238861,14821921,가나,2001-05
2001-05-31,14853462,333998,14519464,에쿠아도르,2001-05
2001-05-31,14648046,65925,14582121,요르단,2001-05
2001-05-31,13733752,0,13733752,이라크,2001-05
2001-05-31,12767320,30536825,-17769505,덴마크,2001-05
2001-05-31,12445847,3105068,9340779,도미니카 공화국,2001-05
2001-05-31,11647871,1679339,9968532,온두라스,2001-05
2001-05-31,11201358,1111324,10090034,루마니아,2001-05
2001-05-31,10733500,16213856,-5480356,우크라이나,2001-05
2001-05-31,10583765,6895131,3688634,헝가리,2001-05
2001-05-31,10380478,2441802,7938676,푸에르토리코,2001-05
2001-05-31,10267718,1056368,9211350,코스타리카,2001-05
2001-05-31,9554843,208284788,-198729945,오만,2001-05
2001-05-31,9318331,5010698,4307633,수단,2001-05
2001-05-31,9144930,12841,9132089,북마리아나 군도,2001-05
2001-05-31,9032123,23071892,-14039769,카자흐스탄,2001-05
2001-05-31,8951863,120288,8831575,캄보디아,2001-05
2001-05-31,8212454,0,8212454,아프카니스탄,2001-05
2001-05-31,7893788,404180,7489608,레바논,2001-05
2001-05-31,7827792,15891,7811901,몽골,2001-05
2001-05-31,7796948,1580748,6216200,모로코,2001-05
2001-05-31,7737398,48976468,-41239070,노르웨이,2001-05
2001-05-31,7224792,783898,6440894,우루과이,2001-05
2001-05-31,7130697,73789,7056908,마카오,2001-05
2001-05-31,6969031,67811,6901220,엘살바도르,2001-05
2001-05-31,6364461,7433878,-1069417,체코공화국,2001-05
2001-05-31,6131812,129097,6002715,튀니지,2001-05
2001-05-31,5263523,88522,5175001,케냐,2001-05
2001-05-31,4361276,0,4361276,니카라과,2001-05
2001-05-31,4244767,107875,4136892,크로아티아,2001-05
2001-05-31,4068229,28483978,-24415749,예맨,2001-05
2001-05-31,3825364,2906677,918687,바레인,2001-05
2001-05-31,3299956,2126,3297830,파라과이,2001-05
2001-05-31,3137690,10565,3127125,아메리칸 사모아,2001-05
2001-05-31,2912544,614960,2297584,불가리아,2001-05
2001-05-31,2868225,4076,2864149,토고,2001-05
2001-05-31,2663895,1485599,1178296,슬로베니아,2001-05
2001-05-31,2471863,14074750,-11602887,브루나이,2001-05
2001-05-31,2101829,2556,2099273,모리셔스,2001-05
2001-05-31,2084000,608024,1475976,벨리제,2001-05
2001-05-31,1751691,43685,1708006,트리니다드 토바고,2001-05
2001-05-31,1734283,94773,1639510,에티오피아,2001-05
2001-05-31,1683952,96712,1587240,키르기스스탄,2001-05
2001-05-31,1647776,826499,821277,리투아니아,2001-05
2001-05-31,1555912,14444,1541468,코트디봐르,2001-05
2001-05-31,1457655,0,1457655,마티니크,2001-05
2001-05-31,1346526,5625900,-4279374,에스토니아,2001-05
2001-05-31,1322310,0,1322310,불령 리유니온 코모도 제도,2001-05
2001-05-31,1285068,0,1285068,베닝,2001-05
2001-05-31,1285046,55974,1229072,마다카스카르,2001-05
2001-05-31,1272649,79495,1193154,자마이카,2001-05
2001-05-31,1221080,3630275,-2409195,몰타,2001-05
2001-05-31,1183820,53985,1129835,네팔,2001-05
2001-05-31,1182392,58617,1123775,탄자니아,2001-05
2001-05-31,1145564,22998363,-21852799,콩고,2001-05
2001-05-31,1141985,0,1141985,앙골라,2001-05
2001-05-31,1084168,0,1084168,과델로프,2001-05
2001-05-31,1002397,0,1002397,지부티,2001-05
2001-05-31,984193,0,984193,아이티,2001-05
2001-05-31,952778,673731,279047,아이슬란드,2001-05
2001-05-31,926937,1069660,-142723,벨라루스,2001-05
2001-05-31,907509,580491,327018,짐바브웨,2001-05
2001-05-31,864584,782837,81747,기니,2001-05
2001-05-31,856311,27789,828522,세네갈,2001-05
2001-05-31,822638,24160880,-23338242,파푸아 뉴기니,2001-05
2001-05-31,765288,1431965,-666677,스와질랜드,2001-05
2001-05-31,753685,135,753550,투르크멘,2001-05
2001-05-31,752243,6529,745714,팔라우,2001-05
2001-05-31,734974,61536,673438,라트비아,2001-05
2001-05-31,733065,0,733065,마이크로네시아,2001-05
2001-05-31,725327,72158,653169,피지,2001-05
2001-05-31,614418,179,614239,유고,2001-05
2001-05-31,604734,50431,554303,카메룬,2001-05
2001-05-31,580357,0,580357,모잠비크,2001-05
2001-05-31,530552,65623,464929,볼리비아,2001-05
2001-05-31,523117,2190599,-1667482,뉴 칼레도니아,2001-05
2001-05-31,503094,1016006,-512912,가봉,2001-05
2001-05-31,483959,1156192,-672233,슬로바키아,2001-05
2001-05-31,470036,27141,442895,불령 폴리네시아,2001-05
2001-05-31,428481,0,428481,아루바,2001-05
2001-05-31,357102,1140626,-783524,룩셈부르그,2001-05
2001-05-31,351655,0,351655,라오스,2001-05
2001-05-31,339716,6280,333436,바베이도스,2001-05
2001-05-31,321358,18918,302440,도미니카,2001-05
2001-05-31,318551,1042,317509,잠비아,2001-05
2001-05-31,274837,2774,272063,보스니아-헤르체고비나,2001-05
2001-05-31,232699,0,232699,보츠와나,2001-05
2001-05-31,191417,11330,180087,모리타니,2001-05
2001-05-31,183957,0,183957,네덜란드 열도,2001-05
2001-05-31,183223,26684252,-26501029,니제르,2001-05
2001-05-31,181631,0,181631,레소토,2001-05
2001-05-31,180805,0,180805,버뮤다,2001-05
2001-05-31,174720,0,174720,마세도니아,2001-05
2001-05-31,166202,0,166202,에리트리아,2001-05
2001-05-31,162577,0,162577,아르메니아,2001-05
2001-05-31,159464,264496,-105032,조지아,2001-05
2001-05-31,156263,748939,-592676,말리,2001-05
2001-05-31,155300,182812,-27512,안도라,2001-05
2001-05-31,151225,0,151225,가이아나,2001-05
2001-05-31,147791,120990,26801,우간다,2001-05
2001-05-31,147643,0,147643,수리남,2001-05
2001-05-31,147505,68828,78677,바누아투,2001-05
2001-05-31,147436,20198,127238,안티가 바부다,2001-05
2001-05-31,144779,333450,-188671,타지크,2001-05
2001-05-31,137035,0,137035,알바니아,2001-05
2001-05-31,131425,0,131425,기네비소,2001-05
2001-05-31,128447,0,128447,말라위,2001-05
2001-05-31,116579,0,116579,부룬디,2001-05
2001-05-31,116516,0,116516,시에라 리온,2001-05
2001-05-31,109428,0,109428,통가,2001-05
2001-05-31,103279,2619,100660,감비아,2001-05
2001-05-31,103233,45670,57563,나미비아,2001-05
2001-05-31,102409,5292,97117,몰디브,2001-05
2001-05-31,88454,0,88454,소말리아,2001-05
2001-05-31,82638,0,82638,사모아,2001-05
2001-05-31,79449,0,79449,그레나다,2001-05
2001-05-31,74935,8897,66038,팔레스타인 해방기구(구),2001-05
2001-05-31,71647,451110,-379463,모나코,2001-05
2001-05-31,53722,5440,48282,중앙아프리카공화국,2001-05
2001-05-31,46101,17000,29101,아제르바이잔,2001-05
2001-05-31,43531,0,43531,세이쉘,2001-05
2001-05-31,38302,0,38302,파나마운하지역,2001-05
2001-05-31,36519,0,36519,세인트 루시아,2001-05
2001-05-31,34138,15733,18405,콩고민주공화국,2001-05
2001-05-31,33740,0,33740,티모르,2001-05
2001-05-31,28494,286729,-258235,부르키나 파소,2001-05
2001-05-31,24082,0,24082,몰도바,2001-05
2001-05-31,22722,0,22722,쿡 아일랜드,2001-05
2001-05-31,20417,1215630,-1195213,솔로몬 군도,2001-05
2001-05-31,19773,3346,16427,르완다,2001-05
2001-05-31,9430,0,9430,지브랄타,2001-05
2001-05-31,9405,0,9405,세인트 키츠 네비스,2001-05
2001-05-31,3985,7256,-3271,프랑스 메트로폴리탄,2001-05
2001-05-31,2871,0,2871,포클랜드 군도,2001-05
2001-05-31,2340,28095,-25755,리히텐슈타인,2001-05
2001-05-31,1372,0,1372,세인트 빈센트 그레나딘,2001-05
2001-05-31,1035,2668,-1633,앙귈라,2001-05
2001-05-31,850,69,781,키리바티,2001-05
2001-05-31,301,0,301,부탄,2001-05
2001-05-31,0,5000,-5000,챠드,2001-05
2001-05-31,0,3504,-3504,존스톤 아일랜드,2001-05
2001-05-31,0,61,-61,영령 버진군도,2001-05
2001-05-31,0,52388,-52388,그린랜드,2001-05
2001-05-31,0,34883,-34883,미드웨이 군도,2001-05
2001-05-31,0,34646,-34646,토켈라우,2001-05
2001-05-31,0,12681231,-12681231,중립지대,2001-05
2001-06-30,2669876560,1817305712,852570848,미국,2001-06
2001-06-30,1647396857,1114708967,532687890,중국,2001-06
2001-06-30,1421370438,2233205483,-811835045,일본,2001-06
2001-06-30,791948637,84333890,707614747,홍콩,2001-06
2001-06-30,494980775,327603559,167377216,대만,2001-06
2001-06-30,352340238,173808086,178532152,영국,2001-06
2001-06-30,307512147,229534528,77977619,싱가포르,2001-06
2001-06-30,282721377,341717744,-58996367,독일,2001-06
2001-06-30,243829265,306971977,-63142712,인도네시아,2001-06
2001-06-30,233593889,160138684,73455205,필리핀,2001-06
2001-06-30,224456977,304360686,-79903709,말레이시아,2001-06
2001-06-30,222813492,153424790,69388702,이탈리아,2001-06
2001-06-30,216617803,124750362,91867441,캐나다,2001-06
2001-06-30,189944151,68121361,121822790,네덜란드,2001-06
2001-06-30,189547745,25083466,164464279,멕시코,2001-06
2001-06-30,187491325,0,187491325,영령 캐이맨 군도,2001-06
2001-06-30,181204926,396459413,-215254487,호주,2001-06
2001-06-30,171525161,479061490,-307536329,아랍에미리트 연합,2001-06
2001-06-30,162529118,29226720,133302398,베트남,2001-06
2001-06-30,162244647,134889946,27354701,태국,2001-06
2001-06-30,159076613,4513533,154563080,파나마,2001-06
2001-06-30,146709274,105432774,41276500,브라질,2001-06
2001-06-30,144525705,63616238,80909467,인도,2001-06
2001-06-30,139548162,30657575,108890587,스페인,2001-06
2001-06-30,110509281,153485008,-42975727,프랑스,2001-06
2001-06-30,101494439,70177,101424262,라이베리아,2001-06
2001-06-30,99554610,687894857,-588340247,사우디아라비아,2001-06
2001-06-30,93804046,2495310,91308736,그리스,2001-06
2001-06-30,79137032,5200220,73936812,튀르키예,2001-06
2001-06-30,71915303,142641832,-70726529,러시아 연방,2001-06
2001-06-30,69622726,273693134,-204070408,이란,2001-06
2001-06-30,61664864,65232062,-3567198,칠레,2001-06
2001-06-30,61559858,81220,61478638,사이프러스,2001-06
2001-06-30,54577184,39894356,14682828,벨기에,2001-06
2001-06-30,50192260,494242,49698018,베네주엘라,2001-06
2001-06-30,46120588,2472391,43648197,방글라데시,2001-06
2001-06-30,42981632,85134512,-42152880,아르헨티나,2001-06
2001-06-30,42432278,9464586,32967692,우즈베키스탄,2001-06
2001-06-30,40675172,70578591,-29903419,남아프리카공화국,2001-06
2001-06-30,40198162,25444386,14753776,과테말라,2001-06
2001-06-30,36763407,39109334,-2345927,스웨덴,2001-06
2001-06-30,35684195,1928353,33755842,이집트,2001-06
2001-06-30,34782119,28403788,6378331,이스라엘,2001-06
2001-06-30,32622024,69466337,-36844313,아일랜드,2001-06
2001-06-30,30804584,3511656,27292928,스리랑카,2001-06
2001-06-30,29246131,26060231,3185900,파키스탄,2001-06
2001-06-30,28472177,128765,28343412,시리아,2001-06
2001-06-30,27873508,41258265,-13384757,핀란드,2001-06
2001-06-30,26766468,9914,26756554,나이지리아,2001-06
2001-06-30,26581658,1060659,25520999,폴란드,2001-06
2001-06-30,26209573,63489723,-37280150,뉴질랜드,2001-06
2001-06-30,24120352,19905257,4215095,오스트리아,2001-06
2001-06-30,22856013,232085,22623928,모나코,2001-06
2001-06-30,20390046,67446435,-47056389,스위스,2001-06
2001-06-30,20051104,0,20051104,마샬군도,2001-06
2001-06-30,18626275,817050,17809225,포루투갈,2001-06
2001-06-30,17462748,205909876,-188447128,쿠웨이트,2001-06
2001-06-30,17187944,16595556,592388,에쿠아도르,2001-06
2001-06-30,17076582,132843,16943739,요르단,2001-06
2001-06-30,16732709,0,16732709,리비아,2001-06
2001-06-30,16653197,1187,16652010,괌,2001-06
2001-06-30,16083611,4482093,11601518,콜롬비아,2001-06
2001-06-30,15995744,1021804,14973940,기타국,2001-06
2001-06-30,14958075,2862510,12095565,페루,2001-06
2001-06-30,14509222,355224,14153998,가나,2001-06
2001-06-30,14388006,24570793,-10182787,덴마크,2001-06
2001-06-30,12967053,0,12967053,이라크,2001-06
2001-06-30,12735741,16129329,-3393588,우크라이나,2001-06
2001-06-30,12548103,1147812,11400291,온두라스,2001-06
2001-06-30,12477903,16236,12461667,몽골,2001-06
2001-06-30,12234117,2841934,9392183,도미니카 공화국,2001-06
2001-06-30,11334549,1058379,10276170,코스타리카,2001-06
2001-06-30,10779762,67793717,-57013955,노르웨이,2001-06
2001-06-30,10699138,12507161,-1808023,헝가리,2001-06
2001-06-30,10388517,2056859,8331658,미얀마,2001-06
2001-06-30,10099846,0,10099846,아프카니스탄,2001-06
2001-06-30,10076129,184514248,-174438119,오만,2001-06
2001-06-30,9011374,5484386,3526988,푸에르토리코,2001-06
2001-06-30,8200745,91694,8109051,엘살바도르,2001-06
2001-06-30,8009122,5710573,2298549,알제리,2001-06
2001-06-30,7758534,8875922,-1117388,체코공화국,2001-06
2001-06-30,7711688,228998,7482690,캄보디아,2001-06
2001-06-30,7269436,4930684,2338752,모로코,2001-06
2001-06-30,7103753,921740,6182013,루마니아,2001-06
2001-06-30,6865549,466648,6398901,레바논,2001-06
2001-06-30,6852952,1202745,5650207,우루과이,2001-06
2001-06-30,6453771,64300,6389471,북마리아나 군도,2001-06
2001-06-30,5771976,261691696,-255919720,카타르,2001-06
2001-06-30,5700624,12678,5687946,니카라과,2001-06
2001-06-30,5136008,4039887,1096121,카자흐스탄,2001-06
2001-06-30,5122446,3100365,2022081,수단,2001-06
2001-06-30,4962005,58626,4903379,마카오,2001-06
2001-06-30,4900458,147797,4752661,튀니지,2001-06
2001-06-30,4724538,0,4724538,토고,2001-06
2001-06-30,4522612,51394,4471218,케냐,2001-06
2001-06-30,3677724,24356458,-20678734,바레인,2001-06
2001-06-30,3473793,1187007,2286786,슬로베니아,2001-06
2001-06-30,2958056,4408,2953648,파라과이,2001-06
2001-06-30,2844635,49167215,-46322580,예맨,2001-06
2001-06-30,2769582,21544,2748038,크로아티아,2001-06
2001-06-30,2677188,96285,2580903,트리니다드 토바고,2001-06
2001-06-30,2324041,596,2323445,아메리칸 사모아,2001-06
2001-06-30,2217806,24384,2193422,에티오피아,2001-06
2001-06-30,2198949,1665,2197284,모리셔스,2001-06
2001-06-30,1936944,0,1936944,코트디봐르,2001-06
2001-06-30,1779538,1684700,94838,몰타,2001-06
2001-06-30,1703602,111636,1591966,키르기스스탄,2001-06
2001-06-30,1632186,131914,1500272,리투아니아,2001-06
2001-06-30,1599323,424091,1175232,불가리아,2001-06
2001-06-30,1494143,22762,1471381,유고,2001-06
2001-06-30,1433174,10563506,-9130332,파푸아 뉴기니,2001-06
2001-06-30,1373303,24575270,-23201967,앙골라,2001-06
2001-06-30,1293503,0,1293503,마티니크,2001-06
2001-06-30,1259814,0,1259814,불령 리유니온 코모도 제도,2001-06
2001-06-30,1248334,28414,1219920,피지,2001-06
2001-06-30,1216316,76844,1139472,네팔,2001-06
2001-06-30,1205266,0,1205266,팔라우,2001-06
2001-06-30,1196643,551,1196092,바하마,2001-06
2001-06-30,1152356,229535,922821,벨리제,2001-06
2001-06-30,1107022,47723,1059299,탄자니아,2001-06
2001-06-30,1051039,1318810,-267771,볼리비아,2001-06
2001-06-30,1030106,22609,1007497,마다카스카르,2001-06
2001-06-30,1024452,1340659,-316207,스와질랜드,2001-06
2001-06-30,1005143,432233,572910,아이슬란드,2001-06
2001-06-30,1004159,159138,845021,자마이카,2001-06
2001-06-30,993002,0,993002,투르크멘,2001-06
2001-06-30,980302,4990083,-4009781,에스토니아,2001-06
2001-06-30,971598,0,971598,과델로프,2001-06
2001-06-30,941318,13683042,-12741724,브루나이,2001-06
2001-06-30,880130,44337,835793,도미니카,2001-06
2001-06-30,860072,0,860072,베닝,2001-06
2001-06-30,775370,0,775370,지부티,2001-06
2001-06-30,764953,2259116,-1494163,뉴 칼레도니아,2001-06
2001-06-30,736137,0,736137,모잠비크,2001-06
2001-06-30,725833,761989,-36156,슬로바키아,2001-06
2001-06-30,651964,36843,615121,라트비아,2001-06
2001-06-30,645097,0,645097,아이티,2001-06
2001-06-30,613434,590600,22834,짐바브웨,2001-06
2001-06-30,543451,24635,518816,세네갈,2001-06
2001-06-30,536883,13563,523320,불령 폴리네시아,2001-06
2001-06-30,535456,13160829,-12625373,중립지대,2001-06
2001-06-30,529859,1080248,-550389,카메룬,2001-06
2001-06-30,529280,29940725,-29411445,가봉,2001-06
2001-06-30,490708,0,490708,미령 버진군도,2001-06
2001-06-30,474727,0,474727,라오스,2001-06
2001-06-30,471802,0,471802,보스니아-헤르체고비나,2001-06
2001-06-30,466799,0,466799,노폴크 아일랜드,2001-06
2001-06-30,443779,51164859,-50721080,콩고,2001-06
2001-06-30,428990,1485416,-1056426,벨라루스,2001-06
2001-06-30,351952,200,351752,아루바,2001-06
2001-06-30,344898,0,344898,레소토,2001-06
2001-06-30,340982,875876,-534894,말리,2001-06
2001-06-30,333521,0,333521,에리트리아,2001-06
2001-06-30,332617,18808,313809,아제르바이잔,2001-06
2001-06-30,299226,422843,-123617,타지크,2001-06
2001-06-30,290485,0,290485,말라위,2001-06
2001-06-30,290244,0,290244,수리남,2001-06
2001-06-30,283640,0,283640,보츠와나,2001-06
2001-06-30,263319,103685,159634,잠비아,2001-06
2001-06-30,260093,23540,236553,시에라 리온,2001-06
2001-06-30,241358,0,241358,알바니아,2001-06
2001-06-30,224025,0,224025,가이아나,2001-06
2001-06-30,204846,0,204846,사모아,2001-06
2001-06-30,197697,14830,182867,바베이도스,2001-06
2001-06-30,193749,0,193749,버뮤다,2001-06
2001-06-30,187742,360106,-172364,기니,2001-06
2001-06-30,181471,0,181471,마세도니아,2001-06
2001-06-30,163915,0,163915,감비아,2001-06
2001-06-30,157261,2325,154936,마이크로네시아,2001-06
2001-06-30,155734,0,155734,몰디브,2001-06
2001-06-30,142697,0,142697,아르메니아,2001-06
2001-06-30,130538,0,130538,네덜란드 열도,2001-06
2001-06-30,130520,740,129780,팔레스타인 해방기구(구),2001-06
2001-06-30,130401,0,130401,소말리아,2001-06
2001-06-30,122796,289,122507,몰도바,2001-06
2001-06-30,122003,22478,99525,바누아투,2001-06
2001-06-30,121036,0,121036,르완다,2001-06
2001-06-30,118965,941429,-822464,룩셈부르그,2001-06
2001-06-30,111840,0,111840,모리타니,2001-06
2001-06-30,110483,1552374,-1441891,솔로몬 군도,2001-06
2001-06-30,81961,6136,75825,세인트 키츠 네비스,2001-06
2001-06-30,79786,414335,-334549,조지아,2001-06
2001-06-30,76200,0,76200,메요트,2001-06
2001-06-30,75256,218136,-142880,우간다,2001-06
2001-06-30,72270,0,72270,부탄,2001-06
2001-06-30,69098,77357,-8259,나미비아,2001-06
2001-06-30,66837,124856,-58019,안티가 바부다,2001-06
2001-06-30,42426,0,42426,부룬디,2001-06
2001-06-30,42242,186847,-144605,안도라,2001-06
2001-06-30,36679,0,36679,티모르,2001-06
2001-06-30,34830,0,34830,투르크 & 카이코스 군도,2001-06
2001-06-30,29883,0,29883,키리바티,2001-06
2001-06-30,29318,0,29318,캔톤아일랜드,2001-06
2001-06-30,29135,0,29135,그레나다,2001-06
2001-06-30,25781,0,25781,세이쉘,2001-06
2001-06-30,22549,313,22236,니제르,2001-06
2001-06-30,19985,0,19985,지브랄타,2001-06
2001-06-30,17633,38142,-20509,앙귈라,2001-06
2001-06-30,15838,0,15838,통가,2001-06
2001-06-30,15653,96962,-81309,중앙아프리카공화국,2001-06
2001-06-30,15102,16894,-1792,콩고민주공화국,2001-06
2001-06-30,12400,0,12400,카보 베르데,2001-06
2001-06-30,11588,0,11588,프랑스 메트로폴리탄,2001-06
2001-06-30,8864,214,8650,파로에 군도,2001-06
2001-06-30,8622,0,8622,세인트 빈센트 그레나딘,2001-06
2001-06-30,8519,0,8519,포클랜드 군도,2001-06
2001-06-30,6701,0,6701,나우루,2001-06
2001-06-30,5009,30708,-25699,리히텐슈타인,2001-06
2001-06-30,734,0,734,세인트 루시아,2001-06
2001-06-30,290,286793,-286503,부르키나 파소,2001-06
2001-06-30,60,0,60,쿡 아일랜드,2001-06
2001-06-30,0,285043,-285043,적도 기니,2001-06
2001-06-30,0,105535,-105535,미드웨이 군도,2001-06
2001-06-30,0,42566,-42566,영령 버진군도,2001-06
2001-06-30,0,256849,-256849,기네비소,2001-06
2001-06-30,0,6727,-6727,토켈라우,2001-06
2001-06-30,0,5961,-5961,세인트 헬레나,2001-06
2001-06-30,0,50009,-50009,그린랜드,2001-06
2001-07-31,2434080251,1838915453,595164798,미국,2001-07
2001-07-31,1532212464,1093696239,438516225,중국,2001-07
2001-07-31,1206250955,2118284739,-912033784,일본,2001-07
2001-07-31,698154966,96036378,602118588,홍콩,2001-07
2001-07-31,434274116,351408483,82865633,대만,2001-07
2001-07-31,358246876,341385928,16860948,독일,2001-07
2001-07-31,318585509,226273645,92311864,싱가포르,2001-07
2001-07-31,248333738,332475390,-84141652,인도네시아,2001-07
2001-07-31,243719807,182260399,61459408,영국,2001-07
2001-07-31,226543026,140775094,85767932,필리핀,2001-07
2001-07-31,197735380,311928869,-114193489,말레이시아,2001-07
2001-07-31,188678781,147492946,41185835,프랑스,2001-07
2001-07-31,186767283,125337448,61429835,캐나다,2001-07
2001-07-31,177160004,20925790,156234214,멕시코,2001-07
2001-07-31,172729182,362574740,-189845558,아랍에미리트 연합,2001-07
2001-07-31,147578297,70159164,77419133,네덜란드,2001-07
2001-07-31,142761073,439208673,-296447600,호주,2001-07
2001-07-31,134354511,30940951,103413560,베트남,2001-07
2001-07-31,132310550,116204413,16106137,태국,2001-07
2001-07-31,130082423,1447674,128634749,그리스,2001-07
2001-07-31,126900401,174787679,-47887278,이탈리아,2001-07
2001-07-31,115001911,100340293,14661618,브라질,2001-07
2001-07-31,112621245,570883499,-458262254,사우디아라비아,2001-07
2001-07-31,110978487,78978544,31999943,인도,2001-07
2001-07-31,108510610,32025056,76485554,스페인,2001-07
2001-07-31,82607739,0,82607739,마샬군도,2001-07
2001-07-31,76886213,198729989,-121843776,러시아 연방,2001-07
2001-07-31,74501178,4373412,70127766,튀르키예,2001-07
2001-07-31,70325309,149483732,-79158423,이란,2001-07
2001-07-31,52414779,0,52414779,라이베리아,2001-07
2001-07-31,51821901,42898143,8923758,벨기에,2001-07
2001-07-31,46989785,92796563,-45806778,아일랜드,2001-07
2001-07-31,46723052,43596626,3126426,칠레,2001-07
2001-07-31,42262353,2490293,39772060,방글라데시,2001-07
2001-07-31,40628434,87764943,-47136509,스위스,2001-07
2001-07-31,40092808,543483,39549325,베네주엘라,2001-07
2001-07-31,34987719,60896800,-25909081,남아프리카공화국,2001-07
2001-07-31,32052655,62036203,-29983548,아르헨티나,2001-07
2001-07-31,30520717,2539901,27980816,폴란드,2001-07
2001-07-31,29940840,22112207,7828633,과테말라,2001-07
2001-07-31,29571270,4929896,24641374,이집트,2001-07
2001-07-31,28700449,43226509,-14526060,스웨덴,2001-07
2001-07-31,27656110,151501,27504609,시리아,2001-07
2001-07-31,27027825,19804348,7223477,핀란드,2001-07
2001-07-31,23866241,31579317,-7713076,파키스탄,2001-07
2001-07-31,23644049,10325197,13318852,우즈베키스탄,2001-07
2001-07-31,23181635,28141530,-4959895,오스트리아,2001-07
2001-07-31,22749831,60778209,-38028378,뉴질랜드,2001-07
2001-07-31,22727725,22995437,-267712,이스라엘,2001-07
2001-07-31,22614910,2734854,19880056,스리랑카,2001-07
2001-07-31,22410851,106,22410745,나이지리아,2001-07
2001-07-31,20369992,77761,20292231,괌,2001-07
2001-07-31,20264200,1888640,18375560,미얀마,2001-07
2001-07-31,18428800,118096,18310704,요르단,2001-07
2001-07-31,18330332,26686478,-8356146,덴마크,2001-07
2001-07-31,18235662,17401547,834115,에쿠아도르,2001-07
2001-07-31,16381800,19466315,-3084515,우크라이나,2001-07
2001-07-31,15760679,6151357,9609322,파나마,2001-07
2001-07-31,15201454,6818127,8383327,헝가리,2001-07
2001-07-31,15125928,1061874,14064054,포루투갈,2001-07
2001-07-31,14631514,2796789,11834725,콜롬비아,2001-07
2001-07-31,13990202,198261902,-184271700,쿠웨이트,2001-07
2001-07-31,12933156,127916541,-114983385,오만,2001-07
2001-07-31,12790903,7988263,4802640,페루,2001-07
2001-07-31,12433285,1638233,10795052,기타국,2001-07
2001-07-31,12025007,22787,12002220,리비아,2001-07
2001-07-31,11741382,11393911,347471,알제리,2001-07
2001-07-31,10998721,92044,10906677,가나,2001-07
2001-07-31,10456596,1618472,8838124,온두라스,2001-07
2001-07-31,10333453,3497113,6836340,도미니카 공화국,2001-07
2001-07-31,9602407,2417033,7185374,푸에르토리코,2001-07
2001-07-31,8371949,0,8371949,아프카니스탄,2001-07
2001-07-31,8263260,1297823,6965437,코스타리카,2001-07
2001-07-31,7530849,53552,7477297,북마리아나 군도,2001-07
2001-07-31,6657638,24152214,-17494576,노르웨이,2001-07
2001-07-31,6639694,1653475,4986219,캄보디아,2001-07
2001-07-31,6582630,387044,6195586,레바논,2001-07
2001-07-31,6249433,290880,5958553,몽골,2001-07
2001-07-31,6057752,31512,6026240,이라크,2001-07
2001-07-31,5994190,3979711,2014479,카자흐스탄,2001-07
2001-07-31,5797805,1833976,3963829,모로코,2001-07
2001-07-31,5793360,7677176,-1883816,체코공화국,2001-07
2001-07-31,5606519,10867796,-5261277,루마니아,2001-07
2001-07-31,5483790,140561842,-135078052,카타르,2001-07
2001-07-31,5144943,867480,4277463,우루과이,2001-07
2001-07-31,4842434,277759,4564675,튀니지,2001-07
2001-07-31,4516018,275522,4240496,수단,2001-07
2001-07-31,4463985,206563,4257422,엘살바도르,2001-07
2001-07-31,4361421,23915,4337506,니카라과,2001-07
2001-07-31,4335615,30926113,-26590498,바레인,2001-07
2001-07-31,4270183,180896,4089287,벨리제,2001-07
2001-07-31,4246525,8020,4238505,토고,2001-07
2001-07-31,3747436,30556498,-26809062,예맨,2001-07
2001-07-31,3725933,22643,3703290,케냐,2001-07
2001-07-31,3557375,126535,3430840,마카오,2001-07
2001-07-31,3223577,957328,2266249,슬로베니아,2001-07
2001-07-31,2579455,17950,2561505,크로아티아,2001-07
2001-07-31,2528394,28028365,-25499971,앙골라,2001-07
2001-07-31,2417409,15016,2402393,사이프러스,2001-07
2001-07-31,2117907,1717694,400213,스와질랜드,2001-07
2001-07-31,2113967,109605,2004362,파라과이,2001-07
2001-07-31,1935445,25873,1909572,에티오피아,2001-07
2001-07-31,1917881,1205099,712782,불가리아,2001-07
2001-07-31,1812716,226123,1586593,리투아니아,2001-07
2001-07-31,1725840,0,1725840,아메리칸 사모아,2001-07
2001-07-31,1689106,14688,1674418,코트디봐르,2001-07
2001-07-31,1573119,56414,1516705,모리셔스,2001-07
2001-07-31,1252885,31244,1221641,탄자니아,2001-07
2001-07-31,1185296,196,1185100,트리니다드 토바고,2001-07
2001-07-31,1178930,257963,920967,짐바브웨,2001-07
2001-07-31,1101280,6821114,-5719834,파푸아 뉴기니,2001-07
2001-07-31,1053972,46588,1007384,키르기스스탄,2001-07
2001-07-31,987322,0,987322,브루나이,2001-07
2001-07-31,966267,111086,855181,네팔,2001-07
2001-07-31,953074,541,952533,자마이카,2001-07
2001-07-31,865307,0,865307,레소토,2001-07
2001-07-31,853827,0,853827,마티니크,2001-07
2001-07-31,840997,107204,733793,세네갈,2001-07
2001-07-31,792325,67964,724361,라트비아,2001-07
2001-07-31,787526,406,787120,불령 리유니온 코모도 제도,2001-07
2001-07-31,783516,112464,671052,아이슬란드,2001-07
2001-07-31,777046,0,777046,네덜란드 열도,2001-07
2001-07-31,755085,62127,692958,피지,2001-07
2001-07-31,748687,0,748687,투르크멘,2001-07
2001-07-31,738912,856195,-117283,룩셈부르그,2001-07
2001-07-31,738158,15616,722542,베닝,2001-07
2001-07-31,716892,38849,678043,마다카스카르,2001-07
2001-07-31,699462,0,699462,아이티,2001-07
2001-07-31,693689,4751771,-4058082,에스토니아,2001-07
2001-07-31,672617,81091,591526,도미니카,2001-07
2001-07-31,631355,0,631355,바하마,2001-07
2001-07-31,583688,3932,579756,지부티,2001-07
2001-07-31,559394,0,559394,팔라우,2001-07
2001-07-31,515998,407647,108351,벨라루스,2001-07
2001-07-31,493737,149833,343904,볼리비아,2001-07
2001-07-31,493688,9218873,-8725185,몰타,2001-07
2001-07-31,488742,0,488742,아루바,2001-07
2001-07-31,466998,0,466998,노폴크 아일랜드,2001-07
2001-07-31,422396,4912,417484,마이크로네시아,2001-07
2001-07-31,401563,385260,16303,슬로바키아,2001-07
2001-07-31,397730,510,397220,뉴 칼레도니아,2001-07
2001-07-31,393897,0,393897,보스니아-헤르체고비나,2001-07
2001-07-31,393179,0,393179,말라위,2001-07
2001-07-31,387553,257410,130143,기니,2001-07
2001-07-31,380306,6782,373524,유고,2001-07
2001-07-31,376506,0,376506,모잠비크,2001-07
2001-07-31,309843,217940,91903,우간다,2001-07
2001-07-31,269340,42838,226502,카메룬,2001-07
2001-07-31,253965,2182,251783,바베이도스,2001-07
2001-07-31,243419,17280,226139,라오스,2001-07
2001-07-31,242626,11633,230993,아제르바이잔,2001-07
2001-07-31,242305,52428448,-52186143,콩고,2001-07
2001-07-31,226901,436831,-209930,나미비아,2001-07
2001-07-31,213172,0,213172,과델로프,2001-07
2001-07-31,209273,0,209273,수리남,2001-07
2001-07-31,179019,0,179019,감비아,2001-07
2001-07-31,159776,0,159776,사모아,2001-07
2001-07-31,154409,14796,139613,불령 폴리네시아,2001-07
2001-07-31,153014,537022,-384008,가봉,2001-07
2001-07-31,149404,6600,142804,영령 캐이맨 군도,2001-07
2001-07-31,149332,0,149332,르완다,2001-07
2001-07-31,140740,0,140740,시에라 리온,2001-07
2001-07-31,127988,0,127988,보츠와나,2001-07
2001-07-31,121538,0,121538,에리트리아,2001-07
2001-07-31,116771,6871,109900,모리타니,2001-07
2001-07-31,111138,315,110823,몰도바,2001-07
2001-07-31,103255,118486,-15231,잠비아,2001-07
2001-07-31,103029,0,103029,알바니아,2001-07
2001-07-31,96363,280486,-184123,말리,2001-07
2001-07-31,91009,0,91009,몰디브,2001-07
2001-07-31,88910,0,88910,소말리아,2001-07
2001-07-31,82915,120,82795,버뮤다,2001-07
2001-07-31,81752,0,81752,가이아나,2001-07
2001-07-31,67917,79623,-11706,바누아투,2001-07
2001-07-31,67835,0,67835,부탄,2001-07
2001-07-31,62776,0,62776,세이쉘,2001-07
2001-07-31,50780,0,50780,세인트 키츠 네비스,2001-07
2001-07-31,48574,141981,-93407,조지아,2001-07
2001-07-31,47020,0,47020,안티가 바부다,2001-07
2001-07-31,46989,0,46989,불령 가이아나,2001-07
2001-07-31,45197,0,45197,포클랜드 군도,2001-07
2001-07-31,42939,0,42939,마세도니아,2001-07
2001-07-31,36042,0,36042,아르메니아,2001-07
2001-07-31,33750,268,33482,챠드,2001-07
2001-07-31,29437,0,29437,그레나다,2001-07
2001-07-31,28360,224,28136,쿡 아일랜드,2001-07
2001-07-31,28037,289368,-261331,콩고민주공화국,2001-07
2001-07-31,27716,4889,22827,부르키나 파소,2001-07
2001-07-31,27700,28648,-948,중립지대,2001-07
2001-07-31,26571,0,26571,세인트 빈센트 그레나딘,2001-07
2001-07-31,25942,0,25942,투발루,2001-07
2001-07-31,22578,0,22578,메요트,2001-07
2001-07-31,20088,67472,-47384,안도라,2001-07
2001-07-31,19885,1600735,-1580850,솔로몬 군도,2001-07
2001-07-31,16796,0,16796,니제르,2001-07
2001-07-31,16739,0,16739,통가,2001-07
2001-07-31,15503,0,15503,카보 베르데,2001-07
2001-07-31,14766,557465,-542699,타지크,2001-07
2001-07-31,12132,18994,-6862,중앙아프리카공화국,2001-07
2001-07-31,9276,2513,6763,존스톤 아일랜드,2001-07
2001-07-31,8000,327876,-319876,모나코,2001-07
2001-07-31,5688,0,5688,앙귈라,2001-07
2001-07-31,3922,63242,-59320,팔레스타인 해방기구(구),2001-07
2001-07-31,3326,0,3326,세인트 루시아,2001-07
2001-07-31,2302,0,2302,스발비드 군도,2001-07
2001-07-31,1869,0,1869,지브랄타,2001-07
2001-07-31,0,76806,-76806,몬트세라트,2001-07
2001-07-31,0,42000,-42000,크리스마스 아일랜드,2001-07
2001-07-31,0,0,0,부룬디,2001-07
2001-07-31,0,38266,-38266,파로에 군도,2001-07
2001-07-31,0,67362,-67362,미드웨이 군도,2001-07
2001-07-31,0,5714,-5714,마이너 아우틀링 합중국 군도,2001-07
2001-07-31,0,3612,-3612,팔레스타인 해방기구,2001-07
2001-07-31,0,1633,-1633,세인트 헬레나,2001-07
2001-07-31,0,195135,-195135,기네비소,2001-07
2001-07-31,0,339394,-339394,적도 기니,2001-07
2001-07-31,0,20323,-20323,토켈라우,2001-07
2001-07-31,0,8166,-8166,교황청,2001-07
2001-07-31,0,39756,-39756,리히텐슈타인,2001-07
2001-08-31,2586477504,1735087879,851389625,미국,2001-08
2001-08-31,1488933965,1149851179,339082786,중국,2001-08
2001-08-31,1210560889,2158950724,-948389835,일본,2001-08
2001-08-31,698675179,91427544,607247635,홍콩,2001-08
2001-08-31,444891119,381061564,63829555,독일,2001-08
2001-08-31,438002519,354263955,83738564,대만,2001-08
2001-08-31,312765453,252333543,60431910,싱가포르,2001-08
2001-08-31,304816732,288746311,16070421,인도네시아,2001-08
2001-08-31,239311595,187806945,51504650,영국,2001-08
2001-08-31,231214846,316829322,-85614476,말레이시아,2001-08
2001-08-31,216703372,143414526,73288846,필리핀,2001-08
2001-08-31,185872746,506705048,-320832302,호주,2001-08
2001-08-31,181184848,21859983,159324865,멕시코,2001-08
2001-08-31,171166912,316849245,-145682333,아랍에미리트 연합,2001-08
2001-08-31,167101585,70246044,96855541,파나마,2001-08
2001-08-31,165164004,96104731,69059273,네덜란드,2001-08
2001-08-31,165116017,147690940,17425077,캐나다,2001-08
2001-08-31,155549539,156316467,-766928,이탈리아,2001-08
2001-08-31,153068776,128251635,24817141,태국,2001-08
2001-08-31,139921356,1044737,138876619,그리스,2001-08
2001-08-31,131830895,34999482,96831413,베트남,2001-08
2001-08-31,109697101,81088384,28608717,인도,2001-08
2001-08-31,108849536,28043626,80805910,스페인,2001-08
2001-08-31,107019099,176857916,-69838817,프랑스,2001-08
2001-08-31,106197249,674790745,-568593496,사우디아라비아,2001-08
2001-08-31,82159784,115003325,-32843541,브라질,2001-08
2001-08-31,73158313,216679740,-143521427,러시아 연방,2001-08
2001-08-31,69729904,165340401,-95610497,이란,2001-08
2001-08-31,58904303,109399,58794904,사이프러스,2001-08
2001-08-31,54462548,9121622,45340926,이집트,2001-08
2001-08-31,53807020,41429570,12377450,칠레,2001-08
2001-08-31,53381729,55123158,-1741429,벨기에,2001-08
2001-08-31,43580652,2525935,41054717,과테말라,2001-08
2001-08-31,40889115,216176,40672939,베네주엘라,2001-08
2001-08-31,40180595,61246232,-21065637,아일랜드,2001-08
2001-08-31,36832559,10840294,25992265,튀르키예,2001-08
2001-08-31,36613662,4114207,32499455,방글라데시,2001-08
2001-08-31,36500373,50807355,-14306982,남아프리카공화국,2001-08
2001-08-31,35628761,35250487,378274,핀란드,2001-08
2001-08-31,34711668,120489,34591179,시리아,2001-08
2001-08-31,33594737,38215036,-4620299,스웨덴,2001-08
2001-08-31,30999599,3332629,27666970,폴란드,2001-08
2001-08-31,29642209,25176689,4465520,파키스탄,2001-08
2001-08-31,29212040,28162668,1049372,덴마크,2001-08
2001-08-31,24427467,62755163,-38327696,뉴질랜드,2001-08
2001-08-31,23763597,2424423,21339174,스리랑카,2001-08
2001-08-31,23752454,106,23752348,나이지리아,2001-08
2001-08-31,23500931,18439610,5061321,이스라엘,2001-08
2001-08-31,23195121,2953,23192168,마샬군도,2001-08
2001-08-31,23190082,55971,23134111,라이베리아,2001-08
2001-08-31,22089440,49654732,-27565292,아르헨티나,2001-08
2001-08-31,20916784,65151569,-44234785,스위스,2001-08
2001-08-31,19622694,14139064,5483630,우크라이나,2001-08
2001-08-31,18841413,6371788,12469625,헝가리,2001-08
2001-08-31,17565350,158654366,-141089016,오만,2001-08
2001-08-31,17259099,16503,17242596,괌,2001-08
2001-08-31,17151979,30022809,-12870830,오스트리아,2001-08
2001-08-31,16239790,4784938,11454852,콜롬비아,2001-08
2001-08-31,16060410,2228540,13831870,요르단,2001-08
2001-08-31,15718021,16246375,-528354,페루,2001-08
2001-08-31,15028641,31938877,-16910236,에쿠아도르,2001-08
2001-08-31,14887665,9265636,5622029,몰타,2001-08
2001-08-31,13539997,912117,12627880,포루투갈,2001-08
2001-08-31,12572890,9847767,2725123,우즈베키스탄,2001-08
2001-08-31,12463262,5098303,7364959,알제리,2001-08
2001-08-31,12411216,3494373,8916843,푸에르토리코,2001-08
2001-08-31,12240157,214547576,-202307419,쿠웨이트,2001-08
2001-08-31,11933494,814829,11118665,코스타리카,2001-08
2001-08-31,11179619,728328,10451291,온두라스,2001-08
2001-08-31,10940251,2747440,8192811,기타국,2001-08
2001-08-31,10824573,1727366,9097207,미얀마,2001-08
2001-08-31,10254092,905615,9348477,루마니아,2001-08
2001-08-31,9363100,0,9363100,리비아,2001-08
2001-08-31,9119954,0,9119954,아프카니스탄,2001-08
2001-08-31,8762940,86783,8676157,수단,2001-08
2001-08-31,8162833,121914,8040919,캄보디아,2001-08
2001-08-31,7683795,7464725,219070,체코공화국,2001-08
2001-08-31,7644866,3304601,4340265,도미니카 공화국,2001-08
2001-08-31,7618974,3441888,4177086,카자흐스탄,2001-08
2001-08-31,6775418,13624,6761794,니카라과,2001-08
2001-08-31,6515357,32243363,-25728006,노르웨이,2001-08
2001-08-31,6227416,121457517,-115230101,카타르,2001-08
2001-08-31,6197966,1026992,5170974,우루과이,2001-08
2001-08-31,5903583,5346417,557166,모로코,2001-08
2001-08-31,5733109,120110,5612999,엘살바도르,2001-08
2001-08-31,5708666,280201,5428465,레바논,2001-08
2001-08-31,5346595,212998,5133597,몽골,2001-08
2001-08-31,5001537,23837,4977700,북마리아나 군도,2001-08
2001-08-31,4729644,583610,4146034,가나,2001-08
2001-08-31,4646315,132502,4513813,예맨,2001-08
2001-08-31,4481300,87491,4393809,케냐,2001-08
2001-08-31,3752784,543230,3209554,슬로베니아,2001-08
2001-08-31,3654138,362613,3291525,마카오,2001-08
2001-08-31,3395341,895,3394446,토고,2001-08
2001-08-31,2961011,78446,2882565,튀니지,2001-08
2001-08-31,2892232,11735654,-8843422,바레인,2001-08
2001-08-31,2462730,32765,2429965,키르기스스탄,2001-08
2001-08-31,2408614,22950,2385664,파라과이,2001-08
2001-08-31,2098801,62596,2036205,모리셔스,2001-08
2001-08-31,1824487,62567,1761920,트리니다드 토바고,2001-08
2001-08-31,1780316,0,1780316,투르크멘,2001-08
2001-08-31,1740433,682138,1058295,슬로바키아,2001-08
2001-08-31,1737878,15606,1722272,도미니카,2001-08
2001-08-31,1563922,12472956,-10909034,브루나이,2001-08
2001-08-31,1536266,1800,1534466,앙골라,2001-08
2001-08-31,1518741,97440,1421301,에티오피아,2001-08
2001-08-31,1491041,102439,1388602,네팔,2001-08
2001-08-31,1486436,503165,983271,불가리아,2001-08
2001-08-31,1439949,0,1439949,레소토,2001-08
2001-08-31,1390428,375396,1015032,리투아니아,2001-08
2001-08-31,1184191,985818,198373,코트디봐르,2001-08
2001-08-31,1141195,0,1141195,이라크,2001-08
2001-08-31,1122799,0,1122799,아제르바이잔,2001-08
2001-08-31,1034460,265547,768913,세네갈,2001-08
2001-08-31,1026990,0,1026990,자마이카,2001-08
2001-08-31,1023127,0,1023127,바하마,2001-08
2001-08-31,976842,12428,964414,베닝,2001-08
2001-08-31,893337,44120,849217,크로아티아,2001-08
2001-08-31,879335,95591,783744,탄자니아,2001-08
2001-08-31,877759,0,877759,불령 리유니온 코모도 제도,2001-08
2001-08-31,873400,2123346,-1249946,스와질랜드,2001-08
2001-08-31,847895,608645,239250,에스토니아,2001-08
2001-08-31,828982,0,828982,아루바,2001-08
2001-08-31,825639,7280519,-6454880,파푸아 뉴기니,2001-08
2001-08-31,810457,4884024,-4073567,뉴 칼레도니아,2001-08
2001-08-31,780728,165094,615634,카메룬,2001-08
2001-08-31,775068,326580,448488,마다카스카르,2001-08
2001-08-31,764449,29589,734860,피지,2001-08
2001-08-31,699210,4828,694382,유고,2001-08
2001-08-31,690235,479869,210366,벨라루스,2001-08
2001-08-31,655274,110360,544914,짐바브웨,2001-08
2001-08-31,655172,0,655172,지부티,2001-08
2001-08-31,652350,178325,474025,콩고,2001-08
2001-08-31,645078,1060,644018,잠비아,2001-08
2001-08-31,609609,0,609609,마티니크,2001-08
2001-08-31,591814,0,591814,아이티,2001-08
2001-08-31,578025,17783,560242,팔라우,2001-08
2001-08-31,562060,7237538,-6675478,기니,2001-08
2001-08-31,519573,0,519573,불령 폴리네시아,2001-08
2001-08-31,483679,0,483679,라오스,2001-08
2001-08-31,483051,87841,395210,라트비아,2001-08
2001-08-31,470091,2433,467658,에리트리아,2001-08
2001-08-31,469030,496862,-27832,안도라,2001-08
2001-08-31,445586,142215,303371,볼리비아,2001-08
2001-08-31,414967,0,414967,시에라 리온,2001-08
2001-08-31,366401,0,366401,아메리칸 사모아,2001-08
2001-08-31,360729,190182,170547,아이슬란드,2001-08
2001-08-31,352867,118615,234252,벨리제,2001-08
2001-08-31,316586,4000,312586,아르메니아,2001-08
2001-08-31,294048,560867,-266819,룩셈부르그,2001-08
2001-08-31,290979,0,290979,모잠비크,2001-08
2001-08-31,268960,50856,218104,네덜란드 열도,2001-08
2001-08-31,245319,0,245319,불령 가이아나,2001-08
2001-08-31,237440,0,237440,말라위,2001-08
2001-08-31,228955,0,228955,과델로프,2001-08
2001-08-31,217943,0,217943,소말리아,2001-08
2001-08-31,217756,0,217756,마세도니아,2001-08
2001-08-31,217332,1124920,-907588,가봉,2001-08
2001-08-31,215803,6120,209683,바베이도스,2001-08
2001-08-31,209589,11734,197855,사모아,2001-08
2001-08-31,203607,37376,166231,팔레스타인 해방기구(구),2001-08
2001-08-31,189229,1393682,-1204453,조지아,2001-08
2001-08-31,187533,0,187533,영령 캐이맨 군도,2001-08
2001-08-31,186624,0,186624,마이크로네시아,2001-08
2001-08-31,185837,400,185437,보츠와나,2001-08
2001-08-31,179901,0,179901,알바니아,2001-08
2001-08-31,164783,0,164783,가이아나,2001-08
2001-08-31,163676,0,163676,보스니아-헤르체고비나,2001-08
2001-08-31,162064,393,161671,몰도바,2001-08
2001-08-31,138179,709397,-571218,타지크,2001-08
2001-08-31,136786,0,136786,수리남,2001-08
2001-08-31,128150,32027,96123,모리타니,2001-08
2001-08-31,107918,0,107918,부르키나 파소,2001-08
2001-08-31,104828,52004,52824,우간다,2001-08
2001-08-31,93711,4396,89315,버뮤다,2001-08
2001-08-31,82565,841,81724,니제르,2001-08
2001-08-31,77711,0,77711,세인트 루시아,2001-08
2001-08-31,75189,0,75189,그레나다,2001-08
2001-08-31,74334,0,74334,부탄,2001-08
2001-08-31,72821,25158,47663,바누아투,2001-08
2001-08-31,71158,0,71158,세이쉘,2001-08
2001-08-31,66667,5584,61083,르완다,2001-08
2001-08-31,60524,201138,-140614,기네비소,2001-08
2001-08-31,54875,351,54524,안티가 바부다,2001-08
2001-08-31,50809,0,50809,감비아,2001-08
2001-08-31,48286,0,48286,투르크 & 카이코스 군도,2001-08
2001-08-31,48027,377554,-329527,모나코,2001-08
2001-08-31,44918,0,44918,메요트,2001-08
2001-08-31,38004,1485438,-1447434,솔로몬 군도,2001-08
2001-08-31,30180,872687,-842507,말리,2001-08
2001-08-31,28438,0,28438,키리바티,2001-08
2001-08-31,27436,0,27436,미령 버진군도,2001-08
2001-08-31,26749,0,26749,콩고민주공화국,2001-08
2001-08-31,24054,910404,-886350,나미비아,2001-08
2001-08-31,23794,0,23794,쿡 아일랜드,2001-08
2001-08-31,20357,0,20357,티모르,2001-08
2001-08-31,14637,1309,13328,프랑스 메트로폴리탄,2001-08
2001-08-31,13996,0,13996,세인트 빈센트 그레나딘,2001-08
2001-08-31,12422,4666,7756,앙귈라,2001-08
2001-08-31,10680,99265,-88585,파로에 군도,2001-08
2001-08-31,8908,0,8908,포클랜드 군도,2001-08
2001-08-31,4186,4151,35,몰디브,2001-08
2001-08-31,2321,51794,-49473,리히텐슈타인,2001-08
2001-08-31,941,0,941,세인트 키츠 네비스,2001-08
2001-08-31,669,0,669,중앙아프리카공화국,2001-08
2001-08-31,0,24062162,-24062162,중립지대,2001-08
2001-08-31,0,3859,-3859,피트카이른,2001-08
2001-08-31,0,305,-305,세인트 헬레나,2001-08
2001-08-31,0,1620,-1620,통가,2001-08
2001-08-31,0,9081,-9081,존스톤 아일랜드,2001-08
2001-08-31,0,216372,-216372,적도 기니,2001-08
2001-08-31,0,96328,-96328,미드웨이 군도,2001-08
2001-08-31,0,2741,-2741,캔톤아일랜드,2001-08
2001-08-31,0,10,-10,교황청,2001-08
2001-09-30,2837276788,1691564093,1145712695,미국,2001-09
2001-09-30,1515586442,1166455585,349130857,중국,2001-09
2001-09-30,1298082968,2242853389,-944770421,일본,2001-09
2001-09-30,774206111,119916007,654290104,홍콩,2001-09
2001-09-30,395042061,333078844,61963217,대만,2001-09
2001-09-30,344997430,360723486,-15726056,독일,2001-09
2001-09-30,307141217,262043243,45097974,싱가포르,2001-09
2001-09-30,289301309,377865049,-88563740,인도네시아,2001-09
2001-09-30,254550489,188157879,66392610,영국,2001-09
2001-09-30,242143151,307579818,-65436667,말레이시아,2001-09
2001-09-30,229669658,142616067,87053591,필리핀,2001-09
2001-09-30,216241423,477983360,-261741937,호주,2001-09
2001-09-30,191868638,28863320,163005318,멕시코,2001-09
2001-09-30,185260061,98299363,86960698,네덜란드,2001-09
2001-09-30,185178665,507456301,-322277636,아랍에미리트 연합,2001-09
2001-09-30,177207112,153504486,23702626,캐나다,2001-09
2001-09-30,166395881,186293958,-19898077,프랑스,2001-09
2001-09-30,157501150,131641589,25859561,태국,2001-09
2001-09-30,153410719,146831564,6579155,이탈리아,2001-09
2001-09-30,137161302,31898052,105263250,베트남,2001-09
2001-09-30,131343263,85844999,45498264,브라질,2001-09
2001-09-30,128210937,26330009,101880928,스페인,2001-09
2001-09-30,124846022,674061438,-549215416,사우디아라비아,2001-09
2001-09-30,114726388,640404,114085984,파나마,2001-09
2001-09-30,104802598,6488424,98314174,베네주엘라,2001-09
2001-09-30,100428265,64226793,36201472,인도,2001-09
2001-09-30,99595142,99445,99495697,사이프러스,2001-09
2001-09-30,86362597,228931358,-142568761,러시아 연방,2001-09
2001-09-30,73554719,151130759,-77576040,이란,2001-09
2001-09-30,67338377,821,67337556,라이베리아,2001-09
2001-09-30,61887976,44538380,17349596,벨기에,2001-09
2001-09-30,54982817,30259225,24723592,핀란드,2001-09
2001-09-30,52973714,61050659,-8076945,칠레,2001-09
2001-09-30,46417695,50448385,-4030690,아일랜드,2001-09
2001-09-30,44819774,1969658,42850116,방글라데시,2001-09
2001-09-30,41428120,18271428,23156692,이집트,2001-09
2001-09-30,40447489,101272,40346217,과테말라,2001-09
2001-09-30,39535098,45801829,-6266731,남아프리카공화국,2001-09
2001-09-30,37197613,6535645,30661968,튀르키예,2001-09
2001-09-30,34596377,35308764,-712387,스웨덴,2001-09
2001-09-30,34444940,883155,33561785,그리스,2001-09
2001-09-30,34043185,62097833,-28054648,스위스,2001-09
2001-09-30,33464667,29649165,3815502,노르웨이,2001-09
2001-09-30,31035994,3264193,27771801,폴란드,2001-09
2001-09-30,30546857,177803,30369054,시리아,2001-09
2001-09-30,28715169,33486575,-4771406,파키스탄,2001-09
2001-09-30,28650820,50433,28600387,나이지리아,2001-09
2001-09-30,27001408,1710347,25291061,리비아,2001-09
2001-09-30,26246192,38830393,-12584201,이스라엘,2001-09
2001-09-30,26183132,37488364,-11305232,아르헨티나,2001-09
2001-09-30,25629017,8873127,16755890,헝가리,2001-09
2001-09-30,23620412,62531603,-38911191,뉴질랜드,2001-09
2001-09-30,22618425,4133227,18485198,스리랑카,2001-09
2001-09-30,21261619,8734,21252885,마샬군도,2001-09
2001-09-30,20187371,24709542,-4522171,오스트리아,2001-09
2001-09-30,20007962,1130002,18877960,루마니아,2001-09
2001-09-30,19204482,2549376,16655106,콜롬비아,2001-09
2001-09-30,18697166,107711,18589455,요르단,2001-09
2001-09-30,18069756,158125250,-140055494,오만,2001-09
2001-09-30,17821412,31035593,-13214181,덴마크,2001-09
2001-09-30,17469964,11422994,6046970,우크라이나,2001-09
2001-09-30,17209750,8180664,9029086,우즈베키스탄,2001-09
2001-09-30,17186663,30465493,-13278830,에쿠아도르,2001-09
2001-09-30,16579364,3938505,12640859,포루투갈,2001-09
2001-09-30,16303972,5030932,11273040,페루,2001-09
2001-09-30,15410673,3382458,12028215,푸에르토리코,2001-09
2001-09-30,14701770,430210,14271560,기타국,2001-09
2001-09-30,13218520,122832406,-109613886,카타르,2001-09
2001-09-30,12882330,1531176,11351154,모로코,2001-09
2001-09-30,12861779,2086174,10775605,온두라스,2001-09
2001-09-30,12584103,208085231,-195501128,쿠웨이트,2001-09
2001-09-30,11902823,3104328,8798495,도미니카 공화국,2001-09
2001-09-30,11142808,23130361,-11987553,알제리,2001-09
2001-09-30,10645698,11133292,-487594,미얀마,2001-09
2001-09-30,9835899,3414814,6421085,카자흐스탄,2001-09
2001-09-30,9352171,3712057,5640114,코스타리카,2001-09
2001-09-30,8964039,8969,8955070,아프카니스탄,2001-09
2001-09-30,8931148,6609660,2321488,체코공화국,2001-09
2001-09-30,8652912,2428833,6224079,캄보디아,2001-09
2001-09-30,7753759,563305,7190454,레바논,2001-09
2001-09-30,7445966,22695,7423271,북마리아나 군도,2001-09
2001-09-30,7293328,34734,7258594,엘살바도르,2001-09
2001-09-30,6345469,4001529,2343940,수단,2001-09
2001-09-30,5602778,79539,5523239,케냐,2001-09
2001-09-30,5510722,111423,5399299,몽골,2001-09
2001-09-30,5506005,104,5505901,니카라과,2001-09
2001-09-30,4996570,883982,4112588,슬로베니아,2001-09
2001-09-30,4859000,1232,4857768,토고,2001-09
2001-09-30,4703486,272510,4430976,가나,2001-09
2001-09-30,4648650,27904366,-23255716,예맨,2001-09
2001-09-30,4377340,402301,3975039,우루과이,2001-09
2001-09-30,4264265,176756,4087509,튀니지,2001-09
2001-09-30,3663312,79016,3584296,마카오,2001-09
2001-09-30,3246215,1513065,1733150,스와질랜드,2001-09
2001-09-30,3181704,339,3181365,모리셔스,2001-09
2001-09-30,2894027,29138,2864889,아메리칸 사모아,2001-09
2001-09-30,2799051,39509,2759542,파라과이,2001-09
2001-09-30,2335072,771154,1563918,불가리아,2001-09
2001-09-30,2317271,53360528,-51043257,앙골라,2001-09
2001-09-30,2143140,0,2143140,불령 리유니온 코모도 제도,2001-09
2001-09-30,2136452,3401423,-1264971,바레인,2001-09
2001-09-30,2110639,57192,2053447,에티오피아,2001-09
2001-09-30,2066466,261420,1805046,리투아니아,2001-09
2001-09-30,1898410,0,1898410,투르크멘,2001-09
2001-09-30,1865874,39164516,-37298642,브루나이,2001-09
2001-09-30,1767378,43749,1723629,키르기스스탄,2001-09
2001-09-30,1726000,215808,1510192,트리니다드 토바고,2001-09
2001-09-30,1693991,37793,1656198,괌,2001-09
2001-09-30,1542321,81765,1460556,탄자니아,2001-09
2001-09-30,1534077,0,1534077,베닝,2001-09
2001-09-30,1499620,1456923,42697,코트디봐르,2001-09
2001-09-30,1408403,586585,821818,에스토니아,2001-09
2001-09-30,1375629,9519,1366110,도미니카,2001-09
2001-09-30,1288845,3692978,-2404133,몰타,2001-09
2001-09-30,1283790,143149,1140641,세네갈,2001-09
2001-09-30,1238100,134881,1103219,네팔,2001-09
2001-09-30,1146588,705423,441165,마다카스카르,2001-09
2001-09-30,1074509,0,1074509,아이티,2001-09
2001-09-30,1015768,28212,987556,시에라 리온,2001-09
2001-09-30,1010553,0,1010553,레소토,2001-09
2001-09-30,897166,62630,834536,기니,2001-09
2001-09-30,776462,5230,771232,자마이카,2001-09
2001-09-30,766422,2126189,-1359767,뉴 칼레도니아,2001-09
2001-09-30,715493,485696,229797,짐바브웨,2001-09
2001-09-30,701771,0,701771,마이크로네시아,2001-09
2001-09-30,689755,1024651,-334896,말리,2001-09
2001-09-30,680584,0,680584,마티니크,2001-09
2001-09-30,674686,1287569,-612883,슬로바키아,2001-09
2001-09-30,661316,0,661316,유고,2001-09
2001-09-30,648953,82498,566455,아루바,2001-09
2001-09-30,635029,0,635029,과델로프,2001-09
2001-09-30,619933,99390,520543,라트비아,2001-09
2001-09-30,617934,0,617934,모잠비크,2001-09
2001-09-30,591714,142776,448938,카메룬,2001-09
2001-09-30,584753,0,584753,바하마,2001-09
2001-09-30,584467,0,584467,영령 캐이맨 군도,2001-09
2001-09-30,563154,0,563154,이라크,2001-09
2001-09-30,532356,41314,491042,피지,2001-09
2001-09-30,528103,0,528103,보스니아-헤르체고비나,2001-09
2001-09-30,527347,1385456,-858109,벨라루스,2001-09
2001-09-30,519433,0,519433,팔라우,2001-09
2001-09-30,486318,110255,376063,크로아티아,2001-09
2001-09-30,484853,1550354,-1065501,파푸아 뉴기니,2001-09
2001-09-30,473761,0,473761,보츠와나,2001-09
2001-09-30,408510,23,408487,안티가 바부다,2001-09
2001-09-30,370319,3614809,-3244490,볼리비아,2001-09
2001-09-30,362649,0,362649,아제르바이잔,2001-09
2001-09-30,361898,1670,360228,불령 폴리네시아,2001-09
2001-09-30,360725,153657,207068,잠비아,2001-09
2001-09-30,355797,238115,117682,벨리제,2001-09
2001-09-30,352070,729773,-377703,룩셈부르그,2001-09
2001-09-30,343304,0,343304,바베이도스,2001-09
2001-09-30,333572,0,333572,소말리아,2001-09
2001-09-30,311243,86470733,-86159490,콩고,2001-09
2001-09-30,295212,0,295212,에리트리아,2001-09
2001-09-30,285461,0,285461,지부티,2001-09
2001-09-30,279891,6911,272980,니제르,2001-09
2001-09-30,266245,23036183,-22769938,가봉,2001-09
2001-09-30,260458,416580,-156122,아이슬란드,2001-09
2001-09-30,242459,48000,194459,라오스,2001-09
2001-09-30,241218,0,241218,사모아,2001-09
2001-09-30,240405,0,240405,마세도니아,2001-09
2001-09-30,239404,63666,175738,모리타니,2001-09
2001-09-30,217802,14535,203267,가이아나,2001-09
2001-09-30,197018,78084,118934,콩고민주공화국,2001-09
2001-09-30,182701,571144,-388443,타지크,2001-09
2001-09-30,172493,219167,-46674,감비아,2001-09
2001-09-30,169302,0,169302,수리남,2001-09
2001-09-30,169261,0,169261,알바니아,2001-09
2001-09-30,154090,0,154090,말라위,2001-09
2001-09-30,138100,604468,-466368,네덜란드 열도,2001-09
2001-09-30,134728,169865,-35137,나미비아,2001-09
2001-09-30,132167,30715,101452,그레나다,2001-09
2001-09-30,123806,0,123806,불령 가이아나,2001-09
2001-09-30,95170,0,95170,투르크 & 카이코스 군도,2001-09
2001-09-30,89562,90534,-972,우간다,2001-09
2001-09-30,88002,0,88002,버뮤다,2001-09
2001-09-30,83997,0,83997,몰디브,2001-09
2001-09-30,74137,221862,-147725,조지아,2001-09
2001-09-30,67572,990,66582,르완다,2001-09
2001-09-30,57706,0,57706,아르메니아,2001-09
2001-09-30,49240,0,49240,챠드,2001-09
2001-09-30,48622,737355,-688733,솔로몬 군도,2001-09
2001-09-30,44499,1446,43053,부룬디,2001-09
2001-09-30,37830,3201201,-3163371,안도라,2001-09
2001-09-30,36338,0,36338,세인트 루시아,2001-09
2001-09-30,35933,88296,-52363,바누아투,2001-09
2001-09-30,30110,0,30110,세인트 빈센트 그레나딘,2001-09
2001-09-30,29680,5107,24573,산마리노,2001-09
2001-09-30,27171,20188,6983,팔레스타인 해방기구(구),2001-09
2001-09-30,25685,311007,-285322,모나코,2001-09
2001-09-30,25241,127,25114,노폴크 아일랜드,2001-09
2001-09-30,23707,0,23707,투발루,2001-09
2001-09-30,23702,1680,22022,쿡 아일랜드,2001-09
2001-09-30,20885,2873,18012,부르키나 파소,2001-09
2001-09-30,18459,0,18459,몰도바,2001-09
2001-09-30,17800,0,17800,미령 버진군도,2001-09
2001-09-30,7427,0,7427,앙귈라,2001-09
2001-09-30,6270,0,6270,코모로스,2001-09
2001-09-30,4626,13072,-8446,영령 버진군도,2001-09
2001-09-30,4364,0,4364,통가,2001-09
2001-09-30,3888,0,3888,세이쉘,2001-09
2001-09-30,2300,0,2300,부탄,2001-09
2001-09-30,2046,11241,-9195,리히텐슈타인,2001-09
2001-09-30,1380,0,1380,그린랜드,2001-09
2001-09-30,940,0,940,세인트 키츠 네비스,2001-09
2001-09-30,839,28046,-27207,중앙아프리카공화국,2001-09
2001-09-30,0,15347,-15347,카보 베르데,2001-09
2001-09-30,0,155937,-155937,기네비소,2001-09
2001-09-30,0,105,-105,니우에,2001-09
2001-09-30,0,32589,-32589,미드웨이 군도,2001-09
2001-09-30,0,113,-113,스발비드 군도,2001-09
2001-09-30,0,0,0,크리스마스 아일랜드,2001-09
2001-09-30,0,152,-152,포클랜드 군도,2001-09
2001-09-30,0,72977,-72977,프랑스 메트로폴리탄,2001-09
2001-09-30,0,67160,-67160,남조지아 & 남샌드위치 군도,2001-09
2001-09-30,0,2849,-2849,지브랄타,2001-09
2001-10-31,2593946857,1756079200,837867657,미국,2001-10
2001-10-31,1485592377,1215552997,270039380,중국,2001-10
2001-10-31,1233369518,2279976183,-1046606665,일본,2001-10
2001-10-31,792686908,139233581,653453327,홍콩,2001-10
2001-10-31,440348522,371966110,68382412,대만,2001-10
2001-10-31,403647127,374771638,28875489,독일,2001-10
2001-10-31,301513963,276053194,25460769,싱가포르,2001-10
2001-10-31,275990785,308921438,-32930653,인도네시아,2001-10
2001-10-31,273132766,185025191,88107575,영국,2001-10
2001-10-31,225458438,153624671,71833767,필리핀,2001-10
2001-10-31,224671447,464980653,-240309206,호주,2001-10
2001-10-31,224034562,261996123,-37961561,말레이시아,2001-10
2001-10-31,198304525,79864884,118439641,네덜란드,2001-10
2001-10-31,176460438,311721212,-135260774,아랍에미리트 연합,2001-10
2001-10-31,170544267,161046368,9497899,프랑스,2001-10
2001-10-31,168016914,27919964,140096950,멕시코,2001-10
2001-10-31,167055184,164941212,2113972,캐나다,2001-10
2001-10-31,145648176,138620215,7027961,태국,2001-10
2001-10-31,140546411,149430168,-8883757,이탈리아,2001-10
2001-10-31,139408674,42463863,96944811,베트남,2001-10
2001-10-31,120925957,2823901,118102056,나이지리아,2001-10
2001-10-31,113789845,24220877,89568968,스페인,2001-10
2001-10-31,109996814,89394341,20602473,인도,2001-10
2001-10-31,104629831,1618,104628213,라이베리아,2001-10
2001-10-31,104589051,675497352,-570908301,사우디아라비아,2001-10
2001-10-31,97383817,3458050,93925767,파나마,2001-10
2001-10-31,87808073,139858021,-52049948,러시아 연방,2001-10
2001-10-31,79951700,147513932,-67562232,브라질,2001-10
2001-10-31,74318623,0,74318623,바하마,2001-10
2001-10-31,71031844,36302865,34728979,핀란드,2001-10
2001-10-31,69784132,127461537,-57677405,이란,2001-10
2001-10-31,64447011,31927484,32519527,노르웨이,2001-10
2001-10-31,63766845,3751326,60015519,몰타,2001-10
2001-10-31,57066830,52969221,4097609,벨기에,2001-10
2001-10-31,47341485,61954701,-14613216,아일랜드,2001-10
2001-10-31,41146277,2003049,39143228,방글라데시,2001-10
2001-10-31,36579250,9516901,27062349,베네주엘라,2001-10
2001-10-31,36091861,7780523,28311338,그리스,2001-10
2001-10-31,34647341,0,34647341,버뮤다,2001-10
2001-10-31,34382921,5561128,28821793,튀르키예,2001-10
2001-10-31,33668167,46529982,-12861815,남아프리카공화국,2001-10
2001-10-31,33244226,43475645,-10231419,스웨덴,2001-10
2001-10-31,32776618,0,32776618,마샬군도,2001-10
2001-10-31,32245801,73145,32172656,과테말라,2001-10
2001-10-31,27523434,7319222,20204212,이집트,2001-10
2001-10-31,27139027,54051531,-26912504,칠레,2001-10
2001-10-31,27003801,3037447,23966354,폴란드,2001-10
2001-10-31,26882035,21734557,5147478,이스라엘,2001-10
2001-10-31,26112109,7152996,18959113,헝가리,2001-10
2001-10-31,25802941,277042,25525899,레바논,2001-10
2001-10-31,25597852,292589,25305263,시리아,2001-10
2001-10-31,24399830,21709361,2690469,파키스탄,2001-10
2001-10-31,22743260,5650062,17093198,모로코,2001-10
2001-10-31,22542155,61232726,-38690571,뉴질랜드,2001-10
2001-10-31,22235899,73813135,-51577236,스위스,2001-10
2001-10-31,21314803,10314629,11000174,우크라이나,2001-10
2001-10-31,18632005,3968863,14663142,콜롬비아,2001-10
2001-10-31,18451708,3494913,14956795,스리랑카,2001-10
2001-10-31,17736482,1279438,16457044,포루투갈,2001-10
2001-10-31,16195350,7253183,8942167,우즈베키스탄,2001-10
2001-10-31,15505438,26867341,-11361903,덴마크,2001-10
2001-10-31,15148485,3030371,12118114,기타국,2001-10
2001-10-31,14716211,10696604,4019607,페루,2001-10
2001-10-31,14661846,444304,14217542,요르단,2001-10
2001-10-31,14636383,15816297,-1179914,에쿠아도르,2001-10
2001-10-31,14100716,29674795,-15574079,오스트리아,2001-10
2001-10-31,13655483,176178809,-162523326,쿠웨이트,2001-10
2001-10-31,12874945,7092513,5782432,푸에르토리코,2001-10
2001-10-31,11231697,43291026,-32059329,아르헨티나,2001-10
2001-10-31,11199053,2951004,8248049,미얀마,2001-10
2001-10-31,10946245,4171476,6774769,카자흐스탄,2001-10
2001-10-31,10705394,178404952,-167699558,오만,2001-10
2001-10-31,9963939,2457074,7506865,코스타리카,2001-10
2001-10-31,9395502,21521220,-12125718,알제리,2001-10
2001-10-31,9306218,2759225,6546993,도미니카 공화국,2001-10
2001-10-31,8150904,374989,7775915,온두라스,2001-10
2001-10-31,7557797,23737,7534060,북마리아나 군도,2001-10
2001-10-31,7127726,168100,6959626,캄보디아,2001-10
2001-10-31,7080810,42398,7038412,수단,2001-10
2001-10-31,6064941,257417,5807524,괌,2001-10
2001-10-31,5731618,82175,5649443,엘살바도르,2001-10
2001-10-31,5628219,8177368,-2549149,체코공화국,2001-10
2001-10-31,5416010,0,5416010,이라크,2001-10
2001-10-31,4555249,1982,4553267,아프카니스탄,2001-10
2001-10-31,4304832,1807602,2497230,리비아,2001-10
2001-10-31,4117545,126317,3991228,몽골,2001-10
2001-10-31,3922611,242788,3679823,우루과이,2001-10
2001-10-31,3773337,627230,3146107,가나,2001-10
2001-10-31,3716181,144997904,-141281723,카타르,2001-10
2001-10-31,3495661,227,3495434,니카라과,2001-10
2001-10-31,3273030,1505470,1767560,슬로베니아,2001-10
2001-10-31,3269989,15968316,-12698327,예맨,2001-10
2001-10-31,3210481,1133663,2076818,루마니아,2001-10
2001-10-31,3087517,0,3087517,아메리칸 사모아,2001-10
2001-10-31,2954301,76727,2877574,사이프러스,2001-10
2001-10-31,2892536,419903,2472633,마카오,2001-10
2001-10-31,2808437,81001,2727436,튀니지,2001-10
2001-10-31,2476988,71183,2405805,케냐,2001-10
2001-10-31,2287101,1571798,715303,크로아티아,2001-10
2001-10-31,2016048,5054,2010994,토고,2001-10
2001-10-31,1980395,0,1980395,베닝,2001-10
2001-10-31,1946408,17220434,-15274026,바레인,2001-10
2001-10-31,1839058,47598197,-45759139,브루나이,2001-10
2001-10-31,1772742,940073,832669,리투아니아,2001-10
2001-10-31,1715136,39571,1675565,파라과이,2001-10
2001-10-31,1704553,399897,1304656,에스토니아,2001-10
2001-10-31,1692807,25262,1667545,마다카스카르,2001-10
2001-10-31,1672187,0,1672187,투르크멘,2001-10
2001-10-31,1630029,22366291,-20736262,콩고,2001-10
2001-10-31,1413569,123337,1290232,키르기스스탄,2001-10
2001-10-31,1411093,29795,1381298,코트디봐르,2001-10
2001-10-31,1403390,29880,1373510,트리니다드 토바고,2001-10
2001-10-31,1397040,844922,552118,불가리아,2001-10
2001-10-31,1380009,1137594,242415,모리셔스,2001-10
2001-10-31,1370924,0,1370924,앙골라,2001-10
2001-10-31,1364561,170148,1194413,네팔,2001-10
2001-10-31,1272672,0,1272672,레소토,2001-10
2001-10-31,1192571,14297,1178274,자마이카,2001-10
2001-10-31,1182968,0,1182968,유고,2001-10
2001-10-31,1061891,0,1061891,불령 리유니온 코모도 제도,2001-10
2001-10-31,1055974,30491,1025483,에티오피아,2001-10
2001-10-31,1009666,71609,938057,탄자니아,2001-10
2001-10-31,1007052,0,1007052,지부티,2001-10
2001-10-31,978764,653877,324887,짐바브웨,2001-10
2001-10-31,951717,335735,615982,피지,2001-10
2001-10-31,896589,919454,-22865,슬로바키아,2001-10
2001-10-31,852455,251396,601059,카메룬,2001-10
2001-10-31,846673,78211,768462,도미니카,2001-10
2001-10-31,823141,821376,1765,기니,2001-10
2001-10-31,784163,0,784163,마티니크,2001-10
2001-10-31,776536,4185,772351,보스니아-헤르체고비나,2001-10
2001-10-31,773031,85573,687458,볼리비아,2001-10
2001-10-31,757495,230880,526615,안도라,2001-10
2001-10-31,716061,335850,380211,벨라루스,2001-10
2001-10-31,609680,342212,267468,아이슬란드,2001-10
2001-10-31,575097,0,575097,아루바,2001-10
2001-10-31,548903,1977939,-1429036,뉴 칼레도니아,2001-10
2001-10-31,510440,0,510440,아이티,2001-10
2001-10-31,506516,93848,412668,라트비아,2001-10
2001-10-31,493799,2968161,-2474362,스와질랜드,2001-10
2001-10-31,455330,748825,-293495,파푸아 뉴기니,2001-10
2001-10-31,441345,428,440917,과델로프,2001-10
2001-10-31,434033,10715,423318,팔레스타인 해방기구(구),2001-10
2001-10-31,432419,53810,378609,불령 폴리네시아,2001-10
2001-10-31,406580,557364,-150784,말리,2001-10
2001-10-31,405702,0,405702,팔라우,2001-10
2001-10-31,402725,117800,284925,모잠비크,2001-10
2001-10-31,396628,0,396628,수리남,2001-10
2001-10-31,378871,0,378871,라오스,2001-10
2001-10-31,368598,144696,223902,세네갈,2001-10
2001-10-31,360112,0,360112,가이아나,2001-10
2001-10-31,345922,623303,-277381,네덜란드 열도,2001-10
2001-10-31,319770,0,319770,사모아,2001-10
2001-10-31,319671,237,319434,마세도니아,2001-10
2001-10-31,314198,33750,280448,잠비아,2001-10
2001-10-31,297961,0,297961,감비아,2001-10
2001-10-31,288189,182438,105751,벨리제,2001-10
2001-10-31,282755,0,282755,아제르바이잔,2001-10
2001-10-31,279356,0,279356,바베이도스,2001-10
2001-10-31,262326,23941502,-23679176,가봉,2001-10
2001-10-31,251735,0,251735,알바니아,2001-10
2001-10-31,236483,11604,224879,마이크로네시아,2001-10
2001-10-31,235809,335904,-100095,나미비아,2001-10
2001-10-31,196879,329324,-132445,타지크,2001-10
2001-10-31,179490,39746,139744,콩고민주공화국,2001-10
2001-10-31,168118,506073,-337955,룩셈부르그,2001-10
2001-10-31,160974,0,160974,챠드,2001-10
2001-10-31,159900,91996,67904,우간다,2001-10
2001-10-31,156222,111590,44632,모리타니,2001-10
2001-10-31,155275,0,155275,안티가 바부다,2001-10
2001-10-31,144415,0,144415,몰디브,2001-10
2001-10-31,142844,0,142844,말라위,2001-10
2001-10-31,111388,405,110983,몰도바,2001-10
2001-10-31,109236,545633,-436397,솔로몬 군도,2001-10
2001-10-31,106550,380702,-274152,조지아,2001-10
2001-10-31,105356,0,105356,보츠와나,2001-10
2001-10-31,96859,9457,87402,바누아투,2001-10
2001-10-31,90630,422152,-331522,시에라 리온,2001-10
2001-10-31,90330,15148,75182,미령 버진군도,2001-10
2001-10-31,79726,0,79726,영령 버진군도,2001-10
2001-10-31,78049,0,78049,불령 가이아나,2001-10
2001-10-31,76294,0,76294,세인트 루시아,2001-10
2001-10-31,65521,0,65521,부룬디,2001-10
2001-10-31,61461,19929,41532,그레나다,2001-10
2001-10-31,50596,0,50596,세이쉘,2001-10
2001-10-31,49901,0,49901,부탄,2001-10
2001-10-31,43771,0,43771,소말리아,2001-10
2001-10-31,43117,0,43117,에리트리아,2001-10
2001-10-31,43108,0,43108,통가,2001-10
2001-10-31,34465,0,34465,키리바티,2001-10
2001-10-31,31275,29660,1615,니제르,2001-10
2001-10-31,25278,0,25278,아르메니아,2001-10
2001-10-31,20592,0,20592,산마리노,2001-10
2001-10-31,20495,0,20495,투르크 & 카이코스 군도,2001-10
2001-10-31,14685,1480,13205,부르키나 파소,2001-10
2001-10-31,14376,0,14376,세인트 빈센트 그레나딘,2001-10
2001-10-31,13617,0,13617,영령 캐이맨 군도,2001-10
2001-10-31,10151,0,10151,왈라스 & 퓨투나 군도,2001-10
2001-10-31,8078,0,8078,토켈라우,2001-10
2001-10-31,1456,203,1253,노폴크 아일랜드,2001-10
2001-10-31,1171,0,1171,르완다,2001-10
2001-10-31,67,0,67,세인트 키츠 네비스,2001-10
2001-10-31,0,7993,-7993,나우루,2001-10
2001-10-31,0,3000,-3000,쿡 아일랜드,2001-10
2001-10-31,0,99101,-99101,앙귈라,2001-10
2001-10-31,0,223,-223,남조지아 & 남샌드위치 군도,2001-10
2001-10-31,0,292841,-292841,기네비소,2001-10
2001-10-31,0,14714328,-14714328,중립지대,2001-10
2001-10-31,0,88503,-88503,중앙아프리카공화국,2001-10
2001-10-31,0,4975,-4975,존스톤 아일랜드,2001-10
2001-10-31,0,71235,-71235,리히텐슈타인,2001-10
2001-10-31,0,222087,-222087,모나코,2001-10
2001-10-31,0,7043,-7043,영령 인도양,2001-10
2001-11-30,2711414606,1723563521,987851085,미국,2001-11
2001-11-30,1517838556,1244395237,273443319,중국,2001-11
2001-11-30,1328742455,2250315893,-921573438,일본,2001-11
2001-11-30,774088862,102849301,671239561,홍콩,2001-11
2001-11-30,507535662,368371550,139164112,대만,2001-11
2001-11-30,330153197,258529248,71623949,싱가포르,2001-11
2001-11-30,299879025,370870463,-70991438,독일,2001-11
2001-11-30,294931451,189233240,105698211,영국,2001-11
2001-11-30,226250561,359396003,-133145442,인도네시아,2001-11
2001-11-30,217590152,161824965,55765187,필리핀,2001-11
2001-11-30,216206998,322967296,-106760298,말레이시아,2001-11
2001-11-30,215991336,82351758,133639578,네덜란드,2001-11
2001-11-30,206956911,0,206956911,마샬군도,2001-11
2001-11-30,189069318,495526145,-306456827,호주,2001-11
2001-11-30,184248897,147765520,36483377,캐나다,2001-11
2001-11-30,178595088,26020349,152574739,멕시코,2001-11
2001-11-30,173429620,281938572,-108508952,아랍에미리트 연합,2001-11
2001-11-30,158303058,31273481,127029577,베트남,2001-11
2001-11-30,150425397,153784046,-3358649,태국,2001-11
2001-11-30,143728228,148245409,-4517181,이탈리아,2001-11
2001-11-30,137333099,28712689,108620410,스페인,2001-11
2001-11-30,128773088,592717660,-463944572,사우디아라비아,2001-11
2001-11-30,127642415,169220127,-41577712,프랑스,2001-11
2001-11-30,101362990,185606683,-84243693,러시아 연방,2001-11
2001-11-30,94572211,88083749,6488462,인도,2001-11
2001-11-30,91036850,109454148,-18417298,브라질,2001-11
2001-11-30,87337545,138275,87199270,파나마,2001-11
2001-11-30,79828916,126586305,-46757389,이란,2001-11
2001-11-30,68878515,5607945,63270570,몰타,2001-11
2001-11-30,66500051,40278107,26221944,핀란드,2001-11
2001-11-30,60690304,52914689,7775615,벨기에,2001-11
2001-11-30,52101547,46399166,5702381,아일랜드,2001-11
2001-11-30,50506404,5751739,44754665,라이베리아,2001-11
2001-11-30,47232517,6550641,40681876,튀르키예,2001-11
2001-11-30,45038020,26259469,18778551,이스라엘,2001-11
2001-11-30,43675970,759,43675211,바하마,2001-11
2001-11-30,42773564,2159110,40614454,방글라데시,2001-11
2001-11-30,41277919,53612,41224307,과테말라,2001-11
2001-11-30,37731420,20070185,17661235,베네주엘라,2001-11
2001-11-30,36408999,45091431,-8682432,칠레,2001-11
2001-11-30,35798947,7447449,28351498,우즈베키스탄,2001-11
2001-11-30,35394340,51483817,-16089477,남아프리카공화국,2001-11
2001-11-30,32566135,52616296,-20050161,스웨덴,2001-11
2001-11-30,32533965,30044112,2489853,나이지리아,2001-11
2001-11-30,31833512,423935,31409577,시리아,2001-11
2001-11-30,31540649,4503072,27037577,이집트,2001-11
2001-11-30,31389938,34042240,-2652302,노르웨이,2001-11
2001-11-30,28449838,7955021,20494817,헝가리,2001-11
2001-11-30,26924538,72610053,-45685515,스위스,2001-11
2001-11-30,25174127,25986431,-812304,파키스탄,2001-11
2001-11-30,24971296,29962773,-4991477,덴마크,2001-11
2001-11-30,24087475,66827492,-42740017,뉴질랜드,2001-11
2001-11-30,22978296,2729031,20249265,스리랑카,2001-11
2001-11-30,22821124,2943402,19877722,폴란드,2001-11
2001-11-30,22030621,1271337,20759284,그리스,2001-11
2001-11-30,20948192,2893777,18054415,콜롬비아,2001-11
2001-11-30,20645088,33574157,-12929069,오스트리아,2001-11
2001-11-30,19447644,3623225,15824419,포루투갈,2001-11
2001-11-30,16969682,17131865,-162183,우크라이나,2001-11
2001-11-30,16639341,2151094,14488247,요르단,2001-11
2001-11-30,14665616,30762424,-16096808,아르헨티나,2001-11
2001-11-30,14528054,7333605,7194449,페루,2001-11
2001-11-30,13346996,162900038,-149553042,쿠웨이트,2001-11
2001-11-30,12751107,9771474,2979633,푸에르토리코,2001-11
2001-11-30,12367498,163883193,-151515695,오만,2001-11
2001-11-30,12029220,0,12029220,리비아,2001-11
2001-11-30,11866154,2120610,9745544,스와질랜드,2001-11
2001-11-30,11786260,27075975,-15289715,에쿠아도르,2001-11
2001-11-30,11482049,2288210,9193839,카자흐스탄,2001-11
2001-11-30,10724825,647867,10076958,온두라스,2001-11
2001-11-30,10285917,12233209,-1947292,알제리,2001-11
2001-11-30,10085690,2281719,7803971,미얀마,2001-11
2001-11-30,9303468,2341446,6962022,모로코,2001-11
2001-11-30,9196002,548969,8647033,캄보디아,2001-11
2001-11-30,9162425,8658752,503673,코스타리카,2001-11
2001-11-30,8959727,300168,8659559,기타국,2001-11
2001-11-30,7685071,9769456,-2084385,체코공화국,2001-11
2001-11-30,7574799,40624,7534175,아메리칸 사모아,2001-11
2001-11-30,7332816,46945,7285871,엘살바도르,2001-11
2001-11-30,7242672,399978,6842694,레바논,2001-11
2001-11-30,7172656,90385,7082271,북마리아나 군도,2001-11
2001-11-30,7137979,14651606,-7513627,수단,2001-11
2001-11-30,7077866,21180,7056686,아프카니스탄,2001-11
2001-11-30,6254103,4901960,1352143,도미니카 공화국,2001-11
2001-11-30,5527455,195739818,-190212363,카타르,2001-11
2001-11-30,5230552,632,5229920,니카라과,2001-11
2001-11-30,4927269,3776971,1150298,루마니아,2001-11
2001-11-30,4646649,102852,4543797,튀니지,2001-11
2001-11-30,4625009,24277560,-19652551,예맨,2001-11
2001-11-30,4442973,711343,3731630,우루과이,2001-11
2001-11-30,4027159,99162,3927997,몽골,2001-11
2001-11-30,3867842,1056672,2811170,슬로베니아,2001-11
2001-11-30,3791531,611309,3180222,가나,2001-11
2001-11-30,3548598,231132,3317466,마카오,2001-11
2001-11-30,3343348,0,3343348,이라크,2001-11
2001-11-30,2724012,727507,1996505,불가리아,2001-11
2001-11-30,2710596,224522,2486074,에스토니아,2001-11
2001-11-30,2520700,3833250,-1312550,바레인,2001-11
2001-11-30,2370788,32459,2338329,파라과이,2001-11
2001-11-30,2354745,50879,2303866,케냐,2001-11
2001-11-30,2096281,21556,2074725,사이프러스,2001-11
2001-11-30,2002714,8700,1994014,시에라 리온,2001-11
2001-11-30,1939221,520159,1419062,크로아티아,2001-11
2001-11-30,1919482,0,1919482,코트디봐르,2001-11
2001-11-30,1914213,106108,1808105,네팔,2001-11
2001-11-30,1835654,10936,1824718,키르기스스탄,2001-11
2001-11-30,1826640,63255,1763385,괌,2001-11
2001-11-30,1785599,0,1785599,토고,2001-11
2001-11-30,1755922,0,1755922,불령 리유니온 코모도 제도,2001-11
2001-11-30,1613035,1631599,-18564,투르크멘,2001-11
2001-11-30,1602810,653687,949123,리투아니아,2001-11
2001-11-30,1581242,4275,1576967,앙골라,2001-11
2001-11-30,1496494,323704,1172790,모리셔스,2001-11
2001-11-30,1467180,0,1467180,베닝,2001-11
2001-11-30,1441459,46370,1395089,자마이카,2001-11
2001-11-30,1427562,46890,1380672,트리니다드 토바고,2001-11
2001-11-30,1376873,258360,1118513,기니,2001-11
2001-11-30,1360030,73124,1286906,에티오피아,2001-11
2001-11-30,1326794,31563436,-30236642,브루나이,2001-11
2001-11-30,1312148,0,1312148,지부티,2001-11
2001-11-30,1202550,55852,1146698,도미니카,2001-11
2001-11-30,1190005,0,1190005,아이티,2001-11
2001-11-30,1120639,145547,975092,탄자니아,2001-11
2001-11-30,1096976,44339,1052637,세네갈,2001-11
2001-11-30,1058454,39000,1019454,마다카스카르,2001-11
2001-11-30,1021697,472961,548736,짐바브웨,2001-11
2001-11-30,933560,0,933560,과델로프,2001-11
2001-11-30,848043,108071,739972,모잠비크,2001-11
2001-11-30,832171,1194425,-362254,슬로바키아,2001-11
2001-11-30,774292,1811330,-1037038,뉴 칼레도니아,2001-11
2001-11-30,734001,212406,521595,라트비아,2001-11
2001-11-30,716782,54709,662073,카메룬,2001-11
2001-11-30,709685,881914,-172229,룩셈부르그,2001-11
2001-11-30,665337,71358,593979,피지,2001-11
2001-11-30,661324,0,661324,불령 폴리네시아,2001-11
2001-11-30,648339,8797,639542,보스니아-헤르체고비나,2001-11
2001-11-30,574982,141,574841,마티니크,2001-11
2001-11-30,574072,0,574072,마이크로네시아,2001-11
2001-11-30,542716,0,542716,아루바,2001-11
2001-11-30,509502,1454479,-944977,파푸아 뉴기니,2001-11
2001-11-30,479938,84187,395751,우간다,2001-11
2001-11-30,469314,0,469314,라오스,2001-11
2001-11-30,467697,156,467541,팔라우,2001-11
2001-11-30,437550,11951,425599,감비아,2001-11
2001-11-30,423917,0,423917,유고,2001-11
2001-11-30,404614,0,404614,사모아,2001-11
2001-11-30,400812,1059490,-658678,볼리비아,2001-11
2001-11-30,368689,7334802,-6966113,벨리제,2001-11
2001-11-30,362616,42055461,-41692845,콩고,2001-11
2001-11-30,354339,785596,-431257,잠비아,2001-11
2001-11-30,320547,740053,-419506,말리,2001-11
2001-11-30,313144,0,313144,수리남,2001-11
2001-11-30,287360,14594731,-14307371,중립지대,2001-11
2001-11-30,279029,93481,185548,니제르,2001-11
2001-11-30,278688,76486,202202,바누아투,2001-11
2001-11-30,262458,1491449,-1228991,벨라루스,2001-11
2001-11-30,197105,9120,187985,아제르바이잔,2001-11
2001-11-30,184560,0,184560,보츠와나,2001-11
2001-11-30,181181,567516,-386335,타지크,2001-11
2001-11-30,178714,0,178714,레소토,2001-11
2001-11-30,164517,0,164517,버뮤다,2001-11
2001-11-30,155529,0,155529,알바니아,2001-11
2001-11-30,150934,1441687,-1290753,가봉,2001-11
2001-11-30,148908,53708,95200,조지아,2001-11
2001-11-30,139590,44011,95579,콩고민주공화국,2001-11
2001-11-30,129034,1229,127805,소말리아,2001-11
2001-11-30,124907,119730,5177,나미비아,2001-11
2001-11-30,122047,0,122047,에리트리아,2001-11
2001-11-30,119675,0,119675,부탄,2001-11
2001-11-30,115451,0,115451,불령 가이아나,2001-11
2001-11-30,114405,16309,98096,바베이도스,2001-11
2001-11-30,112453,0,112453,몰디브,2001-11
2001-11-30,109472,2967,106505,모리타니,2001-11
2001-11-30,105075,0,105075,마세도니아,2001-11
2001-11-30,103269,0,103269,가이아나,2001-11
2001-11-30,91613,0,91613,아르메니아,2001-11
2001-11-30,80534,1058924,-978390,솔로몬 군도,2001-11
2001-11-30,74929,0,74929,몰도바,2001-11
2001-11-30,70358,443016,-372658,아이슬란드,2001-11
2001-11-30,68300,0,68300,말라위,2001-11
2001-11-30,65604,941190,-875586,네덜란드 열도,2001-11
2001-11-30,61896,0,61896,메요트,2001-11
2001-11-30,57627,0,57627,안티가 바부다,2001-11
2001-11-30,50701,0,50701,카보 베르데,2001-11
2001-11-30,44413,1332127,-1287714,부르키나 파소,2001-11
2001-11-30,41660,0,41660,그레나다,2001-11
2001-11-30,38574,1617,36957,팔레스타인 해방기구(구),2001-11
2001-11-30,37291,0,37291,파나마운하지역,2001-11
2001-11-30,27521,0,27521,투발루,2001-11
2001-11-30,25784,4500,21284,산마리노,2001-11
2001-11-30,25671,143312,-117641,모나코,2001-11
2001-11-30,25465,1293,24172,프랑스 메트로폴리탄,2001-11
2001-11-30,18629,0,18629,영령 캐이맨 군도,2001-11
2001-11-30,13460,0,13460,투르크 & 카이코스 군도,2001-11
2001-11-30,12710,0,12710,챠드,2001-11
2001-11-30,11435,0,11435,세인트 루시아,2001-11
2001-11-30,9768,33063,-23295,리히텐슈타인,2001-11
2001-11-30,8426,0,8426,부룬디,2001-11
2001-11-30,7699,436289,-428590,안도라,2001-11
2001-11-30,7569,0,7569,토켈라우,2001-11
2001-11-30,7061,13491,-6430,미령 버진군도,2001-11
2001-11-30,6042,102064,-96022,파로에 군도,2001-11
2001-11-30,2663,0,2663,세인트 빈센트 그레나딘,2001-11
2001-11-30,1380,0,1380,포클랜드 군도,2001-11
2001-11-30,972,0,972,지브랄타,2001-11
2001-11-30,864,0,864,불령 남부지역,2001-11
2001-11-30,830,0,830,세이쉘,2001-11
2001-11-30,756,17300,-16544,르완다,2001-11
2001-11-30,0,2228,-2228,세인트 헬레나,2001-11
2001-11-30,0,2048,-2048,마이너 아우틀링 합중국 군도,2001-11
2001-11-30,0,2684,-2684,상토메 프린스페,2001-11
2001-11-30,0,119161,-119161,기네비소,2001-11
2001-11-30,0,0,0,안타티카,2001-11
2001-12-31,2377681032,1754175483,623505549,미국,2001-12
2001-12-31,1502461022,1160348940,342112082,중국,2001-12
2001-12-31,1161800697,2016200335,-854399638,일본,2001-12
2001-12-31,768677224,112269171,656408053,홍콩,2001-12
2001-12-31,532830887,368157787,164673100,대만,2001-12
2001-12-31,357564973,389231738,-31666765,독일,2001-12
2001-12-31,317730852,263141220,54589632,싱가포르,2001-12
2001-12-31,266742278,44351759,222390519,파나마,2001-12
2001-12-31,265615074,254954205,10660869,영국,2001-12
2001-12-31,217987981,345140217,-127152236,아랍에미리트 연합,2001-12
2001-12-31,212073494,345070104,-132996610,인도네시아,2001-12
2001-12-31,208918532,317031744,-108113212,말레이시아,2001-12
2001-12-31,194891907,451696013,-256804106,호주,2001-12
2001-12-31,193099066,94441373,98657693,네덜란드,2001-12
2001-12-31,163049200,160748175,2301025,필리핀,2001-12
2001-12-31,162373205,144099652,18273553,이탈리아,2001-12
2001-12-31,160867191,130518229,30348962,태국,2001-12
2001-12-31,156708036,29944403,126763633,베트남,2001-12
2001-12-31,149830515,23099883,126730632,멕시코,2001-12
2001-12-31,144672440,160708659,-16036219,캐나다,2001-12
2001-12-31,122005481,1674358,120331123,몰타,2001-12
2001-12-31,121653680,25665151,95988529,스페인,2001-12
2001-12-31,113453443,50,113453393,라이베리아,2001-12
2001-12-31,103656266,12356446,91299820,튀르키예,2001-12
2001-12-31,100391097,107237350,-6846253,인도,2001-12
2001-12-31,97476577,186460625,-88984048,프랑스,2001-12
2001-12-31,88368353,469459420,-381091067,사우디아라비아,2001-12
2001-12-31,85761081,117151893,-31390812,이란,2001-12
2001-12-31,78771606,110721243,-31949637,브라질,2001-12
2001-12-31,73124463,159366083,-86241620,러시아 연방,2001-12
2001-12-31,70752230,26399,70725831,사이프러스,2001-12
2001-12-31,60177521,41162176,19015345,벨기에,2001-12
2001-12-31,56196182,194094,56002088,베네주엘라,2001-12
2001-12-31,54993915,1042050,53951865,그리스,2001-12
2001-12-31,53652792,30721639,22931153,핀란드,2001-12
2001-12-31,49641890,27604505,22037385,이스라엘,2001-12
2001-12-31,42277816,479114,41798702,리비아,2001-12
2001-12-31,40225842,40799117,-573275,스웨덴,2001-12
2001-12-31,39561616,1755079,37806537,방글라데시,2001-12
2001-12-31,37358662,56843723,-19485061,아일랜드,2001-12
2001-12-31,36510011,133143,36376868,과테말라,2001-12
2001-12-31,35653253,268742,35384511,시리아,2001-12
2001-12-31,33829208,0,33829208,마샬군도,2001-12
2001-12-31,32346605,16388561,15958044,이집트,2001-12
2001-12-31,30292121,7532946,22759175,나이지리아,2001-12
2001-12-31,30065769,61899383,-31833614,남아프리카공화국,2001-12
2001-12-31,29512914,0,29512914,안티가 바부다,2001-12
2001-12-31,28789308,25259602,3529706,파키스탄,2001-12
2001-12-31,27089528,61004823,-33915295,칠레,2001-12
2001-12-31,26148525,32194762,-6046237,우즈베키스탄,2001-12
2001-12-31,26041416,4627057,21414359,폴란드,2001-12
2001-12-31,23201902,0,23201902,세인트 빈센트 그레나딘,2001-12
2001-12-31,21673486,69697117,-48023631,뉴질랜드,2001-12
2001-12-31,20147179,1647906,18499273,포루투갈,2001-12
2001-12-31,18876918,12743338,6133580,페루,2001-12
2001-12-31,18857648,9625624,9232024,헝가리,2001-12
2001-12-31,18388434,80996958,-62608524,스위스,2001-12
2001-12-31,17593225,117410099,-99816874,쿠웨이트,2001-12
2001-12-31,17553558,3444797,14108761,스리랑카,2001-12
2001-12-31,17409352,20481715,-3072363,오스트리아,2001-12
2001-12-31,16583095,3450537,13132558,콜롬비아,2001-12
2001-12-31,15304202,3964,15300238,괌,2001-12
2001-12-31,15228286,23925296,-8697010,알제리,2001-12
2001-12-31,14689990,27857585,-13167595,우크라이나,2001-12
2001-12-31,14643799,31556302,-16912503,덴마크,2001-12
2001-12-31,14544434,224507,14319927,요르단,2001-12
2001-12-31,13653169,264196,13388973,우루과이,2001-12
2001-12-31,12363390,235562,12127828,온두라스,2001-12
2001-12-31,12266967,514278,11752689,캄보디아,2001-12
2001-12-31,12088688,4604546,7484142,카자흐스탄,2001-12
2001-12-31,11924868,6862303,5062565,푸에르토리코,2001-12
2001-12-31,11886933,12561885,-674952,에쿠아도르,2001-12
2001-12-31,11394882,43299950,-31905068,노르웨이,2001-12
2001-12-31,10853275,9311500,1541775,미얀마,2001-12
2001-12-31,10808240,33611842,-22803602,콩고,2001-12
2001-12-31,10241922,157623013,-147381091,오만,2001-12
2001-12-31,9622269,714058,8908211,루마니아,2001-12
2001-12-31,9529587,4739870,4789717,코스타리카,2001-12
2001-12-31,8680974,3986550,4694424,기타국,2001-12
2001-12-31,7924966,116464,7808502,몽골,2001-12
2001-12-31,7920514,0,7920514,이라크,2001-12
2001-12-31,6770698,27074,6743624,아프카니스탄,2001-12
2001-12-31,6648982,8540426,-1891444,체코공화국,2001-12
2001-12-31,6529717,155515,6374202,도미니카 공화국,2001-12
2001-12-31,6242355,27486123,-21243768,아르헨티나,2001-12
2001-12-31,6038747,1314192,4724555,모로코,2001-12
2001-12-31,5960382,51370,5909012,엘살바도르,2001-12
2001-12-31,5527938,1668118,3859820,슬로베니아,2001-12
2001-12-31,5499612,1283,5498329,북마리아나 군도,2001-12
2001-12-31,5481942,184156,5297786,레바논,2001-12
2001-12-31,5068885,395,5068490,니카라과,2001-12
2001-12-31,4637928,6919,4631009,케냐,2001-12
2001-12-31,4414981,32845610,-28430629,수단,2001-12
2001-12-31,3927921,221857966,-217930045,카타르,2001-12
2001-12-31,3587773,5088,3582685,아메리칸 사모아,2001-12
2001-12-31,3526480,624812,2901668,가나,2001-12
2001-12-31,3298804,49020,3249784,튀니지,2001-12
2001-12-31,3121111,4064409,-943298,바레인,2001-12
2001-12-31,2766821,92851,2673970,마카오,2001-12
2001-12-31,2599830,19632932,-17033102,예맨,2001-12
2001-12-31,2324727,14245,2310482,코트디봐르,2001-12
2001-12-31,2224245,27654,2196591,파라과이,2001-12
2001-12-31,2198559,1095,2197464,시에라 리온,2001-12
2001-12-31,2082587,6027,2076560,토고,2001-12
2001-12-31,1940545,375802,1564743,크로아티아,2001-12
2001-12-31,1648584,60020775,-58372191,앙골라,2001-12
2001-12-31,1540498,570042,970456,리투아니아,2001-12
2001-12-31,1471809,26895,1444914,트리니다드 토바고,2001-12
2001-12-31,1460385,320626,1139759,에스토니아,2001-12
2001-12-31,1365723,714671,651052,불가리아,2001-12
2001-12-31,1329190,334439,994751,짐바브웨,2001-12
2001-12-31,1231177,373376,857801,모리셔스,2001-12
2001-12-31,1212572,0,1212572,베닝,2001-12
2001-12-31,1155969,64847,1091122,키르기스스탄,2001-12
2001-12-31,1153331,19702,1133629,탄자니아,2001-12
2001-12-31,1136436,114949,1021487,네팔,2001-12
2001-12-31,1045763,82015,963748,마다카스카르,2001-12
2001-12-31,1044308,267813,776495,투르크멘,2001-12
2001-12-31,991637,609539,382098,슬로바키아,2001-12
2001-12-31,975250,140115,835135,에티오피아,2001-12
2001-12-31,954318,0,954318,모잠비크,2001-12
2001-12-31,950718,1732950,-782232,뉴 칼레도니아,2001-12
2001-12-31,917941,1644497,-726556,파푸아 뉴기니,2001-12
2001-12-31,911083,2191428,-1280345,스와질랜드,2001-12
2001-12-31,897243,122110,775133,라오스,2001-12
2001-12-31,888247,345575,542672,피지,2001-12
2001-12-31,875497,43520,831977,자마이카,2001-12
2001-12-31,863269,0,863269,불령 리유니온 코모도 제도,2001-12
2001-12-31,856895,326376,530519,기니,2001-12
2001-12-31,842838,818793,24045,벨라루스,2001-12
2001-12-31,818740,0,818740,팔라우,2001-12
2001-12-31,790790,54852610,-54061820,브루나이,2001-12
2001-12-31,780396,0,780396,아이티,2001-12
2001-12-31,778218,4232,773986,보스니아-헤르체고비나,2001-12
2001-12-31,767600,554433,213167,벨리제,2001-12
2001-12-31,757671,0,757671,마티니크,2001-12
2001-12-31,713600,1570493,-856893,아이슬란드,2001-12
2001-12-31,596999,964,596035,지부티,2001-12
2001-12-31,590898,179197,411701,과델로프,2001-12
2001-12-31,588294,0,588294,레소토,2001-12
2001-12-31,582390,18180,564210,라트비아,2001-12
2001-12-31,560063,0,560063,아루바,2001-12
2001-12-31,541642,0,541642,아제르바이잔,2001-12
2001-12-31,507843,8539,499304,도미니카,2001-12
2001-12-31,450557,86526,364031,세네갈,2001-12
2001-12-31,421694,400731,20963,카메룬,2001-12
2001-12-31,381722,0,381722,모리타니,2001-12
2001-12-31,335435,383824,-48389,조지아,2001-12
2001-12-31,332841,0,332841,에리트리아,2001-12
2001-12-31,304119,0,304119,소말리아,2001-12
2001-12-31,296769,0,296769,말라위,2001-12
2001-12-31,294504,91,294413,바하마,2001-12
2001-12-31,260043,748920,-488877,네덜란드 열도,2001-12
2001-12-31,253672,27788,225884,불령 가이아나,2001-12
2001-12-31,252406,0,252406,보츠와나,2001-12
2001-12-31,234885,16072,218813,유고,2001-12
2001-12-31,218752,30667,188085,볼리비아,2001-12
2001-12-31,202532,205318,-2786,잠비아,2001-12
2001-12-31,200995,0,200995,마세도니아,2001-12
2001-12-31,200213,0,200213,사모아,2001-12
2001-12-31,193195,664190,-470995,타지크,2001-12
2001-12-31,191556,48943,142613,우간다,2001-12
2001-12-31,184070,88105,95965,안도라,2001-12
2001-12-31,158348,0,158348,마이크로네시아,2001-12
2001-12-31,153377,131,153246,버뮤다,2001-12
2001-12-31,150144,394753,-244609,말리,2001-12
2001-12-31,146911,0,146911,수리남,2001-12
2001-12-31,128491,8064,120427,바베이도스,2001-12
2001-12-31,122742,0,122742,알바니아,2001-12
2001-12-31,121713,25250,96463,불령 폴리네시아,2001-12
2001-12-31,117038,935672,-818634,룩셈부르그,2001-12
2001-12-31,106824,41187,65637,가봉,2001-12
2001-12-31,97577,45322,52255,몰도바,2001-12
2001-12-31,90241,0,90241,몰디브,2001-12
2001-12-31,83397,23710,59687,미령 버진군도,2001-12
2001-12-31,80695,0,80695,그레나다,2001-12
2001-12-31,75150,0,75150,아르메니아,2001-12
2001-12-31,75144,0,75144,르완다,2001-12
2001-12-31,73294,88727,-15433,바누아투,2001-12
2001-12-31,69124,0,69124,티모르,2001-12
2001-12-31,66982,165910,-98928,나미비아,2001-12
2001-12-31,66575,0,66575,적도 기니,2001-12
2001-12-31,52021,0,52021,챠드,2001-12
2001-12-31,48283,0,48283,키리바티,2001-12
2001-12-31,43633,0,43633,가이아나,2001-12
2001-12-31,41754,121371,-79617,콩고민주공화국,2001-12
2001-12-31,40876,0,40876,카보 베르데,2001-12
2001-12-31,38923,0,38923,감비아,2001-12
2001-12-31,33358,34802,-1444,리히텐슈타인,2001-12
2001-12-31,31529,1897307,-1865778,솔로몬 군도,2001-12
2001-12-31,29310,0,29310,부탄,2001-12
2001-12-31,28719,11924,16795,니제르,2001-12
2001-12-31,28261,0,28261,산마리노,2001-12
2001-12-31,24783,0,24783,세이쉘,2001-12
2001-12-31,16075,0,16075,통가,2001-12
2001-12-31,13770,0,13770,파로에 군도,2001-12
2001-12-31,13284,0,13284,파나마운하지역,2001-12
2001-12-31,13136,233197,-220061,모나코,2001-12
2001-12-31,12045,0,12045,부룬디,2001-12
2001-12-31,11200,0,11200,메요트,2001-12
2001-12-31,10878,0,10878,미드웨이 군도,2001-12
2001-12-31,8766,0,8766,토켈라우,2001-12
2001-12-31,7685,0,7685,영령 캐이맨 군도,2001-12
2001-12-31,459,0,459,쿡 아일랜드,2001-12
2001-12-31,446,569656,-569210,팔레스타인 해방기구(구),2001-12
2001-12-31,432,0,432,중앙아프리카공화국,2001-12
2001-12-31,252,0,252,지브랄타,2001-12
2001-12-31,115,0,115,서사하라,2001-12
2001-12-31,0,7437,-7437,상토메 프린스페,2001-12
2001-12-31,0,384040,-384040,기네비소,2001-12
2001-12-31,0,213907,-213907,부르키나 파소,2001-12
2001-12-31,0,55182,-55182,존스톤 아일랜드,2001-12
2001-12-31,0,2528,-2528,나우루,2001-12
2001-12-31,0,107,-107,앙귈라,2001-12
2001-12-31,0,19296,-19296,몬트세라트,2001-12
2002-01-31,2496356532,1776559846,719796686,미국,2002-01
2002-01-31,1471487338,1230279911,241207427,중국,2002-01
2002-01-31,1054722674,1882855177,-828132503,일본,2002-01
2002-01-31,710914959,119581684,591333275,홍콩,2002-01
2002-01-31,510407473,369869216,140538257,대만,2002-01
2002-01-31,324457083,396885525,-72428442,독일,2002-01
2002-01-31,299182480,265176964,34005516,싱가포르,2002-01
2002-01-31,277536309,162392921,115143388,영국,2002-01
2002-01-31,230870663,341482023,-110611360,말레이시아,2002-01
2002-01-31,216327641,355698243,-139370602,인도네시아,2002-01
2002-01-31,204973056,79444879,125528177,네덜란드,2002-01
2002-01-31,198756395,151357771,47398624,필리핀,2002-01
2002-01-31,190566776,7564,190559212,바하마,2002-01
2002-01-31,188397370,129915554,58481816,캐나다,2002-01
2002-01-31,184273636,216876982,-32603346,프랑스,2002-01
2002-01-31,171837022,18542399,153294623,멕시코,2002-01
2002-01-31,162683342,311061149,-148377807,아랍에미리트 연합,2002-01
2002-01-31,153560600,126929664,26630936,태국,2002-01
2002-01-31,152538397,499514327,-346975930,호주,2002-01
2002-01-31,141286949,174910391,-33623442,이탈리아,2002-01
2002-01-31,126243658,36172758,90070900,베트남,2002-01
2002-01-31,117150835,30114376,87036459,스페인,2002-01
2002-01-31,107880939,111299430,-3418491,이란,2002-01
2002-01-31,92804986,568397347,-475592361,사우디아라비아,2002-01
2002-01-31,91996526,112152333,-20155807,인도,2002-01
2002-01-31,83654592,110209847,-26555255,브라질,2002-01
2002-01-31,78379475,112635774,-34256299,러시아 연방,2002-01
2002-01-31,76502017,33915614,42586403,핀란드,2002-01
2002-01-31,70302030,67769,70234261,사이프러스,2002-01
2002-01-31,61360322,4894545,56465777,몰타,2002-01
2002-01-31,57043848,56263112,780736,벨기에,2002-01
2002-01-31,46908057,29530,46878527,라이베리아,2002-01
2002-01-31,44374666,9350949,35023717,그리스,2002-01
2002-01-31,43914057,6774593,37139464,튀르키예,2002-01
2002-01-31,37585746,554977,37030769,베네주엘라,2002-01
2002-01-31,36358683,1955807,34402876,방글라데시,2002-01
2002-01-31,35720995,45496609,-9775614,스웨덴,2002-01
2002-01-31,35450892,28646866,6804026,이스라엘,2002-01
2002-01-31,34056895,50453749,-16396854,아일랜드,2002-01
2002-01-31,32654848,64359157,-31704309,칠레,2002-01
2002-01-31,31426013,4629825,26796188,과테말라,2002-01
2002-01-31,27831434,45093,27786341,나이지리아,2002-01
2002-01-31,26806162,10821950,15984212,우즈베키스탄,2002-01
2002-01-31,26704249,3518264,23185985,폴란드,2002-01
2002-01-31,25161923,23049052,2112871,파키스탄,2002-01
2002-01-31,24972733,28508095,-3535362,덴마크,2002-01
2002-01-31,23227120,64909834,-41682714,뉴질랜드,2002-01
2002-01-31,22612003,55061364,-32449361,이집트,2002-01
2002-01-31,22079805,25166089,-3086284,오스트리아,2002-01
2002-01-31,21892248,2481235,19411013,스리랑카,2002-01
2002-01-31,21769094,3584235,18184859,콜롬비아,2002-01
2002-01-31,21755227,8478944,13276283,시리아,2002-01
2002-01-31,21119081,9181435,11937646,헝가리,2002-01
2002-01-31,21091700,43223133,-22131433,남아프리카공화국,2002-01
2002-01-31,18671994,420148,18251846,파나마,2002-01
2002-01-31,17767634,186049050,-168281416,쿠웨이트,2002-01
2002-01-31,16934862,36184893,-19250031,노르웨이,2002-01
2002-01-31,16500144,1546842,14953302,포루투갈,2002-01
2002-01-31,15798859,19133874,-3335015,페루,2002-01
2002-01-31,15332611,18833128,-3500517,우크라이나,2002-01
2002-01-31,14001312,80668382,-66667070,스위스,2002-01
2002-01-31,12334136,539393,11794743,요르단,2002-01
2002-01-31,11971575,11311399,660176,에쿠아도르,2002-01
2002-01-31,11367840,9149836,2218004,이라크,2002-01
2002-01-31,10374076,2441593,7932483,미얀마,2002-01
2002-01-31,9880620,184398,9696222,온두라스,2002-01
2002-01-31,9392793,1573932,7818861,기타국,2002-01
2002-01-31,8824664,11888178,-3063514,푸에르토리코,2002-01
2002-01-31,8606538,1276177,7330361,루마니아,2002-01
2002-01-31,8482687,5286492,3196195,카자흐스탄,2002-01
2002-01-31,8203100,2898300,5304800,코스타리카,2002-01
2002-01-31,8068930,8055725,13205,알제리,2002-01
2002-01-31,7617262,0,7617262,아프카니스탄,2002-01
2002-01-31,7398678,1020600,6378078,리비아,2002-01
2002-01-31,7059228,2278494,4780734,도미니카 공화국,2002-01
2002-01-31,6629723,170821,6458902,캄보디아,2002-01
2002-01-31,6465149,205648970,-199183821,오만,2002-01
2002-01-31,5627553,4072124,1555429,모로코,2002-01
2002-01-31,5546437,831879,4714558,슬로베니아,2002-01
2002-01-31,5418041,6941141,-1523100,체코공화국,2002-01
2002-01-31,5079917,3534,5076383,북마리아나 군도,2002-01
2002-01-31,4945004,608979,4336025,레바논,2002-01
2002-01-31,4860743,51051,4809692,엘살바도르,2002-01
2002-01-31,4737880,149475,4588405,튀니지,2002-01
2002-01-31,4344577,18818907,-14474330,예맨,2002-01
2002-01-31,4328701,643595,3685106,우루과이,2002-01
2002-01-31,4304306,5297429,-993123,바레인,2002-01
2002-01-31,4271712,209587835,-205316123,카타르,2002-01
2002-01-31,4055323,430,4054893,니카라과,2002-01
2002-01-31,4020569,9810689,-5790120,수단,2002-01
2002-01-31,3896793,388145,3508648,몽골,2002-01
2002-01-31,2909278,363438,2545840,리투아니아,2002-01
2002-01-31,2780811,547581,2233230,크로아티아,2002-01
2002-01-31,2731862,41168998,-38437136,아르헨티나,2002-01
2002-01-31,2691225,815432,1875793,가나,2002-01
2002-01-31,2409566,957929,1451637,마카오,2002-01
2002-01-31,2166282,575974,1590308,케냐,2002-01
2002-01-31,2118454,0,2118454,코트디봐르,2002-01
2002-01-31,1927906,0,1927906,토고,2002-01
2002-01-31,1907724,1195637,712087,불가리아,2002-01
2002-01-31,1793048,0,1793048,베닝,2002-01
2002-01-31,1787995,496104,1291891,투르크멘,2002-01
2002-01-31,1553236,196425,1356811,에스토니아,2002-01
2002-01-31,1390075,3718,1386357,파라과이,2002-01
2002-01-31,1243008,4759,1238249,유고,2002-01
2002-01-31,1192899,18170,1174729,괌,2002-01
2002-01-31,1150076,3211,1146865,시에라 리온,2002-01
2002-01-31,1126723,89159,1037564,탄자니아,2002-01
2002-01-31,1119858,714058,405800,짐바브웨,2002-01
2002-01-31,1078669,81640,997029,세네갈,2002-01
2002-01-31,1039950,41002471,-39962521,브루나이,2002-01
2002-01-31,1019728,87562,932166,트리니다드 토바고,2002-01
2002-01-31,1018976,311,1018665,아메리칸 사모아,2002-01
2002-01-31,1014847,77904,936943,키르기스스탄,2002-01
2002-01-31,990813,127777,863036,라트비아,2002-01
2002-01-31,981389,0,981389,사모아,2002-01
2002-01-31,959738,5818887,-4859149,기니,2002-01
2002-01-31,950629,329,950300,앙골라,2002-01
2002-01-31,930240,44362191,-43431951,콩고,2002-01
2002-01-31,928654,672376,256278,모리셔스,2002-01
2002-01-31,916911,67626,849285,피지,2002-01
2002-01-31,915116,0,915116,아이티,2002-01
2002-01-31,882129,155351,726778,네팔,2002-01
2002-01-31,869639,97403,772236,안도라,2002-01
2002-01-31,868655,436159,432496,벨라루스,2002-01
2002-01-31,856960,8004,848956,자마이카,2002-01
2002-01-31,794800,252697,542103,에티오피아,2002-01
2002-01-31,790693,0,790693,지부티,2002-01
2002-01-31,787685,1545089,-757404,스와질랜드,2002-01
2002-01-31,786454,11100,775354,불령 리유니온 코모도 제도,2002-01
2002-01-31,691330,351900,339430,아이슬란드,2002-01
2002-01-31,679225,544740,134485,슬로바키아,2002-01
2002-01-31,644097,0,644097,과델로프,2002-01
2002-01-31,618795,932666,-313871,파푸아 뉴기니,2002-01
2002-01-31,610510,6540,603970,불령 폴리네시아,2002-01
2002-01-31,556971,238334,318637,볼리비아,2002-01
2002-01-31,542878,1831198,-1288320,뉴 칼레도니아,2002-01
2002-01-31,542547,21819,520728,카메룬,2002-01
2002-01-31,526294,38071,488223,마샬군도,2002-01
2002-01-31,480912,919038,-438126,룩셈부르그,2002-01
2002-01-31,479798,0,479798,모잠비크,2002-01
2002-01-31,458712,0,458712,마티니크,2002-01
2002-01-31,435239,0,435239,팔라우,2002-01
2002-01-31,417215,55056,362159,마다카스카르,2002-01
2002-01-31,412044,8300,403744,라오스,2002-01
2002-01-31,409750,29360,380390,모리타니,2002-01
2002-01-31,365342,53129,312213,잠비아,2002-01
2002-01-31,345884,0,345884,아루바,2002-01
2002-01-31,344555,0,344555,우간다,2002-01
2002-01-31,317582,0,317582,말라위,2002-01
2002-01-31,309645,411511,-101866,조지아,2002-01
2002-01-31,308232,0,308232,불령 가이아나,2002-01
2002-01-31,307059,22197,284862,도미니카,2002-01
2002-01-31,295601,375222,-79621,네덜란드 열도,2002-01
2002-01-31,262147,329,261818,마이크로네시아,2002-01
2002-01-31,261940,29917,232023,바베이도스,2002-01
2002-01-31,260328,177,260151,벨리제,2002-01
2002-01-31,258268,22042415,-21784147,가봉,2002-01
2002-01-31,247912,3580,244332,몰디브,2002-01
2002-01-31,237077,1443596,-1206519,가이아나,2002-01
2002-01-31,219562,125601,93961,에리트리아,2002-01
2002-01-31,216312,565506,-349194,타지크,2002-01
2002-01-31,212169,27531,184638,니제르,2002-01
2002-01-31,205590,0,205590,아르메니아,2002-01
2002-01-31,188281,0,188281,마세도니아,2002-01
2002-01-31,174992,26843,148149,아제르바이잔,2002-01
2002-01-31,172646,0,172646,감비아,2002-01
2002-01-31,157182,0,157182,안티가 바부다,2002-01
2002-01-31,147357,0,147357,알바니아,2002-01
2002-01-31,142016,0,142016,레소토,2002-01
2002-01-31,124240,51153,73087,나미비아,2002-01
2002-01-31,112547,8722,103825,보스니아-헤르체고비나,2002-01
2002-01-31,112248,0,112248,수리남,2002-01
2002-01-31,107292,0,107292,바누아투,2002-01
2002-01-31,79694,0,79694,보츠와나,2002-01
2002-01-31,76971,0,76971,소말리아,2002-01
2002-01-31,48285,14753,33532,몰도바,2002-01
2002-01-31,35289,1762670,-1727381,리히텐슈타인,2002-01
2002-01-31,32816,0,32816,그레나다,2002-01
2002-01-31,31952,89215,-57263,팔레스타인 해방기구(구),2002-01
2002-01-31,28575,12250,16325,콩고민주공화국,2002-01
2002-01-31,28068,720038,-691970,솔로몬 군도,2002-01
2002-01-31,27332,0,27332,산마리노,2002-01
2002-01-31,26752,270,26482,쿡 아일랜드,2002-01
2002-01-31,18744,0,18744,통가,2002-01
2002-01-31,17523,0,17523,부탄,2002-01
2002-01-31,17299,70,17229,버뮤다,2002-01
2002-01-31,12894,0,12894,세인트 루시아,2002-01
2002-01-31,10557,0,10557,키리바티,2002-01
2002-01-31,8477,13523,-5046,중앙아프리카공화국,2002-01
2002-01-31,7560,15383,-7823,영령 버진군도,2002-01
2002-01-31,4600,406957,-402357,모나코,2002-01
2002-01-31,3560,0,3560,부룬디,2002-01
2002-01-31,3110,0,3110,세이쉘,2002-01
2002-01-31,2216,406,1810,지브랄타,2002-01
2002-01-31,1367,0,1367,챠드,2002-01
2002-01-31,363,0,363,파로에 군도,2002-01
2002-01-31,359,0,359,미령 버진군도,2002-01
2002-01-31,335,906310,-905975,말리,2002-01
2002-01-31,191,0,191,메요트,2002-01
2002-01-31,15,0,15,불령 남부지역,2002-01
2002-01-31,0,1603,-1603,영령 인도양,2002-01
2002-01-31,0,216365,-216365,적도 기니,2002-01
2002-01-31,0,842,-842,존스톤 아일랜드,2002-01
2002-01-31,0,0,0,토켈라우,2002-01
2002-01-31,0,1410,-1410,마이너 아우틀링 합중국 군도,2002-01
2002-01-31,0,9641131,-9641131,중립지대,2002-01
2002-01-31,0,356190,-356190,기네비소,2002-01
2002-01-31,0,113585,-113585,미드웨이 군도,2002-01
2002-01-31,0,0,0,몬트세라트,2002-01
2002-01-31,0,284573,-284573,부르키나 파소,2002-01
2002-01-31,0,29309,-29309,프랑스 메트로폴리탄,2002-01
2002-01-31,0,6014,-6014,영령 캐이맨 군도,2002-01
2002-01-31,0,204997,-204997,그린랜드,2002-01
2002-02-28,2267664325,1561338967,706325358,미국,2002-02
2002-02-28,1314887195,1073030432,241856763,중국,2002-02
2002-02-28,1065870276,1985281546,-919411270,일본,2002-02
2002-02-28,658025209,108702450,549322759,홍콩,2002-02
2002-02-28,477463580,315915106,161548474,대만,2002-02
2002-02-28,379905255,117325565,262579690,태국,2002-02
2002-02-28,373572144,348812338,24759806,독일,2002-02
2002-02-28,325966817,238482019,87484798,싱가포르,2002-02
2002-02-28,279716278,148295345,131420933,영국,2002-02
2002-02-28,223197564,328789719,-105592155,인도네시아,2002-02
2002-02-28,217201334,176901441,40299893,필리핀,2002-02
2002-02-28,207361270,307267952,-99906682,말레이시아,2002-02
2002-02-28,174689450,60879430,113810020,네덜란드,2002-02
2002-02-28,172402893,20162494,152240399,멕시코,2002-02
2002-02-28,158727218,141856164,16871054,이탈리아,2002-02
2002-02-28,149914960,445698272,-295783312,호주,2002-02
2002-02-28,146492317,326701579,-180209262,아랍에미리트 연합,2002-02
2002-02-28,133822660,143779153,-9956493,프랑스,2002-02
2002-02-28,133803156,121574906,12228250,캐나다,2002-02
2002-02-28,118939281,32033635,86905646,베트남,2002-02
2002-02-28,111570507,43676,111526831,라이베리아,2002-02
2002-02-28,105775522,24850484,80925038,스페인,2002-02
2002-02-28,97638621,92382810,5255811,브라질,2002-02
2002-02-28,94429517,507255405,-412825888,사우디아라비아,2002-02
2002-02-28,92698864,92484625,214239,인도,2002-02
2002-02-28,85659335,3973062,81686273,파나마,2002-02
2002-02-28,80334697,80795,80253902,사이프러스,2002-02
2002-02-28,79202112,155163847,-75961735,러시아 연방,2002-02
2002-02-28,71978388,102866303,-30887915,이란,2002-02
2002-02-28,59930292,4440339,55489953,몰타,2002-02
2002-02-28,54449326,59780,54389546,마샬군도,2002-02
2002-02-28,51245735,41067205,10178530,벨기에,2002-02
2002-02-28,50580163,23727560,26852603,핀란드,2002-02
2002-02-28,41094649,3555857,37538792,튀르키예,2002-02
2002-02-28,41064531,3696563,37367968,베네주엘라,2002-02
2002-02-28,40485330,1781650,38703680,방글라데시,2002-02
2002-02-28,34736724,22508063,12228661,나이지리아,2002-02
2002-02-28,34381810,20496209,13885601,이스라엘,2002-02
2002-02-28,34188851,43068602,-8879751,아일랜드,2002-02
2002-02-28,32619504,47204177,-14584673,칠레,2002-02
2002-02-28,29767415,25114939,4652476,파키스탄,2002-02
2002-02-28,29314601,2105870,27208731,폴란드,2002-02
2002-02-28,28530788,31290350,-2759562,스웨덴,2002-02
2002-02-28,27406998,20844669,6562329,과테말라,2002-02
2002-02-28,26034020,7335226,18698794,이집트,2002-02
2002-02-28,25981907,27819871,-1837964,남아프리카공화국,2002-02
2002-02-28,25302051,140034,25162017,시리아,2002-02
2002-02-28,24278458,69411108,-45132650,스위스,2002-02
2002-02-28,23353883,2079464,21274419,콜롬비아,2002-02
2002-02-28,23287745,6890876,16396869,헝가리,2002-02
2002-02-28,20509857,14426333,6083524,우크라이나,2002-02
2002-02-28,20008291,2556210,17452081,스리랑카,2002-02
2002-02-28,19793855,18819576,974279,오스트리아,2002-02
2002-02-28,19624963,6358970,13265993,우즈베키스탄,2002-02
2002-02-28,19538014,1135396,18402618,그리스,2002-02
2002-02-28,18687440,2184335,16503105,포루투갈,2002-02
2002-02-28,16502752,50708089,-34205337,뉴질랜드,2002-02
2002-02-28,16364997,4897451,11467546,알제리,2002-02
2002-02-28,15204133,136327343,-121123210,쿠웨이트,2002-02
2002-02-28,15188195,2492897,12695298,요르단,2002-02
2002-02-28,14236040,24388009,-10151969,페루,2002-02
2002-02-28,12953137,36253730,-23300593,에쿠아도르,2002-02
2002-02-28,12917956,0,12917956,아프카니스탄,2002-02
2002-02-28,12507175,9961702,2545473,이라크,2002-02
2002-02-28,11212152,31949033,-20736881,덴마크,2002-02
2002-02-28,10028838,5424993,4603845,체코공화국,2002-02
2002-02-28,9810999,2129019,7681980,미얀마,2002-02
2002-02-28,9546903,2265913,7280990,카자흐스탄,2002-02
2002-02-28,9491132,1688627,7802505,기타국,2002-02
2002-02-28,9316842,5728095,3588747,푸에르토리코,2002-02
2002-02-28,8452983,23111874,-14658891,노르웨이,2002-02
2002-02-28,8430560,357016,8073544,온두라스,2002-02
2002-02-28,7887275,238576888,-230689613,오만,2002-02
2002-02-28,7280370,432394,6847976,캄보디아,2002-02
2002-02-28,7222361,2580880,4641481,루마니아,2002-02
2002-02-28,6920202,1349549,5570653,코스타리카,2002-02
2002-02-28,6683971,197001,6486970,튀니지,2002-02
2002-02-28,6608635,361681,6246954,레바논,2002-02
2002-02-28,5884510,394072,5490438,리비아,2002-02
2002-02-28,5577315,103254,5474061,도미니카 공화국,2002-02
2002-02-28,5148790,4554305,594485,모로코,2002-02
2002-02-28,4770411,149130,4621281,엘살바도르,2002-02
2002-02-28,4665643,24002,4641641,키르기스스탄,2002-02
2002-02-28,4623307,24271,4599036,니카라과,2002-02
2002-02-28,4510902,462,4510440,북마리아나 군도,2002-02
2002-02-28,4242606,18930458,-14687852,바레인,2002-02
2002-02-28,4002392,218051569,-214049177,카타르,2002-02
2002-02-28,4000356,73364,3926992,케냐,2002-02
2002-02-28,3794507,423706,3370801,우루과이,2002-02
2002-02-28,3740371,61737024,-57996653,예맨,2002-02
2002-02-28,3702040,1387589,2314451,슬로베니아,2002-02
2002-02-28,3676545,27947,3648598,수단,2002-02
2002-02-28,3515047,0,3515047,아메리칸 사모아,2002-02
2002-02-28,3122007,590084,2531923,가나,2002-02
2002-02-28,2869397,686290,2183107,마카오,2002-02
2002-02-28,2778009,501212,2276797,투르크멘,2002-02
2002-02-28,2695450,45411,2650039,리투아니아,2002-02
2002-02-28,2472300,261438,2210862,몽골,2002-02
2002-02-28,2360288,270190,2090098,불가리아,2002-02
2002-02-28,2085695,6187,2079508,도미니카,2002-02
2002-02-28,2038015,343233,1694782,기니,2002-02
2002-02-28,1925247,342680,1582567,자마이카,2002-02
2002-02-28,1893911,29178643,-27284732,아르헨티나,2002-02
2002-02-28,1836001,16790,1819211,파라과이,2002-02
2002-02-28,1828767,454400,1374367,타지크,2002-02
2002-02-28,1549127,0,1549127,토고,2002-02
2002-02-28,1399496,982570,416926,슬로바키아,2002-02
2002-02-28,1398834,48973205,-47574371,브루나이,2002-02
2002-02-28,1370929,0,1370929,아이티,2002-02
2002-02-28,1358435,35193,1323242,피지,2002-02
2002-02-28,1357732,24862,1332870,괌,2002-02
2002-02-28,1343677,5727,1337950,크로아티아,2002-02
2002-02-28,1267099,14970,1252129,코트디봐르,2002-02
2002-02-28,1246947,4727995,-3481048,에스토니아,2002-02
2002-02-28,1149394,1937404,-788010,스와질랜드,2002-02
2002-02-28,1089153,7139,1082014,라트비아,2002-02
2002-02-28,1015460,23745,991715,네팔,2002-02
2002-02-28,1003883,41641,962242,탄자니아,2002-02
2002-02-28,992376,72809,919567,트리니다드 토바고,2002-02
2002-02-28,958858,0,958858,지부티,2002-02
2002-02-28,951510,20653,930857,마다카스카르,2002-02
2002-02-28,946548,1131096,-184548,베닝,2002-02
2002-02-28,894104,1262,892842,유고,2002-02
2002-02-28,874349,5675,868674,모리셔스,2002-02
2002-02-28,865379,174533,690846,짐바브웨,2002-02
2002-02-28,816629,1079865,-263236,볼리비아,2002-02
2002-02-28,749762,21176,728586,모잠비크,2002-02
2002-02-28,674397,64909,609488,에티오피아,2002-02
2002-02-28,636984,0,636984,아루바,2002-02
2002-02-28,631993,1235,630758,앙골라,2002-02
2002-02-28,627783,2034807,-1407024,뉴 칼레도니아,2002-02
2002-02-28,529862,2445,527417,니제르,2002-02
2002-02-28,452583,121068,331515,나미비아,2002-02
2002-02-28,452499,727783,-275284,가봉,2002-02
2002-02-28,449405,1011628,-562223,벨라루스,2002-02
2002-02-28,435879,361722,74157,아이슬란드,2002-02
2002-02-28,405461,98241,307220,세네갈,2002-02
2002-02-28,394477,0,394477,마티니크,2002-02
2002-02-28,384108,8255813,-7871705,파푸아 뉴기니,2002-02
2002-02-28,382544,488,382056,과델로프,2002-02
2002-02-28,375852,200259,175593,카메룬,2002-02
2002-02-28,352085,0,352085,팔라우,2002-02
2002-02-28,351557,2448,349109,불령 폴리네시아,2002-02
2002-02-28,351115,418732,-67617,불령 리유니온 코모도 제도,2002-02
2002-02-28,349452,0,349452,벨리제,2002-02
2002-02-28,331806,0,331806,보츠와나,2002-02
2002-02-28,326647,604411,-277764,잠비아,2002-02
2002-02-28,321941,0,321941,사모아,2002-02
2002-02-28,314447,0,314447,보스니아-헤르체고비나,2002-02
2002-02-28,307073,0,307073,안티가 바부다,2002-02
2002-02-28,305458,0,305458,바하마,2002-02
2002-02-28,278582,6947,271635,바베이도스,2002-02
2002-02-28,277959,0,277959,아제르바이잔,2002-02
2002-02-28,262443,0,262443,아르메니아,2002-02
2002-02-28,212146,6288,205858,모리타니,2002-02
2002-02-28,207421,0,207421,라오스,2002-02
2002-02-28,206805,0,206805,가이아나,2002-02
2002-02-28,197358,31832572,-31635214,콩고,2002-02
2002-02-28,193991,0,193991,말라위,2002-02
2002-02-28,190543,0,190543,마세도니아,2002-02
2002-02-28,190508,0,190508,버뮤다,2002-02
2002-02-28,182977,0,182977,감비아,2002-02
2002-02-28,175882,1459951,-1284069,룩셈부르그,2002-02
2002-02-28,162965,0,162965,세인트 빈센트 그레나딘,2002-02
2002-02-28,146496,0,146496,마이크로네시아,2002-02
2002-02-28,145575,0,145575,소말리아,2002-02
2002-02-28,139505,278522,-139017,조지아,2002-02
2002-02-28,121566,0,121566,영령 캐이맨 군도,2002-02
2002-02-28,119581,105864,13717,네덜란드 열도,2002-02
2002-02-28,118687,294326,-175639,시에라 리온,2002-02
2002-02-28,117786,0,117786,우간다,2002-02
2002-02-28,99469,0,99469,알바니아,2002-02
2002-02-28,98636,0,98636,수리남,2002-02
2002-02-28,97485,0,97485,몰도바,2002-02
2002-02-28,89218,0,89218,불령 가이아나,2002-02
2002-02-28,84792,2625,82167,그레나다,2002-02
2002-02-28,70808,0,70808,중앙아프리카공화국,2002-02
2002-02-28,64629,0,64629,바누아투,2002-02
2002-02-28,63891,3425,60466,몰디브,2002-02
2002-02-28,58802,202,58600,부룬디,2002-02
2002-02-28,40067,89,39978,에리트리아,2002-02
2002-02-28,32870,0,32870,키리바티,2002-02
2002-02-28,29173,0,29173,부르키나 파소,2002-02
2002-02-28,29161,1183687,-1154526,솔로몬 군도,2002-02
2002-02-28,25698,0,25698,쿡 아일랜드,2002-02
2002-02-28,23050,0,23050,세인트 키츠 네비스,2002-02
2002-02-28,20135,0,20135,세인트 루시아,2002-02
2002-02-28,19524,0,19524,세이쉘,2002-02
2002-02-28,16795,1662,15133,프랑스 메트로폴리탄,2002-02
2002-02-28,15120,69416,-54296,리히텐슈타인,2002-02
2002-02-28,12712,0,12712,피트카이른,2002-02
2002-02-28,6186,27067,-20881,안도라,2002-02
2002-02-28,5392,0,5392,지브랄타,2002-02
2002-02-28,1457,0,1457,불령 남부지역,2002-02
2002-02-28,1407,5700,-4293,챠드,2002-02
2002-02-28,566,0,566,메요트,2002-02
2002-02-28,257,0,257,파나마운하지역,2002-02
2002-02-28,192,0,192,미령 버진군도,2002-02
2002-02-28,172,272640,-272468,콩고민주공화국,2002-02
2002-02-28,0,252234,-252234,기네비소,2002-02
2002-02-28,0,777642,-777642,모나코,2002-02
2002-02-28,0,66984,-66984,그린랜드,2002-02
2002-02-28,0,277,-277,나우루,2002-02
2002-02-28,0,144385,-144385,말리,2002-02
2002-02-28,0,57627,-57627,미드웨이 군도,2002-02
2002-02-28,0,25554,-25554,마이너 아우틀링 합중국 군도,2002-02
2002-02-28,0,3452,-3452,세인트 헬레나,2002-02
2002-02-28,0,9264226,-9264226,중립지대,2002-02
2002-02-28,0,6619,-6619,몬트세라트,2002-02
2002-02-28,0,15106,-15106,존스톤 아일랜드,2002-02
2002-02-28,0,119,-119,서사하라,2002-02
2002-02-28,0,109,-109,팔레스타인 해방기구(구),2002-02
2002-03-31,2745682039,1822146537,923535502,미국,2002-03
2002-03-31,1776786999,1303922425,472864574,중국,2002-03
2002-03-31,1194416507,2311765302,-1117348795,일본,2002-03
2002-03-31,849361366,151682024,697679342,홍콩,2002-03
2002-03-31,627451494,397308990,230142504,대만,2002-03
2002-03-31,450474244,393087363,57386881,독일,2002-03
2002-03-31,342747224,196764495,145982729,영국,2002-03
2002-03-31,313137742,261068431,52069311,싱가포르,2002-03
2002-03-31,278233163,335945156,-57711993,말레이시아,2002-03
2002-03-31,264932834,399762853,-134830019,인도네시아,2002-03
2002-03-31,263387070,188176288,75210782,필리핀,2002-03
2002-03-31,233169757,96033197,137136560,네덜란드,2002-03
2002-03-31,220089215,20954001,199135214,멕시코,2002-03
2002-03-31,205276826,159957218,45319608,태국,2002-03
2002-03-31,198428418,315972794,-117544376,아랍에미리트 연합,2002-03
2002-03-31,180546038,181534349,-988311,이탈리아,2002-03
2002-03-31,179417400,706798,178710602,파나마,2002-03
2002-03-31,179374985,142118012,37256973,캐나다,2002-03
2002-03-31,177633966,472685579,-295051613,호주,2002-03
2002-03-31,162112998,31211161,130901837,베트남,2002-03
2002-03-31,144013298,26452851,117560447,스페인,2002-03
2002-03-31,133203636,30209,133173427,마샬군도,2002-03
2002-03-31,119025318,169873836,-50848518,프랑스,2002-03
2002-03-31,114887904,92794446,22093458,브라질,2002-03
2002-03-31,107842471,511279238,-403436767,사우디아라비아,2002-03
2002-03-31,102895148,149786185,-46891037,인도,2002-03
2002-03-31,90765717,9330243,81435474,그리스,2002-03
2002-03-31,83072805,160567495,-77494690,러시아 연방,2002-03
2002-03-31,80828872,116989195,-36160323,이란,2002-03
2002-03-31,72995379,20995,72974384,라이베리아,2002-03
2002-03-31,62211114,45395853,16815261,벨기에,2002-03
2002-03-31,60548588,5644048,54904540,몰타,2002-03
2002-03-31,54947251,1979350,52967901,방글라데시,2002-03
2002-03-31,54896406,3984732,50911674,튀르키예,2002-03
2002-03-31,43237930,28759396,14478534,이스라엘,2002-03
2002-03-31,41173417,66733563,-25560146,아일랜드,2002-03
2002-03-31,39712981,75241529,-35528548,칠레,2002-03
2002-03-31,38977151,2251938,36725213,폴란드,2002-03
2002-03-31,36842769,0,36842769,바하마,2002-03
2002-03-31,36661453,23499124,13162329,오스트리아,2002-03
2002-03-31,34748001,1733360,33014641,시리아,2002-03
2002-03-31,34614988,22757611,11857377,파키스탄,2002-03
2002-03-31,34395452,64395555,-30000103,남아프리카공화국,2002-03
2002-03-31,33223398,25084435,8138963,과테말라,2002-03
2002-03-31,32966704,46262964,-13296260,핀란드,2002-03
2002-03-31,32455226,2057586,30397640,나이지리아,2002-03
2002-03-31,29512433,38449965,-8937532,스웨덴,2002-03
2002-03-31,29070127,8271569,20798558,이집트,2002-03
2002-03-31,28684939,840909,27844030,베네주엘라,2002-03
2002-03-31,27975465,64592948,-36617483,뉴질랜드,2002-03
2002-03-31,27332765,3634706,23698059,콜롬비아,2002-03
2002-03-31,25590156,5189926,20400230,스리랑카,2002-03
2002-03-31,22656397,75019046,-52362649,스위스,2002-03
2002-03-31,22356176,7465821,14890355,헝가리,2002-03
2002-03-31,21320608,0,21320608,이라크,2002-03
2002-03-31,20710988,9245512,11465476,우즈베키스탄,2002-03
2002-03-31,17814708,1672154,16142554,포루투갈,2002-03
2002-03-31,15992475,1048730,14943745,요르단,2002-03
2002-03-31,15311419,18984682,-3673263,페루,2002-03
2002-03-31,15285076,15143455,141621,알제리,2002-03
2002-03-31,14864278,32279282,-17415004,덴마크,2002-03
2002-03-31,14715257,19005967,-4290710,우크라이나,2002-03
2002-03-31,14518105,33791920,-19273815,노르웨이,2002-03
2002-03-31,14197142,148374693,-134177551,쿠웨이트,2002-03
2002-03-31,14107913,299,14107614,아프카니스탄,2002-03
2002-03-31,13469524,24049983,-10580459,에쿠아도르,2002-03
2002-03-31,12994061,436863,12557198,캄보디아,2002-03
2002-03-31,11900349,10300347,1600002,미얀마,2002-03
2002-03-31,10762347,3172530,7589817,루마니아,2002-03
2002-03-31,10639940,68250,10571690,몽골,2002-03
2002-03-31,10437292,950663,9486629,기타국,2002-03
2002-03-31,10147370,43162,10104208,도미니카 공화국,2002-03
2002-03-31,9886859,11100691,-1213832,푸에르토리코,2002-03
2002-03-31,9731347,1802076,7929271,코스타리카,2002-03
2002-03-31,9158565,615889,8542676,온두라스,2002-03
2002-03-31,9030486,19247416,-10216930,수단,2002-03
2002-03-31,8981828,10300104,-1318276,체코공화국,2002-03
2002-03-31,8531367,5446430,3084937,카자흐스탄,2002-03
2002-03-31,8400213,187510368,-179110155,오만,2002-03
2002-03-31,8378913,867085,7511828,리비아,2002-03
2002-03-31,7759352,8436347,-676995,모로코,2002-03
2002-03-31,7568629,0,7568629,니카라과,2002-03
2002-03-31,6945925,97559,6848366,엘살바도르,2002-03
2002-03-31,6447494,365257,6082237,튀니지,2002-03
2002-03-31,6013575,184857014,-178843439,카타르,2002-03
2002-03-31,5957664,2231,5955433,북마리아나 군도,2002-03
2002-03-31,5432669,704119,4728550,레바논,2002-03
2002-03-31,4302990,3680613,622377,바레인,2002-03
2002-03-31,3822706,17937465,-14114759,예맨,2002-03
2002-03-31,3673474,79360281,-75686807,브루나이,2002-03
2002-03-31,3649515,128269,3521246,케냐,2002-03
2002-03-31,3114203,963165,2151038,가나,2002-03
2002-03-31,2994674,710289,2284385,슬로베니아,2002-03
2002-03-31,2918666,1945890,972776,사이프러스,2002-03
2002-03-31,2878458,347447,2531011,마카오,2002-03
2002-03-31,2791785,190682,2601103,크로아티아,2002-03
2002-03-31,2778127,485487,2292640,리투아니아,2002-03
2002-03-31,2565450,299261,2266189,우루과이,2002-03
2002-03-31,2220552,117790,2102762,투르크멘,2002-03
2002-03-31,2193094,617894,1575200,코트디봐르,2002-03
2002-03-31,2164475,20449414,-18284939,아르헨티나,2002-03
2002-03-31,2163532,565666,1597866,토고,2002-03
2002-03-31,2100835,22010,2078825,키르기스스탄,2002-03
2002-03-31,2085993,45799,2040194,파라과이,2002-03
2002-03-31,1925082,0,1925082,도미니카,2002-03
2002-03-31,1855772,102782,1752990,세네갈,2002-03
2002-03-31,1708713,851,1707862,사모아,2002-03
2002-03-31,1647661,708,1646953,유고,2002-03
2002-03-31,1629166,78417,1550749,트리니다드 토바고,2002-03
2002-03-31,1615881,44293,1571588,괌,2002-03
2002-03-31,1496114,1423942,72172,불가리아,2002-03
2002-03-31,1456598,178988,1277610,탄자니아,2002-03
2002-03-31,1451825,2362,1449463,모리셔스,2002-03
2002-03-31,1446947,0,1446947,베닝,2002-03
2002-03-31,1314033,0,1314033,앙골라,2002-03
2002-03-31,1309449,3247922,-1938473,스와질랜드,2002-03
2002-03-31,1231590,0,1231590,불령 리유니온 코모도 제도,2002-03
2002-03-31,1224261,0,1224261,라트비아,2002-03
2002-03-31,1137203,0,1137203,아이티,2002-03
2002-03-31,1117233,50487,1066746,네팔,2002-03
2002-03-31,1065053,85840,979213,자마이카,2002-03
2002-03-31,1010355,12092,998263,과델로프,2002-03
2002-03-31,986931,703448,283483,짐바브웨,2002-03
2002-03-31,973961,151643,822318,에스토니아,2002-03
2002-03-31,955237,1499141,-543904,파푸아 뉴기니,2002-03
2002-03-31,869687,50348,819339,피지,2002-03
2002-03-31,762496,49873,712623,카메룬,2002-03
2002-03-31,757882,26119,731763,에티오피아,2002-03
2002-03-31,678803,25640564,-24961761,콩고,2002-03
2002-03-31,663230,0,663230,마이크로네시아,2002-03
2002-03-31,658584,341863,316721,기니,2002-03
2002-03-31,635089,1064908,-429819,볼리비아,2002-03
2002-03-31,622241,2302016,-1679775,뉴 칼레도니아,2002-03
2002-03-31,612350,1622904,-1010554,룩셈부르그,2002-03
2002-03-31,597843,0,597843,마세도니아,2002-03
2002-03-31,575676,0,575676,마티니크,2002-03
2002-03-31,566966,971716,-404750,타지크,2002-03
2002-03-31,549765,538930,10835,아이슬란드,2002-03
2002-03-31,545194,128400,416794,모잠비크,2002-03
2002-03-31,542531,0,542531,아메리칸 사모아,2002-03
2002-03-31,527319,162425,364894,안도라,2002-03
2002-03-31,520822,37427,483395,라오스,2002-03
2002-03-31,493117,2124830,-1631713,벨라루스,2002-03
2002-03-31,475698,0,475698,지부티,2002-03
2002-03-31,464872,0,464872,아루바,2002-03
2002-03-31,439249,140700,298549,네덜란드 열도,2002-03
2002-03-31,424229,0,424229,말라위,2002-03
2002-03-31,362447,0,362447,아제르바이잔,2002-03
2002-03-31,361289,1620069,-1258780,슬로바키아,2002-03
2002-03-31,353154,50000,303154,보스니아-헤르체고비나,2002-03
2002-03-31,328547,49443,279104,니제르,2002-03
2002-03-31,286066,16090,269976,우간다,2002-03
2002-03-31,278579,21291784,-21013205,가봉,2002-03
2002-03-31,274768,130652,144116,마다카스카르,2002-03
2002-03-31,268211,2272872,-2004661,벨리제,2002-03
2002-03-31,257956,0,257956,수리남,2002-03
2002-03-31,255607,0,255607,레소토,2002-03
2002-03-31,232561,0,232561,보츠와나,2002-03
2002-03-31,220881,9849,211032,바베이도스,2002-03
2002-03-31,212424,92814,119610,잠비아,2002-03
2002-03-31,208875,0,208875,버뮤다,2002-03
2002-03-31,202516,0,202516,감비아,2002-03
2002-03-31,184256,0,184256,불령 폴리네시아,2002-03
2002-03-31,184200,0,184200,영령 캐이맨 군도,2002-03
2002-03-31,176977,0,176977,부탄,2002-03
2002-03-31,174690,0,174690,팔라우,2002-03
2002-03-31,166408,45062,121346,콩고민주공화국,2002-03
2002-03-31,159018,0,159018,불령 가이아나,2002-03
2002-03-31,154235,8146,146089,모리타니,2002-03
2002-03-31,151858,617487,-465629,조지아,2002-03
2002-03-31,143343,0,143343,아르메니아,2002-03
2002-03-31,122768,39585,83183,안티가 바부다,2002-03
2002-03-31,121937,9463,112474,에리트리아,2002-03
2002-03-31,117660,87969,29691,시에라 리온,2002-03
2002-03-31,111264,0,111264,부르키나 파소,2002-03
2002-03-31,108765,25000,83765,바누아투,2002-03
2002-03-31,101411,0,101411,부룬디,2002-03
2002-03-31,81615,0,81615,소말리아,2002-03
2002-03-31,80896,14834,66062,알바니아,2002-03
2002-03-31,61189,1877548,-1816359,솔로몬 군도,2002-03
2002-03-31,52593,0,52593,세인트 루시아,2002-03
2002-03-31,43404,24607,18797,리히텐슈타인,2002-03
2002-03-31,42515,0,42515,포클랜드 군도,2002-03
2002-03-31,34500,0,34500,영령 인도양,2002-03
2002-03-31,33190,0,33190,르완다,2002-03
2002-03-31,31583,0,31583,그레나다,2002-03
2002-03-31,29537,6047,23490,몰디브,2002-03
2002-03-31,28697,118384,-89687,나미비아,2002-03
2002-03-31,27300,0,27300,쿡 아일랜드,2002-03
2002-03-31,27194,631015,-603821,모나코,2002-03
2002-03-31,25252,0,25252,투발루,2002-03
2002-03-31,18900,0,18900,코모로스,2002-03
2002-03-31,14150,0,14150,영령 버진군도,2002-03
2002-03-31,12830,4163,8667,몰도바,2002-03
2002-03-31,10711,0,10711,세인트 빈센트 그레나딘,2002-03
2002-03-31,7872,82,7790,통가,2002-03
2002-03-31,4930,9006,-4076,산마리노,2002-03
2002-03-31,4410,7781,-3371,팔레스타인 해방기구(구),2002-03
2002-03-31,3863,0,3863,지브랄타,2002-03
2002-03-31,3000,0,3000,코스 군도,2002-03
2002-03-31,1239,0,1239,적도 기니,2002-03
2002-03-31,592,547981,-547389,말리,2002-03
2002-03-31,491,6453,-5962,중앙아프리카공화국,2002-03
2002-03-31,350,0,350,챠드,2002-03
2002-03-31,219,976,-757,앙귈라,2002-03
2002-03-31,110,0,110,세이쉘,2002-03
2002-03-31,0,135939,-135939,미드웨이 군도,2002-03
2002-03-31,0,83767,-83767,기네비소,2002-03
2002-03-31,0,6716,-6716,크리스마스 아일랜드,2002-03
2002-03-31,0,242,-242,존스톤 아일랜드,2002-03
2002-03-31,0,10,-10,남조지아 & 남샌드위치 군도,2002-03
2002-03-31,0,1051,-1051,세인트 키츠 네비스,2002-03
2002-03-31,0,503740,-503740,나우루,2002-03
2002-03-31,0,1894,-1894,몬트세라트,2002-03
2002-04-30,2754209141,2010567547,743641594,미국,2002-04
2002-04-30,1857224615,1452717632,404506983,중국,2002-04
2002-04-30,1187275726,2417211425,-1229935699,일본,2002-04
2002-04-30,843910378,142996521,700913857,홍콩,2002-04
2002-04-30,621967273,406066537,215900736,대만,2002-04
2002-04-30,330491190,246139090,84352100,영국,2002-04
2002-04-30,326424019,278733294,47690725,싱가포르,2002-04
2002-04-30,313187913,413082660,-99894747,독일,2002-04
2002-04-30,288515249,302725590,-14210341,말레이시아,2002-04
2002-04-30,274910719,4550326,270360393,그리스,2002-04
2002-04-30,262447162,405401135,-142953973,인도네시아,2002-04
2002-04-30,258463104,156641136,101821968,필리핀,2002-04
2002-04-30,209845339,32225235,177620104,멕시코,2002-04
2002-04-30,205837287,11945617,193891670,파나마,2002-04
2002-04-30,200097991,179980630,20117361,이탈리아,2002-04
2002-04-30,198502079,485402405,-286900326,호주,2002-04
2002-04-30,197481812,34796481,162685331,베트남,2002-04
2002-04-30,183895050,144755327,39139723,태국,2002-04
2002-04-30,181659884,253649496,-71989612,아랍에미리트 연합,2002-04
2002-04-30,176847586,106805939,70041647,네덜란드,2002-04
2002-04-30,174950264,137677145,37273119,캐나다,2002-04
2002-04-30,125160039,32216978,92943061,스페인,2002-04
2002-04-30,114762790,93595872,21166918,브라질,2002-04
2002-04-30,112674524,189918092,-77243568,프랑스,2002-04
2002-04-30,104898293,121432570,-16534277,인도,2002-04
2002-04-30,103212385,615792784,-512580399,사우디아라비아,2002-04
2002-04-30,86168478,139859604,-53691126,러시아 연방,2002-04
2002-04-30,72006471,152354711,-80348240,이란,2002-04
2002-04-30,67658556,55192275,12466281,벨기에,2002-04
2002-04-30,53441486,53759416,-317930,튀르키예,2002-04
2002-04-30,52147799,1612410,50535389,방글라데시,2002-04
2002-04-30,47124611,40396,47084215,라이베리아,2002-04
2002-04-30,47009676,26544278,20465398,핀란드,2002-04
2002-04-30,46417026,4191649,42225377,몰타,2002-04
2002-04-30,43424218,12649456,30774762,과테말라,2002-04
2002-04-30,41848462,32677973,9170489,파키스탄,2002-04
2002-04-30,40141809,28414558,11727251,이스라엘,2002-04
2002-04-30,37911751,71428772,-33517021,칠레,2002-04
2002-04-30,34568601,119398,34449203,사이프러스,2002-04
2002-04-30,34082812,84079787,-49996975,아일랜드,2002-04
2002-04-30,32714409,52706161,-19991752,남아프리카공화국,2002-04
2002-04-30,32709697,74006053,-41296356,스위스,2002-04
2002-04-30,32174487,2849053,29325434,폴란드,2002-04
2002-04-30,29219474,19914728,9304746,알제리,2002-04
2002-04-30,29128738,48260933,-19132195,스웨덴,2002-04
2002-04-30,28598997,13068724,15530273,리비아,2002-04
2002-04-30,26167481,1787402,24380079,이집트,2002-04
2002-04-30,25502003,9471917,16030086,헝가리,2002-04
2002-04-30,24698870,294954,24403916,시리아,2002-04
2002-04-30,24457542,29393005,-4935463,덴마크,2002-04
2002-04-30,24325680,7227863,17097817,나이지리아,2002-04
2002-04-30,24278292,9950338,14327954,우즈베키스탄,2002-04
2002-04-30,23755676,5054613,18701063,콜롬비아,2002-04
2002-04-30,23719080,3538491,20180589,스리랑카,2002-04
2002-04-30,23071058,21890881,1180177,오스트리아,2002-04
2002-04-30,21440993,1230061,20210932,베네주엘라,2002-04
2002-04-30,21410043,387564,21022479,요르단,2002-04
2002-04-30,19782116,63262574,-43480458,뉴질랜드,2002-04
2002-04-30,17702304,297180,17405124,크로아티아,2002-04
2002-04-30,16355329,8221420,8133909,페루,2002-04
2002-04-30,15694315,3113029,12581286,포루투갈,2002-04
2002-04-30,14547890,13595013,952877,우크라이나,2002-04
2002-04-30,14083922,157067515,-142983593,쿠웨이트,2002-04
2002-04-30,13881852,3722500,10159352,루마니아,2002-04
2002-04-30,12591152,29533039,-16941887,에쿠아도르,2002-04
2002-04-30,12537592,2550036,9987556,미얀마,2002-04
2002-04-30,11855140,7351620,4503520,푸에르토리코,2002-04
2002-04-30,11571798,0,11571798,바하마,2002-04
2002-04-30,11565130,1783700,9781430,온두라스,2002-04
2002-04-30,11489497,53644370,-42154873,노르웨이,2002-04
2002-04-30,11178946,2818842,8360104,기타국,2002-04
2002-04-30,11112246,241624,10870622,도미니카 공화국,2002-04
2002-04-30,10243957,204708,10039249,캄보디아,2002-04
2002-04-30,10199914,3247,10196667,아프카니스탄,2002-04
2002-04-30,10187602,988283,9199319,코스타리카,2002-04
2002-04-30,9536824,182487907,-172951083,오만,2002-04
2002-04-30,8836594,7651522,1185072,체코공화국,2002-04
2002-04-30,8385834,5172522,3213312,카자흐스탄,2002-04
2002-04-30,8172462,27067,8145395,북마리아나 군도,2002-04
2002-04-30,7980276,3991160,3989116,모로코,2002-04
2002-04-30,7327354,2315205,5012149,수단,2002-04
2002-04-30,7323742,114049,7209693,튀니지,2002-04
2002-04-30,7184181,51882,7132299,몽골,2002-04
2002-04-30,6960336,133840250,-126879914,카타르,2002-04
2002-04-30,6253548,0,6253548,니카라과,2002-04
2002-04-30,6160620,21195931,-15035311,바레인,2002-04
2002-04-30,5769014,954323,4814691,레바논,2002-04
2002-04-30,5768090,78772,5689318,엘살바도르,2002-04
2002-04-30,5509592,0,5509592,이라크,2002-04
2002-04-30,4895387,26358331,-21462944,아르헨티나,2002-04
2002-04-30,4072432,293512,3778920,우루과이,2002-04
2002-04-30,3882634,1839492,2043142,슬로베니아,2002-04
2002-04-30,3814995,430475,3384520,마카오,2002-04
2002-04-30,3377707,40345,3337362,케냐,2002-04
2002-04-30,3107467,624057,2483410,가나,2002-04
2002-04-30,3072200,8463,3063737,키르기스스탄,2002-04
2002-04-30,2756502,0,2756502,앙골라,2002-04
2002-04-30,2678869,70957159,-68278290,예맨,2002-04
2002-04-30,2511899,829362,1682537,불가리아,2002-04
2002-04-30,2403659,619715,1783944,코트디봐르,2002-04
2002-04-30,2133086,203864,1929222,괌,2002-04
2002-04-30,2093463,0,2093463,토고,2002-04
2002-04-30,1862822,0,1862822,팔라우,2002-04
2002-04-30,1780612,279378,1501234,리투아니아,2002-04
2002-04-30,1675201,33895009,-32219808,브루나이,2002-04
2002-04-30,1643852,0,1643852,아이티,2002-04
2002-04-30,1630756,185002,1445754,카메룬,2002-04
2002-04-30,1593989,46032,1547957,라트비아,2002-04
2002-04-30,1447784,72047,1375737,피지,2002-04
2002-04-30,1354545,47018,1307527,파라과이,2002-04
2002-04-30,1349896,5369,1344527,모리셔스,2002-04
2002-04-30,1284143,67009,1217134,안도라,2002-04
2002-04-30,1218318,1454,1216864,과델로프,2002-04
2002-04-30,1150947,56160,1094787,자마이카,2002-04
2002-04-30,1130322,0,1130322,베닝,2002-04
2002-04-30,1062963,0,1062963,불령 리유니온 코모도 제도,2002-04
2002-04-30,1025648,58054,967594,탄자니아,2002-04
2002-04-30,1021053,471369,549684,에스토니아,2002-04
2002-04-30,1015591,35800,979791,트리니다드 토바고,2002-04
2002-04-30,986941,100213,886728,에티오피아,2002-04
2002-04-30,932253,63627,868626,투르크멘,2002-04
2002-04-30,904353,1341214,-436861,벨라루스,2002-04
2002-04-30,876046,49420254,-48544208,콩고,2002-04
2002-04-30,856809,0,856809,아루바,2002-04
2002-04-30,832821,7722716,-6889895,기니,2002-04
2002-04-30,816459,40784,775675,네팔,2002-04
2002-04-30,815358,265652,549706,세네갈,2002-04
2002-04-30,800892,0,800892,지부티,2002-04
2002-04-30,778247,14277,763970,도미니카,2002-04
2002-04-30,764062,0,764062,아르메니아,2002-04
2002-04-30,698040,34795,663245,짐바브웨,2002-04
2002-04-30,640301,1869545,-1229244,파푸아 뉴기니,2002-04
2002-04-30,619554,611667,7887,아이슬란드,2002-04
2002-04-30,607217,46404,560813,아메리칸 사모아,2002-04
2002-04-30,589557,209928,379629,볼리비아,2002-04
2002-04-30,551157,2272390,-1721233,뉴 칼레도니아,2002-04
2002-04-30,546568,3297491,-2750923,스와질랜드,2002-04
2002-04-30,526346,1485512,-959166,슬로바키아,2002-04
2002-04-30,484451,0,484451,마티니크,2002-04
2002-04-30,414604,0,414604,마세도니아,2002-04
2002-04-30,389451,32922,356529,우간다,2002-04
2002-04-30,370601,1097,369504,유고,2002-04
2002-04-30,361079,0,361079,알바니아,2002-04
2002-04-30,348450,10290,338160,사모아,2002-04
2002-04-30,323117,57977,265140,가봉,2002-04
2002-04-30,311265,916975,-605710,잠비아,2002-04
2002-04-30,300801,25978,274823,벨리제,2002-04
2002-04-30,266921,610685,-343764,타지크,2002-04
2002-04-30,264835,13211,251624,바베이도스,2002-04
2002-04-30,219504,0,219504,모리타니,2002-04
2002-04-30,217316,209,217107,보스니아-헤르체고비나,2002-04
2002-04-30,213980,0,213980,레소토,2002-04
2002-04-30,196535,0,196535,버뮤다,2002-04
2002-04-30,193629,0,193629,안티가 바부다,2002-04
2002-04-30,193619,4775,188844,에리트리아,2002-04
2002-04-30,180799,664739,-483940,룩셈부르그,2002-04
2002-04-30,178574,0,178574,수리남,2002-04
2002-04-30,171018,105360,65658,불령 폴리네시아,2002-04
2002-04-30,166569,0,166569,아제르바이잔,2002-04
2002-04-30,158286,13881,144405,불령 가이아나,2002-04
2002-04-30,154493,249589,-95096,나미비아,2002-04
2002-04-30,145019,155909,-10890,조지아,2002-04
2002-04-30,137492,0,137492,모잠비크,2002-04
2002-04-30,135850,0,135850,보츠와나,2002-04
2002-04-30,135165,10618,124547,콩고민주공화국,2002-04
2002-04-30,130771,0,130771,바누아투,2002-04
2002-04-30,120641,60,120581,마이크로네시아,2002-04
2002-04-30,119733,0,119733,라오스,2002-04
2002-04-30,117141,0,117141,몰디브,2002-04
2002-04-30,96175,0,96175,말라위,2002-04
2002-04-30,94063,1561,92502,가이아나,2002-04
2002-04-30,90740,0,90740,몰도바,2002-04
2002-04-30,82933,694,82239,감비아,2002-04
2002-04-30,80764,0,80764,세인트 빈센트 그레나딘,2002-04
2002-04-30,69604,121345,-51741,리히텐슈타인,2002-04
2002-04-30,68666,436603,-367937,네덜란드 열도,2002-04
2002-04-30,64357,608884,-544527,말리,2002-04
2002-04-30,59511,0,59511,키리바티,2002-04
2002-04-30,54600,22736,31864,쿡 아일랜드,2002-04
2002-04-30,49122,55791,-6669,마다카스카르,2002-04
2002-04-30,41745,0,41745,소말리아,2002-04
2002-04-30,37979,0,37979,통가,2002-04
2002-04-30,37973,0,37973,세이쉘,2002-04
2002-04-30,35960,0,35960,영령 캐이맨 군도,2002-04
2002-04-30,33528,0,33528,그레나다,2002-04
2002-04-30,31429,0,31429,영령 인도양,2002-04
2002-04-30,30948,0,30948,르완다,2002-04
2002-04-30,29982,1148,28834,시에라 리온,2002-04
2002-04-30,29860,322,29538,니제르,2002-04
2002-04-30,20373,4118,16255,부룬디,2002-04
2002-04-30,18933,32955,-14022,미령 버진군도,2002-04
2002-04-30,17195,60650,-43455,팔레스타인 해방기구(구),2002-04
2002-04-30,16428,752936,-736508,솔로몬 군도,2002-04
2002-04-30,15822,0,15822,세인트 루시아,2002-04
2002-04-30,14804,0,14804,중립지대,2002-04
2002-04-30,14177,0,14177,프랑스 메트로폴리탄,2002-04
2002-04-30,11495,0,11495,부탄,2002-04
2002-04-30,11307,29430,-18123,마샬군도,2002-04
2002-04-30,11271,0,11271,부르키나 파소,2002-04
2002-04-30,10959,12731,-1772,중앙아프리카공화국,2002-04
2002-04-30,7510,0,7510,파로에 군도,2002-04
2002-04-30,3650,0,3650,세인트 키츠 네비스,2002-04
2002-04-30,957,0,957,티모르,2002-04
2002-04-30,819,0,819,적도 기니,2002-04
2002-04-30,18,0,18,영령 버진군도,2002-04
2002-04-30,0,547420,-547420,모나코,2002-04
2002-04-30,0,4111,-4111,팔레스타인 해방기구,2002-04
2002-04-30,0,424814,-424814,기네비소,2002-04
2002-04-30,0,57898,-57898,그린랜드,2002-04
2002-04-30,0,147018,-147018,크리스마스 아일랜드,2002-04
2002-04-30,0,177,-177,앙귈라,2002-04
2002-04-30,0,13200,-13200,카보 베르데,2002-04
2002-05-31,2836154720,1981673964,854480756,미국,2002-05
2002-05-31,1941925212,1411442423,530482789,중국,2002-05
2002-05-31,1282811471,2364028853,-1081217382,일본,2002-05
2002-05-31,897000426,156071835,740928591,홍콩,2002-05
2002-05-31,592557763,408197236,184360527,대만,2002-05
2002-05-31,385833887,268006194,117827693,싱가포르,2002-05
2002-05-31,306703904,227698298,79005606,영국,2002-05
2002-05-31,301641676,158322001,143319675,필리핀,2002-05
2002-05-31,287437096,363712914,-76275818,말레이시아,2002-05
2002-05-31,281202443,36011587,245190856,베트남,2002-05
2002-05-31,268036794,468312698,-200275904,독일,2002-05
2002-05-31,261032321,419387331,-158355010,인도네시아,2002-05
2002-05-31,234863930,162212038,72651892,캐나다,2002-05
2002-05-31,228931789,178127772,50804017,이탈리아,2002-05
2002-05-31,200394057,530010656,-329616599,호주,2002-05
2002-05-31,198470453,295045763,-96575310,아랍에미리트 연합,2002-05
2002-05-31,195943944,28194553,167749391,멕시코,2002-05
2002-05-31,195888531,1144047,194744484,그리스,2002-05
2002-05-31,192236354,110535842,81700512,네덜란드,2002-05
2002-05-31,184499804,122259,184377545,라이베리아,2002-05
2002-05-31,175896058,150212920,25683138,태국,2002-05
2002-05-31,162814148,136893168,25920980,이란,2002-05
2002-05-31,155033462,0,155033462,버뮤다,2002-05
2002-05-31,134704256,31612730,103091526,스페인,2002-05
2002-05-31,130594860,95753168,34841692,브라질,2002-05
2002-05-31,121146536,638013374,-516866838,사우디아라비아,2002-05
2002-05-31,110602081,176957257,-66355176,프랑스,2002-05
2002-05-31,99914026,9757755,90156271,몰타,2002-05
2002-05-31,98632810,110362993,-11730183,인도,2002-05
2002-05-31,89651643,0,89651643,마샬군도,2002-05
2002-05-31,88218817,145802384,-57583567,러시아 연방,2002-05
2002-05-31,80093464,1186965,78906499,파나마,2002-05
2002-05-31,75495764,11797194,63698570,튀르키예,2002-05
2002-05-31,70544472,50102884,20441588,벨기에,2002-05
2002-05-31,68234684,53490,68181194,사이프러스,2002-05
2002-05-31,51006491,37838015,13168476,핀란드,2002-05
2002-05-31,46935490,1445178,45490312,방글라데시,2002-05
2002-05-31,45722984,20620842,25102142,과테말라,2002-05
2002-05-31,44543429,25905008,18638421,이스라엘,2002-05
2002-05-31,40015494,34991152,5024342,덴마크,2002-05
2002-05-31,39014262,73827645,-34813383,아일랜드,2002-05
2002-05-31,37872908,71080867,-33207959,칠레,2002-05
2002-05-31,37643680,21513401,16130279,파키스탄,2002-05
2002-05-31,37171233,0,37171233,리비아,2002-05
2002-05-31,37141967,0,37141967,바하마,2002-05
2002-05-31,35555608,583718,34971890,시리아,2002-05
2002-05-31,33755269,54102342,-20347073,남아프리카공화국,2002-05
2002-05-31,33595540,73192924,-39597384,뉴질랜드,2002-05
2002-05-31,30015082,51114101,-21099019,스웨덴,2002-05
2002-05-31,28999356,17659205,11340151,이집트,2002-05
2002-05-31,28788950,30950153,-2161203,오스트리아,2002-05
2002-05-31,28706575,4575102,24131473,폴란드,2002-05
2002-05-31,27473112,3456138,24016974,콜롬비아,2002-05
2002-05-31,27410058,3805854,23604204,스리랑카,2002-05
2002-05-31,26338197,4860483,21477714,나이지리아,2002-05
2002-05-31,24710819,874615,23836204,괌,2002-05
2002-05-31,22550207,4956960,17593247,루마니아,2002-05
2002-05-31,22334009,2524704,19809305,요르단,2002-05
2002-05-31,20356072,9298040,11058032,헝가리,2002-05
2002-05-31,18932253,75399925,-56467672,스위스,2002-05
2002-05-31,17923136,2843415,15079721,포루투갈,2002-05
2002-05-31,15655257,171374,15483883,베네주엘라,2002-05
2002-05-31,15525042,0,15525042,아프카니스탄,2002-05
2002-05-31,15332775,8516654,6816121,우즈베키스탄,2002-05
2002-05-31,15149280,7443180,7706100,우크라이나,2002-05
2002-05-31,14735593,2915323,11820270,미얀마,2002-05
2002-05-31,14555488,252958424,-238402936,쿠웨이트,2002-05
2002-05-31,14043947,26505562,-12461615,페루,2002-05
2002-05-31,13941481,1008296,12933185,온두라스,2002-05
2002-05-31,12560436,7721952,4838484,알제리,2002-05
2002-05-31,12230473,2701392,9529081,기타국,2002-05
2002-05-31,11170858,30664148,-19493290,에쿠아도르,2002-05
2002-05-31,10762426,9886220,876206,푸에르토리코,2002-05
2002-05-31,10438849,230927,10207922,도미니카 공화국,2002-05
2002-05-31,10008144,24823,9983321,북마리아나 군도,2002-05
2002-05-31,9865129,163612974,-153747845,카타르,2002-05
2002-05-31,9207015,3709231,5497784,코스타리카,2002-05
2002-05-31,8832449,3287863,5544586,모로코,2002-05
2002-05-31,8787818,194531,8593287,몽골,2002-05
2002-05-31,8171299,72989367,-64818068,노르웨이,2002-05
2002-05-31,8128442,112939,8015503,캄보디아,2002-05
2002-05-31,7892054,8077436,-185382,카자흐스탄,2002-05
2002-05-31,7879269,143760578,-135881309,오만,2002-05
2002-05-31,7495152,8157954,-662802,체코공화국,2002-05
2002-05-31,7335181,128004,7207177,엘살바도르,2002-05
2002-05-31,6839008,78038,6760970,수단,2002-05
2002-05-31,6406581,92,6406489,니카라과,2002-05
2002-05-31,6269300,876885,5392415,레바논,2002-05
2002-05-31,5984286,1202894,4781392,가나,2002-05
2002-05-31,4463314,1263248,3200066,슬로베니아,2002-05
2002-05-31,4318849,441405,3877444,아이슬란드,2002-05
2002-05-31,4148259,434032,3714227,마카오,2002-05
2002-05-31,4013286,20302862,-16289576,바레인,2002-05
2002-05-31,3724571,56077,3668494,케냐,2002-05
2002-05-31,3649882,173195,3476687,리투아니아,2002-05
2002-05-31,3349760,19593372,-16243612,예맨,2002-05
2002-05-31,2883759,711949,2171810,크로아티아,2002-05
2002-05-31,2871940,257311,2614629,우루과이,2002-05
2002-05-31,2822510,98089,2724421,트리니다드 토바고,2002-05
2002-05-31,2528919,3533129,-1004210,에스토니아,2002-05
2002-05-31,2497670,167,2497503,코트디봐르,2002-05
2002-05-31,2204865,14898145,-12693280,브루나이,2002-05
2002-05-31,2188693,80865,2107828,에티오피아,2002-05
2002-05-31,2152054,1103929,1048125,불가리아,2002-05
2002-05-31,2033348,27163,2006185,파라과이,2002-05
2002-05-31,1933229,55683453,-53750224,아르헨티나,2002-05
2002-05-31,1919478,9,1919469,아이티,2002-05
2002-05-31,1891605,15596,1876009,키르기스스탄,2002-05
2002-05-31,1821980,122521,1699459,카메룬,2002-05
2002-05-31,1682227,372,1681855,아메리칸 사모아,2002-05
2002-05-31,1499087,101507,1397580,모리셔스,2002-05
2002-05-31,1494870,76167,1418703,세네갈,2002-05
2002-05-31,1402119,210074,1192045,탄자니아,2002-05
2002-05-31,1349320,0,1349320,도미니카,2002-05
2002-05-31,1282004,0,1282004,과델로프,2002-05
2002-05-31,1274200,102,1274098,투르크멘,2002-05
2002-05-31,1221239,25382296,-24161057,앙골라,2002-05
2002-05-31,1203833,0,1203833,불령 리유니온 코모도 제도,2002-05
2002-05-31,1180980,62053,1118927,튀니지,2002-05
2002-05-31,1163232,45911,1117321,자마이카,2002-05
2002-05-31,1123414,322899,800515,토고,2002-05
2002-05-31,1068978,23456600,-22387622,콩고,2002-05
2002-05-31,1055967,295739,760228,짐바브웨,2002-05
2002-05-31,1015662,78910,936752,네팔,2002-05
2002-05-31,971932,0,971932,베닝,2002-05
2002-05-31,956453,0,956453,벨리제,2002-05
2002-05-31,951027,0,951027,마티니크,2002-05
2002-05-31,860367,824865,35502,슬로바키아,2002-05
2002-05-31,850191,4096675,-3246484,스와질랜드,2002-05
2002-05-31,848704,399784,448920,기니,2002-05
2002-05-31,761594,37986,723608,라트비아,2002-05
2002-05-31,733844,1731970,-998126,파푸아 뉴기니,2002-05
2002-05-31,687476,914662,-227186,룩셈부르그,2002-05
2002-05-31,632456,0,632456,모잠비크,2002-05
2002-05-31,583270,220687,362583,피지,2002-05
2002-05-31,552799,0,552799,지부티,2002-05
2002-05-31,526629,377975,148654,볼리비아,2002-05
2002-05-31,510485,8800,501685,불령 폴리네시아,2002-05
2002-05-31,510483,1074799,-564316,벨라루스,2002-05
2002-05-31,498401,6447,491954,마이크로네시아,2002-05
2002-05-31,449182,868,448314,마세도니아,2002-05
2002-05-31,448282,4445,443837,유고,2002-05
2002-05-31,441972,0,441972,팔라우,2002-05
2002-05-31,422729,0,422729,아루바,2002-05
2002-05-31,415017,102741,312276,말리,2002-05
2002-05-31,403614,0,403614,라오스,2002-05
2002-05-31,368017,2453800,-2085783,뉴 칼레도니아,2002-05
2002-05-31,358112,0,358112,몰도바,2002-05
2002-05-31,342434,0,342434,이라크,2002-05
2002-05-31,324239,497644,-173405,잠비아,2002-05
2002-05-31,323889,11772,312117,바베이도스,2002-05
2002-05-31,298312,1597,296715,시에라 리온,2002-05
2002-05-31,296210,0,296210,티모르,2002-05
2002-05-31,291919,46121,245798,네덜란드 열도,2002-05
2002-05-31,289765,298741,-8976,안도라,2002-05
2002-05-31,262752,46314,216438,우간다,2002-05
2002-05-31,249925,0,249925,알바니아,2002-05
2002-05-31,235332,0,235332,보스니아-헤르체고비나,2002-05
2002-05-31,233780,0,233780,불령 가이아나,2002-05
2002-05-31,230406,0,230406,사모아,2002-05
2002-05-31,222696,0,222696,아제르바이잔,2002-05
2002-05-31,219174,0,219174,수리남,2002-05
2002-05-31,207289,930,206359,바누아투,2002-05
2002-05-31,207194,695384,-488190,타지크,2002-05
2002-05-31,187270,0,187270,파로에 군도,2002-05
2002-05-31,174707,543865,-369158,가봉,2002-05
2002-05-31,173303,0,173303,챠드,2002-05
2002-05-31,172144,0,172144,안티가 바부다,2002-05
2002-05-31,154760,5449,149311,몰디브,2002-05
2002-05-31,148830,0,148830,부룬디,2002-05
2002-05-31,140974,436889,-295915,조지아,2002-05
2002-05-31,135747,0,135747,에리트리아,2002-05
2002-05-31,131163,0,131163,아르메니아,2002-05
2002-05-31,114640,26182,88458,보츠와나,2002-05
2002-05-31,108857,214793,-105936,부르키나 파소,2002-05
2002-05-31,106524,0,106524,말라위,2002-05
2002-05-31,104990,2991,101999,팔레스타인 해방기구(구),2002-05
2002-05-31,98768,0,98768,세인트 빈센트 그레나딘,2002-05
2002-05-31,97060,17754,79306,마다카스카르,2002-05
2002-05-31,96649,2653,93996,감비아,2002-05
2002-05-31,85868,29068,56800,리히텐슈타인,2002-05
2002-05-31,81475,2166,79309,르완다,2002-05
2002-05-31,67800,0,67800,레소토,2002-05
2002-05-31,66261,0,66261,가이아나,2002-05
2002-05-31,63834,0,63834,미령 버진군도,2002-05
2002-05-31,63003,244132,-181129,나미비아,2002-05
2002-05-31,54081,0,54081,중앙아프리카공화국,2002-05
2002-05-31,50658,10853,39805,영령 캐이맨 군도,2002-05
2002-05-31,48937,58718,-9781,콩고민주공화국,2002-05
2002-05-31,32047,0,32047,중립지대,2002-05
2002-05-31,27300,0,27300,쿡 아일랜드,2002-05
2002-05-31,24989,0,24989,허드 앤 맥도날드 군도,2002-05
2002-05-31,22959,51548,-28589,모리타니,2002-05
2002-05-31,12726,0,12726,부탄,2002-05
2002-05-31,12037,8010,4027,토켈라우,2002-05
2002-05-31,7720,0,7720,투발루,2002-05
2002-05-31,7656,0,7656,캔톤아일랜드,2002-05
2002-05-31,6972,0,6972,세인트 루시아,2002-05
2002-05-31,5291,1709243,-1703952,솔로몬 군도,2002-05
2002-05-31,4826,0,4826,니제르,2002-05
2002-05-31,4738,613498,-608760,모나코,2002-05
2002-05-31,2830,0,2830,그린랜드,2002-05
2002-05-31,1497,1870,-373,프랑스 메트로폴리탄,2002-05
2002-05-31,765,0,765,영령 버진군도,2002-05
2002-05-31,712,0,712,지브랄타,2002-05
2002-05-31,517,0,517,그레나다,2002-05
2002-05-31,402,0,402,적도 기니,2002-05
2002-05-31,0,2645,-2645,존스톤 아일랜드,2002-05
2002-05-31,0,40343,-40343,상토메 프린스페,2002-05
2002-05-31,0,8702,-8702,팔레스타인 해방기구,2002-05
2002-05-31,0,29820,-29820,카보 베르데,2002-05
2002-05-31,0,13565,-13565,세인트 헬레나,2002-05
2002-05-31,0,33031,-33031,크리스마스 아일랜드,2002-05
2002-05-31,0,5600,-5600,안타티카,2002-05
2002-05-31,0,182210,-182210,기네비소,2002-05
2002-06-30,2381101704,1895272676,485829028,미국,2002-06
2002-06-30,1838409871,1280590161,557819710,중국,2002-06
2002-06-30,1220583003,2526388563,-1305805560,일본,2002-06
2002-06-30,938056325,133177969,804878356,홍콩,2002-06
2002-06-30,544107583,370481825,173625758,대만,2002-06
2002-06-30,367678657,261123846,106554811,싱가포르,2002-06
2002-06-30,328346753,444784099,-116437346,독일,2002-06
2002-06-30,307025663,186726705,120298958,영국,2002-06
2002-06-30,280884823,290045240,-9160417,말레이시아,2002-06
2002-06-30,276737293,444697727,-167960434,인도네시아,2002-06
2002-06-30,234804988,137193171,97611817,필리핀,2002-06
2002-06-30,198034906,32540980,165493926,베트남,2002-06
2002-06-30,197702988,456218510,-258515522,호주,2002-06
2002-06-30,191220900,78852894,112368006,네덜란드,2002-06
2002-06-30,181768072,139507175,42260897,캐나다,2002-06
2002-06-30,178847761,311158973,-132311212,아랍에미리트 연합,2002-06
2002-06-30,178118529,181915182,-3796653,이탈리아,2002-06
2002-06-30,177818433,20706839,157111594,멕시코,2002-06
2002-06-30,173450192,155540595,17909597,태국,2002-06
2002-06-30,162169439,91661,162077778,나이지리아,2002-06
2002-06-30,155542778,1569325,153973453,그리스,2002-06
2002-06-30,148670362,0,148670362,바하마,2002-06
2002-06-30,141542093,1550024,139992069,파나마,2002-06
2002-06-30,132538215,92182144,40356071,브라질,2002-06
2002-06-30,129862151,94926509,34935642,인도,2002-06
2002-06-30,115222232,166162455,-50940223,프랑스,2002-06
2002-06-30,102332847,632110379,-529777532,사우디아라비아,2002-06
2002-06-30,101900671,32157703,69742968,스페인,2002-06
2002-06-30,92848367,4698141,88150226,튀르키예,2002-06
2002-06-30,89680352,70060697,19619655,이란,2002-06
2002-06-30,80062981,152936874,-72873893,러시아 연방,2002-06
2002-06-30,76279876,88482,76191394,사이프러스,2002-06
2002-06-30,74173914,52417419,21756495,벨기에,2002-06
2002-06-30,47571422,1552368,46019054,몰타,2002-06
2002-06-30,44908710,62950369,-18041659,스위스,2002-06
2002-06-30,41128777,12372944,28755833,과테말라,2002-06
2002-06-30,38886785,32358751,6528034,이스라엘,2002-06
2002-06-30,38490646,54003694,-15513048,아일랜드,2002-06
2002-06-30,37713286,1498992,36214294,방글라데시,2002-06
2002-06-30,33354235,32717173,637062,핀란드,2002-06
2002-06-30,33197761,38956204,-5758443,남아프리카공화국,2002-06
2002-06-30,31466349,25197755,6268594,오스트리아,2002-06
2002-06-30,30697300,40499541,-9802241,스웨덴,2002-06
2002-06-30,29956442,2191743,27764699,스리랑카,2002-06
2002-06-30,29696139,57566840,-27870701,칠레,2002-06
2002-06-30,27113144,3375750,23737394,콜롬비아,2002-06
2002-06-30,27093611,19257765,7835846,파키스탄,2002-06
2002-06-30,26925350,225085,26700265,라이베리아,2002-06
2002-06-30,26567769,2394602,24173167,이집트,2002-06
2002-06-30,24370837,2605726,21765111,폴란드,2002-06
2002-06-30,23548343,10262647,13285696,헝가리,2002-06
2002-06-30,21780133,164099,21616034,괌,2002-06
2002-06-30,21727565,54681408,-32953843,뉴질랜드,2002-06
2002-06-30,20351920,12088,20339832,시리아,2002-06
2002-06-30,19145928,8752560,10393368,우즈베키스탄,2002-06
2002-06-30,17270264,277750,16992514,요르단,2002-06
2002-06-30,15985502,3910347,12075155,베네주엘라,2002-06
2002-06-30,15366450,62354,15304096,리비아,2002-06
2002-06-30,14620161,22943593,-8323432,페루,2002-06
2002-06-30,13781521,1477924,12303597,포루투갈,2002-06
2002-06-30,13327204,12082013,1245191,미얀마,2002-06
2002-06-30,12986246,2554531,10431715,루마니아,2002-06
2002-06-30,12403073,16653873,-4250800,에쿠아도르,2002-06
2002-06-30,11999743,3391505,8608238,도미니카 공화국,2002-06
2002-06-30,11890107,99133,11790974,수단,2002-06
2002-06-30,11544861,32612827,-21067966,덴마크,2002-06
2002-06-30,11117917,212992606,-201874689,쿠웨이트,2002-06
2002-06-30,11092778,1433037,9659741,온두라스,2002-06
2002-06-30,10749161,16037301,-5288140,알제리,2002-06
2002-06-30,10634346,1966950,8667396,코스타리카,2002-06
2002-06-30,10259500,5613994,4645506,카자흐스탄,2002-06
2002-06-30,9761100,0,9761100,아프카니스탄,2002-06
2002-06-30,9710836,8573667,1137169,모로코,2002-06
2002-06-30,9531273,141383,9389890,캄보디아,2002-06
2002-06-30,9193729,26463609,-17269880,우크라이나,2002-06
2002-06-30,9044504,50189185,-41144681,노르웨이,2002-06
2002-06-30,8103220,2367280,5735940,기타국,2002-06
2002-06-30,7844072,358293,7485779,몽골,2002-06
2002-06-30,7404945,8778370,-1373425,푸에르토리코,2002-06
2002-06-30,7060731,107037154,-99976423,카타르,2002-06
2002-06-30,6894613,11362,6883251,북마리아나 군도,2002-06
2002-06-30,6882095,7075667,-193572,체코공화국,2002-06
2002-06-30,6855955,113,6855842,니카라과,2002-06
2002-06-30,6640851,110170766,-103529915,오만,2002-06
2002-06-30,6179423,156569,6022854,튀니지,2002-06
2002-06-30,6169030,9271856,-3102826,바레인,2002-06
2002-06-30,5794074,942120,4851954,슬로베니아,2002-06
2002-06-30,5645585,55579,5590006,엘살바도르,2002-06
2002-06-30,5145152,478736,4666416,레바논,2002-06
2002-06-30,4156669,245574,3911095,마카오,2002-06
2002-06-30,3776480,30208213,-26431733,예맨,2002-06
2002-06-30,3400980,531430,2869550,케냐,2002-06
2002-06-30,3227445,26643368,-23415923,앙골라,2002-06
2002-06-30,3131305,422751,2708554,가나,2002-06
2002-06-30,2733738,31194567,-28460829,아르헨티나,2002-06
2002-06-30,2731607,285070,2446537,리투아니아,2002-06
2002-06-30,2703125,427824,2275301,크로아티아,2002-06
2002-06-30,2607258,437684,2169574,우루과이,2002-06
2002-06-30,2560819,55022,2505797,에티오피아,2002-06
2002-06-30,2404398,14139,2390259,파라과이,2002-06
2002-06-30,2265832,96534,2169298,투르크멘,2002-06
2002-06-30,2011620,2808857,-797237,파푸아 뉴기니,2002-06
2002-06-30,1982016,32868,1949148,탄자니아,2002-06
2002-06-30,1971035,862,1970173,아이티,2002-06
2002-06-30,1949205,0,1949205,코트디봐르,2002-06
2002-06-30,1684447,1316147,368300,불가리아,2002-06
2002-06-30,1657767,6919968,-5262201,브루나이,2002-06
2002-06-30,1424108,4212,1419896,아메리칸 사모아,2002-06
2002-06-30,1405693,7700,1397993,키르기스스탄,2002-06
2002-06-30,1278476,825349,453127,에스토니아,2002-06
2002-06-30,1250414,61670,1188744,라트비아,2002-06
2002-06-30,1249305,0,1249305,베닝,2002-06
2002-06-30,1239815,0,1239815,시에라 리온,2002-06
2002-06-30,1164913,0,1164913,이라크,2002-06
2002-06-30,1149509,101068,1048441,짐바브웨,2002-06
2002-06-30,1105103,52939,1052164,트리니다드 토바고,2002-06
2002-06-30,1060435,39882,1020553,모리셔스,2002-06
2002-06-30,1059532,6075855,-5016323,스와질랜드,2002-06
2002-06-30,1056635,0,1056635,챠드,2002-06
2002-06-30,1030888,39766,991122,네팔,2002-06
2002-06-30,1022312,18522,1003790,피지,2002-06
2002-06-30,963234,62974,900260,자마이카,2002-06
2002-06-30,944854,227320,717534,세네갈,2002-06
2002-06-30,857159,3070,854089,유고,2002-06
2002-06-30,768266,155871,612395,토고,2002-06
2002-06-30,746895,107686,639209,볼리비아,2002-06
2002-06-30,744610,618804,125806,슬로바키아,2002-06
2002-06-30,728528,1144741,-416213,벨라루스,2002-06
2002-06-30,687650,0,687650,불령 리유니온 코모도 제도,2002-06
2002-06-30,674876,95013,579863,카메룬,2002-06
2002-06-30,599783,12536732,-11936949,기니,2002-06
2002-06-30,596813,525916,70897,아이슬란드,2002-06
2002-06-30,518821,0,518821,마티니크,2002-06
2002-06-30,496148,0,496148,과델로프,2002-06
2002-06-30,473648,0,473648,우간다,2002-06
2002-06-30,438117,21441546,-21003429,콩고,2002-06
2002-06-30,399321,0,399321,지부티,2002-06
2002-06-30,358888,0,358888,팔라우,2002-06
2002-06-30,316329,0,316329,도미니카,2002-06
2002-06-30,286373,18200,268173,불령 폴리네시아,2002-06
2002-06-30,269489,0,269489,마이크로네시아,2002-06
2002-06-30,269380,0,269380,레소토,2002-06
2002-06-30,269290,0,269290,알바니아,2002-06
2002-06-30,268132,2311806,-2043674,룩셈부르그,2002-06
2002-06-30,263397,0,263397,라오스,2002-06
2002-06-30,257251,0,257251,소말리아,2002-06
2002-06-30,253156,0,253156,사모아,2002-06
2002-06-30,246597,747799,-501202,가봉,2002-06
2002-06-30,241788,0,241788,마세도니아,2002-06
2002-06-30,228453,2601961,-2373508,뉴 칼레도니아,2002-06
2002-06-30,208072,0,208072,수리남,2002-06
2002-06-30,201121,0,201121,말라위,2002-06
2002-06-30,199155,298500,-99345,타지크,2002-06
2002-06-30,167452,0,167452,벨리제,2002-06
2002-06-30,160853,0,160853,부탄,2002-06
2002-06-30,159393,0,159393,불령 가이아나,2002-06
2002-06-30,158274,0,158274,몰도바,2002-06
2002-06-30,155085,68050,87035,콩고민주공화국,2002-06
2002-06-30,155058,0,155058,가이아나,2002-06
2002-06-30,153015,123225,29790,나미비아,2002-06
2002-06-30,152777,500,152277,바베이도스,2002-06
2002-06-30,150059,0,150059,아제르바이잔,2002-06
2002-06-30,142458,3234,139224,몰디브,2002-06
2002-06-30,140043,75,139968,니제르,2002-06
2002-06-30,129470,141482,-12012,안티가 바부다,2002-06
2002-06-30,116460,0,116460,보스니아-헤르체고비나,2002-06
2002-06-30,115176,7730,107446,에리트리아,2002-06
2002-06-30,114341,676686,-562345,잠비아,2002-06
2002-06-30,113059,36939,76120,마다카스카르,2002-06
2002-06-30,106298,19034,87264,보츠와나,2002-06
2002-06-30,105090,0,105090,아루바,2002-06
2002-06-30,104066,53558,50508,모잠비크,2002-06
2002-06-30,102506,41673,60833,마샬군도,2002-06
2002-06-30,87559,28075,59484,네덜란드 열도,2002-06
2002-06-30,84023,1958,82065,산마리노,2002-06
2002-06-30,81834,109,81725,버뮤다,2002-06
2002-06-30,71883,0,71883,아르메니아,2002-06
2002-06-30,64432,312098,-247666,조지아,2002-06
2002-06-30,63481,634681,-571200,말리,2002-06
2002-06-30,59378,0,59378,감비아,2002-06
2002-06-30,58093,25000,33093,바누아투,2002-06
2002-06-30,51165,0,51165,세이쉘,2002-06
2002-06-30,49154,0,49154,모리타니,2002-06
2002-06-30,41036,757186,-716150,부르키나 파소,2002-06
2002-06-30,37440,0,37440,보빗군도,2002-06
2002-06-30,32772,0,32772,세인트 루시아,2002-06
2002-06-30,32748,0,32748,부룬디,2002-06
2002-06-30,32368,792440,-760072,솔로몬 군도,2002-06
2002-06-30,28167,0,28167,그레나다,2002-06
2002-06-30,28020,0,28020,통가,2002-06
2002-06-30,26764,15146,11618,리히텐슈타인,2002-06
2002-06-30,25910,0,25910,영령 캐이맨 군도,2002-06
2002-06-30,16875,62819,-45944,팔레스타인 해방기구(구),2002-06
2002-06-30,14715,0,14715,세인트 빈센트 그레나딘,2002-06
2002-06-30,10956,0,10956,키리바티,2002-06
2002-06-30,10098,582909,-572811,모나코,2002-06
2002-06-30,9405,11556,-2151,세인트 키츠 네비스,2002-06
2002-06-30,8364,3305,5059,안도라,2002-06
2002-06-30,7055,0,7055,티모르,2002-06
2002-06-30,6297,0,6297,프랑스 메트로폴리탄,2002-06
2002-06-30,4843,0,4843,투발루,2002-06
2002-06-30,2765,50371,-47606,그린랜드,2002-06
2002-06-30,1773,9035,-7262,미령 버진군도,2002-06
2002-06-30,768,0,768,앙귈라,2002-06
2002-06-30,517,0,517,웨이크 아일랜드,2002-06
2002-06-30,396,0,396,교황청,2002-06
2002-06-30,378,42,336,쿡 아일랜드,2002-06
2002-06-30,332,0,332,나우루,2002-06
2002-06-30,122,0,122,메요트,2002-06
2002-06-30,0,293151,-293151,기네비소,2002-06
2002-06-30,0,911,-911,존스톤 아일랜드,2002-06
2002-06-30,0,0,0,안타티카,2002-06
2002-06-30,0,4717,-4717,크리스마스 아일랜드,2002-06
2002-06-30,0,27583,-27583,팔레스타인 해방기구,2002-06
2002-06-30,0,15600,-15600,카보 베르데,2002-06
2002-07-31,2708340089,2212835444,495504645,미국,2002-07
2002-07-31,2010716667,1433386736,577329931,중국,2002-07
2002-07-31,1302584242,2648188560,-1345604318,일본,2002-07
2002-07-31,903056331,100404996,802651335,홍콩,2002-07
2002-07-31,547621085,394605103,153015982,대만,2002-07
2002-07-31,368487386,308087290,60400096,싱가포르,2002-07
2002-07-31,324621858,499634252,-175012394,독일,2002-07
2002-07-31,312094483,368845271,-56750788,인도네시아,2002-07
2002-07-31,289455529,215631088,73824441,영국,2002-07
2002-07-31,288145073,277786690,10358383,말레이시아,2002-07
2002-07-31,243795659,137179052,106616607,필리핀,2002-07
2002-07-31,221185814,335428312,-114242498,아랍에미리트 연합,2002-07
2002-07-31,202319360,152363215,49956145,캐나다,2002-07
2002-07-31,202117339,97128051,104989288,네덜란드,2002-07
2002-07-31,199073416,237930458,-38857042,이탈리아,2002-07
2002-07-31,195662566,133885557,61777009,태국,2002-07
2002-07-31,191382748,26910042,164472706,멕시코,2002-07
2002-07-31,168237505,37955307,130282198,베트남,2002-07
2002-07-31,167105177,513175948,-346070771,호주,2002-07
2002-07-31,161936425,173254766,-11318341,프랑스,2002-07
2002-07-31,147800091,1874111,145925980,그리스,2002-07
2002-07-31,139660610,120,139660490,라이베리아,2002-07
2002-07-31,108994439,81893780,27100659,인도,2002-07
2002-07-31,104196848,39036993,65159855,스페인,2002-07
2002-07-31,102335368,190071,102145297,파나마,2002-07
2002-07-31,102300204,655963470,-553663266,사우디아라비아,2002-07
2002-07-31,100141556,77849093,22292463,브라질,2002-07
2002-07-31,87549611,8957305,78592306,튀르키예,2002-07
2002-07-31,86772971,106975687,-20202716,이란,2002-07
2002-07-31,84981984,288456336,-203474352,러시아 연방,2002-07
2002-07-31,76535023,69281536,7253487,벨기에,2002-07
2002-07-31,65722904,92358968,-26636064,스위스,2002-07
2002-07-31,53651441,54,53651387,바하마,2002-07
2002-07-31,50546555,29605163,20941392,핀란드,2002-07
2002-07-31,48349164,53557339,-5208175,칠레,2002-07
2002-07-31,44558967,30119870,14439097,오스트리아,2002-07
2002-07-31,43378536,8612525,34766011,과테말라,2002-07
2002-07-31,41062241,42759471,-1697230,이스라엘,2002-07
2002-07-31,40861350,71489052,-30627702,아일랜드,2002-07
2002-07-31,38982437,56504701,-17522264,스웨덴,2002-07
2002-07-31,37627684,23154774,14472910,파키스탄,2002-07
2002-07-31,36372146,2162377,34209769,방글라데시,2002-07
2002-07-31,35440842,52438587,-16997745,남아프리카공화국,2002-07
2002-07-31,33834401,1668848,32165553,나이지리아,2002-07
2002-07-31,29385338,8624497,20760841,헝가리,2002-07
2002-07-31,28542337,11347469,17194868,이집트,2002-07
2002-07-31,25304193,2500239,22803954,루마니아,2002-07
2002-07-31,25070412,3135913,21934499,폴란드,2002-07
2002-07-31,24805186,3599200,21205986,스리랑카,2002-07
2002-07-31,24667266,45310484,-20643218,덴마크,2002-07
2002-07-31,24446534,71135346,-46688812,뉴질랜드,2002-07
2002-07-31,24426091,5537031,18889060,콜롬비아,2002-07
2002-07-31,23430632,184306,23246326,시리아,2002-07
2002-07-31,20527399,10286850,10240549,페루,2002-07
2002-07-31,19633780,13245299,6388481,우크라이나,2002-07
2002-07-31,16241259,275615,15965644,요르단,2002-07
2002-07-31,15945733,2307970,13637763,포루투갈,2002-07
2002-07-31,14919898,16495398,-1575500,에쿠아도르,2002-07
2002-07-31,14597191,18288279,-3691088,알제리,2002-07
2002-07-31,14279877,191620,14088257,도미니카 공화국,2002-07
2002-07-31,13747610,113090823,-99343213,쿠웨이트,2002-07
2002-07-31,13693735,78197164,-64503429,노르웨이,2002-07
2002-07-31,12816379,77177,12739202,리비아,2002-07
2002-07-31,12215617,1381384,10834233,온두라스,2002-07
2002-07-31,12047887,5753226,6294661,베네주엘라,2002-07
2002-07-31,11170465,2578736,8591729,푸에르토리코,2002-07
2002-07-31,10672295,8447771,2224524,우즈베키스탄,2002-07
2002-07-31,10580272,10292361,287911,체코공화국,2002-07
2002-07-31,10233204,115714300,-105481096,카타르,2002-07
2002-07-31,9985508,3186130,6799378,기타국,2002-07
2002-07-31,8943440,70379,8873061,북마리아나 군도,2002-07
2002-07-31,8913648,140644,8773004,캄보디아,2002-07
2002-07-31,8862299,4820703,4041596,카자흐스탄,2002-07
2002-07-31,8588961,2269005,6319956,미얀마,2002-07
2002-07-31,8292548,0,8292548,아프카니스탄,2002-07
2002-07-31,8248275,100898687,-92650412,오만,2002-07
2002-07-31,8204664,1483070,6721594,코스타리카,2002-07
2002-07-31,7728532,315687,7412845,몽골,2002-07
2002-07-31,6774373,11374170,-4599797,바레인,2002-07
2002-07-31,6746739,65388877,-58642138,예맨,2002-07
2002-07-31,6335479,24678,6310801,니카라과,2002-07
2002-07-31,5817702,85458,5732244,엘살바도르,2002-07
2002-07-31,5426957,807533,4619424,레바논,2002-07
2002-07-31,5318598,2547692,2770906,수단,2002-07
2002-07-31,5209940,0,5209940,이라크,2002-07
2002-07-31,5154124,1330210,3823914,슬로베니아,2002-07
2002-07-31,4814653,2767168,2047485,모로코,2002-07
2002-07-31,4068796,15208,4053588,케냐,2002-07
2002-07-31,3789669,619672,3169997,마카오,2002-07
2002-07-31,3786226,300660,3485566,크로아티아,2002-07
2002-07-31,3695338,846678,2848660,가나,2002-07
2002-07-31,3235873,36621093,-33385220,아르헨티나,2002-07
2002-07-31,3160056,4760538,-1600482,리투아니아,2002-07
2002-07-31,2819792,30930658,-28110866,브루나이,2002-07
2002-07-31,2665641,836335,1829306,우루과이,2002-07
2002-07-31,2583946,30695,2553251,코트디봐르,2002-07
2002-07-31,2554757,1483599,1071158,불가리아,2002-07
2002-07-31,2507747,159970,2347777,튀니지,2002-07
2002-07-31,2454250,691054,1763196,에스토니아,2002-07
2002-07-31,2236212,0,2236212,아메리칸 사모아,2002-07
2002-07-31,1874247,34149,1840098,모리셔스,2002-07
2002-07-31,1812276,68840,1743436,라트비아,2002-07
2002-07-31,1781056,28392,1752664,파라과이,2002-07
2002-07-31,1659788,198264,1461524,사이프러스,2002-07
2002-07-31,1586271,34134,1552137,네팔,2002-07
2002-07-31,1565694,277680,1288014,세네갈,2002-07
2002-07-31,1541017,200,1540817,도미니카,2002-07
2002-07-31,1512921,134312,1378609,괌,2002-07
2002-07-31,1497040,41731,1455309,키르기스스탄,2002-07
2002-07-31,1488527,188622,1299905,에티오피아,2002-07
2002-07-31,1442594,0,1442594,불령 리유니온 코모도 제도,2002-07
2002-07-31,1395148,16931,1378217,트리니다드 토바고,2002-07
2002-07-31,1372288,27359285,-25986997,앙골라,2002-07
2002-07-31,1367210,9920,1357290,탄자니아,2002-07
2002-07-31,1245937,1286803,-40866,몰타,2002-07
2002-07-31,1220456,273,1220183,베닝,2002-07
2002-07-31,1167045,96825,1070220,투르크멘,2002-07
2002-07-31,1099143,25589151,-24490008,콩고,2002-07
2002-07-31,1076519,2535566,-1459047,뉴 칼레도니아,2002-07
2002-07-31,1061755,633331,428424,슬로바키아,2002-07
2002-07-31,1016011,138,1015873,토고,2002-07
2002-07-31,1012791,16324858,-15312067,스와질랜드,2002-07
2002-07-31,1001522,77487,924035,유고,2002-07
2002-07-31,980166,260353,719813,카메룬,2002-07
2002-07-31,956406,527,955879,아이티,2002-07
2002-07-31,887544,0,887544,마티니크,2002-07
2002-07-31,843956,143082,700874,짐바브웨,2002-07
2002-07-31,800757,211066,589691,아이슬란드,2002-07
2002-07-31,781867,13247,768620,레소토,2002-07
2002-07-31,740295,15668,724627,볼리비아,2002-07
2002-07-31,740022,2492660,-1752638,파푸아 뉴기니,2002-07
2002-07-31,737695,1290,736405,라오스,2002-07
2002-07-31,669664,878000,-208336,가봉,2002-07
2002-07-31,650082,0,650082,과델로프,2002-07
2002-07-31,648971,3821343,-3172372,자마이카,2002-07
2002-07-31,620596,6125,614471,우간다,2002-07
2002-07-31,616586,0,616586,지부티,2002-07
2002-07-31,565785,23091,542694,모잠비크,2002-07
2002-07-31,543481,32886,510595,피지,2002-07
2002-07-31,540032,505236,34796,벨리제,2002-07
2002-07-31,533966,0,533966,불령 가이아나,2002-07
2002-07-31,525907,2633650,-2107743,벨라루스,2002-07
2002-07-31,492737,370,492367,아제르바이잔,2002-07
2002-07-31,396099,0,396099,아루바,2002-07
2002-07-31,394743,272338,122405,타지크,2002-07
2002-07-31,369324,14118113,-13748789,기니,2002-07
2002-07-31,362706,0,362706,마이크로네시아,2002-07
2002-07-31,325281,18955,306326,보스니아-헤르체고비나,2002-07
2002-07-31,322506,2648,319858,몰도바,2002-07
2002-07-31,320933,99840,221093,불령 폴리네시아,2002-07
2002-07-31,313365,1738358,-1424993,룩셈부르그,2002-07
2002-07-31,310371,0,310371,팔라우,2002-07
2002-07-31,287915,53688,234227,영령 버진군도,2002-07
2002-07-31,241462,2045,239417,알바니아,2002-07
2002-07-31,231246,21212,210034,모리타니,2002-07
2002-07-31,219762,16611,203151,바베이도스,2002-07
2002-07-31,212229,0,212229,시에라 리온,2002-07
2002-07-31,197115,1416798,-1219683,조지아,2002-07
2002-07-31,184995,54496,130499,콩고민주공화국,2002-07
2002-07-31,160337,1588250,-1427913,솔로몬 군도,2002-07
2002-07-31,159256,0,159256,말라위,2002-07
2002-07-31,157543,0,157543,사모아,2002-07
2002-07-31,143385,2539,140846,수리남,2002-07
2002-07-31,130381,224900,-94519,나미비아,2002-07
2002-07-31,126693,104220,22473,말리,2002-07
2002-07-31,125816,0,125816,아르메니아,2002-07
2002-07-31,114341,0,114341,마세도니아,2002-07
2002-07-31,110382,0,110382,가이아나,2002-07
2002-07-31,109873,0,109873,소말리아,2002-07
2002-07-31,107546,7891,99655,마다카스카르,2002-07
2002-07-31,107272,0,107272,세인트 키츠 네비스,2002-07
2002-07-31,102072,0,102072,마샬군도,2002-07
2002-07-31,83208,378939,-295731,잠비아,2002-07
2002-07-31,81099,0,81099,에리트리아,2002-07
2002-07-31,80527,0,80527,미령 버진군도,2002-07
2002-07-31,76996,198674,-121678,세이쉘,2002-07
2002-07-31,75923,0,75923,부탄,2002-07
2002-07-31,68621,0,68621,그레나다,2002-07
2002-07-31,64412,109,64303,버뮤다,2002-07
2002-07-31,64293,0,64293,중립지대,2002-07
2002-07-31,63163,0,63163,바누아투,2002-07
2002-07-31,59348,0,59348,쿡 아일랜드,2002-07
2002-07-31,58083,0,58083,안티가 바부다,2002-07
2002-07-31,55907,0,55907,감비아,2002-07
2002-07-31,55425,38817,16608,팔레스타인 해방기구(구),2002-07
2002-07-31,53568,8,53560,부룬디,2002-07
2002-07-31,49939,28235,21704,보츠와나,2002-07
2002-07-31,39226,8520,30706,네덜란드 열도,2002-07
2002-07-31,36006,0,36006,투발루,2002-07
2002-07-31,29399,90,29309,영령 캐이맨 군도,2002-07
2002-07-31,24450,1232672,-1208222,나우루,2002-07
2002-07-31,22034,698403,-676369,모나코,2002-07
2002-07-31,16051,0,16051,세인트 루시아,2002-07
2002-07-31,15259,0,15259,르완다,2002-07
2002-07-31,14861,0,14861,왈라스 & 퓨투나 군도,2002-07
2002-07-31,12792,541,12251,세인트 빈센트 그레나딘,2002-07
2002-07-31,7999,1680,6319,몰디브,2002-07
2002-07-31,7215,861,6354,니제르,2002-07
2002-07-31,6112,9251,-3139,챠드,2002-07
2002-07-31,5283,0,5283,지브랄타,2002-07
2002-07-31,4703,0,4703,중앙아프리카공화국,2002-07
2002-07-31,3603,0,3603,파나마운하지역,2002-07
2002-07-31,1749,18440,-16691,프랑스 메트로폴리탄,2002-07
2002-07-31,1360,76467,-75107,리히텐슈타인,2002-07
2002-07-31,113,50192,-50079,안도라,2002-07
2002-07-31,0,27,-27,마이너 아우틀링 합중국 군도,2002-07
2002-07-31,0,3411,-3411,기네비소,2002-07
2002-07-31,0,89887,-89887,그린랜드,2002-07
2002-07-31,0,80537,-80537,크리스마스 아일랜드,2002-07
2002-07-31,0,3375,-3375,교황청,2002-07
2002-07-31,0,11500,-11500,토켈라우,2002-07
2002-07-31,0,10618,-10618,통가,2002-07
2002-07-31,0,8956,-8956,팔레스타인 해방기구,2002-07
2002-07-31,0,80,-80,허드 앤 맥도날드 군도,2002-07
2002-07-31,0,757113,-757113,부르키나 파소,2002-07
2002-07-31,0,15948,-15948,코스 군도,2002-07
2002-08-31,2745114596,1914981394,830133202,미국,2002-08
2002-08-31,2034950003,1544184623,490765380,중국,2002-08
2002-08-31,1244127422,2543726912,-1299599490,일본,2002-08
2002-08-31,856444734,120737978,735706756,홍콩,2002-08
2002-08-31,531372006,399886548,131485458,대만,2002-08
2002-08-31,418078341,223887679,194190662,영국,2002-08
2002-08-31,396949077,285449093,111499984,싱가포르,2002-08
2002-08-31,324282092,536800193,-212518101,독일,2002-08
2002-08-31,283294988,309640963,-26345975,말레이시아,2002-08
2002-08-31,274066883,351749194,-77682311,인도네시아,2002-08
2002-08-31,233599737,151612981,81986756,필리핀,2002-08
2002-08-31,224184828,97631348,126553480,네덜란드,2002-08
2002-08-31,215957876,46879293,169078583,파나마,2002-08
2002-08-31,210068606,88129984,121938622,노르웨이,2002-08
2002-08-31,209541169,140956352,68584817,캐나다,2002-08
2002-08-31,190971565,534468923,-343497358,호주,2002-08
2002-08-31,188396641,238263754,-49867113,아랍에미리트 연합,2002-08
2002-08-31,171441657,28731343,142710314,멕시코,2002-08
2002-08-31,170654120,138513201,32140919,태국,2002-08
2002-08-31,170608783,42926704,127682079,베트남,2002-08
2002-08-31,163111635,205270525,-42158890,이탈리아,2002-08
2002-08-31,157996110,0,157996110,버뮤다,2002-08
2002-08-31,129613514,40373019,89240495,스페인,2002-08
2002-08-31,127409963,85,127409878,바하마,2002-08
2002-08-31,121466835,173994096,-52527261,프랑스,2002-08
2002-08-31,113791620,110354694,3436926,인도,2002-08
2002-08-31,107728823,104322174,3406649,브라질,2002-08
2002-08-31,100608441,667766606,-567158165,사우디아라비아,2002-08
2002-08-31,89354169,211774852,-122420683,러시아 연방,2002-08
2002-08-31,84845885,102066926,-17221041,이란,2002-08
2002-08-31,82163875,196721,81967154,라이베리아,2002-08
2002-08-31,75833604,6206104,69627500,튀르키예,2002-08
2002-08-31,71785269,5163813,66621456,몰타,2002-08
2002-08-31,70324463,1393706,68930757,그리스,2002-08
2002-08-31,60016071,55780006,4236065,벨기에,2002-08
2002-08-31,54101763,0,54101763,리비아,2002-08
2002-08-31,53274345,35267483,18006862,핀란드,2002-08
2002-08-31,51114380,32847521,18266859,오스트리아,2002-08
2002-08-31,48329478,20881891,27447587,이스라엘,2002-08
2002-08-31,47122639,270752,46851887,과테말라,2002-08
2002-08-31,44211110,59031936,-14820826,아일랜드,2002-08
2002-08-31,43008404,0,43008404,마샬군도,2002-08
2002-08-31,41520671,66848,41453823,사이프러스,2002-08
2002-08-31,38045614,57572182,-19526568,스웨덴,2002-08
2002-08-31,37589812,3188295,34401517,도미니카 공화국,2002-08
2002-08-31,36249470,68092716,-31843246,남아프리카공화국,2002-08
2002-08-31,35891228,22990246,12900982,파키스탄,2002-08
2002-08-31,34898615,1717689,33180926,방글라데시,2002-08
2002-08-31,34026466,78238713,-44212247,칠레,2002-08
2002-08-31,33765719,61493091,-27727372,뉴질랜드,2002-08
2002-08-31,30186778,2715280,27471498,나이지리아,2002-08
2002-08-31,29456764,3080092,26376672,폴란드,2002-08
2002-08-31,29018369,87861461,-58843092,스위스,2002-08
2002-08-31,28374023,3028337,25345686,스리랑카,2002-08
2002-08-31,26719591,21688993,5030598,우크라이나,2002-08
2002-08-31,26682438,2880459,23801979,이집트,2002-08
2002-08-31,24796238,8336529,16459709,헝가리,2002-08
2002-08-31,24277499,124702,24152797,시리아,2002-08
2002-08-31,22322501,4292817,18029684,콜롬비아,2002-08
2002-08-31,21601214,33164609,-11563395,에쿠아도르,2002-08
2002-08-31,18966356,7623631,11342725,푸에르토리코,2002-08
2002-08-31,18628106,2086422,16541684,포루투갈,2002-08
2002-08-31,17500586,19050791,-1550205,페루,2002-08
2002-08-31,17254186,2503499,14750687,요르단,2002-08
2002-08-31,16422558,39821498,-23398940,덴마크,2002-08
2002-08-31,13718861,3537612,10181249,알제리,2002-08
2002-08-31,13534909,231122336,-217587427,쿠웨이트,2002-08
2002-08-31,13232453,906039,12326414,온두라스,2002-08
2002-08-31,12938237,732009,12206228,베네주엘라,2002-08
2002-08-31,12463087,3106498,9356589,루마니아,2002-08
2002-08-31,11870590,5661796,6208794,체코공화국,2002-08
2002-08-31,10938094,4670071,6268023,기타국,2002-08
2002-08-31,10901828,7206753,3695075,우즈베키스탄,2002-08
2002-08-31,10530506,201444250,-190913744,카타르,2002-08
2002-08-31,10144398,256247,9888151,괌,2002-08
2002-08-31,9816990,12540632,-2723642,미얀마,2002-08
2002-08-31,9810631,5268640,4541991,카자흐스탄,2002-08
2002-08-31,8996418,670328,8326090,캄보디아,2002-08
2002-08-31,8528737,57465849,-48937112,오만,2002-08
2002-08-31,8493223,263,8492960,아프카니스탄,2002-08
2002-08-31,7912347,136,7912211,니카라과,2002-08
2002-08-31,7105337,3984369,3120968,코스타리카,2002-08
2002-08-31,7055431,868103,6187328,몽골,2002-08
2002-08-31,7001464,1895040,5106424,모로코,2002-08
2002-08-31,6829783,8172,6821611,북마리아나 군도,2002-08
2002-08-31,5992641,221108,5771533,엘살바도르,2002-08
2002-08-31,5405055,792115,4612940,레바논,2002-08
2002-08-31,5260319,10909960,-5649641,바레인,2002-08
2002-08-31,5226936,1229976,3996960,슬로베니아,2002-08
2002-08-31,4952138,490245,4461893,리투아니아,2002-08
2002-08-31,4753862,19244880,-14491018,수단,2002-08
2002-08-31,4699161,483692,4215469,가나,2002-08
2002-08-31,4493223,23158616,-18665393,아르헨티나,2002-08
2002-08-31,4164382,33816,4130566,예맨,2002-08
2002-08-31,4075120,81812,3993308,케냐,2002-08
2002-08-31,3338378,194959,3143419,튀니지,2002-08
2002-08-31,3261321,3450,3257871,코트디봐르,2002-08
2002-08-31,3120630,834178,2286452,마카오,2002-08
2002-08-31,2806403,32228,2774175,탄자니아,2002-08
2002-08-31,2580983,46828,2534155,트리니다드 토바고,2002-08
2002-08-31,2302718,0,2302718,에리트리아,2002-08
2002-08-31,2202098,19703,2182395,키르기스스탄,2002-08
2002-08-31,2111387,63221,2048166,투르크멘,2002-08
2002-08-31,2045098,84237,1960861,크로아티아,2002-08
2002-08-31,2022892,418436,1604456,에스토니아,2002-08
2002-08-31,1966191,26422054,-24455863,브루나이,2002-08
2002-08-31,1887304,59481,1827823,라트비아,2002-08
2002-08-31,1829088,54061,1775027,파라과이,2002-08
2002-08-31,1785726,46227255,-44441529,앙골라,2002-08
2002-08-31,1762071,0,1762071,불령 리유니온 코모도 제도,2002-08
2002-08-31,1672227,53099,1619128,자마이카,2002-08
2002-08-31,1549988,0,1549988,모리셔스,2002-08
2002-08-31,1490107,39290,1450817,도미니카,2002-08
2002-08-31,1475351,334950,1140401,우루과이,2002-08
2002-08-31,1440180,1643455,-203275,불가리아,2002-08
2002-08-31,1375337,36594,1338743,아메리칸 사모아,2002-08
2002-08-31,1355320,0,1355320,팔라우,2002-08
2002-08-31,1179453,0,1179453,레소토,2002-08
2002-08-31,1141522,213374,928148,카메룬,2002-08
2002-08-31,1096631,52012,1044619,피지,2002-08
2002-08-31,1051710,16529,1035181,네팔,2002-08
2002-08-31,1041510,572299,469211,짐바브웨,2002-08
2002-08-31,1002197,0,1002197,베닝,2002-08
2002-08-31,974032,97,973935,아이티,2002-08
2002-08-31,868388,122501,745887,아이슬란드,2002-08
2002-08-31,841452,1494152,-652700,슬로바키아,2002-08
2002-08-31,788971,2082441,-1293470,볼리비아,2002-08
2002-08-31,753678,85391,668287,지부티,2002-08
2002-08-31,712783,402439,310344,세네갈,2002-08
2002-08-31,679888,0,679888,이라크,2002-08
2002-08-31,676800,16158,660642,보츠와나,2002-08
2002-08-31,666760,2215,664545,우간다,2002-08
2002-08-31,582967,0,582967,마티니크,2002-08
2002-08-31,575945,2536513,-1960568,파푸아 뉴기니,2002-08
2002-08-31,560143,2334685,-1774542,스와질랜드,2002-08
2002-08-31,556118,0,556118,토고,2002-08
2002-08-31,551105,0,551105,과델로프,2002-08
2002-08-31,530435,11545,518890,마다카스카르,2002-08
2002-08-31,510830,815104,-304274,벨라루스,2002-08
2002-08-31,506147,2667022,-2160875,뉴 칼레도니아,2002-08
2002-08-31,486916,9204,477712,유고,2002-08
2002-08-31,466525,0,466525,아루바,2002-08
2002-08-31,464637,21037,443600,에티오피아,2002-08
2002-08-31,445624,24000,421624,불령 폴리네시아,2002-08
2002-08-31,444752,0,444752,모잠비크,2002-08
2002-08-31,420759,22731814,-22311055,콩고,2002-08
2002-08-31,405056,554330,-149274,타지크,2002-08
2002-08-31,362442,17637,344805,네덜란드 열도,2002-08
2002-08-31,318470,8543,309927,벨리제,2002-08
2002-08-31,285115,1419661,-1134546,룩셈부르그,2002-08
2002-08-31,281519,27450493,-27168974,기니,2002-08
2002-08-31,274272,411880,-137608,말리,2002-08
2002-08-31,249877,115186,134691,모리타니,2002-08
2002-08-31,241593,328188,-86595,조지아,2002-08
2002-08-31,233127,2957,230170,마이크로네시아,2002-08
2002-08-31,222734,0,222734,영령 캐이맨 군도,2002-08
2002-08-31,206597,341,206256,라오스,2002-08
2002-08-31,197905,0,197905,바베이도스,2002-08
2002-08-31,195200,0,195200,통가,2002-08
2002-08-31,187568,0,187568,불령 가이아나,2002-08
2002-08-31,181718,666,181052,감비아,2002-08
2002-08-31,171998,0,171998,아제르바이잔,2002-08
2002-08-31,167577,0,167577,부탄,2002-08
2002-08-31,157558,13019,144539,가이아나,2002-08
2002-08-31,156181,0,156181,알바니아,2002-08
2002-08-31,153502,0,153502,사모아,2002-08
2002-08-31,151249,34249,117000,아르메니아,2002-08
2002-08-31,149427,378,149049,마세도니아,2002-08
2002-08-31,149186,2584,146602,안티가 바부다,2002-08
2002-08-31,143095,0,143095,보스니아-헤르체고비나,2002-08
2002-08-31,141425,12544,128881,콩고민주공화국,2002-08
2002-08-31,131323,65217,66106,말라위,2002-08
2002-08-31,120900,280,120620,니제르,2002-08
2002-08-31,118399,0,118399,몰디브,2002-08
2002-08-31,115213,571,114642,수리남,2002-08
2002-08-31,106748,178507,-71759,나미비아,2002-08
2002-08-31,104962,0,104962,시에라 리온,2002-08
2002-08-31,82071,0,82071,소말리아,2002-08
2002-08-31,73017,0,73017,부룬디,2002-08
2002-08-31,67117,4500,62617,몰도바,2002-08
2002-08-31,60098,9035372,-8975274,바누아투,2002-08
2002-08-31,54760,0,54760,투르크 & 카이코스 군도,2002-08
2002-08-31,47810,1631670,-1583860,가봉,2002-08
2002-08-31,47738,527920,-480182,잠비아,2002-08
2002-08-31,39662,118618,-78956,팔레스타인 해방기구(구),2002-08
2002-08-31,39558,31,39527,르완다,2002-08
2002-08-31,32222,1379214,-1346992,솔로몬 군도,2002-08
2002-08-31,29286,0,29286,세이쉘,2002-08
2002-08-31,26080,0,26080,세인트 키츠 네비스,2002-08
2002-08-31,18360,756920,-738560,부르키나 파소,2002-08
2002-08-31,17991,647590,-629599,모나코,2002-08
2002-08-31,16399,0,16399,그레나다,2002-08
2002-08-31,14792,251917,-237125,안도라,2002-08
2002-08-31,14083,0,14083,키리바티,2002-08
2002-08-31,8089,0,8089,중립지대,2002-08
2002-08-31,7594,0,7594,영령 버진군도,2002-08
2002-08-31,6590,0,6590,프랑스 메트로폴리탄,2002-08
2002-08-31,2491,105803,-103312,리히텐슈타인,2002-08
2002-08-31,2058,0,2058,세인트 루시아,2002-08
2002-08-31,1423,0,1423,교황청,2002-08
2002-08-31,696,656216,-655520,나우루,2002-08
2002-08-31,0,3291,-3291,토켈라우,2002-08
2002-08-31,0,2058,-2058,미드웨이 군도,2002-08
2002-08-31,0,26869,-26869,세인트 헬레나,2002-08
2002-08-31,0,101710,-101710,그린랜드,2002-08
2002-08-31,0,176349,-176349,기네비소,2002-08
2002-08-31,0,0,0,메요트,2002-08
2002-08-31,0,12844,-12844,팔레스타인 해방기구,2002-08
2002-08-31,0,185488,-185488,적도 기니,2002-08
2002-09-30,2745226658,1878522249,866704409,미국,2002-09
2002-09-30,2107709414,1554936592,552772822,중국,2002-09
2002-09-30,1287483718,2615506120,-1328022402,일본,2002-09
2002-09-30,830116731,166839853,663276878,홍콩,2002-09
2002-09-30,542049272,427670351,114378921,대만,2002-09
2002-09-30,447134169,269780787,177353382,싱가포르,2002-09
2002-09-30,380889314,441165140,-60275826,독일,2002-09
2002-09-30,322081608,180620254,141461354,영국,2002-09
2002-09-30,273482598,363493777,-90011179,인도네시아,2002-09
2002-09-30,273388450,312648757,-39260307,말레이시아,2002-09
2002-09-30,237252611,79099251,158153360,네덜란드,2002-09
2002-09-30,234972215,4387,234967828,라이베리아,2002-09
2002-09-30,229868718,144647649,85221069,필리핀,2002-09
2002-09-30,215307797,175853659,39454138,캐나다,2002-09
2002-09-30,212068337,518682071,-306613734,호주,2002-09
2002-09-30,206024292,436387964,-230363672,아랍에미리트 연합,2002-09
2002-09-30,181676569,171567831,10108738,이탈리아,2002-09
2002-09-30,179083363,23687925,155395438,멕시코,2002-09
2002-09-30,175078338,55128484,119949854,베트남,2002-09
2002-09-30,170760747,176837706,-6076959,프랑스,2002-09
2002-09-30,167479029,141115163,26363866,태국,2002-09
2002-09-30,148101106,1816065,146285041,룩셈부르그,2002-09
2002-09-30,121796516,61076858,60719658,스페인,2002-09
2002-09-30,118983326,98181818,20801508,인도,2002-09
2002-09-30,118444673,116333318,2111355,브라질,2002-09
2002-09-30,106088196,749480840,-643392644,사우디아라비아,2002-09
2002-09-30,101204150,23659,101180491,마샬군도,2002-09
2002-09-30,95556718,62469723,33086995,이란,2002-09
2002-09-30,93279369,7128813,86150556,튀르키예,2002-09
2002-09-30,91278747,206527436,-115248689,러시아 연방,2002-09
2002-09-30,69407637,26218866,43188771,핀란드,2002-09
2002-09-30,67525850,1193924,66331926,그리스,2002-09
2002-09-30,53479665,0,53479665,바하마,2002-09
2002-09-30,53341792,50885491,2456301,벨기에,2002-09
2002-09-30,50818074,47299738,3518336,칠레,2002-09
2002-09-30,46909411,194355,46715056,파나마,2002-09
2002-09-30,45395809,230471186,-185075377,카타르,2002-09
2002-09-30,44878355,1183159,43695196,리비아,2002-09
2002-09-30,44383650,23386763,20996887,오스트리아,2002-09
2002-09-30,43371688,73133643,-29761955,아일랜드,2002-09
2002-09-30,42728001,53376670,-10648669,남아프리카공화국,2002-09
2002-09-30,42254533,26173989,16080544,이스라엘,2002-09
2002-09-30,41965487,2286111,39679376,방글라데시,2002-09
2002-09-30,40051135,55468,39995667,과테말라,2002-09
2002-09-30,35928942,28300251,7628691,나이지리아,2002-09
2002-09-30,35069981,23701,35046280,사이프러스,2002-09
2002-09-30,31048677,11263732,19784945,헝가리,2002-09
2002-09-30,30033029,32804298,-2771269,스웨덴,2002-09
2002-09-30,29927734,3394705,26533029,폴란드,2002-09
2002-09-30,29848470,89109085,-59260615,스위스,2002-09
2002-09-30,28847778,20461060,8386718,파키스탄,2002-09
2002-09-30,25777264,9712079,16065185,이집트,2002-09
2002-09-30,25455535,3271448,22184087,스리랑카,2002-09
2002-09-30,24940557,66142562,-41202005,뉴질랜드,2002-09
2002-09-30,22845232,31765765,-8920533,우크라이나,2002-09
2002-09-30,22640236,2896057,19744179,콜롬비아,2002-09
2002-09-30,19490933,6067731,13423202,도미니카 공화국,2002-09
2002-09-30,16973921,887382,16086539,요르단,2002-09
2002-09-30,16721003,611410,16109593,시리아,2002-09
2002-09-30,16443005,220785482,-204342477,쿠웨이트,2002-09
2002-09-30,16125926,33358210,-17232284,에쿠아도르,2002-09
2002-09-30,15992168,11047290,4944878,푸에르토리코,2002-09
2002-09-30,15243415,1516764,13726651,포루투갈,2002-09
2002-09-30,14799947,15287342,-487395,페루,2002-09
2002-09-30,14767350,17295769,-2528419,알제리,2002-09
2002-09-30,14134857,37550342,-23415485,덴마크,2002-09
2002-09-30,13447210,2088872,11358338,미얀마,2002-09
2002-09-30,12138118,2132724,10005394,기타국,2002-09
2002-09-30,12029423,6071034,5958389,카자흐스탄,2002-09
2002-09-30,11565707,0,11565707,아프카니스탄,2002-09
2002-09-30,11522668,7716193,3806475,베네주엘라,2002-09
2002-09-30,11287238,1461407,9825831,온두라스,2002-09
2002-09-30,10816113,939753,9876360,몽골,2002-09
2002-09-30,10743366,11375188,-631822,루마니아,2002-09
2002-09-30,10561539,19430727,-8869188,이라크,2002-09
2002-09-30,9782435,5983570,3798865,코스타리카,2002-09
2002-09-30,9386142,8326253,1059889,체코공화국,2002-09
2002-09-30,8948320,3451192,5497128,모로코,2002-09
2002-09-30,8586941,115791,8471150,캄보디아,2002-09
2002-09-30,8397498,84467393,-76069895,오만,2002-09
2002-09-30,7951830,184969,7766861,엘살바도르,2002-09
2002-09-30,7226930,514,7226416,니카라과,2002-09
2002-09-30,6981972,5855137,1126835,우즈베키스탄,2002-09
2002-09-30,6849236,200951,6648285,북마리아나 군도,2002-09
2002-09-30,6441403,28178742,-21737339,노르웨이,2002-09
2002-09-30,5781129,64079889,-58298760,예맨,2002-09
2002-09-30,4764361,777821,3986540,레바논,2002-09
2002-09-30,4538538,132167,4406371,튀니지,2002-09
2002-09-30,4362648,219817,4142831,케냐,2002-09
2002-09-30,3993511,30275153,-26281642,아르헨티나,2002-09
2002-09-30,3965557,767141,3198416,슬로베니아,2002-09
2002-09-30,3910742,4016862,-106120,바레인,2002-09
2002-09-30,3886584,30612,3855972,수단,2002-09
2002-09-30,3685770,2152006,1533764,불가리아,2002-09
2002-09-30,3224906,5684066,-2459160,리투아니아,2002-09
2002-09-30,2907109,1626481,1280628,가나,2002-09
2002-09-30,2635117,204980,2430137,마카오,2002-09
2002-09-30,2316898,30962,2285936,코트디봐르,2002-09
2002-09-30,2253739,389641,1864098,우루과이,2002-09
2002-09-30,2203848,25034539,-22830691,브루나이,2002-09
2002-09-30,2196603,108756,2087847,크로아티아,2002-09
2002-09-30,2065516,1585148,480368,에스토니아,2002-09
2002-09-30,2026517,124084,1902433,파라과이,2002-09
2002-09-30,1929646,23348,1906298,트리니다드 토바고,2002-09
2002-09-30,1829901,28489,1801412,도미니카,2002-09
2002-09-30,1824077,27561,1796516,키르기스스탄,2002-09
2002-09-30,1807261,1355,1805906,유고,2002-09
2002-09-30,1742133,26514,1715619,아메리칸 사모아,2002-09
2002-09-30,1727562,135974,1591588,네팔,2002-09
2002-09-30,1642606,66240,1576366,에티오피아,2002-09
2002-09-30,1555975,325981,1229994,모리셔스,2002-09
2002-09-30,1492844,6184,1486660,베닝,2002-09
2002-09-30,1437575,27571199,-26133624,콩고,2002-09
2002-09-30,1378828,34886,1343942,탄자니아,2002-09
2002-09-30,1279672,76945,1202727,괌,2002-09
2002-09-30,1271853,4549,1267304,토고,2002-09
2002-09-30,1269891,223,1269668,투르크멘,2002-09
2002-09-30,1165793,221406,944387,자마이카,2002-09
2002-09-30,1149812,919,1148893,과델로프,2002-09
2002-09-30,1114906,0,1114906,레소토,2002-09
2002-09-30,1086817,11672,1075145,몰디브,2002-09
2002-09-30,1012720,307470,705250,카메룬,2002-09
2002-09-30,1006343,2671805,-1665462,뉴 칼레도니아,2002-09
2002-09-30,984555,426778,557777,세네갈,2002-09
2002-09-30,931779,0,931779,불령 리유니온 코모도 제도,2002-09
2002-09-30,912247,23419,888828,라트비아,2002-09
2002-09-30,895152,0,895152,아이티,2002-09
2002-09-30,890836,283258,607578,아이슬란드,2002-09
2002-09-30,874347,3410025,-2535678,스와질랜드,2002-09
2002-09-30,840348,0,840348,마티니크,2002-09
2002-09-30,784582,44887,739695,피지,2002-09
2002-09-30,772865,1512117,-739252,파푸아 뉴기니,2002-09
2002-09-30,751950,0,751950,니제르,2002-09
2002-09-30,676833,0,676833,아루바,2002-09
2002-09-30,629443,2213279,-1583836,벨라루스,2002-09
2002-09-30,605847,1957,603890,앙골라,2002-09
2002-09-30,593096,50683,542413,마다카스카르,2002-09
2002-09-30,580663,238223,342440,볼리비아,2002-09
2002-09-30,573707,0,573707,영령 캐이맨 군도,2002-09
2002-09-30,568767,2190261,-1621494,몰타,2002-09
2002-09-30,557938,0,557938,모잠비크,2002-09
2002-09-30,541046,980381,-439335,슬로바키아,2002-09
2002-09-30,505305,0,505305,마이크로네시아,2002-09
2002-09-30,448876,574715,-125839,짐바브웨,2002-09
2002-09-30,441143,1180812,-739669,기니,2002-09
2002-09-30,421552,108,421444,불령 폴리네시아,2002-09
2002-09-30,368623,0,368623,사모아,2002-09
2002-09-30,348187,0,348187,라오스,2002-09
2002-09-30,302643,140136,162507,가봉,2002-09
2002-09-30,291817,621676,-329859,조지아,2002-09
2002-09-30,283185,502,282683,아제르바이잔,2002-09
2002-09-30,281335,0,281335,알바니아,2002-09
2002-09-30,265894,989,264905,감비아,2002-09
2002-09-30,256609,85336,171273,벨리제,2002-09
2002-09-30,246322,29901,216421,우간다,2002-09
2002-09-30,245659,337810,-92151,잠비아,2002-09
2002-09-30,233425,0,233425,보스니아-헤르체고비나,2002-09
2002-09-30,232086,0,232086,마세도니아,2002-09
2002-09-30,230265,0,230265,부탄,2002-09
2002-09-30,227623,0,227623,버뮤다,2002-09
2002-09-30,226684,21285,205399,네덜란드 열도,2002-09
2002-09-30,209904,0,209904,수리남,2002-09
2002-09-30,209755,0,209755,불령 가이아나,2002-09
2002-09-30,208572,0,208572,티모르,2002-09
2002-09-30,207148,154785,52363,모리타니,2002-09
2002-09-30,206342,275638,-69296,안티가 바부다,2002-09
2002-09-30,194220,273749,-79529,나미비아,2002-09
2002-09-30,193311,19510,173801,콩고민주공화국,2002-09
2002-09-30,189476,413206,-223730,타지크,2002-09
2002-09-30,185883,0,185883,팔라우,2002-09
2002-09-30,169169,10866,158303,지부티,2002-09
2002-09-30,161498,0,161498,바베이도스,2002-09
2002-09-30,145748,0,145748,몰도바,2002-09
2002-09-30,117421,0,117421,보츠와나,2002-09
2002-09-30,111470,0,111470,시에라 리온,2002-09
2002-09-30,91831,68400,23431,아르메니아,2002-09
2002-09-30,89462,1222648,-1133186,솔로몬 군도,2002-09
2002-09-30,88772,0,88772,말라위,2002-09
2002-09-30,82071,0,82071,소말리아,2002-09
2002-09-30,71654,104695,-33041,말리,2002-09
2002-09-30,66847,0,66847,세인트 루시아,2002-09
2002-09-30,60289,0,60289,통가,2002-09
2002-09-30,59225,0,59225,르완다,2002-09
2002-09-30,40011,1751,38260,가이아나,2002-09
2002-09-30,28143,0,28143,쿡 아일랜드,2002-09
2002-09-30,26572,1581,24991,에리트리아,2002-09
2002-09-30,23544,424,23120,바누아투,2002-09
2002-09-30,20816,52262,-31446,팔레스타인 해방기구(구),2002-09
2002-09-30,20160,0,20160,보빗군도,2002-09
2002-09-30,18139,0,18139,세이쉘,2002-09
2002-09-30,15768,33042,-17274,안도라,2002-09
2002-09-30,12317,0,12317,세인트 빈센트 그레나딘,2002-09
2002-09-30,11685,0,11685,세인트 키츠 네비스,2002-09
2002-09-30,10227,62,10165,미령 버진군도,2002-09
2002-09-30,8607,98604,-89997,리히텐슈타인,2002-09
2002-09-30,7720,0,7720,프랑스 메트로폴리탄,2002-09
2002-09-30,6600,0,6600,상토메 프린스페,2002-09
2002-09-30,5794,0,5794,부르키나 파소,2002-09
2002-09-30,5188,4471,717,토켈라우,2002-09
2002-09-30,5000,0,5000,챠드,2002-09
2002-09-30,3624,0,3624,그레나다,2002-09
2002-09-30,2307,0,2307,부룬디,2002-09
2002-09-30,2203,0,2203,왈라스 & 퓨투나 군도,2002-09
2002-09-30,1792,32690,-30898,산마리노,2002-09
2002-09-30,470,1659,-1189,교황청,2002-09
2002-09-30,270,0,270,중앙아프리카공화국,2002-09
2002-09-30,29,0,29,메요트,2002-09
2002-09-30,0,40729,-40729,기네비소,2002-09
2002-09-30,0,860088,-860088,모나코,2002-09
2002-09-30,0,106665,-106665,그린랜드,2002-09
2002-09-30,0,1328,-1328,투르크 & 카이코스 군도,2002-09
2002-10-31,3110798556,1975422917,1135375639,미국,2002-10
2002-10-31,2472827761,1728790720,744037041,중국,2002-10
2002-10-31,1409834404,2783817337,-1373982933,일본,2002-10
2002-10-31,890016045,161617526,728398519,홍콩,2002-10
2002-10-31,534275423,431558363,102717060,대만,2002-10
2002-10-31,409758923,196725303,213033620,영국,2002-10
2002-10-31,376911176,478949515,-102038339,독일,2002-10
2002-10-31,336209590,352226737,-16017147,싱가포르,2002-10
2002-10-31,333810335,403516512,-69706177,인도네시아,2002-10
2002-10-31,292427721,402734085,-110306364,말레이시아,2002-10
2002-10-31,271328967,153834544,117494423,필리핀,2002-10
2002-10-31,250621974,507984760,-257362786,호주,2002-10
2002-10-31,228246609,176811635,51434974,캐나다,2002-10
2002-10-31,225537843,73997450,151540393,네덜란드,2002-10
2002-10-31,219061171,51169103,167892068,베트남,2002-10
2002-10-31,216425500,23116235,193309265,멕시코,2002-10
2002-10-31,206078411,414349262,-208270851,아랍에미리트 연합,2002-10
2002-10-31,204741588,180739161,24002427,이탈리아,2002-10
2002-10-31,195039760,148864661,46175099,태국,2002-10
2002-10-31,167376473,125968834,41407639,이란,2002-10
2002-10-31,167214295,39918721,127295574,스페인,2002-10
2002-10-31,147250891,31381,147219510,라이베리아,2002-10
2002-10-31,124679611,159975144,-35295533,프랑스,2002-10
2002-10-31,118434406,100196072,18238334,인도,2002-10
2002-10-31,112379052,203253462,-90874410,러시아 연방,2002-10
2002-10-31,98420030,649031534,-550611504,사우디아라비아,2002-10
2002-10-31,91365649,38528438,52837211,핀란드,2002-10
2002-10-31,91236313,4611668,86624645,튀르키예,2002-10
2002-10-31,81372995,16800,81356195,마샬군도,2002-10
2002-10-31,78519377,99009933,-20490556,스위스,2002-10
2002-10-31,75139831,1215289,73924542,그리스,2002-10
2002-10-31,71888675,144998,71743677,사이프러스,2002-10
2002-10-31,71824940,152845166,-81020226,브라질,2002-10
2002-10-31,71192079,66,71192013,바하마,2002-10
2002-10-31,67780580,51215150,16565430,아일랜드,2002-10
2002-10-31,63460016,59079719,4380297,벨기에,2002-10
2002-10-31,51718077,152991,51565086,과테말라,2002-10
2002-10-31,47529375,21208964,26320411,이스라엘,2002-10
2002-10-31,40565701,2273666,38292035,방글라데시,2002-10
2002-10-31,40033281,444120,39589161,나이지리아,2002-10
2002-10-31,39541666,7504734,32036932,헝가리,2002-10
2002-10-31,36525298,42263336,-5738038,남아프리카공화국,2002-10
2002-10-31,36346230,28675,36317555,리비아,2002-10
2002-10-31,35850890,32959151,2891739,오스트리아,2002-10
2002-10-31,35112131,62762426,-27650295,칠레,2002-10
2002-10-31,32423276,269220,32154056,도미니카 공화국,2002-10
2002-10-31,31147085,63884424,-32737339,뉴질랜드,2002-10
2002-10-31,31139019,20292206,10846813,파키스탄,2002-10
2002-10-31,30493578,3688875,26804703,폴란드,2002-10
2002-10-31,29848376,48982884,-19134508,스웨덴,2002-10
2002-10-31,28172985,3259895,24913090,스리랑카,2002-10
2002-10-31,26787201,35589362,-8802161,덴마크,2002-10
2002-10-31,26639446,2057818,24581628,이집트,2002-10
2002-10-31,24288595,18407945,5880650,우크라이나,2002-10
2002-10-31,23689913,17139975,6549938,페루,2002-10
2002-10-31,23432510,451633,22980877,시리아,2002-10
2002-10-31,22797298,3370026,19427272,푸에르토리코,2002-10
2002-10-31,22583666,5742193,16841473,콜롬비아,2002-10
2002-10-31,21461146,200821561,-179360415,카타르,2002-10
2002-10-31,20945931,191994411,-171048480,쿠웨이트,2002-10
2002-10-31,19737765,2196005,17541760,기타국,2002-10
2002-10-31,18580544,20571587,-1991043,알제리,2002-10
2002-10-31,18191088,4698109,13492979,베네주엘라,2002-10
2002-10-31,17081055,54430476,-37349421,파나마,2002-10
2002-10-31,16173951,238018,15935933,크로아티아,2002-10
2002-10-31,15991205,17616801,-1625596,에쿠아도르,2002-10
2002-10-31,15639967,6612139,9027828,카자흐스탄,2002-10
2002-10-31,15396395,2255617,13140778,포루투갈,2002-10
2002-10-31,15101085,2672365,12428720,몰타,2002-10
2002-10-31,14066143,330548,13735595,온두라스,2002-10
2002-10-31,12241220,7200,12234020,아프카니스탄,2002-10
2002-10-31,10663019,5971019,4692000,코스타리카,2002-10
2002-10-31,10511307,9576591,934716,체코공화국,2002-10
2002-10-31,10429775,399862,10029913,요르단,2002-10
2002-10-31,10312557,2997969,7314588,미얀마,2002-10
2002-10-31,10062370,9146,10053224,북마리아나 군도,2002-10
2002-10-31,9945521,1814166,8131355,모로코,2002-10
2002-10-31,9804220,296054,9508166,캄보디아,2002-10
2002-10-31,9617405,1061821,8555584,몽골,2002-10
2002-10-31,9117039,781,9116258,니카라과,2002-10
2002-10-31,8874289,45299880,-36425591,노르웨이,2002-10
2002-10-31,8868129,0,8868129,이라크,2002-10
2002-10-31,8832865,185020966,-176188101,오만,2002-10
2002-10-31,8322905,12195081,-3872176,루마니아,2002-10
2002-10-31,7967475,23834881,-15867406,아르헨티나,2002-10
2002-10-31,5854809,531974,5322835,레바논,2002-10
2002-10-31,5741283,4733555,1007728,우즈베키스탄,2002-10
2002-10-31,5506041,397651,5108390,엘살바도르,2002-10
2002-10-31,5369121,482483,4886638,리투아니아,2002-10
2002-10-31,5147040,69449,5077591,예맨,2002-10
2002-10-31,5000674,1984894,3015780,슬로베니아,2002-10
2002-10-31,4698318,49661,4648657,케냐,2002-10
2002-10-31,4239398,11891430,-7652032,바레인,2002-10
2002-10-31,4209617,26316530,-22106913,수단,2002-10
2002-10-31,3975819,46406537,-42430718,브루나이,2002-10
2002-10-31,3622925,426894,3196031,마카오,2002-10
2002-10-31,3128433,152901,2975532,에티오피아,2002-10
2002-10-31,2900813,666030,2234783,가나,2002-10
2002-10-31,2780717,963133,1817584,불가리아,2002-10
2002-10-31,2778646,106004,2672642,튀니지,2002-10
2002-10-31,2748942,50470,2698472,키르기스스탄,2002-10
2002-10-31,2648620,597939,2050681,괌,2002-10
2002-10-31,2363332,91920,2271412,라트비아,2002-10
2002-10-31,2313316,26514,2286802,아메리칸 사모아,2002-10
2002-10-31,2204974,459672,1745302,우루과이,2002-10
2002-10-31,2164962,0,2164962,파라과이,2002-10
2002-10-31,1944955,641217,1303738,아이슬란드,2002-10
2002-10-31,1910883,110142,1800741,트리니다드 토바고,2002-10
2002-10-31,1904578,27970659,-26066081,앙골라,2002-10
2002-10-31,1863840,803752,1060088,에스토니아,2002-10
2002-10-31,1859674,46600,1813074,탄자니아,2002-10
2002-10-31,1858402,6000,1852402,투르크멘,2002-10
2002-10-31,1848655,4454,1844201,코트디봐르,2002-10
2002-10-31,1663465,4963,1658502,모리셔스,2002-10
2002-10-31,1606662,13561,1593101,도미니카,2002-10
2002-10-31,1395001,3421484,-2026483,스와질랜드,2002-10
2002-10-31,1366705,11,1366694,토고,2002-10
2002-10-31,1293868,84892,1208976,네팔,2002-10
2002-10-31,1292209,0,1292209,불령 리유니온 코모도 제도,2002-10
2002-10-31,1255933,13209,1242724,베닝,2002-10
2002-10-31,1083229,653233,429996,슬로바키아,2002-10
2002-10-31,1077323,13520,1063803,팔라우,2002-10
2002-10-31,1032597,2522965,-1490368,뉴 칼레도니아,2002-10
2002-10-31,1008259,0,1008259,지부티,2002-10
2002-10-31,949649,0,949649,마티니크,2002-10
2002-10-31,947024,117,946907,아이티,2002-10
2002-10-31,936129,1641,934488,과델로프,2002-10
2002-10-31,914256,3808,910448,자마이카,2002-10
2002-10-31,812432,1127443,-315011,짐바브웨,2002-10
2002-10-31,802176,108278,693898,피지,2002-10
2002-10-31,800655,0,800655,레소토,2002-10
2002-10-31,769304,0,769304,마다카스카르,2002-10
2002-10-31,704735,0,704735,세이쉘,2002-10
2002-10-31,701074,49491165,-48790091,콩고,2002-10
2002-10-31,669277,12138,657139,유고,2002-10
2002-10-31,647721,342121,305600,세네갈,2002-10
2002-10-31,645264,184803,460461,카메룬,2002-10
2002-10-31,602636,0,602636,벨리제,2002-10
2002-10-31,552173,29742,522431,우간다,2002-10
2002-10-31,522179,0,522179,아루바,2002-10
2002-10-31,510373,0,510373,불령 폴리네시아,2002-10
2002-10-31,508406,33034,475372,볼리비아,2002-10
2002-10-31,491653,4948,486705,마이크로네시아,2002-10
2002-10-31,451884,406,451478,라오스,2002-10
2002-10-31,432457,2515149,-2082692,파푸아 뉴기니,2002-10
2002-10-31,407168,0,407168,바베이도스,2002-10
2002-10-31,403957,83148352,-82744395,기니,2002-10
2002-10-31,393566,62911,330655,아제르바이잔,2002-10
2002-10-31,379651,1496873,-1117222,룩셈부르그,2002-10
2002-10-31,354400,0,354400,보스니아-헤르체고비나,2002-10
2002-10-31,348105,14342,333763,감비아,2002-10
2002-10-31,339818,12725228,-12385410,몰도바,2002-10
2002-10-31,324765,0,324765,안티가 바부다,2002-10
2002-10-31,321958,0,321958,사모아,2002-10
2002-10-31,310122,410294,-100172,잠비아,2002-10
2002-10-31,306020,0,306020,마세도니아,2002-10
2002-10-31,298639,1794,296845,네덜란드 열도,2002-10
2002-10-31,296044,3411223,-3115179,모잠비크,2002-10
2002-10-31,283269,354411,-71142,타지크,2002-10
2002-10-31,275670,174,275496,알바니아,2002-10
2002-10-31,271483,1751051,-1479568,가봉,2002-10
2002-10-31,229255,0,229255,영령 캐이맨 군도,2002-10
2002-10-31,228871,0,228871,그레나다,2002-10
2002-10-31,219888,2448434,-2228546,벨라루스,2002-10
2002-10-31,216732,2372523,-2155791,솔로몬 군도,2002-10
2002-10-31,210936,195065,15871,나미비아,2002-10
2002-10-31,188807,0,188807,말라위,2002-10
2002-10-31,187649,1446,186203,수리남,2002-10
2002-10-31,181573,0,181573,니제르,2002-10
2002-10-31,179534,0,179534,불령 가이아나,2002-10
2002-10-31,178680,791390,-612710,모나코,2002-10
2002-10-31,171948,62942,109006,모리타니,2002-10
2002-10-31,170925,570645,-399720,조지아,2002-10
2002-10-31,145131,0,145131,버뮤다,2002-10
2002-10-31,144202,207159,-62957,말리,2002-10
2002-10-31,140899,2524,138375,시에라 리온,2002-10
2002-10-31,140162,22250,117912,콩고민주공화국,2002-10
2002-10-31,134176,1375554,-1241378,가이아나,2002-10
2002-10-31,99389,12600,86789,몰디브,2002-10
2002-10-31,99167,85236,13931,안도라,2002-10
2002-10-31,91920,11248,80672,산마리노,2002-10
2002-10-31,83402,19461,63941,키리바티,2002-10
2002-10-31,78720,0,78720,소말리아,2002-10
2002-10-31,70836,0,70836,세인트 루시아,2002-10
2002-10-31,70233,0,70233,부탄,2002-10
2002-10-31,64350,0,64350,에리트리아,2002-10
2002-10-31,64217,0,64217,아르메니아,2002-10
2002-10-31,63166,26907,36259,보츠와나,2002-10
2002-10-31,51655,0,51655,영령 버진군도,2002-10
2002-10-31,50307,21500,28807,바누아투,2002-10
2002-10-31,39217,0,39217,프랑스 메트로폴리탄,2002-10
2002-10-31,32682,0,32682,세인트 빈센트 그레나딘,2002-10
2002-10-31,31709,1512595,-1480886,부르키나 파소,2002-10
2002-10-31,27919,0,27919,투발루,2002-10
2002-10-31,21147,0,21147,카보 베르데,2002-10
2002-10-31,17333,76,17257,서사하라,2002-10
2002-10-31,15279,0,15279,티모르,2002-10
2002-10-31,14418,0,14418,중앙아프리카공화국,2002-10
2002-10-31,13046,313522,-300476,리히텐슈타인,2002-10
2002-10-31,12390,0,12390,노폴크 아일랜드,2002-10
2002-10-31,11114,0,11114,지브랄타,2002-10
2002-10-31,8980,0,8980,통가,2002-10
2002-10-31,7509,48860,-41351,팔레스타인 해방기구(구),2002-10
2002-10-31,6952,0,6952,챠드,2002-10
2002-10-31,2000,0,2000,파나마운하지역,2002-10
2002-10-31,889,0,889,파로에 군도,2002-10
2002-10-31,360,20500,-20140,그린랜드,2002-10
2002-10-31,0,203,-203,보네르 신트외스타티위스,2002-10
2002-10-31,0,1588,-1588,크리스마스 아일랜드,2002-10
2002-10-31,0,21811,-21811,존스톤 아일랜드,2002-10
2002-10-31,0,30572,-30572,니우에,2002-10
2002-10-31,0,4061,-4061,투르크 & 카이코스 군도,2002-10
2002-10-31,0,420,-420,르완다,2002-10
2002-10-31,0,2154,-2154,몬트세라트,2002-10
2002-10-31,0,788,-788,토켈라우,2002-10
2002-10-31,0,3641,-3641,코스 군도,2002-10
2002-10-31,0,66,-66,마이너 아우틀링 합중국 군도,2002-10
2002-11-30,3028530917,1907245070,1121285847,미국,2002-11
2002-11-30,2396004989,1727207156,668797833,중국,2002-11
2002-11-30,1474813167,2889041236,-1414228069,일본,2002-11
2002-11-30,888201439,176897403,711304036,홍콩,2002-11
2002-11-30,567181786,218739787,348441999,영국,2002-11
2002-11-30,551765689,474357603,77408086,대만,2002-11
2002-11-30,432637670,487198988,-54561318,독일,2002-11
2002-11-30,357724704,321094431,36630273,싱가포르,2002-11
2002-11-30,289917728,177569431,112348297,필리핀,2002-11
2002-11-30,247058284,414904021,-167845737,말레이시아,2002-11
2002-11-30,235016187,469368977,-234352790,호주,2002-11
2002-11-30,234218315,102766188,131452127,네덜란드,2002-11
2002-11-30,215989041,41443385,174545656,베트남,2002-11
2002-11-30,214228802,409953073,-195724271,인도네시아,2002-11
2002-11-30,211269830,2205,211267625,바하마,2002-11
2002-11-30,206684090,496943085,-290258995,아랍에미리트 연합,2002-11
2002-11-30,200210336,159165017,41045319,캐나다,2002-11
2002-11-30,190146267,1427498,188718769,그리스,2002-11
2002-11-30,182377596,24351918,158025678,멕시코,2002-11
2002-11-30,175530404,152147208,23383196,태국,2002-11
2002-11-30,174433981,223052279,-48618298,이탈리아,2002-11
2002-11-30,169402307,176747835,-7345528,프랑스,2002-11
2002-11-30,149685146,36205902,113479244,스페인,2002-11
2002-11-30,134520743,85225701,49295042,인도,2002-11
2002-11-30,129338395,304057,129034338,라이베리아,2002-11
2002-11-30,101081300,124338464,-23257164,이란,2002-11
2002-11-30,100096060,636166664,-536070604,사우디아라비아,2002-11
2002-11-30,97383048,215427360,-118044312,러시아 연방,2002-11
2002-11-30,91293592,0,91293592,마샬군도,2002-11
2002-11-30,86442700,125442096,-38999396,브라질,2002-11
2002-11-30,79678734,40268641,39410093,핀란드,2002-11
2002-11-30,79381606,1150456,78231150,파나마,2002-11
2002-11-30,76719963,6273472,70446491,튀르키예,2002-11
2002-11-30,70145698,38777840,31367858,아일랜드,2002-11
2002-11-30,69616601,53699706,15916895,벨기에,2002-11
2002-11-30,68077142,35273173,32803969,덴마크,2002-11
2002-11-30,58851223,88277954,-29426731,스위스,2002-11
2002-11-30,57935232,41249771,16685461,노르웨이,2002-11
2002-11-30,57900461,7685695,50214766,헝가리,2002-11
2002-11-30,49105001,93150,49011851,과테말라,2002-11
2002-11-30,47228558,0,47228558,버뮤다,2002-11
2002-11-30,42550649,2025016,40525633,방글라데시,2002-11
2002-11-30,41559335,22740527,18818808,이스라엘,2002-11
2002-11-30,41060655,2412209,38648446,나이지리아,2002-11
2002-11-30,40367855,1036891,39330964,리비아,2002-11
2002-11-30,37216586,61972824,-24756238,뉴질랜드,2002-11
2002-11-30,33591285,21755370,11835915,파키스탄,2002-11
2002-11-30,33241131,69724166,-36483035,스웨덴,2002-11
2002-11-30,31205381,39993422,-8788041,오스트리아,2002-11
2002-11-30,28901928,42615211,-13713283,남아프리카공화국,2002-11
2002-11-30,28672335,9842370,18829965,폴란드,2002-11
2002-11-30,26824795,2788758,24036037,스리랑카,2002-11
2002-11-30,26771755,58996785,-32225030,칠레,2002-11
2002-11-30,24109090,184026,23925064,시리아,2002-11
2002-11-30,22780350,4096662,18683688,이집트,2002-11
2002-11-30,17936420,2733547,15202873,도미니카 공화국,2002-11
2002-11-30,16958888,7877365,9081523,루마니아,2002-11
2002-11-30,16753620,5533581,11220039,베네주엘라,2002-11
2002-11-30,16299687,28206593,-11906906,우크라이나,2002-11
2002-11-30,16051886,3185847,12866039,포루투갈,2002-11
2002-11-30,15946044,174733915,-158787871,쿠웨이트,2002-11
2002-11-30,15769517,36814981,-21045464,알제리,2002-11
2002-11-30,15204537,4711410,10493127,콜롬비아,2002-11
2002-11-30,14864515,70584,14793931,요르단,2002-11
2002-11-30,14796520,59099,14737421,캄보디아,2002-11
2002-11-30,14669204,9127410,5541794,페루,2002-11
2002-11-30,14649674,14825303,-175629,푸에르토리코,2002-11
2002-11-30,14545733,1956871,12588862,미얀마,2002-11
2002-11-30,14141057,35026806,-20885749,에쿠아도르,2002-11
2002-11-30,12744320,1994335,10749985,기타국,2002-11
2002-11-30,12650791,8845573,3805218,카자흐스탄,2002-11
2002-11-30,10845408,168384469,-157539061,오만,2002-11
2002-11-30,10787317,604176,10183141,온두라스,2002-11
2002-11-30,10760135,244101,10516034,아프카니스탄,2002-11
2002-11-30,10395031,225353331,-214958300,카타르,2002-11
2002-11-30,9941641,4205051,5736590,코스타리카,2002-11
2002-11-30,9860949,3330734,6530215,모로코,2002-11
2002-11-30,9827049,1584,9825465,니카라과,2002-11
2002-11-30,9824322,11536624,-1712302,체코공화국,2002-11
2002-11-30,9430144,13992,9416152,괌,2002-11
2002-11-30,8657685,0,8657685,이라크,2002-11
2002-11-30,7195777,95248,7100529,북마리아나 군도,2002-11
2002-11-30,6916468,35125532,-28209064,아르헨티나,2002-11
2002-11-30,6649247,5437272,1211975,우즈베키스탄,2002-11
2002-11-30,6452056,450080,6001976,엘살바도르,2002-11
2002-11-30,5136001,14208001,-9072000,바레인,2002-11
2002-11-30,5012868,631057,4381811,몽골,2002-11
2002-11-30,4921591,29529217,-24607626,예맨,2002-11
2002-11-30,4610025,60305,4549720,수단,2002-11
2002-11-30,4108851,5875088,-1766237,리투아니아,2002-11
2002-11-30,4018320,1776902,2241418,가나,2002-11
2002-11-30,3781929,0,3781929,트리니다드 토바고,2002-11
2002-11-30,3693309,113532,3579777,마카오,2002-11
2002-11-30,3681568,99497,3582071,케냐,2002-11
2002-11-30,3521919,760046,2761873,슬로베니아,2002-11
2002-11-30,3467057,188592,3278465,레바논,2002-11
2002-11-30,3421654,905,3420749,에리트리아,2002-11
2002-11-30,3026675,53791,2972884,크로아티아,2002-11
2002-11-30,2960258,97224,2863034,키르기스스탄,2002-11
2002-11-30,2597081,1162257,1434824,슬로바키아,2002-11
2002-11-30,2566914,0,2566914,투르크멘,2002-11
2002-11-30,2437686,1416633,1021053,불가리아,2002-11
2002-11-30,2354650,874411,1480239,우루과이,2002-11
2002-11-30,2168505,0,2168505,불령 리유니온 코모도 제도,2002-11
2002-11-30,2055137,173626,1881511,튀니지,2002-11
2002-11-30,1981705,26803,1954902,에티오피아,2002-11
2002-11-30,1706549,54023410,-52316861,브루나이,2002-11
2002-11-30,1699371,2717,1696654,모리셔스,2002-11
2002-11-30,1674848,0,1674848,아이티,2002-11
2002-11-30,1645023,586460,1058563,에스토니아,2002-11
2002-11-30,1555092,17014,1538078,코트디봐르,2002-11
2002-11-30,1502095,26377,1475718,베닝,2002-11
2002-11-30,1402744,184489,1218255,네팔,2002-11
2002-11-30,1393869,120935,1272934,파라과이,2002-11
2002-11-30,1365844,145054,1220790,탄자니아,2002-11
2002-11-30,1351748,112380,1239368,세네갈,2002-11
2002-11-30,1346642,210799,1135843,아이슬란드,2002-11
2002-11-30,1300618,0,1300618,마티니크,2002-11
2002-11-30,1288029,45128,1242901,라트비아,2002-11
2002-11-30,1250602,24130400,-22879798,앙골라,2002-11
2002-11-30,1238559,0,1238559,아메리칸 사모아,2002-11
2002-11-30,1204590,3808763,-2604173,스와질랜드,2002-11
2002-11-30,1196631,728850,467781,짐바브웨,2002-11
2002-11-30,1154475,62795,1091680,카메룬,2002-11
2002-11-30,1022146,62399,959747,사이프러스,2002-11
2002-11-30,910120,32887,877233,자마이카,2002-11
2002-11-30,908300,4585060,-3676760,몰타,2002-11
2002-11-30,872928,42816,830112,피지,2002-11
2002-11-30,831417,6359,825058,과델로프,2002-11
2002-11-30,825726,2356276,-1530550,볼리비아,2002-11
2002-11-30,819479,1060,818419,도미니카,2002-11
2002-11-30,813700,742,812958,유고,2002-11
2002-11-30,769291,483722,285569,잠비아,2002-11
2002-11-30,745903,1374525,-628622,벨라루스,2002-11
2002-11-30,707486,1405508,-698022,파푸아 뉴기니,2002-11
2002-11-30,613253,4048,609205,토고,2002-11
2002-11-30,585762,1005088,-419326,기니,2002-11
2002-11-30,549583,0,549583,마이크로네시아,2002-11
2002-11-30,524801,13242,511559,바베이도스,2002-11
2002-11-30,522428,1381,521047,니제르,2002-11
2002-11-30,491898,85595,406303,벨리제,2002-11
2002-11-30,468880,2497854,-2028974,뉴 칼레도니아,2002-11
2002-11-30,441637,107968176,-107526539,콩고,2002-11
2002-11-30,416677,1582811,-1166134,안도라,2002-11
2002-11-30,374269,0,374269,지부티,2002-11
2002-11-30,373010,0,373010,사모아,2002-11
2002-11-30,362657,5378,357279,마다카스카르,2002-11
2002-11-30,354564,2795,351769,팔라우,2002-11
2002-11-30,353943,0,353943,아루바,2002-11
2002-11-30,353732,0,353732,모잠비크,2002-11
2002-11-30,335967,8748,327219,라오스,2002-11
2002-11-30,333514,0,333514,세인트 루시아,2002-11
2002-11-30,288987,0,288987,알바니아,2002-11
2002-11-30,286326,658382,-372056,타지크,2002-11
2002-11-30,285951,0,285951,불령 가이아나,2002-11
2002-11-30,282903,375,282528,티모르,2002-11
2002-11-30,264174,0,264174,우간다,2002-11
2002-11-30,246931,102909,144022,불령 폴리네시아,2002-11
2002-11-30,224147,0,224147,감비아,2002-11
2002-11-30,222105,68968,153137,네덜란드 열도,2002-11
2002-11-30,202806,740752,-537946,조지아,2002-11
2002-11-30,194299,249166,-54867,가봉,2002-11
2002-11-30,188833,2241786,-2052953,룩셈부르그,2002-11
2002-11-30,162957,0,162957,부탄,2002-11
2002-11-30,150384,102600,47784,아르메니아,2002-11
2002-11-30,143386,32769,110617,수리남,2002-11
2002-11-30,141994,0,141994,말라위,2002-11
2002-11-30,141989,0,141989,보스니아-헤르체고비나,2002-11
2002-11-30,141159,9356,131803,보츠와나,2002-11
2002-11-30,138516,11327,127189,몰도바,2002-11
2002-11-30,113425,0,113425,아제르바이잔,2002-11
2002-11-30,100445,0,100445,안티가 바부다,2002-11
2002-11-30,91516,6029,85487,그레나다,2002-11
2002-11-30,90512,0,90512,레소토,2002-11
2002-11-30,88587,0,88587,몰디브,2002-11
2002-11-30,83094,0,83094,바누아투,2002-11
2002-11-30,76210,190479,-114269,모리타니,2002-11
2002-11-30,69076,0,69076,가이아나,2002-11
2002-11-30,59479,0,59479,마세도니아,2002-11
2002-11-30,58244,0,58244,세인트 빈센트 그레나딘,2002-11
2002-11-30,55410,149171,-93761,시에라 리온,2002-11
2002-11-30,50522,112403,-61881,말리,2002-11
2002-11-30,37995,6324,31671,세인트 키츠 네비스,2002-11
2002-11-30,35474,29420,6054,콩고민주공화국,2002-11
2002-11-30,27951,0,27951,소말리아,2002-11
2002-11-30,24101,6808,17293,팔레스타인 해방기구(구),2002-11
2002-11-30,24028,1022619,-998591,솔로몬 군도,2002-11
2002-11-30,19810,0,19810,영령 캐이맨 군도,2002-11
2002-11-30,13550,0,13550,영령 버진군도,2002-11
2002-11-30,11021,1014127,-1003106,모나코,2002-11
2002-11-30,9753,337773,-328020,나미비아,2002-11
2002-11-30,7507,0,7507,투르크 & 카이코스 군도,2002-11
2002-11-30,4202,1222,2980,지브랄타,2002-11
2002-11-30,4015,0,4015,부룬디,2002-11
2002-11-30,3550,42987,-39437,리히텐슈타인,2002-11
2002-11-30,2541,7828,-5287,통가,2002-11
2002-11-30,1884,0,1884,중립지대,2002-11
2002-11-30,1337,0,1337,세이쉘,2002-11
2002-11-30,422,34064,-33642,키리바티,2002-11
2002-11-30,362,0,362,챠드,2002-11
2002-11-30,0,4842,-4842,노폴크 아일랜드,2002-11
2002-11-30,0,2343905,-2343905,교황청,2002-11
2002-11-30,0,144827,-144827,그린랜드,2002-11
2002-11-30,0,22370,-22370,르완다,2002-11
2002-11-30,0,1904,-1904,파나마운하지역,2002-11
2002-11-30,0,15765,-15765,마이너 아우틀링 합중국 군도,2002-11
2002-11-30,0,19167,-19167,코스 군도,2002-11
2002-11-30,0,6162,-6162,앙귈라,2002-11
2002-11-30,0,758748,-758748,부르키나 파소,2002-11
2002-11-30,0,130,-130,스발비드 군도,2002-11
2002-12-31,2961008886,2071872916,889135970,미국,2002-12
2002-12-31,2530655690,1659290145,871365545,중국,2002-12
2002-12-31,1418660277,2888416832,-1469756555,일본,2002-12
2002-12-31,880431442,156331060,724100382,홍콩,2002-12
2002-12-31,550542885,436079025,114463860,대만,2002-12
2002-12-31,404682531,233763151,170919380,영국,2002-12
2002-12-31,389797324,563666581,-173869257,독일,2002-12
2002-12-31,321628813,2210787,319418026,그리스,2002-12
2002-12-31,296831201,320840883,-24009682,싱가포르,2002-12
2002-12-31,270752993,166435919,104317074,네덜란드,2002-12
2002-12-31,260684610,382538457,-121853847,말레이시아,2002-12
2002-12-31,232408560,472127575,-239719015,인도네시아,2002-12
2002-12-31,207272483,133915126,73357357,필리핀,2002-12
2002-12-31,207197508,38919011,168278497,베트남,2002-12
2002-12-31,207121403,540169488,-333048085,호주,2002-12
2002-12-31,206539798,217320559,-10780761,이탈리아,2002-12
2002-12-31,203234219,150967,203083252,라이베리아,2002-12
2002-12-31,198039076,355875,197683201,나이지리아,2002-12
2002-12-31,191846496,207736287,-15889791,캐나다,2002-12
2002-12-31,173829681,475216875,-301387194,아랍에미리트 연합,2002-12
2002-12-31,168428189,91909223,76518966,인도,2002-12
2002-12-31,159098629,133275469,25823160,태국,2002-12
2002-12-31,151268660,35387561,115881099,스페인,2002-12
2002-12-31,142169576,27766753,114402823,멕시코,2002-12
2002-12-31,139968799,0,139968799,마샬군도,2002-12
2002-12-31,129481516,719585092,-590103576,사우디아라비아,2002-12
2002-12-31,106409397,123132958,-16723561,이란,2002-12
2002-12-31,105167365,191848027,-86680662,프랑스,2002-12
2002-12-31,95393612,225198604,-129804992,러시아 연방,2002-12
2002-12-31,94065201,53018269,41046932,벨기에,2002-12
2002-12-31,88582792,94262231,-5679439,브라질,2002-12
2002-12-31,79610797,7594418,72016379,튀르키예,2002-12
2002-12-31,72136362,88648157,-16511795,아일랜드,2002-12
2002-12-31,71235124,40549173,30685951,핀란드,2002-12
2002-12-31,70387485,167037,70220448,사이프러스,2002-12
2002-12-31,49040926,10,49040916,안티가 바부다,2002-12
2002-12-31,48638402,14427110,34211292,몰타,2002-12
2002-12-31,48453626,66199001,-17745375,칠레,2002-12
2002-12-31,47533601,172199,47361402,과테말라,2002-12
2002-12-31,46678108,3538444,43139664,포루투갈,2002-12
2002-12-31,44681810,9326965,35354845,헝가리,2002-12
2002-12-31,43854582,23730284,20124298,이스라엘,2002-12
2002-12-31,41969138,13877520,28091618,파키스탄,2002-12
2002-12-31,41486084,57492817,-16006733,스웨덴,2002-12
2002-12-31,40727607,1699072,39028535,방글라데시,2002-12
2002-12-31,33509037,63147693,-29638656,남아프리카공화국,2002-12
2002-12-31,31784096,140329,31643767,리비아,2002-12
2002-12-31,31159421,11670186,19489235,이집트,2002-12
2002-12-31,29193697,107135101,-77941404,스위스,2002-12
2002-12-31,28756133,27782268,973865,오스트리아,2002-12
2002-12-31,27907748,57052317,-29144569,뉴질랜드,2002-12
2002-12-31,25169038,2760,25166278,바하마,2002-12
2002-12-31,25150435,6063543,19086892,폴란드,2002-12
2002-12-31,24053118,403912,23649206,시리아,2002-12
2002-12-31,22357565,3051058,19306507,스리랑카,2002-12
2002-12-31,21633127,11485424,10147703,우즈베키스탄,2002-12
2002-12-31,21109457,17024778,4084679,우크라이나,2002-12
2002-12-31,20647201,8390139,12257062,푸에르토리코,2002-12
2002-12-31,16765915,36738469,-19972554,알제리,2002-12
2002-12-31,16261419,204897788,-188636369,쿠웨이트,2002-12
2002-12-31,15615952,11035994,4579958,베네주엘라,2002-12
2002-12-31,15086937,54012,15032925,요르단,2002-12
2002-12-31,14780076,41892899,-27112823,덴마크,2002-12
2002-12-31,14610372,5682295,8928077,기타국,2002-12
2002-12-31,14281240,13500075,781165,페루,2002-12
2002-12-31,14210218,4540507,9669711,콜롬비아,2002-12
2002-12-31,14064033,1952989,12111044,미얀마,2002-12
2002-12-31,14018707,8188909,5829798,카자흐스탄,2002-12
2002-12-31,12267856,58809729,-46541873,노르웨이,2002-12
2002-12-31,12193190,182249439,-170056249,카타르,2002-12
2002-12-31,11956206,471621,11484585,온두라스,2002-12
2002-12-31,11508019,20625598,-9117579,파나마,2002-12
2002-12-31,10620822,4903233,5717589,코스타리카,2002-12
2002-12-31,10505265,1198465,9306800,루마니아,2002-12
2002-12-31,10371096,231477897,-221106801,오만,2002-12
2002-12-31,10267693,102880,10164813,괌,2002-12
2002-12-31,10154569,31070250,-20915681,에쿠아도르,2002-12
2002-12-31,9662730,3432979,6229751,모로코,2002-12
2002-12-31,9323936,244822,9079114,캄보디아,2002-12
2002-12-31,9272818,10731,9262087,니카라과,2002-12
2002-12-31,9028853,9293188,-264335,체코공화국,2002-12
2002-12-31,8512095,23370659,-14858564,아르헨티나,2002-12
2002-12-31,7559189,247219,7311970,북마리아나 군도,2002-12
2002-12-31,6962138,3068914,3893224,도미니카 공화국,2002-12
2002-12-31,6894240,23832882,-16938642,바레인,2002-12
2002-12-31,6615881,1891803,4724078,슬로바키아,2002-12
2002-12-31,6427318,0,6427318,아프카니스탄,2002-12
2002-12-31,6172778,577475,5595303,몽골,2002-12
2002-12-31,5867984,344469,5523515,엘살바도르,2002-12
2002-12-31,5576194,472304,5103890,레바논,2002-12
2002-12-31,5069418,1834373,3235045,슬로베니아,2002-12
2002-12-31,5008047,34087,4973960,수단,2002-12
2002-12-31,4791669,149450,4642219,네팔,2002-12
2002-12-31,3802140,69312,3732828,케냐,2002-12
2002-12-31,3795165,50708935,-46913770,예맨,2002-12
2002-12-31,3552232,453022,3099210,크로아티아,2002-12
2002-12-31,3524036,1062789,2461247,불가리아,2002-12
2002-12-31,3462447,394502,3067945,우루과이,2002-12
2002-12-31,3192210,164985,3027225,마카오,2002-12
2002-12-31,2885136,17104,2868032,가나,2002-12
2002-12-31,2849772,188440,2661332,튀니지,2002-12
2002-12-31,2490874,696541,1794333,리투아니아,2002-12
2002-12-31,2439848,85063,2354785,트리니다드 토바고,2002-12
2002-12-31,2427976,54255091,-51827115,브루나이,2002-12
2002-12-31,2310401,30987,2279414,코트디봐르,2002-12
2002-12-31,2242142,23692,2218450,키르기스스탄,2002-12
2002-12-31,1854326,0,1854326,베닝,2002-12
2002-12-31,1789937,1173579,616358,에스토니아,2002-12
2002-12-31,1522637,0,1522637,앙골라,2002-12
2002-12-31,1505107,36438,1468669,탄자니아,2002-12
2002-12-31,1458357,1529,1456828,아이티,2002-12
2002-12-31,1434715,0,1434715,투르크멘,2002-12
2002-12-31,1371385,89666,1281719,라트비아,2002-12
2002-12-31,1363429,214,1363215,모리셔스,2002-12
2002-12-31,1332608,52999,1279609,에티오피아,2002-12
2002-12-31,1331638,0,1331638,토고,2002-12
2002-12-31,1307216,8605549,-7298333,기니,2002-12
2002-12-31,1227388,0,1227388,마티니크,2002-12
2002-12-31,1108569,0,1108569,영령 버진군도,2002-12
2002-12-31,1044658,81313,963345,파라과이,2002-12
2002-12-31,1013540,254,1013286,불령 리유니온 코모도 제도,2002-12
2002-12-31,974349,0,974349,아제르바이잔,2002-12
2002-12-31,948822,181770,767052,아이슬란드,2002-12
2002-12-31,921707,172569,749138,세네갈,2002-12
2002-12-31,825167,91574,733593,자마이카,2002-12
2002-12-31,814020,4469071,-3655051,스와질랜드,2002-12
2002-12-31,800810,0,800810,지부티,2002-12
2002-12-31,756771,2105,754666,과델로프,2002-12
2002-12-31,700289,299534,400755,벨라루스,2002-12
2002-12-31,683358,34174,649184,유고,2002-12
2002-12-31,680207,2594838,-1914631,뉴 칼레도니아,2002-12
2002-12-31,671389,21385,650004,마다카스카르,2002-12
2002-12-31,580010,124701,455309,타지크,2002-12
2002-12-31,540516,0,540516,아루바,2002-12
2002-12-31,530854,0,530854,마이크로네시아,2002-12
2002-12-31,496349,2446086,-1949737,룩셈부르그,2002-12
2002-12-31,491607,53489,438118,라오스,2002-12
2002-12-31,466030,328738,137292,볼리비아,2002-12
2002-12-31,462811,52658,410153,우간다,2002-12
2002-12-31,442269,4637522,-4195253,파푸아 뉴기니,2002-12
2002-12-31,438428,5870,432558,도미니카,2002-12
2002-12-31,416052,142191,273861,피지,2002-12
2002-12-31,412267,103497,308770,카메룬,2002-12
2002-12-31,391677,463235,-71558,짐바브웨,2002-12
2002-12-31,383234,79233012,-78849778,콩고,2002-12
2002-12-31,348395,289094,59301,잠비아,2002-12
2002-12-31,331339,8819,322520,바베이도스,2002-12
2002-12-31,320393,0,320393,니제르,2002-12
2002-12-31,308668,0,308668,모잠비크,2002-12
2002-12-31,306210,0,306210,마세도니아,2002-12
2002-12-31,283095,0,283095,보스니아-헤르체고비나,2002-12
2002-12-31,279314,1120,278194,팔라우,2002-12
2002-12-31,276289,0,276289,이라크,2002-12
2002-12-31,275047,46526,228521,불령 폴리네시아,2002-12
2002-12-31,265852,0,265852,모리타니,2002-12
2002-12-31,263856,0,263856,알바니아,2002-12
2002-12-31,263455,76085,187370,벨리제,2002-12
2002-12-31,238202,0,238202,사모아,2002-12
2002-12-31,229389,18373,211016,보츠와나,2002-12
2002-12-31,214873,0,214873,불령 가이아나,2002-12
2002-12-31,213480,0,213480,말라위,2002-12
2002-12-31,211103,0,211103,레소토,2002-12
2002-12-31,192722,915,191807,네덜란드 열도,2002-12
2002-12-31,177809,289490,-111681,나미비아,2002-12
2002-12-31,175934,0,175934,아르메니아,2002-12
2002-12-31,157767,0,157767,에리트리아,2002-12
2002-12-31,140003,456399,-316396,아메리칸 사모아,2002-12
2002-12-31,132225,2032,130193,몰디브,2002-12
2002-12-31,119146,53316,65830,감비아,2002-12
2002-12-31,116651,0,116651,수리남,2002-12
2002-12-31,111477,642386,-530909,가봉,2002-12
2002-12-31,103413,0,103413,르완다,2002-12
2002-12-31,101782,0,101782,미령 버진군도,2002-12
2002-12-31,98739,1272,97467,영령 캐이맨 군도,2002-12
2002-12-31,94870,0,94870,시에라 리온,2002-12
2002-12-31,92818,240623,-147805,조지아,2002-12
2002-12-31,86421,258,86163,가이아나,2002-12
2002-12-31,80247,0,80247,소말리아,2002-12
2002-12-31,75033,1266181,-1191148,솔로몬 군도,2002-12
2002-12-31,64638,0,64638,부룬디,2002-12
2002-12-31,58684,0,58684,부르키나 파소,2002-12
2002-12-31,51794,107339,-55545,안도라,2002-12
2002-12-31,50752,0,50752,그레나다,2002-12
2002-12-31,49613,337530,-287917,리히텐슈타인,2002-12
2002-12-31,47732,0,47732,부탄,2002-12
2002-12-31,45448,0,45448,중앙아프리카공화국,2002-12
2002-12-31,35296,0,35296,세인트 루시아,2002-12
2002-12-31,34931,0,34931,쿡 아일랜드,2002-12
2002-12-31,34893,0,34893,바누아투,2002-12
2002-12-31,27121,0,27121,카보 베르데,2002-12
2002-12-31,26965,103916,-76951,말리,2002-12
2002-12-31,26100,0,26100,투발루,2002-12
2002-12-31,21858,3829,18029,몰도바,2002-12
2002-12-31,18965,0,18965,중립지대,2002-12
2002-12-31,17130,0,17130,키리바티,2002-12
2002-12-31,15524,0,15524,세인트 빈센트 그레나딘,2002-12
2002-12-31,15318,0,15318,버뮤다,2002-12
2002-12-31,14800,0,14800,투르크 & 카이코스 군도,2002-12
2002-12-31,11559,0,11559,통가,2002-12
2002-12-31,9900,12236,-2336,콩고민주공화국,2002-12
2002-12-31,9300,0,9300,티모르,2002-12
2002-12-31,8524,0,8524,상토메 프린스페,2002-12
2002-12-31,6969,196659,-189690,토켈라우,2002-12
2002-12-31,4166,66384,-62218,산마리노,2002-12
2002-12-31,2525,872273,-869748,모나코,2002-12
2002-12-31,2273,49500,-47227,팔레스타인 해방기구(구),2002-12
2002-12-31,715,0,715,지브랄타,2002-12
2002-12-31,0,88,-88,코스 군도,2002-12
2002-12-31,0,1244984,-1244984,나우루,2002-12
2002-12-31,0,850,-850,적도 기니,2002-12
2002-12-31,0,53323,-53323,세이쉘,2002-12
2002-12-31,0,153,-153,존스톤 아일랜드,2002-12
2002-12-31,0,6590,-6590,보빗군도,2002-12
2002-12-31,0,4556,-4556,세인트 키츠 네비스,2002-12
2002-12-31,0,58711,-58711,그린랜드,2002-12
2003-01-31,2612314009,2061341219,550972790,미국,2003-01
2003-01-31,2289754881,1666810732,622944149,중국,2003-01
2003-01-31,1395928617,2526910476,-1130981859,일본,2003-01
2003-01-31,882496951,172945258,709551693,홍콩,2003-01
2003-01-31,540088089,500657567,39430522,대만,2003-01
2003-01-31,397993732,220391675,177602057,영국,2003-01
2003-01-31,371340074,499299122,-127959048,독일,2003-01
2003-01-31,315575438,359491246,-43915808,싱가포르,2003-01
2003-01-31,298556994,491360990,-192803996,인도네시아,2003-01
2003-01-31,250021175,405169860,-155148685,말레이시아,2003-01
2003-01-31,249152900,141549650,107603250,필리핀,2003-01
2003-01-31,222487826,87703771,134784055,네덜란드,2003-01
2003-01-31,203113060,187292922,15820138,이탈리아,2003-01
2003-01-31,200528752,189269,200339483,파나마,2003-01
2003-01-31,192293508,138361411,53932097,캐나다,2003-01
2003-01-31,185200664,141926934,43273730,태국,2003-01
2003-01-31,176888636,147243104,29645532,이란,2003-01
2003-01-31,176197876,554795305,-378597429,호주,2003-01
2003-01-31,170596628,19822279,150774349,멕시코,2003-01
2003-01-31,162377951,139,162377812,버뮤다,2003-01
2003-01-31,160001619,41718753,118282866,베트남,2003-01
2003-01-31,158011002,42108818,115902184,노르웨이,2003-01
2003-01-31,155965881,93154103,62811778,인도,2003-01
2003-01-31,155270493,460661535,-305391042,아랍에미리트 연합,2003-01
2003-01-31,145113194,33177505,111935689,스페인,2003-01
2003-01-31,132409092,16460725,115948367,그리스,2003-01
2003-01-31,128402345,179244589,-50842244,프랑스,2003-01
2003-01-31,98489115,934031077,-835541962,사우디아라비아,2003-01
2003-01-31,93054148,96726408,-3672260,벨기에,2003-01
2003-01-31,89596386,98427703,-8831317,브라질,2003-01
2003-01-31,88045692,221132767,-133087075,러시아 연방,2003-01
2003-01-31,86845831,48734308,38111523,스웨덴,2003-01
2003-01-31,77753164,97624071,-19870907,스위스,2003-01
2003-01-31,72644665,4604142,68040523,나이지리아,2003-01
2003-01-31,72040322,79796,71960526,사이프러스,2003-01
2003-01-31,70818032,27290223,43527809,핀란드,2003-01
2003-01-31,69383552,5322977,64060575,튀르키예,2003-01
2003-01-31,65161046,31284,65129762,라이베리아,2003-01
2003-01-31,51868555,37163230,14705325,아일랜드,2003-01
2003-01-31,45628507,24748474,20880033,이스라엘,2003-01
2003-01-31,44741063,23355743,21385320,파키스탄,2003-01
2003-01-31,44235451,1417,44234034,마샬군도,2003-01
2003-01-31,41848902,1648856,40200046,과테말라,2003-01
2003-01-31,41550131,81541518,-39991387,칠레,2003-01
2003-01-31,40943492,7921372,33022120,헝가리,2003-01
2003-01-31,39060194,1735735,37324459,방글라데시,2003-01
2003-01-31,35940751,300061384,-264120633,카타르,2003-01
2003-01-31,33401248,73810402,-40409154,남아프리카공화국,2003-01
2003-01-31,32668451,731,32667720,영령 캐이맨 군도,2003-01
2003-01-31,31812303,67943060,-36130757,뉴질랜드,2003-01
2003-01-31,31706031,8313530,23392501,폴란드,2003-01
2003-01-31,30306566,15429842,14876724,이집트,2003-01
2003-01-31,26618866,11720048,14898818,몰타,2003-01
2003-01-31,26413968,27911122,-1497154,오스트리아,2003-01
2003-01-31,23745285,36705522,-12960237,덴마크,2003-01
2003-01-31,21945152,24522938,-2577786,우크라이나,2003-01
2003-01-31,20769671,2074719,18694952,스리랑카,2003-01
2003-01-31,20522207,24166043,-3643836,페루,2003-01
2003-01-31,20142342,179639,19962703,시리아,2003-01
2003-01-31,18849340,7756595,11092745,콜롬비아,2003-01
2003-01-31,16716597,2974065,13742532,포루투갈,2003-01
2003-01-31,16099822,8449356,7650466,카자흐스탄,2003-01
2003-01-31,14084219,2346405,11737814,요르단,2003-01
2003-01-31,13684300,522475,13161825,리비아,2003-01
2003-01-31,13025765,255868517,-242842752,쿠웨이트,2003-01
2003-01-31,12783354,229841,12553513,온두라스,2003-01
2003-01-31,12388919,8127600,4261319,체코공화국,2003-01
2003-01-31,11851043,1281229,10569814,기타국,2003-01
2003-01-31,11664883,0,11664883,아프카니스탄,2003-01
2003-01-31,11459863,1234762,10225101,미얀마,2003-01
2003-01-31,11214481,8519716,2694765,우즈베키스탄,2003-01
2003-01-31,11187850,23397301,-12209451,알제리,2003-01
2003-01-31,11156194,4283438,6872756,푸에르토리코,2003-01
2003-01-31,8733411,15905432,-7172021,에쿠아도르,2003-01
2003-01-31,8680070,1876680,6803390,루마니아,2003-01
2003-01-31,8630236,2309337,6320899,모로코,2003-01
2003-01-31,8170504,5914912,2255592,코스타리카,2003-01
2003-01-31,8131569,195437,7936132,캄보디아,2003-01
2003-01-31,7725352,19013,7706339,네팔,2003-01
2003-01-31,7336133,60821777,-53485644,아르헨티나,2003-01
2003-01-31,7263296,1229163,6034133,슬로바키아,2003-01
2003-01-31,7068748,500054,6568694,레바논,2003-01
2003-01-31,6714764,273900293,-267185529,오만,2003-01
2003-01-31,6614473,1660201,4954272,슬로베니아,2003-01
2003-01-31,6069861,61727,6008134,북마리아나 군도,2003-01
2003-01-31,6036591,0,6036591,니카라과,2003-01
2003-01-31,5468258,30850111,-25381853,예맨,2003-01
2003-01-31,5272036,4081680,1190356,도미니카 공화국,2003-01
2003-01-31,5197940,157683,5040257,크로아티아,2003-01
2003-01-31,5186026,5169599,16427,베네주엘라,2003-01
2003-01-31,4934883,188784,4746099,케냐,2003-01
2003-01-31,4619200,1667966,2951234,엘살바도르,2003-01
2003-01-31,4435822,188020,4247802,몽골,2003-01
2003-01-31,4117317,30492528,-26375211,바레인,2003-01
2003-01-31,3987105,1039399,2947706,리투아니아,2003-01
2003-01-31,3260225,891112,2369113,우루과이,2003-01
2003-01-31,3205008,821455,2383553,불가리아,2003-01
2003-01-31,3145737,0,3145737,수단,2003-01
2003-01-31,2876403,1423910,1452493,가나,2003-01
2003-01-31,2856038,314494,2541544,튀니지,2003-01
2003-01-31,2651014,11324379,-8673365,괌,2003-01
2003-01-31,2446188,768889,1677299,에스토니아,2003-01
2003-01-31,2235672,397606,1838066,마카오,2003-01
2003-01-31,2226640,42957,2183683,키르기스스탄,2003-01
2003-01-31,2219983,26622,2193361,투르크멘,2003-01
2003-01-31,2040451,62192590,-60152139,브루나이,2003-01
2003-01-31,2007057,32059,1974998,코트디봐르,2003-01
2003-01-31,1900816,1009,1899807,불령 리유니온 코모도 제도,2003-01
2003-01-31,1657171,0,1657171,마티니크,2003-01
2003-01-31,1621337,0,1621337,베닝,2003-01
2003-01-31,1571182,70521,1500661,탄자니아,2003-01
2003-01-31,1564799,54526,1510273,에티오피아,2003-01
2003-01-31,1543846,16204,1527642,파라과이,2003-01
2003-01-31,1539121,55789,1483332,모리셔스,2003-01
2003-01-31,1534092,11283,1522809,유고,2003-01
2003-01-31,1498330,0,1498330,과델로프,2003-01
2003-01-31,1469944,0,1469944,아이티,2003-01
2003-01-31,1458207,51681,1406526,마다카스카르,2003-01
2003-01-31,1245793,4469053,-3223260,스와질랜드,2003-01
2003-01-31,1206131,46153,1159978,트리니다드 토바고,2003-01
2003-01-31,1096595,114077,982518,라트비아,2003-01
2003-01-31,1090248,38417778,-37327530,앙골라,2003-01
2003-01-31,1087213,15309,1071904,토고,2003-01
2003-01-31,1055088,19295,1035793,자마이카,2003-01
2003-01-31,985327,2816211,-1830884,뉴 칼레도니아,2003-01
2003-01-31,887608,350812,536796,세네갈,2003-01
2003-01-31,833720,294178,539542,아이슬란드,2003-01
2003-01-31,816750,468,816282,도미니카,2003-01
2003-01-31,768689,66986,701703,카메룬,2003-01
2003-01-31,756163,1678794,-922631,파푸아 뉴기니,2003-01
2003-01-31,715496,892240,-176744,짐바브웨,2003-01
2003-01-31,700383,508156,192227,잠비아,2003-01
2003-01-31,688999,0,688999,아루바,2003-01
2003-01-31,638655,0,638655,마이크로네시아,2003-01
2003-01-31,621015,7048,613967,바하마,2003-01
2003-01-31,595231,2039820,-1444589,룩셈부르그,2003-01
2003-01-31,584223,5650,578573,팔라우,2003-01
2003-01-31,552032,54929298,-54377266,콩고,2003-01
2003-01-31,546334,0,546334,가이아나,2003-01
2003-01-31,534899,0,534899,보스니아-헤르체고비나,2003-01
2003-01-31,518421,0,518421,불령 가이아나,2003-01
2003-01-31,474720,96322,378398,피지,2003-01
2003-01-31,435624,12324,423300,라오스,2003-01
2003-01-31,423795,7477107,-7053312,볼리비아,2003-01
2003-01-31,355474,261180,94294,타지크,2003-01
2003-01-31,352852,0,352852,불령 폴리네시아,2003-01
2003-01-31,348572,0,348572,아제르바이잔,2003-01
2003-01-31,336235,96060,240175,모잠비크,2003-01
2003-01-31,326237,0,326237,바베이도스,2003-01
2003-01-31,299036,0,299036,사모아,2003-01
2003-01-31,290465,16223,274242,우간다,2003-01
2003-01-31,255792,30867170,-30611378,기니,2003-01
2003-01-31,253935,3451262,-3197327,벨라루스,2003-01
2003-01-31,236665,133085,103580,소말리아,2003-01
2003-01-31,228602,20159,208443,안티가 바부다,2003-01
2003-01-31,216452,163,216289,에리트리아,2003-01
2003-01-31,199554,988,198566,마세도니아,2003-01
2003-01-31,192585,0,192585,아메리칸 사모아,2003-01
2003-01-31,172236,0,172236,말라위,2003-01
2003-01-31,167423,3380,164043,벨리제,2003-01
2003-01-31,166195,0,166195,부룬디,2003-01
2003-01-31,164338,91142,73196,모리타니,2003-01
2003-01-31,159293,1241,158052,수리남,2003-01
2003-01-31,148313,0,148313,레소토,2003-01
2003-01-31,147951,1021762,-873811,조지아,2003-01
2003-01-31,141713,0,141713,부탄,2003-01
2003-01-31,139587,1659271,-1519684,가봉,2003-01
2003-01-31,129433,26969,102464,팔레스타인 해방기구(구),2003-01
2003-01-31,120606,0,120606,콩고민주공화국,2003-01
2003-01-31,115439,36601,78838,보츠와나,2003-01
2003-01-31,107848,0,107848,알바니아,2003-01
2003-01-31,100790,0,100790,영령 버진군도,2003-01
2003-01-31,96522,539,95983,니제르,2003-01
2003-01-31,95308,0,95308,몰디브,2003-01
2003-01-31,93463,18698,74765,아르메니아,2003-01
2003-01-31,86225,167380,-81155,감비아,2003-01
2003-01-31,78885,412,78473,네덜란드 열도,2003-01
2003-01-31,76578,0,76578,이라크,2003-01
2003-01-31,71192,0,71192,티모르,2003-01
2003-01-31,54856,4687,50169,나우루,2003-01
2003-01-31,54648,0,54648,지브랄타,2003-01
2003-01-31,51800,11128,40672,중앙아프리카공화국,2003-01
2003-01-31,48989,0,48989,바누아투,2003-01
2003-01-31,47556,0,47556,세인트 빈센트 그레나딘,2003-01
2003-01-31,44784,0,44784,몰도바,2003-01
2003-01-31,40320,0,40320,보빗군도,2003-01
2003-01-31,39792,158156,-118364,나미비아,2003-01
2003-01-31,38970,0,38970,르완다,2003-01
2003-01-31,34646,6067,28579,시에라 리온,2003-01
2003-01-31,33601,0,33601,세인트 루시아,2003-01
2003-01-31,28000,410357,-382357,말리,2003-01
2003-01-31,27367,0,27367,통가,2003-01
2003-01-31,27300,7450,19850,쿡 아일랜드,2003-01
2003-01-31,20880,37303,-16423,부르키나 파소,2003-01
2003-01-31,19053,399,18654,프랑스 메트로폴리탄,2003-01
2003-01-31,18162,0,18162,지부티,2003-01
2003-01-31,16852,548,16304,토켈라우,2003-01
2003-01-31,15629,1989452,-1973823,솔로몬 군도,2003-01
2003-01-31,14081,0,14081,그레나다,2003-01
2003-01-31,10612,24125,-13513,리히텐슈타인,2003-01
2003-01-31,8585,0,8585,포클랜드 군도,2003-01
2003-01-31,7372,0,7372,코모로스,2003-01
2003-01-31,6434,0,6434,세인트 키츠 네비스,2003-01
2003-01-31,4725,7590,-2865,상토메 프린스페,2003-01
2003-01-31,3860,7905,-4045,안도라,2003-01
2003-01-31,3413,0,3413,미령 버진군도,2003-01
2003-01-31,2112,0,2112,세인트 헬레나,2003-01
2003-01-31,2100,0,2100,투르크 & 카이코스 군도,2003-01
2003-01-31,967,0,967,세이쉘,2003-01
2003-01-31,588,0,588,앙귈라,2003-01
2003-01-31,0,17854,-17854,마이너 아우틀링 합중국 군도,2003-01
2003-01-31,0,65100,-65100,산마리노,2003-01
2003-01-31,0,2671567,-2671567,교황청,2003-01
2003-01-31,0,847925,-847925,모나코,2003-01
2003-01-31,0,101222,-101222,그린랜드,2003-01
2003-01-31,0,276,-276,코스 군도,2003-01
2003-02-28,2383517948,2046860867,336657081,미국,2003-02
2003-02-28,2379306564,1397214525,982092039,중국,2003-02
2003-02-28,1225944611,2915663321,-1689718710,일본,2003-02
2003-02-28,892958358,175748306,717210052,홍콩,2003-02
2003-02-28,466338519,444305551,22032968,대만,2003-02
2003-02-28,426675413,481277673,-54602260,독일,2003-02
2003-02-28,310566325,168862475,141703850,영국,2003-02
2003-02-28,294916731,100914011,194002720,인도,2003-02
2003-02-28,283230301,331522426,-48292125,싱가포르,2003-02
2003-02-28,239599015,414754884,-175155869,인도네시아,2003-02
2003-02-28,237593706,365477734,-127884028,말레이시아,2003-02
2003-02-28,233643815,153916697,79727118,필리핀,2003-02
2003-02-28,228825949,153323914,75502035,네덜란드,2003-02
2003-02-28,222052583,198811989,23240594,이탈리아,2003-02
2003-02-28,205345989,430062033,-224716044,호주,2003-02
2003-02-28,202216014,140437369,61778645,캐나다,2003-02
2003-02-28,201437855,7061283,194376572,그리스,2003-02
2003-02-28,178559479,21883334,156676145,멕시코,2003-02
2003-02-28,177835527,149325918,28509609,태국,2003-02
2003-02-28,174049075,36739401,137309674,스페인,2003-02
2003-02-28,168340812,36634057,131706755,베트남,2003-02
2003-02-28,145393501,538692053,-393298552,아랍에미리트 연합,2003-02
2003-02-28,118386963,175493661,-57106698,프랑스,2003-02
2003-02-28,108682823,154866345,-46183522,러시아 연방,2003-02
2003-02-28,100949556,80881335,20068221,브라질,2003-02
2003-02-28,96219087,714322353,-618103266,사우디아라비아,2003-02
2003-02-28,96199599,161798408,-65598809,이란,2003-02
2003-02-28,91544192,54651493,36892699,벨기에,2003-02
2003-02-28,89045467,34623587,54421880,핀란드,2003-02
2003-02-28,73341778,41280965,32060813,아일랜드,2003-02
2003-02-28,71810260,0,71810260,라이베리아,2003-02
2003-02-28,71411504,5739653,65671851,튀르키예,2003-02
2003-02-28,57849325,19466,57829859,마샬군도,2003-02
2003-02-28,53494701,118264172,-64769471,스위스,2003-02
2003-02-28,44567005,71747936,-27180931,칠레,2003-02
2003-02-28,43144187,30455186,12689001,파키스탄,2003-02
2003-02-28,42495934,85913,42410021,나이지리아,2003-02
2003-02-28,40169396,4958060,35211336,헝가리,2003-02
2003-02-28,37988650,17912420,20076230,이스라엘,2003-02
2003-02-28,37351254,2147053,35204201,방글라데시,2003-02
2003-02-28,35314892,50766754,-15451862,남아프리카공화국,2003-02
2003-02-28,35297613,13501356,21796257,과테말라,2003-02
2003-02-28,32309230,25778315,6530915,이집트,2003-02
2003-02-28,30717150,4684316,26032834,폴란드,2003-02
2003-02-28,28476557,52794175,-24317618,뉴질랜드,2003-02
2003-02-28,28012206,41149896,-13137690,스웨덴,2003-02
2003-02-28,24992212,26026,24966186,바하마,2003-02
2003-02-28,24171192,28061640,-3890448,오스트리아,2003-02
2003-02-28,23827635,2035883,21791752,기타국,2003-02
2003-02-28,23647641,3297501,20350140,스리랑카,2003-02
2003-02-28,22283024,26646807,-4363783,우크라이나,2003-02
2003-02-28,19984299,6493682,13490617,콜롬비아,2003-02
2003-02-28,19434342,26062118,-6627776,덴마크,2003-02
2003-02-28,19428944,205220430,-185791486,쿠웨이트,2003-02
2003-02-28,18905131,26982327,-8077196,알제리,2003-02
2003-02-28,18499659,2366207,16133452,파나마,2003-02
2003-02-28,18014744,11018973,6995771,페루,2003-02
2003-02-28,17050818,3224250,13826568,포루투갈,2003-02
2003-02-28,17007476,145961,16861515,시리아,2003-02
2003-02-28,16485122,236717264,-220232142,카타르,2003-02
2003-02-28,13676393,20504873,-6828480,에쿠아도르,2003-02
2003-02-28,12857769,4350171,8507598,카자흐스탄,2003-02
2003-02-28,11985249,1673697,10311552,요르단,2003-02
2003-02-28,10033921,5217195,4816726,우즈베키스탄,2003-02
2003-02-28,9785451,1392854,8392597,미얀마,2003-02
2003-02-28,9725606,88794788,-79069182,노르웨이,2003-02
2003-02-28,9562746,6935645,2627101,체코공화국,2003-02
2003-02-28,9506435,0,9506435,아프카니스탄,2003-02
2003-02-28,8865749,1189667,7676082,슬로베니아,2003-02
2003-02-28,8604512,6406819,2197693,코스타리카,2003-02
2003-02-28,8385073,5072131,3312942,모로코,2003-02
2003-02-28,8268547,8294680,-26133,푸에르토리코,2003-02
2003-02-28,8042154,44336366,-36294212,아르헨티나,2003-02
2003-02-28,7458348,1000892,6457456,온두라스,2003-02
2003-02-28,7184756,2649980,4534776,루마니아,2003-02
2003-02-28,7010889,806842,6204047,리비아,2003-02
2003-02-28,6990643,230208298,-223217655,오만,2003-02
2003-02-28,6904640,719649,6184991,슬로바키아,2003-02
2003-02-28,6670913,188337,6482576,몽골,2003-02
2003-02-28,6098495,175535,5922960,캄보디아,2003-02
2003-02-28,5855104,1959587,3895517,도미니카 공화국,2003-02
2003-02-28,5294640,4966281,328359,엘살바도르,2003-02
2003-02-28,5037628,0,5037628,수단,2003-02
2003-02-28,5001961,0,5001961,니카라과,2003-02
2003-02-28,4789785,21159,4768626,북마리아나 군도,2003-02
2003-02-28,4645187,675791,3969396,가나,2003-02
2003-02-28,4232853,350320,3882533,크로아티아,2003-02
2003-02-28,4216922,5200532,-983610,바레인,2003-02
2003-02-28,4213393,646797,3566596,레바논,2003-02
2003-02-28,4064610,418771,3645839,리투아니아,2003-02
2003-02-28,3997724,0,3997724,투르크멘,2003-02
2003-02-28,3721455,955365,2766090,불가리아,2003-02
2003-02-28,3578588,310869,3267719,튀니지,2003-02
2003-02-28,3402268,66256,3336012,라트비아,2003-02
2003-02-28,3390083,32989154,-29599071,예맨,2003-02
2003-02-28,2990430,101254,2889176,케냐,2003-02
2003-02-28,2972847,628143,2344704,우루과이,2003-02
2003-02-28,2695352,80,2695272,트리니다드 토바고,2003-02
2003-02-28,2667902,16152,2651750,키르기스스탄,2003-02
2003-02-28,2618686,100322,2518364,괌,2003-02
2003-02-28,2390278,55592604,-53202326,브루나이,2003-02
2003-02-28,2381527,799232,1582295,에스토니아,2003-02
2003-02-28,2331515,522053,1809462,마카오,2003-02
2003-02-28,2307300,232609,2074691,사이프러스,2003-02
2003-02-28,2180836,215564,1965272,베네주엘라,2003-02
2003-02-28,1838219,102947,1735272,에티오피아,2003-02
2003-02-28,1754889,30711797,-28956908,앙골라,2003-02
2003-02-28,1546632,1442537,104095,짐바브웨,2003-02
2003-02-28,1191696,907,1190789,유고,2003-02
2003-02-28,1154129,2968,1151161,도미니카,2003-02
2003-02-28,1152364,1434445,-282081,룩셈부르그,2003-02
2003-02-28,1146380,40992,1105388,네팔,2003-02
2003-02-28,1141839,3193217,-2051378,스와질랜드,2003-02
2003-02-28,1072644,74807,997837,탄자니아,2003-02
2003-02-28,1062982,42333,1020649,파라과이,2003-02
2003-02-28,1028357,15374,1012983,모리셔스,2003-02
2003-02-28,946842,13055,933787,아이티,2003-02
2003-02-28,936750,145,936605,베닝,2003-02
2003-02-28,919680,0,919680,이라크,2003-02
2003-02-28,899894,96035,803859,자마이카,2003-02
2003-02-28,893908,3767611,-2873703,몰타,2003-02
2003-02-28,883511,3474249,-2590738,뉴 칼레도니아,2003-02
2003-02-28,882413,0,882413,아제르바이잔,2003-02
2003-02-28,871458,0,871458,코트디봐르,2003-02
2003-02-28,852367,0,852367,사모아,2003-02
2003-02-28,808239,0,808239,아메리칸 사모아,2003-02
2003-02-28,800019,0,800019,아루바,2003-02
2003-02-28,792825,0,792825,불령 리유니온 코모도 제도,2003-02
2003-02-28,785716,16,785700,토고,2003-02
2003-02-28,779471,133712,645759,카메룬,2003-02
2003-02-28,756192,58174127,-57417935,콩고,2003-02
2003-02-28,709201,0,709201,지부티,2003-02
2003-02-28,704840,20570,684270,피지,2003-02
2003-02-28,692804,402095,290709,볼리비아,2003-02
2003-02-28,687894,825999,-138105,아이슬란드,2003-02
2003-02-28,661845,48343550,-47681705,기니,2003-02
2003-02-28,641585,66486,575099,마다카스카르,2003-02
2003-02-28,637530,0,637530,과델로프,2003-02
2003-02-28,549937,855,549082,알바니아,2003-02
2003-02-28,509040,231356,277684,세네갈,2003-02
2003-02-28,466029,822746,-356717,벨라루스,2003-02
2003-02-28,430991,1284,429707,마이크로네시아,2003-02
2003-02-28,415943,89780,326163,니제르,2003-02
2003-02-28,413491,2263,411228,우간다,2003-02
2003-02-28,397353,7439455,-7042102,파푸아 뉴기니,2003-02
2003-02-28,374613,30628,343985,불령 폴리네시아,2003-02
2003-02-28,372981,0,372981,팔라우,2003-02
2003-02-28,305429,323536,-18107,조지아,2003-02
2003-02-28,290340,289984,356,타지크,2003-02
2003-02-28,277329,0,277329,모잠비크,2003-02
2003-02-28,261386,0,261386,벨리제,2003-02
2003-02-28,259219,0,259219,모리타니,2003-02
2003-02-28,256313,0,256313,불령 가이아나,2003-02
2003-02-28,237039,0,237039,마티니크,2003-02
2003-02-28,228107,9062,219045,가이아나,2003-02
2003-02-28,212962,1329,211633,보스니아-헤르체고비나,2003-02
2003-02-28,206724,0,206724,영령 캐이맨 군도,2003-02
2003-02-28,202814,0,202814,마세도니아,2003-02
2003-02-28,202388,1216238,-1013850,솔로몬 군도,2003-02
2003-02-28,197970,2062,195908,에리트리아,2003-02
2003-02-28,192655,107,192548,바베이도스,2003-02
2003-02-28,185444,0,185444,아르메니아,2003-02
2003-02-28,185132,0,185132,라오스,2003-02
2003-02-28,178516,12340,166176,수리남,2003-02
2003-02-28,176395,0,176395,몰디브,2003-02
2003-02-28,168137,436,167701,지브랄타,2003-02
2003-02-28,166365,1669,164696,네덜란드 열도,2003-02
2003-02-28,154303,923378,-769075,가봉,2003-02
2003-02-28,137525,0,137525,안티가 바부다,2003-02
2003-02-28,129034,0,129034,소말리아,2003-02
2003-02-28,120982,2655,118327,팔레스타인 해방기구(구),2003-02
2003-02-28,112510,0,112510,부룬디,2003-02
2003-02-28,102593,0,102593,몰도바,2003-02
2003-02-28,98906,3245,95661,레소토,2003-02
2003-02-28,85426,8000,77426,시에라 리온,2003-02
2003-02-28,82883,0,82883,말리,2003-02
2003-02-28,77075,51082,25993,보츠와나,2003-02
2003-02-28,61982,4163572,-4101590,잠비아,2003-02
2003-02-28,56425,0,56425,부탄,2003-02
2003-02-28,55902,177728,-121826,안도라,2003-02
2003-02-28,49452,0,49452,세인트 루시아,2003-02
2003-02-28,46957,1250,45707,세인트 빈센트 그레나딘,2003-02
2003-02-28,40722,2889,37833,토켈라우,2003-02
2003-02-28,40039,0,40039,투발루,2003-02
2003-02-28,38761,0,38761,상토메 프린스페,2003-02
2003-02-28,37330,3347,33983,감비아,2003-02
2003-02-28,36009,0,36009,바누아투,2003-02
2003-02-28,34550,0,34550,말라위,2003-02
2003-02-28,27300,0,27300,쿡 아일랜드,2003-02
2003-02-28,23834,0,23834,키리바티,2003-02
2003-02-28,17096,0,17096,그레나다,2003-02
2003-02-28,16307,0,16307,티모르,2003-02
2003-02-28,16240,242566,-226326,리히텐슈타인,2003-02
2003-02-28,12065,0,12065,통가,2003-02
2003-02-28,7275,176343,-169068,나미비아,2003-02
2003-02-28,6339,405264,-398925,부르키나 파소,2003-02
2003-02-28,2790,4572763,-4569973,버뮤다,2003-02
2003-02-28,1859,0,1859,세이쉘,2003-02
2003-02-28,612,0,612,노폴크 아일랜드,2003-02
2003-02-28,388,0,388,투르크 & 카이코스 군도,2003-02
2003-02-28,109,0,109,영령 버진군도,2003-02
2003-02-28,0,724128,-724128,모나코,2003-02
2003-02-28,0,164128,-164128,그린랜드,2003-02
2003-02-28,0,668141,-668141,나우루,2003-02
2003-02-28,0,0,0,중앙아프리카공화국,2003-02
2003-02-28,0,8120,-8120,존스톤 아일랜드,2003-02
2003-02-28,0,667906,-667906,교황청,2003-02
2003-02-28,0,32623,-32623,몬트세라트,2003-02
2003-02-28,0,13294,-13294,코스 군도,2003-02
2003-02-28,0,6984,-6984,미드웨이 군도,2003-02
2003-03-31,2749138408,2164395240,584743168,미국,2003-03
2003-03-31,2659292622,1774908027,884384595,중국,2003-03
2003-03-31,1371507580,3045529018,-1674021438,일본,2003-03
2003-03-31,1072609239,230628557,841980682,홍콩,2003-03
2003-03-31,545374748,504171324,41203424,대만,2003-03
2003-03-31,436813659,552049685,-115236026,독일,2003-03
2003-03-31,381502299,357282295,24220004,싱가포르,2003-03
2003-03-31,309657778,182616675,127041103,영국,2003-03
2003-03-31,291912486,510121251,-218208765,인도네시아,2003-03
2003-03-31,274398975,361957736,-87558761,말레이시아,2003-03
2003-03-31,266445668,161325274,105120394,필리핀,2003-03
2003-03-31,252511469,38700273,213811196,베트남,2003-03
2003-03-31,245954531,2205,245952326,바하마,2003-03
2003-03-31,236484509,118042102,118442407,인도,2003-03
2003-03-31,222319284,157412445,64906839,네덜란드,2003-03
2003-03-31,218092275,430087831,-211995556,호주,2003-03
2003-03-31,208512710,24645807,183866903,멕시코,2003-03
2003-03-31,205291049,142998815,62292234,캐나다,2003-03
2003-03-31,201313286,196261790,5051496,이탈리아,2003-03
2003-03-31,199110193,155492623,43617570,태국,2003-03
2003-03-31,189553816,594548798,-404994982,아랍에미리트 연합,2003-03
2003-03-31,183555223,1278967,182276256,그리스,2003-03
2003-03-31,175235139,36165773,139069366,스페인,2003-03
2003-03-31,133282625,207570250,-74287625,러시아 연방,2003-03
2003-03-31,128504630,228122633,-99618003,프랑스,2003-03
2003-03-31,127124603,13151228,113973375,파나마,2003-03
2003-03-31,119247068,103040939,16206129,브라질,2003-03
2003-03-31,111967707,201818449,-89850742,이란,2003-03
2003-03-31,108396787,32875189,75521598,핀란드,2003-03
2003-03-31,106499095,904795757,-798296662,사우디아라비아,2003-03
2003-03-31,93575013,58145965,35429048,벨기에,2003-03
2003-03-31,85344644,309713219,-224368575,카타르,2003-03
2003-03-31,70089492,4347960,65741532,튀르키예,2003-03
2003-03-31,59456003,55639501,3816502,노르웨이,2003-03
2003-03-31,54628448,66447134,-11818686,아일랜드,2003-03
2003-03-31,53116737,291138981,-238022244,스위스,2003-03
2003-03-31,51716836,2288866,49427970,방글라데시,2003-03
2003-03-31,47750154,9990932,37759222,헝가리,2003-03
2003-03-31,46528915,18017571,28511344,과테말라,2003-03
2003-03-31,46264983,11033127,35231856,나이지리아,2003-03
2003-03-31,43385655,0,43385655,마샬군도,2003-03
2003-03-31,43316777,90580643,-47263866,칠레,2003-03
2003-03-31,40716454,24068955,16647499,이스라엘,2003-03
2003-03-31,36306740,55075922,-18769182,남아프리카공화국,2003-03
2003-03-31,36233376,27429181,8804195,이집트,2003-03
2003-03-31,35698098,72925296,-37227198,스웨덴,2003-03
2003-03-31,34200764,3412356,30788408,스와질랜드,2003-03
2003-03-31,34013967,30697,33983270,라이베리아,2003-03
2003-03-31,31187744,7411337,23776407,우크라이나,2003-03
2003-03-31,30155751,32850442,-2694691,파키스탄,2003-03
2003-03-31,29037414,30596051,-1558637,오스트리아,2003-03
2003-03-31,29004166,4354,28999812,바베이도스,2003-03
2003-03-31,28202416,3760951,24441465,콜롬비아,2003-03
2003-03-31,27476319,59446095,-31969776,뉴질랜드,2003-03
2003-03-31,26199301,6115736,20083565,폴란드,2003-03
2003-03-31,25501929,3084148,22417781,스리랑카,2003-03
2003-03-31,21794592,52456623,-30662031,알제리,2003-03
2003-03-31,20795442,11427043,9368399,우즈베키스탄,2003-03
2003-03-31,20369851,4095387,16274464,포루투갈,2003-03
2003-03-31,19602699,8448048,11154651,페루,2003-03
2003-03-31,18348813,33373583,-15024770,덴마크,2003-03
2003-03-31,17756397,20555133,-2798736,카자흐스탄,2003-03
2003-03-31,15618388,81464,15536924,시리아,2003-03
2003-03-31,14897028,358473,14538555,에쿠아도르,2003-03
2003-03-31,14163522,392624854,-378461332,쿠웨이트,2003-03
2003-03-31,13910397,1751211,12159186,슬로바키아,2003-03
2003-03-31,13538699,2463978,11074721,기타국,2003-03
2003-03-31,13027679,829740,12197939,요르단,2003-03
2003-03-31,12610440,1253797,11356643,온두라스,2003-03
2003-03-31,11637899,1665524,9972375,모로코,2003-03
2003-03-31,11253064,10068683,1184381,체코공화국,2003-03
2003-03-31,11129977,265848,10864129,가나,2003-03
2003-03-31,10990614,1703508,9287106,미얀마,2003-03
2003-03-31,10832954,556203,10276751,리비아,2003-03
2003-03-31,10424641,87398,10337243,캄보디아,2003-03
2003-03-31,10209470,9393968,815502,루마니아,2003-03
2003-03-31,9899011,10461602,-562591,푸에르토리코,2003-03
2003-03-31,9897813,36558,9861255,괌,2003-03
2003-03-31,8786655,0,8786655,아프카니스탄,2003-03
2003-03-31,8533211,47096,8486115,도미니카 공화국,2003-03
2003-03-31,8446287,30791443,-22345156,아르헨티나,2003-03
2003-03-31,7945517,175088578,-167143061,오만,2003-03
2003-03-31,7106389,412473,6693916,몽골,2003-03
2003-03-31,7070198,152698,6917500,엘살바도르,2003-03
2003-03-31,6690815,79218,6611597,북마리아나 군도,2003-03
2003-03-31,6554352,30234,6524118,니카라과,2003-03
2003-03-31,6522913,6564365,-41452,코스타리카,2003-03
2003-03-31,6198943,1578696,4620247,베네주엘라,2003-03
2003-03-31,6013102,49793,5963309,탄자니아,2003-03
2003-03-31,5680057,67884655,-62204598,수단,2003-03
2003-03-31,5063188,34649268,-29586080,예맨,2003-03
2003-03-31,4740035,33485929,-28745894,앙골라,2003-03
2003-03-31,4715256,66935,4648321,케냐,2003-03
2003-03-31,4476469,611417,3865052,레바논,2003-03
2003-03-31,4204732,1649264,2555468,슬로베니아,2003-03
2003-03-31,4130977,234643,3896334,튀니지,2003-03
2003-03-31,4124260,373648,3750612,리투아니아,2003-03
2003-03-31,3344010,423694,2920316,크로아티아,2003-03
2003-03-31,3336385,437575,2898810,우루과이,2003-03
2003-03-31,3316128,14308488,-10992360,바레인,2003-03
2003-03-31,3116474,294432,2822042,마카오,2003-03
2003-03-31,3035226,8,3035218,투르크멘,2003-03
2003-03-31,2984364,22826,2961538,키르기스스탄,2003-03
2003-03-31,2633863,1485155,1148708,불가리아,2003-03
2003-03-31,2243733,157657,2086076,에스토니아,2003-03
2003-03-31,2217164,0,2217164,토고,2003-03
2003-03-31,2174769,79666,2095103,사이프러스,2003-03
2003-03-31,2099861,4831015,-2731154,몰타,2003-03
2003-03-31,1966271,43934,1922337,코트디봐르,2003-03
2003-03-31,1948382,85599078,-83650696,브루나이,2003-03
2003-03-31,1782951,81244,1701707,에티오피아,2003-03
2003-03-31,1755170,18825,1736345,트리니다드 토바고,2003-03
2003-03-31,1647749,81709,1566040,네팔,2003-03
2003-03-31,1644076,193887,1450189,피지,2003-03
2003-03-31,1637445,27752,1609693,베닝,2003-03
2003-03-31,1578165,236920,1341245,모리셔스,2003-03
2003-03-31,1363014,266,1362748,아제르바이잔,2003-03
2003-03-31,1320406,95186103,-93865697,콩고,2003-03
2003-03-31,1308513,77138,1231375,파라과이,2003-03
2003-03-31,1295375,185403,1109972,자마이카,2003-03
2003-03-31,1230117,39862,1190255,도미니카,2003-03
2003-03-31,1212697,18329994,-17117297,기니,2003-03
2003-03-31,1206666,1783782,-577116,아이슬란드,2003-03
2003-03-31,1205236,4970,1200266,라오스,2003-03
2003-03-31,1196097,83954,1112143,라트비아,2003-03
2003-03-31,1181965,168642,1013323,세네갈,2003-03
2003-03-31,1170006,2387130,-1217124,룩셈부르그,2003-03
2003-03-31,1092025,583639,508386,짐바브웨,2003-03
2003-03-31,1071042,3778167,-2707125,뉴 칼레도니아,2003-03
2003-03-31,986954,0,986954,마티니크,2003-03
2003-03-31,834053,0,834053,아루바,2003-03
2003-03-31,802466,61528,740938,마다카스카르,2003-03
2003-03-31,801419,0,801419,불령 리유니온 코모도 제도,2003-03
2003-03-31,736848,20294,716554,유고,2003-03
2003-03-31,731087,284478,446609,카메룬,2003-03
2003-03-31,690588,761,689827,과델로프,2003-03
2003-03-31,566235,34800824,-34234589,가봉,2003-03
2003-03-31,558886,397617,161269,타지크,2003-03
2003-03-31,554896,0,554896,아이티,2003-03
2003-03-31,524683,123592,401091,볼리비아,2003-03
2003-03-31,506599,61261,445338,알바니아,2003-03
2003-03-31,500951,1275031,-774080,파푸아 뉴기니,2003-03
2003-03-31,498136,0,498136,니제르,2003-03
2003-03-31,468687,58682,410005,모잠비크,2003-03
2003-03-31,454591,0,454591,보스니아-헤르체고비나,2003-03
2003-03-31,431861,0,431861,사모아,2003-03
2003-03-31,413639,29100,384539,불령 폴리네시아,2003-03
2003-03-31,398843,2350,396493,마이크로네시아,2003-03
2003-03-31,374434,352302,22132,벨라루스,2003-03
2003-03-31,332249,0,332249,마세도니아,2003-03
2003-03-31,317314,4195,313119,벨리제,2003-03
2003-03-31,306901,0,306901,시에라 리온,2003-03
2003-03-31,294115,0,294115,안티가 바부다,2003-03
2003-03-31,291444,183270,108174,모리타니,2003-03
2003-03-31,280865,249605,31260,소말리아,2003-03
2003-03-31,275162,0,275162,팔라우,2003-03
2003-03-31,272400,90809,181591,조지아,2003-03
2003-03-31,271205,0,271205,수리남,2003-03
2003-03-31,253859,0,253859,지부티,2003-03
2003-03-31,238132,207886,30246,말리,2003-03
2003-03-31,212836,0,212836,버뮤다,2003-03
2003-03-31,211765,0,211765,아르메니아,2003-03
2003-03-31,182129,2085925,-1903796,솔로몬 군도,2003-03
2003-03-31,171917,0,171917,불령 가이아나,2003-03
2003-03-31,153908,14283,139625,바누아투,2003-03
2003-03-31,142880,0,142880,몰디브,2003-03
2003-03-31,136071,0,136071,말라위,2003-03
2003-03-31,131032,241,130791,아메리칸 사모아,2003-03
2003-03-31,121849,0,121849,우간다,2003-03
2003-03-31,120326,0,120326,르완다,2003-03
2003-03-31,117505,0,117505,감비아,2003-03
2003-03-31,107695,4659,103036,앙귈라,2003-03
2003-03-31,104068,3594,100474,가이아나,2003-03
2003-03-31,102299,57903,44396,부르키나 파소,2003-03
2003-03-31,100277,30000,70277,에리트리아,2003-03
2003-03-31,98227,0,98227,영령 캐이맨 군도,2003-03
2003-03-31,95728,0,95728,세인트 빈센트 그레나딘,2003-03
2003-03-31,76742,3953171,-3876429,잠비아,2003-03
2003-03-31,65107,0,65107,부탄,2003-03
2003-03-31,63554,0,63554,세인트 루시아,2003-03
2003-03-31,62084,0,62084,네덜란드 열도,2003-03
2003-03-31,60826,81377,-20551,보츠와나,2003-03
2003-03-31,60808,545,60263,세이쉘,2003-03
2003-03-31,50879,0,50879,부룬디,2003-03
2003-03-31,43608,11897,31711,팔레스타인 해방기구(구),2003-03
2003-03-31,37303,0,37303,그레나다,2003-03
2003-03-31,36874,52267,-15393,안도라,2003-03
2003-03-31,36600,0,36600,이라크,2003-03
2003-03-31,34190,2148,32042,지브랄타,2003-03
2003-03-31,30420,12460,17960,투르크 & 카이코스 군도,2003-03
2003-03-31,24746,0,24746,챠드,2003-03
2003-03-31,23646,0,23646,몰도바,2003-03
2003-03-31,21679,0,21679,티모르,2003-03
2003-03-31,21483,0,21483,코모로스,2003-03
2003-03-31,21154,249258,-228104,나미비아,2003-03
2003-03-31,17648,0,17648,콩고민주공화국,2003-03
2003-03-31,12275,32,12243,포클랜드 군도,2003-03
2003-03-31,10301,279258,-268957,리히텐슈타인,2003-03
2003-03-31,5883,0,5883,미령 버진군도,2003-03
2003-03-31,2392,9450,-7058,통가,2003-03
2003-03-31,1368,21171,-19803,산마리노,2003-03
2003-03-31,1315,0,1315,중앙아프리카공화국,2003-03
2003-03-31,663,0,663,남조지아 & 남샌드위치 군도,2003-03
2003-03-31,375,98658,-98283,그린랜드,2003-03
2003-03-31,318,0,318,메요트,2003-03
2003-03-31,168,0,168,몬트세라트,2003-03
2003-03-31,166,7050,-6884,쿡 아일랜드,2003-03
2003-03-31,0,47332,-47332,존스톤 아일랜드,2003-03
2003-03-31,0,8994,-8994,토켈라우,2003-03
2003-03-31,0,716698,-716698,모나코,2003-03
2003-03-31,0,57674,-57674,투발루,2003-03
2003-03-31,0,11234,-11234,세인트 헬레나,2003-03
2003-03-31,0,1632,-1632,코스 군도,2003-03
2003-03-31,0,315,-315,영령 버진군도,2003-03
2003-04-30,2807774807,2129005160,678769647,미국,2003-04
2003-04-30,2560138383,1827758375,732380008,중국,2003-04
2003-04-30,1406227585,3022018911,-1615791326,일본,2003-04
2003-04-30,1138131661,206140417,931991244,홍콩,2003-04
2003-04-30,529582037,501585761,27996276,대만,2003-04
2003-04-30,435595091,582321676,-146726585,독일,2003-04
2003-04-30,429854551,439286402,-9431851,인도네시아,2003-04
2003-04-30,371452634,341129294,30323340,싱가포르,2003-04
2003-04-30,315743389,345510088,-29766699,말레이시아,2003-04
2003-04-30,310592770,185142626,125450144,영국,2003-04
2003-04-30,290438530,218570605,71867925,이탈리아,2003-04
2003-04-30,254067765,41555377,212512388,베트남,2003-04
2003-04-30,253801327,128611390,125189937,인도,2003-04
2003-04-30,247272568,149353076,97919492,필리핀,2003-04
2003-04-30,245820584,176798320,69022264,캐나다,2003-04
2003-04-30,245191181,26976,245164205,마샬군도,2003-04
2003-04-30,222394881,96343295,126051586,네덜란드,2003-04
2003-04-30,201330417,555067231,-353736814,호주,2003-04
2003-04-30,198524215,33157274,165366941,멕시코,2003-04
2003-04-30,184584757,147214546,37370211,태국,2003-04
2003-04-30,182739337,3968609,178770728,그리스,2003-04
2003-04-30,172560052,38610135,133949917,스페인,2003-04
2003-04-30,172248037,70798149,101449888,이란,2003-04
2003-04-30,162514089,492266813,-329752724,아랍에미리트 연합,2003-04
2003-04-30,156051797,4530163,151521634,파나마,2003-04
2003-04-30,146314939,184459560,-38144621,프랑스,2003-04
2003-04-30,121572142,174526400,-52954258,러시아 연방,2003-04
2003-04-30,109907803,33822269,76085534,노르웨이,2003-04
2003-04-30,109631274,743430491,-633799217,사우디아라비아,2003-04
2003-04-30,95220879,144142255,-48921376,브라질,2003-04
2003-04-30,88295038,57712780,30582258,벨기에,2003-04
2003-04-30,79116587,5049738,74066849,튀르키예,2003-04
2003-04-30,71509135,29511026,41998109,핀란드,2003-04
2003-04-30,56127145,2353399,53773746,기타국,2003-04
2003-04-30,54059771,2336972,51722799,방글라데시,2003-04
2003-04-30,48942532,58755360,-9812828,남아프리카공화국,2003-04
2003-04-30,45898421,6476433,39421988,나이지리아,2003-04
2003-04-30,45321639,3399917,41921722,과테말라,2003-04
2003-04-30,44297628,48341121,-4043493,아일랜드,2003-04
2003-04-30,41962201,25846484,16115717,오스트리아,2003-04
2003-04-30,41880384,53718437,-11838053,스웨덴,2003-04
2003-04-30,41199485,5093820,36105665,몰타,2003-04
2003-04-30,40174130,102215350,-62041220,칠레,2003-04
2003-04-30,38933435,25375789,13557646,이스라엘,2003-04
2003-04-30,38670708,7121659,31549049,헝가리,2003-04
2003-04-30,38423279,63614754,-25191475,뉴질랜드,2003-04
2003-04-30,38184394,16813561,21370833,파키스탄,2003-04
2003-04-30,33829213,3002080,30827133,스리랑카,2003-04
2003-04-30,33709399,29596,33679803,라이베리아,2003-04
2003-04-30,31974533,30477808,1496725,이집트,2003-04
2003-04-30,30524314,6876268,23648046,폴란드,2003-04
2003-04-30,29951702,262835136,-232883434,카타르,2003-04
2003-04-30,29389525,204282256,-174892731,쿠웨이트,2003-04
2003-04-30,29268336,10786827,18481509,우크라이나,2003-04
2003-04-30,26340016,5514441,20825575,콜롬비아,2003-04
2003-04-30,24139801,6798469,17341332,우즈베키스탄,2003-04
2003-04-30,21485997,77407441,-55921444,스위스,2003-04
2003-04-30,20136726,165917,19970809,시리아,2003-04
2003-04-30,20012964,9977415,10035549,알제리,2003-04
2003-04-30,19677800,4262424,15415376,도미니카 공화국,2003-04
2003-04-30,19387423,825872,18561551,가나,2003-04
2003-04-30,17139460,0,17139460,리비아,2003-04
2003-04-30,17038925,3319233,13719692,포루투갈,2003-04
2003-04-30,16685233,32293050,-15607817,덴마크,2003-04
2003-04-30,16657412,40234843,-23577431,에쿠아도르,2003-04
2003-04-30,16005937,9838094,6167843,카자흐스탄,2003-04
2003-04-30,15614124,1775409,13838715,온두라스,2003-04
2003-04-30,14349257,19579348,-5230091,페루,2003-04
2003-04-30,14192425,9506200,4686225,체코공화국,2003-04
2003-04-30,13945721,2677917,11267804,모로코,2003-04
2003-04-30,13524266,2880168,10644098,루마니아,2003-04
2003-04-30,11922638,2409856,9512782,요르단,2003-04
2003-04-30,11382629,51588571,-40205942,아르헨티나,2003-04
2003-04-30,11238393,2585990,8652403,미얀마,2003-04
2003-04-30,10535605,2773530,7762075,슬로바키아,2003-04
2003-04-30,9227888,12045575,-2817687,푸에르토리코,2003-04
2003-04-30,9137715,1479441,7658274,베네주엘라,2003-04
2003-04-30,8431342,357904,8073438,괌,2003-04
2003-04-30,8225879,0,8225879,아프카니스탄,2003-04
2003-04-30,8211807,116396,8095411,엘살바도르,2003-04
2003-04-30,7848724,140949486,-133100762,오만,2003-04
2003-04-30,7765119,98577,7666542,북마리아나 군도,2003-04
2003-04-30,7426245,35149198,-27722953,예맨,2003-04
2003-04-30,7339504,165253,7174251,수단,2003-04
2003-04-30,7200810,158751,7042059,캄보디아,2003-04
2003-04-30,6262350,4423114,1839236,코스타리카,2003-04
2003-04-30,6015204,113608,5901596,크로아티아,2003-04
2003-04-30,5839205,90257,5748948,몽골,2003-04
2003-04-30,5601104,254204,5346900,니카라과,2003-04
2003-04-30,5588332,2054897,3533435,슬로베니아,2003-04
2003-04-30,5406196,2014244,3391952,불가리아,2003-04
2003-04-30,5297906,711661,4586245,리투아니아,2003-04
2003-04-30,5296829,93825,5203004,탄자니아,2003-04
2003-04-30,4733761,96720,4637041,케냐,2003-04
2003-04-30,4608377,736580,3871797,레바논,2003-04
2003-04-30,4513603,27226636,-22713033,바레인,2003-04
2003-04-30,3908901,685325,3223576,우루과이,2003-04
2003-04-30,3541835,37971822,-34429987,브루나이,2003-04
2003-04-30,3060551,67289,2993262,코트디봐르,2003-04
2003-04-30,3007042,56946,2950096,유고,2003-04
2003-04-30,2691930,47431,2644499,네팔,2003-04
2003-04-30,2671675,162245,2509430,튀니지,2003-04
2003-04-30,2508699,424432,2084267,마카오,2003-04
2003-04-30,2268836,406726,1862110,에스토니아,2003-04
2003-04-30,2182347,81300,2101047,파라과이,2003-04
2003-04-30,2172422,81414,2091008,불령 리유니온 코모도 제도,2003-04
2003-04-30,2155143,34493,2120650,키르기스스탄,2003-04
2003-04-30,2109764,7916604,-5806840,사이프러스,2003-04
2003-04-30,1970703,16222,1954481,라오스,2003-04
2003-04-30,1875399,0,1875399,투르크멘,2003-04
2003-04-30,1865586,88633118,-86767532,앙골라,2003-04
2003-04-30,1809326,0,1809326,트리니다드 토바고,2003-04
2003-04-30,1808785,0,1808785,토고,2003-04
2003-04-30,1757569,287922,1469647,아이슬란드,2003-04
2003-04-30,1694990,0,1694990,이라크,2003-04
2003-04-30,1607688,0,1607688,마티니크,2003-04
2003-04-30,1487722,3350,1484372,마이크로네시아,2003-04
2003-04-30,1479784,0,1479784,아루바,2003-04
2003-04-30,1430048,116497,1313551,라트비아,2003-04
2003-04-30,1417359,13021,1404338,모리셔스,2003-04
2003-04-30,1267905,4072823,-2804918,뉴 칼레도니아,2003-04
2003-04-30,1224160,3820428,-2596268,스와질랜드,2003-04
2003-04-30,1223634,25450,1198184,도미니카,2003-04
2003-04-30,1137265,21371,1115894,자마이카,2003-04
2003-04-30,1073760,206619,867141,세네갈,2003-04
2003-04-30,1058930,0,1058930,과델로프,2003-04
2003-04-30,1011191,2893209,-1882018,파푸아 뉴기니,2003-04
2003-04-30,997025,0,997025,에티오피아,2003-04
2003-04-30,985946,1048227,-62281,벨라루스,2003-04
2003-04-30,939323,68905,870418,피지,2003-04
2003-04-30,878795,79449,799346,카메룬,2003-04
2003-04-30,854628,0,854628,베닝,2003-04
2003-04-30,758021,13664,744357,마다카스카르,2003-04
2003-04-30,722746,28276525,-27553779,콩고,2003-04
2003-04-30,699102,156,698946,모잠비크,2003-04
2003-04-30,654487,851398,-196911,타지크,2003-04
2003-04-30,646694,225446,421248,볼리비아,2003-04
2003-04-30,628145,1363,626782,니제르,2003-04
2003-04-30,595476,0,595476,보스니아-헤르체고비나,2003-04
2003-04-30,532634,0,532634,아제르바이잔,2003-04
2003-04-30,518535,1243,517292,불령 가이아나,2003-04
2003-04-30,501697,0,501697,마세도니아,2003-04
2003-04-30,455602,96,455506,아이티,2003-04
2003-04-30,447885,18850,429035,불령 폴리네시아,2003-04
2003-04-30,414043,2745926,-2331883,룩셈부르그,2003-04
2003-04-30,410682,7412,403270,바하마,2003-04
2003-04-30,408439,0,408439,아르메니아,2003-04
2003-04-30,390917,0,390917,바베이도스,2003-04
2003-04-30,384129,2634,381495,알바니아,2003-04
2003-04-30,317580,5431,312149,안티가 바부다,2003-04
2003-04-30,288076,16200,271876,팔라우,2003-04
2003-04-30,266536,0,266536,모리타니,2003-04
2003-04-30,262869,0,262869,사모아,2003-04
2003-04-30,240585,962344,-721759,짐바브웨,2003-04
2003-04-30,238438,397261,-158823,나미비아,2003-04
2003-04-30,234601,180,234421,아메리칸 사모아,2003-04
2003-04-30,227815,82006,145809,가봉,2003-04
2003-04-30,207785,66684,141101,벨리제,2003-04
2003-04-30,203610,480284,-276674,콩고민주공화국,2003-04
2003-04-30,197580,0,197580,우간다,2003-04
2003-04-30,196443,448385,-251942,기니,2003-04
2003-04-30,192457,0,192457,지부티,2003-04
2003-04-30,192399,0,192399,수리남,2003-04
2003-04-30,184458,0,184458,영령 캐이맨 군도,2003-04
2003-04-30,184442,0,184442,부탄,2003-04
2003-04-30,156135,0,156135,말라위,2003-04
2003-04-30,143900,0,143900,세인트 빈센트 그레나딘,2003-04
2003-04-30,139016,1180,137836,몰도바,2003-04
2003-04-30,135358,30955,104403,보츠와나,2003-04
2003-04-30,134890,0,134890,감비아,2003-04
2003-04-30,129303,0,129303,네덜란드 열도,2003-04
2003-04-30,124054,804792,-680738,모나코,2003-04
2003-04-30,123070,1677442,-1554372,조지아,2003-04
2003-04-30,119600,0,119600,세인트 키츠 네비스,2003-04
2003-04-30,114067,0,114067,영령 버진군도,2003-04
2003-04-30,112597,4339,108258,팔레스타인 해방기구(구),2003-04
2003-04-30,110744,0,110744,가이아나,2003-04
2003-04-30,107712,161,107551,시에라 리온,2003-04
2003-04-30,71286,0,71286,바누아투,2003-04
2003-04-30,59465,0,59465,투발루,2003-04
2003-04-30,55095,11578,43517,에리트리아,2003-04
2003-04-30,52398,0,52398,버뮤다,2003-04
2003-04-30,48236,0,48236,그레나다,2003-04
2003-04-30,44550,9098,35452,투르크 & 카이코스 군도,2003-04
2003-04-30,39726,4590359,-4550633,잠비아,2003-04
2003-04-30,39719,3570,36149,몰디브,2003-04
2003-04-30,35266,0,35266,파나마운하지역,2003-04
2003-04-30,33236,463188,-429952,부르키나 파소,2003-04
2003-04-30,33166,0,33166,쿡 아일랜드,2003-04
2003-04-30,29782,0,29782,세이쉘,2003-04
2003-04-30,21909,143022,-121113,안도라,2003-04
2003-04-30,17593,158,17435,레소토,2003-04
2003-04-30,17217,12373,4844,소말리아,2003-04
2003-04-30,12559,0,12559,키리바티,2003-04
2003-04-30,12342,2454,9888,챠드,2003-04
2003-04-30,11600,0,11600,기네비소,2003-04
2003-04-30,9457,0,9457,포클랜드 군도,2003-04
2003-04-30,8328,257452,-249124,리히텐슈타인,2003-04
2003-04-30,8325,220034,-211709,말리,2003-04
2003-04-30,7208,0,7208,적도 기니,2003-04
2003-04-30,6350,0,6350,티모르,2003-04
2003-04-30,4233,0,4233,부룬디,2003-04
2003-04-30,2957,0,2957,세인트 루시아,2003-04
2003-04-30,1961,0,1961,프랑스 메트로폴리탄,2003-04
2003-04-30,1289,0,1289,르완다,2003-04
2003-04-30,1096,2550895,-2549799,솔로몬 군도,2003-04
2003-04-30,840,107,733,미령 버진군도,2003-04
2003-04-30,0,9659,-9659,세인트 헬레나,2003-04
2003-04-30,0,12638,-12638,영령 인도양,2003-04
2003-04-30,0,1034,-1034,토켈라우,2003-04
2003-04-30,0,0,0,산마리노,2003-04
2003-04-30,0,6750,-6750,교황청,2003-04
2003-04-30,0,3213,-3213,그린랜드,2003-04
2003-04-30,0,5738,-5738,파로에 군도,2003-04
2003-04-30,0,9383,-9383,상토메 프린스페,2003-04
2003-04-30,0,64694,-64694,왈라스 & 퓨투나 군도,2003-04
2003-04-30,0,1431,-1431,코스 군도,2003-04
2003-04-30,0,18126,-18126,중립지대,2003-04
2003-04-30,0,2241,-2241,존스톤 아일랜드,2003-04
2003-04-30,0,54341,-54341,미드웨이 군도,2003-04
2003-05-31,2633439848,1984945681,648494167,미국,2003-05
2003-05-31,2475020616,1702513646,772506970,중국,2003-05
2003-05-31,1350886060,2630631141,-1279745081,일본,2003-05
2003-05-31,1119015400,198982122,920033278,홍콩,2003-05
2003-05-31,498783236,465657051,33126185,대만,2003-05
2003-05-31,368171847,557642095,-189470248,독일,2003-05
2003-05-31,364767415,297298273,67469142,싱가포르,2003-05
2003-05-31,330889901,166967295,163922606,영국,2003-05
2003-05-31,316763337,397854487,-81091150,인도네시아,2003-05
2003-05-31,303583428,340853089,-37269661,말레이시아,2003-05
2003-05-31,267294487,177075708,90218779,이탈리아,2003-05
2003-05-31,236404469,42199498,194204971,베트남,2003-05
2003-05-31,223051705,145903048,77148657,필리핀,2003-05
2003-05-31,204764250,205037486,-273236,캐나다,2003-05
2003-05-31,201716591,88449199,113267392,네덜란드,2003-05
2003-05-31,197841199,123473641,74367558,인도,2003-05
2003-05-31,192052893,408539285,-216486392,호주,2003-05
2003-05-31,189152438,52183410,136969028,노르웨이,2003-05
2003-05-31,188636703,154495300,34141403,태국,2003-05
2003-05-31,183355973,487889478,-304533505,아랍에미리트 연합,2003-05
2003-05-31,173747908,24517841,149230067,멕시코,2003-05
2003-05-31,161109327,40680566,120428761,스페인,2003-05
2003-05-31,154136992,17576891,136560101,그리스,2003-05
2003-05-31,146554321,1974774,144579547,파나마,2003-05
2003-05-31,144371693,16182052,128189641,튀르키예,2003-05
2003-05-31,120117872,70712812,49405060,이란,2003-05
2003-05-31,119940796,162071653,-42130857,프랑스,2003-05
2003-05-31,113855795,181885521,-68029726,러시아 연방,2003-05
2003-05-31,107019087,719347958,-612328871,사우디아라비아,2003-05
2003-05-31,91211411,115457252,-24245841,브라질,2003-05
2003-05-31,81881603,63014225,18867378,벨기에,2003-05
2003-05-31,63248538,226552169,-163303631,카타르,2003-05
2003-05-31,58819250,0,58819250,라이베리아,2003-05
2003-05-31,55610751,19359585,36251166,이스라엘,2003-05
2003-05-31,50218522,35843077,14375445,핀란드,2003-05
2003-05-31,49554577,69779,49484798,나이지리아,2003-05
2003-05-31,48795461,90328,48705133,마샬군도,2003-05
2003-05-31,48159304,2381690,45777614,방글라데시,2003-05
2003-05-31,46508119,69713256,-23205137,칠레,2003-05
2003-05-31,43764529,9307982,34456547,과테말라,2003-05
2003-05-31,37172006,45638120,-8466114,남아프리카공화국,2003-05
2003-05-31,35678565,66964606,-31286041,뉴질랜드,2003-05
2003-05-31,34225804,17362921,16862883,파키스탄,2003-05
2003-05-31,34120474,37663099,-3542625,아일랜드,2003-05
2003-05-31,32857142,5338102,27519040,폴란드,2003-05
2003-05-31,32381741,29141568,3240173,오스트리아,2003-05
2003-05-31,31828819,286652,31542167,요르단,2003-05
2003-05-31,31666448,62221042,-30554594,스웨덴,2003-05
2003-05-31,31308726,27116777,4191949,우크라이나,2003-05
2003-05-31,30706593,2200043,28506550,스리랑카,2003-05
2003-05-31,28915224,7042660,21872564,헝가리,2003-05
2003-05-31,28318965,20149476,8169489,이집트,2003-05
2003-05-31,26940831,29924542,-2983711,덴마크,2003-05
2003-05-31,26664560,233869359,-207204799,쿠웨이트,2003-05
2003-05-31,26133591,16831506,9302085,페루,2003-05
2003-05-31,24018764,7505571,16513193,콜롬비아,2003-05
2003-05-31,24006734,97073092,-73066358,스위스,2003-05
2003-05-31,21556949,2293461,19263488,포루투갈,2003-05
2003-05-31,20093926,245981,19847945,시리아,2003-05
2003-05-31,18557285,13336254,5221031,알제리,2003-05
2003-05-31,16602908,1586840,15016068,미얀마,2003-05
2003-05-31,15914781,9522127,6392654,우즈베키스탄,2003-05
2003-05-31,15872204,11500712,4371492,카자흐스탄,2003-05
2003-05-31,15568996,5534491,10034505,루마니아,2003-05
2003-05-31,14420744,16157024,-1736280,에쿠아도르,2003-05
2003-05-31,13436506,7463448,5973058,체코공화국,2003-05
2003-05-31,13062652,4277,13058375,리비아,2003-05
2003-05-31,12796962,1447283,11349679,기타국,2003-05
2003-05-31,12725217,23083220,-10358003,아르헨티나,2003-05
2003-05-31,12240534,16378,12224156,아프카니스탄,2003-05
2003-05-31,11236108,1292263,9943845,온두라스,2003-05
2003-05-31,9763497,200910,9562587,캄보디아,2003-05
2003-05-31,8943801,2332080,6611721,모로코,2003-05
2003-05-31,8609024,6025185,2583839,푸에르토리코,2003-05
2003-05-31,8393737,70565,8323172,북마리아나 군도,2003-05
2003-05-31,8329145,2512578,5816567,베네주엘라,2003-05
2003-05-31,7391961,47580,7344381,몽골,2003-05
2003-05-31,7388276,1693770,5694506,슬로바키아,2003-05
2003-05-31,7112061,96912,7015149,엘살바도르,2003-05
2003-05-31,6944540,4831410,2113130,수단,2003-05
2003-05-31,6770669,4442309,2328360,도미니카 공화국,2003-05
2003-05-31,6651443,110305785,-103654342,오만,2003-05
2003-05-31,6288070,137792,6150278,리투아니아,2003-05
2003-05-31,5962435,0,5962435,니카라과,2003-05
2003-05-31,5872036,1299508,4572528,슬로베니아,2003-05
2003-05-31,5805889,99649,5706240,크로아티아,2003-05
2003-05-31,5627743,49503,5578240,케냐,2003-05
2003-05-31,5479857,7868296,-2388439,코스타리카,2003-05
2003-05-31,5323320,414467,4908853,레바논,2003-05
2003-05-31,5313242,506040,4807202,가나,2003-05
2003-05-31,5163631,19562335,-14398704,바레인,2003-05
2003-05-31,5154385,1486288,3668097,우루과이,2003-05
2003-05-31,4747885,42510454,-37762569,예맨,2003-05
2003-05-31,3219814,107647,3112167,튀니지,2003-05
2003-05-31,3043885,1466060,1577825,불가리아,2003-05
2003-05-31,3022723,474414,2548309,마카오,2003-05
2003-05-31,2414357,3565,2410792,코트디봐르,2003-05
2003-05-31,2292089,79559,2212530,네팔,2003-05
2003-05-31,2277484,52235,2225249,키르기스스탄,2003-05
2003-05-31,2181807,160776,2021031,라트비아,2003-05
2003-05-31,2170512,23325,2147187,괌,2003-05
2003-05-31,2155602,26756281,-24600679,브루나이,2003-05
2003-05-31,2081014,1507,2079507,유고,2003-05
2003-05-31,1991615,54241,1937374,사이프러스,2003-05
2003-05-31,1672402,37610,1634792,파라과이,2003-05
2003-05-31,1661686,0,1661686,베닝,2003-05
2003-05-31,1641637,728405,913232,에스토니아,2003-05
2003-05-31,1600775,8688,1592087,모리셔스,2003-05
2003-05-31,1563477,0,1563477,투르크멘,2003-05
2003-05-31,1543333,0,1543333,앙골라,2003-05
2003-05-31,1479547,6352137,-4872590,몰타,2003-05
2003-05-31,1416628,0,1416628,불령 리유니온 코모도 제도,2003-05
2003-05-31,1365278,7611,1357667,토고,2003-05
2003-05-31,1306130,7314469,-6008339,파푸아 뉴기니,2003-05
2003-05-31,1269136,56086,1213050,트리니다드 토바고,2003-05
2003-05-31,1171499,197083,974416,탄자니아,2003-05
2003-05-31,1159888,124072,1035816,세네갈,2003-05
2003-05-31,1132867,7385,1125482,뉴 칼레도니아,2003-05
2003-05-31,1102673,48008,1054665,에티오피아,2003-05
2003-05-31,1099498,6392,1093106,과델로프,2003-05
2003-05-31,1083612,4417222,-3333610,스와질랜드,2003-05
2003-05-31,1019319,67786,951533,피지,2003-05
2003-05-31,975650,259338,716312,아이슬란드,2003-05
2003-05-31,961055,24862,936193,마다카스카르,2003-05
2003-05-31,883310,0,883310,아이티,2003-05
2003-05-31,874577,26194143,-25319566,콩고,2003-05
2003-05-31,861342,39349,821993,말리,2003-05
2003-05-31,793038,0,793038,아제르바이잔,2003-05
2003-05-31,761825,0,761825,니제르,2003-05
2003-05-31,761170,754638,6532,기니,2003-05
2003-05-31,740703,44867,695836,자마이카,2003-05
2003-05-31,740201,0,740201,지부티,2003-05
2003-05-31,717985,0,717985,마티니크,2003-05
2003-05-31,703763,415908,287855,벨라루스,2003-05
2003-05-31,663104,14165,648939,라오스,2003-05
2003-05-31,596270,18745,577525,카메룬,2003-05
2003-05-31,536740,134121,402619,말라위,2003-05
2003-05-31,521444,184129,337315,볼리비아,2003-05
2003-05-31,497823,0,497823,모잠비크,2003-05
2003-05-31,462112,0,462112,아루바,2003-05
2003-05-31,420851,0,420851,알바니아,2003-05
2003-05-31,410927,1693,409234,챠드,2003-05
2003-05-31,384223,0,384223,보스니아-헤르체고비나,2003-05
2003-05-31,377531,150757,226774,아르메니아,2003-05
2003-05-31,364076,0,364076,마이크로네시아,2003-05
2003-05-31,363910,4384,359526,벨리제,2003-05
2003-05-31,355443,0,355443,도미니카,2003-05
2003-05-31,348581,2054727,-1706146,룩셈부르그,2003-05
2003-05-31,329639,586982,-257343,짐바브웨,2003-05
2003-05-31,328064,17385,310679,바하마,2003-05
2003-05-31,312229,18687,293542,시에라 리온,2003-05
2003-05-31,308622,542512,-233890,우간다,2003-05
2003-05-31,290788,279627,11161,조지아,2003-05
2003-05-31,290717,830151,-539434,타지크,2003-05
2003-05-31,278638,0,278638,마세도니아,2003-05
2003-05-31,263585,0,263585,사모아,2003-05
2003-05-31,262914,6300,256614,몰디브,2003-05
2003-05-31,259410,0,259410,바베이도스,2003-05
2003-05-31,251921,106047,145874,에리트리아,2003-05
2003-05-31,236676,0,236676,불령 가이아나,2003-05
2003-05-31,231637,0,231637,아메리칸 사모아,2003-05
2003-05-31,213539,0,213539,부탄,2003-05
2003-05-31,210300,2915443,-2705143,잠비아,2003-05
2003-05-31,187070,0,187070,안티가 바부다,2003-05
2003-05-31,171581,0,171581,세인트 빈센트 그레나딘,2003-05
2003-05-31,166180,0,166180,레소토,2003-05
2003-05-31,165421,505,164916,가이아나,2003-05
2003-05-31,164339,25040819,-24876480,가봉,2003-05
2003-05-31,158187,0,158187,모리타니,2003-05
2003-05-31,143888,23367,120521,불령 폴리네시아,2003-05
2003-05-31,137918,15195,122723,영령 캐이맨 군도,2003-05
2003-05-31,132370,168560,-36190,콩고민주공화국,2003-05
2003-05-31,120829,16185,104644,팔레스타인 해방기구(구),2003-05
2003-05-31,91267,0,91267,팔라우,2003-05
2003-05-31,80582,11169,69413,수리남,2003-05
2003-05-31,75401,76978,-1577,보츠와나,2003-05
2003-05-31,74549,39,74510,버뮤다,2003-05
2003-05-31,73765,0,73765,그레나다,2003-05
2003-05-31,71785,158,71627,이라크,2003-05
2003-05-31,68854,8652,60202,토켈라우,2003-05
2003-05-31,62202,8266,53936,몰도바,2003-05
2003-05-31,56926,464110,-407184,모나코,2003-05
2003-05-31,44215,0,44215,네덜란드 열도,2003-05
2003-05-31,41782,0,41782,바누아투,2003-05
2003-05-31,38306,0,38306,부룬디,2003-05
2003-05-31,36635,0,36635,세인트 루시아,2003-05
2003-05-31,34384,360530,-326146,안도라,2003-05
2003-05-31,26756,1393,25363,쿡 아일랜드,2003-05
2003-05-31,19366,169363,-149997,리히텐슈타인,2003-05
2003-05-31,17969,0,17969,르완다,2003-05
2003-05-31,12400,3372,9028,감비아,2003-05
2003-05-31,12223,429952,-417729,나미비아,2003-05
2003-05-31,10688,0,10688,산마리노,2003-05
2003-05-31,6724,0,6724,앙귈라,2003-05
2003-05-31,4572,594,3978,지브랄타,2003-05
2003-05-31,4000,0,4000,소말리아,2003-05
2003-05-31,2060,0,2060,세이쉘,2003-05
2003-05-31,1764,484466,-482702,솔로몬 군도,2003-05
2003-05-31,1266,0,1266,영령 버진군도,2003-05
2003-05-31,559,5706,-5147,통가,2003-05
2003-05-31,543,2933,-2390,교황청,2003-05
2003-05-31,350,0,350,포클랜드 군도,2003-05
2003-05-31,225,1760,-1535,키리바티,2003-05
2003-05-31,0,282,-282,마이너 아우틀링 합중국 군도,2003-05
2003-05-31,0,231578,-231578,부르키나 파소,2003-05
2003-05-31,0,183027,-183027,미드웨이 군도,2003-05
2003-05-31,0,28144,-28144,코스 군도,2003-05
2003-05-31,0,155,-155,미령 버진군도,2003-05
2003-05-31,0,15312,-15312,세인트 키츠 네비스,2003-05
2003-05-31,0,980,-980,보네르 신트외스타티위스,2003-05
2003-05-31,0,99242,-99242,그린랜드,2003-05
2003-05-31,0,426,-426,존스톤 아일랜드,2003-05
2003-05-31,0,563,-563,크리스마스 아일랜드,2003-05
2003-06-30,2803208194,2201653169,601555025,미국,2003-06
2003-06-30,2609510640,1662343508,947167132,중국,2003-06
2003-06-30,1319147409,2761062224,-1441914815,일본,2003-06
2003-06-30,1154056078,203055218,951000860,홍콩,2003-06
2003-06-30,514101154,438071999,76029155,대만,2003-06
2003-06-30,435490482,578630963,-143140481,독일,2003-06
2003-06-30,397367189,428464812,-31097623,호주,2003-06
2003-06-30,371705806,283893646,87812160,싱가포르,2003-06
2003-06-30,331697373,286663340,45034033,말레이시아,2003-06
2003-06-30,310179109,159535191,150643918,영국,2003-06
2003-06-30,263134492,415177643,-152043151,인도네시아,2003-06
2003-06-30,233962438,164136481,69825957,필리핀,2003-06
2003-06-30,228234538,40738337,187496201,베트남,2003-06
2003-06-30,205962477,117945398,88017079,캐나다,2003-06
2003-06-30,199192669,170045786,29146883,프랑스,2003-06
2003-06-30,196954540,143782921,53171619,태국,2003-06
2003-06-30,189245358,22672794,166572564,멕시코,2003-06
2003-06-30,184907765,122389552,62518213,네덜란드,2003-06
2003-06-30,184470336,193261410,-8791074,이탈리아,2003-06
2003-06-30,175491117,309256993,-133765876,아랍에미리트 연합,2003-06
2003-06-30,174989168,70323743,104665425,인도,2003-06
2003-06-30,170423940,11508,170412432,라이베리아,2003-06
2003-06-30,160551424,8820,160542604,바하마,2003-06
2003-06-30,156168138,37925688,118242450,스페인,2003-06
2003-06-30,132357954,614087265,-481729311,사우디아라비아,2003-06
2003-06-30,129972942,130258217,-285275,이란,2003-06
2003-06-30,116083948,151986730,-35902782,러시아 연방,2003-06
2003-06-30,114474109,4994808,109479301,튀르키예,2003-06
2003-06-30,114168395,18076486,96091909,파나마,2003-06
2003-06-30,112363207,0,112363207,마샬군도,2003-06
2003-06-30,96107127,127440879,-31333752,브라질,2003-06
2003-06-30,90352707,59432724,30919983,벨기에,2003-06
2003-06-30,77741186,23212537,54528649,핀란드,2003-06
2003-06-30,73777893,4079911,69697982,그리스,2003-06
2003-06-30,71749281,249023940,-177274659,쿠웨이트,2003-06
2003-06-30,68870459,80127240,-11256781,아일랜드,2003-06
2003-06-30,58090728,2295040,55795688,기타국,2003-06
2003-06-30,57880105,126362111,-68482006,스위스,2003-06
2003-06-30,56830972,9181411,47649561,이집트,2003-06
2003-06-30,56431498,28470487,27961011,노르웨이,2003-06
2003-06-30,54856418,164710,54691708,사이프러스,2003-06
2003-06-30,51319127,16691,51302436,나이지리아,2003-06
2003-06-30,48589378,2589289,46000089,방글라데시,2003-06
2003-06-30,46196029,95995191,-49799162,칠레,2003-06
2003-06-30,45995273,41100128,4895145,남아프리카공화국,2003-06
2003-06-30,45768848,0,45768848,영령 캐이맨 군도,2003-06
2003-06-30,43094654,22494976,20599678,이스라엘,2003-06
2003-06-30,42820816,56325124,-13504308,뉴질랜드,2003-06
2003-06-30,41562712,228175,41334537,요르단,2003-06
2003-06-30,40840336,54599547,-13759211,스웨덴,2003-06
2003-06-30,38282031,12069192,26212839,과테말라,2003-06
2003-06-30,37152477,27364141,9788336,오스트리아,2003-06
2003-06-30,36240136,16186067,20054069,파키스탄,2003-06
2003-06-30,33586130,157594,33428536,괌,2003-06
2003-06-30,32957389,6131729,26825660,폴란드,2003-06
2003-06-30,32890287,10114291,22775996,헝가리,2003-06
2003-06-30,31680112,196421595,-164741483,카타르,2003-06
2003-06-30,28582448,2575949,26006499,스리랑카,2003-06
2003-06-30,24793955,181819,24612136,시리아,2003-06
2003-06-30,24365878,4017567,20348311,콜롬비아,2003-06
2003-06-30,23532656,9722170,13810486,우크라이나,2003-06
2003-06-30,22055551,30525145,-8469594,덴마크,2003-06
2003-06-30,21587892,12540,21575352,리비아,2003-06
2003-06-30,19912481,2897131,17015350,포루투갈,2003-06
2003-06-30,19062915,5346347,13716568,알제리,2003-06
2003-06-30,18988891,17749115,1239776,에쿠아도르,2003-06
2003-06-30,17288880,9943685,7345195,우즈베키스탄,2003-06
2003-06-30,17174197,8524086,8650111,체코공화국,2003-06
2003-06-30,16871562,6331462,10540100,루마니아,2003-06
2003-06-30,16212130,1659117,14553013,페루,2003-06
2003-06-30,14528560,12590022,1938538,푸에르토리코,2003-06
2003-06-30,12942859,12064,12930795,아프카니스탄,2003-06
2003-06-30,12771880,18682021,-5910141,아르헨티나,2003-06
2003-06-30,12166879,1021406,11145473,모로코,2003-06
2003-06-30,11138418,1493206,9645212,온두라스,2003-06
2003-06-30,10501362,176031421,-165530059,오만,2003-06
2003-06-30,10237296,13611306,-3374010,카자흐스탄,2003-06
2003-06-30,9796799,8357217,1439582,코스타리카,2003-06
2003-06-30,9713898,2354183,7359715,미얀마,2003-06
2003-06-30,9324501,953061,8371440,슬로바키아,2003-06
2003-06-30,8641961,325600,8316361,캄보디아,2003-06
2003-06-30,8247078,18256,8228822,북마리아나 군도,2003-06
2003-06-30,7446551,217206,7229345,엘살바도르,2003-06
2003-06-30,7225416,132741,7092675,몽골,2003-06
2003-06-30,6922164,687411,6234753,레바논,2003-06
2003-06-30,6128984,4295,6124689,니카라과,2003-06
2003-06-30,5762000,72313,5689687,수단,2003-06
2003-06-30,5560851,1495610,4065241,불가리아,2003-06
2003-06-30,5383191,4470535,912656,도미니카 공화국,2003-06
2003-06-30,5373247,158624,5214623,튀니지,2003-06
2003-06-30,5322435,8354442,-3032007,리투아니아,2003-06
2003-06-30,4937823,13953284,-9015461,바레인,2003-06
2003-06-30,4617682,22825059,-18207377,예맨,2003-06
2003-06-30,4092280,1830328,2261952,베네주엘라,2003-06
2003-06-30,4031621,117150,3914471,크로아티아,2003-06
2003-06-30,3737162,1995193,1741969,슬로베니아,2003-06
2003-06-30,3527774,237909,3289865,가나,2003-06
2003-06-30,3150929,127722,3023207,케냐,2003-06
2003-06-30,3113393,15121204,-12007811,브루나이,2003-06
2003-06-30,3062622,25306,3037316,파라과이,2003-06
2003-06-30,2768841,1206465,1562376,우루과이,2003-06
2003-06-30,2678808,266229,2412579,마카오,2003-06
2003-06-30,2380800,312117,2068683,라트비아,2003-06
2003-06-30,2308219,966361,1341858,에스토니아,2003-06
2003-06-30,2290050,45344,2244706,유고,2003-06
2003-06-30,2275115,57394,2217721,네팔,2003-06
2003-06-30,2036678,22679,2013999,키르기스스탄,2003-06
2003-06-30,1985139,60022,1925117,불령 리유니온 코모도 제도,2003-06
2003-06-30,1908876,0,1908876,앙골라,2003-06
2003-06-30,1551976,19434,1532542,코트디봐르,2003-06
2003-06-30,1514404,10302,1504102,트리니다드 토바고,2003-06
2003-06-30,1485327,7688803,-6203476,뉴 칼레도니아,2003-06
2003-06-30,1458498,10004,1448494,아이티,2003-06
2003-06-30,1422152,48585,1373567,탄자니아,2003-06
2003-06-30,1414732,8360,1406372,불령 폴리네시아,2003-06
2003-06-30,1381287,0,1381287,투르크멘,2003-06
2003-06-30,1348660,39938,1308722,자마이카,2003-06
2003-06-30,1316541,3623094,-2306553,몰타,2003-06
2003-06-30,1257806,48009,1209797,에티오피아,2003-06
2003-06-30,1242971,0,1242971,토고,2003-06
2003-06-30,1231684,55783,1175901,마다카스카르,2003-06
2003-06-30,1211098,752040,459058,아이슬란드,2003-06
2003-06-30,1151861,275196,876665,베닝,2003-06
2003-06-30,1125454,0,1125454,이라크,2003-06
2003-06-30,1110680,18680,1092000,모리셔스,2003-06
2003-06-30,1082671,0,1082671,마티니크,2003-06
2003-06-30,986515,194,986321,과델로프,2003-06
2003-06-30,981071,2697831,-1716760,스와질랜드,2003-06
2003-06-30,873179,411784,461395,콩고,2003-06
2003-06-30,821810,265373,556437,카메룬,2003-06
2003-06-30,742316,5190632,-4448316,잠비아,2003-06
2003-06-30,705289,1232851,-527562,볼리비아,2003-06
2003-06-30,643359,67279,576080,피지,2003-06
2003-06-30,608427,347440,260987,벨라루스,2003-06
2003-06-30,572624,331345,241279,세네갈,2003-06
2003-06-30,568586,642384,-73798,짐바브웨,2003-06
2003-06-30,557329,3314408,-2757079,파푸아 뉴기니,2003-06
2003-06-30,538753,0,538753,도미니카,2003-06
2003-06-30,522193,0,522193,지부티,2003-06
2003-06-30,503368,182475,320893,모리타니,2003-06
2003-06-30,503257,0,503257,알바니아,2003-06
2003-06-30,501793,0,501793,아제르바이잔,2003-06
2003-06-30,486368,0,486368,모잠비크,2003-06
2003-06-30,480143,0,480143,아루바,2003-06
2003-06-30,460342,0,460342,마이크로네시아,2003-06
2003-06-30,454186,2624,451562,안도라,2003-06
2003-06-30,445980,0,445980,팔라우,2003-06
2003-06-30,436685,0,436685,불령 가이아나,2003-06
2003-06-30,433944,0,433944,말라위,2003-06
2003-06-30,392467,66604,325863,보츠와나,2003-06
2003-06-30,386653,0,386653,니제르,2003-06
2003-06-30,383594,0,383594,보스니아-헤르체고비나,2003-06
2003-06-30,378885,0,378885,바베이도스,2003-06
2003-06-30,377776,28958,348818,라오스,2003-06
2003-06-30,372274,38,372236,마세도니아,2003-06
2003-06-30,362467,0,362467,수리남,2003-06
2003-06-30,360550,406990,-46440,조지아,2003-06
2003-06-30,358815,578714,-219899,기니,2003-06
2003-06-30,332808,0,332808,벨리제,2003-06
2003-06-30,292333,0,292333,콩고민주공화국,2003-06
2003-06-30,285726,0,285726,사모아,2003-06
2003-06-30,246506,627332,-380826,우간다,2003-06
2003-06-30,236465,0,236465,중앙아프리카공화국,2003-06
2003-06-30,217320,0,217320,미령 버진군도,2003-06
2003-06-30,213832,2103876,-1890044,룩셈부르그,2003-06
2003-06-30,209296,0,209296,시에라 리온,2003-06
2003-06-30,202034,0,202034,안티가 바부다,2003-06
2003-06-30,174196,105,174091,아메리칸 사모아,2003-06
2003-06-30,172854,375392,-202538,타지크,2003-06
2003-06-30,165255,0,165255,지브랄타,2003-06
2003-06-30,165118,0,165118,부탄,2003-06
2003-06-30,156621,0,156621,레소토,2003-06
2003-06-30,136970,0,136970,가이아나,2003-06
2003-06-30,126163,0,126163,버뮤다,2003-06
2003-06-30,125448,0,125448,에리트리아,2003-06
2003-06-30,120640,0,120640,몰도바,2003-06
2003-06-30,117627,28089,89538,바누아투,2003-06
2003-06-30,116632,3474335,-3357703,솔로몬 군도,2003-06
2003-06-30,113630,50040,63590,아르메니아,2003-06
2003-06-30,107935,0,107935,파로에 군도,2003-06
2003-06-30,103085,175134,-72049,나미비아,2003-06
2003-06-30,99566,10980,88586,팔레스타인 해방기구(구),2003-06
2003-06-30,98708,0,98708,챠드,2003-06
2003-06-30,98121,0,98121,부룬디,2003-06
2003-06-30,83721,0,83721,세인트 빈센트 그레나딘,2003-06
2003-06-30,72555,0,72555,그레나다,2003-06
2003-06-30,55633,173619,-117986,부르키나 파소,2003-06
2003-06-30,55271,764,54507,네덜란드 열도,2003-06
2003-06-30,51936,219911,-167975,말리,2003-06
2003-06-30,45300,0,45300,몰디브,2003-06
2003-06-30,41947,0,41947,소말리아,2003-06
2003-06-30,30000,0,30000,투발루,2003-06
2003-06-30,29526,0,29526,세인트 루시아,2003-06
2003-06-30,29389,135923,-106534,가봉,2003-06
2003-06-30,29336,4240,25096,키리바티,2003-06
2003-06-30,28224,0,28224,통가,2003-06
2003-06-30,28076,11091,16985,쿡 아일랜드,2003-06
2003-06-30,23638,415,23223,티모르,2003-06
2003-06-30,15357,0,15357,세이쉘,2003-06
2003-06-30,12596,0,12596,코스 군도,2003-06
2003-06-30,12046,42612,-30566,리히텐슈타인,2003-06
2003-06-30,10536,12816,-2280,감비아,2003-06
2003-06-30,8888,459497,-450609,모나코,2003-06
2003-06-30,4600,0,4600,교황청,2003-06
2003-06-30,4350,0,4350,프랑스 메트로폴리탄,2003-06
2003-06-30,3080,10838,-7758,상토메 프린스페,2003-06
2003-06-30,1510,0,1510,앙귈라,2003-06
2003-06-30,80,0,80,산마리노,2003-06
2003-06-30,25,0,25,중립지대,2003-06
2003-06-30,0,3937,-3937,토켈라우,2003-06
2003-06-30,0,1587,-1587,크리스마스 아일랜드,2003-06
2003-06-30,0,50846,-50846,그린랜드,2003-06
2003-06-30,0,18000,-18000,세인트 헬레나,2003-06
2003-06-30,0,41699,-41699,투르크 & 카이코스 군도,2003-06
2003-06-30,0,59,-59,르완다,2003-06
2003-06-30,0,670,-670,남조지아 & 남샌드위치 군도,2003-06
2003-06-30,0,2808,-2808,영령 버진군도,2003-06
2003-07-31,2964910238,1866545081,1098365157,중국,2003-07
2003-07-31,2497304252,2021117171,476187081,미국,2003-07
2003-07-31,1382143845,3055485610,-1673341765,일본,2003-07
2003-07-31,1103554595,171038333,932516262,홍콩,2003-07
2003-07-31,603816437,453795775,150020662,대만,2003-07
2003-07-31,460967643,560232685,-99265042,독일,2003-07
2003-07-31,428039477,355547737,72491740,싱가포르,2003-07
2003-07-31,381554498,184905616,196648882,영국,2003-07
2003-07-31,355737452,314285377,41452075,말레이시아,2003-07
2003-07-31,254354939,358132818,-103777879,인도네시아,2003-07
2003-07-31,237319891,478972091,-241652200,호주,2003-07
2003-07-31,232709360,113653000,119056360,인도,2003-07
2003-07-31,232042240,165718752,66323488,필리핀,2003-07
2003-07-31,227139632,32958152,194181480,멕시코,2003-07
2003-07-31,215927361,152977439,62949922,태국,2003-07
2003-07-31,214071861,109067268,105004593,이란,2003-07
2003-07-31,205881406,611148677,-405267271,아랍에미리트 연합,2003-07
2003-07-31,202034071,85834824,116199247,네덜란드,2003-07
2003-07-31,194171150,39766750,154404400,베트남,2003-07
2003-07-31,170458473,164336023,6122450,캐나다,2003-07
2003-07-31,155199255,247540946,-92341691,이탈리아,2003-07
2003-07-31,135668092,191364713,-55696621,러시아 연방,2003-07
2003-07-31,130582602,197459332,-66876730,프랑스,2003-07
2003-07-31,127122355,33927905,93194450,스페인,2003-07
2003-07-31,121328294,791939750,-670611456,사우디아라비아,2003-07
2003-07-31,117352460,24176,117328284,마샬군도,2003-07
2003-07-31,116242863,42099,116200764,바하마,2003-07
2003-07-31,111362427,4520816,106841611,튀르키예,2003-07
2003-07-31,109958287,6345659,103612628,몰타,2003-07
2003-07-31,98378883,1829770,96549113,그리스,2003-07
2003-07-31,95084176,72728842,22355334,벨기에,2003-07
2003-07-31,87452478,42375528,45076950,핀란드,2003-07
2003-07-31,72769114,186444645,-113675531,브라질,2003-07
2003-07-31,69148260,52697422,16450838,아일랜드,2003-07
2003-07-31,54288660,59639,54229021,사이프러스,2003-07
2003-07-31,49645731,34137677,15508054,이스라엘,2003-07
2003-07-31,49419991,237260285,-187840294,카타르,2003-07
2003-07-31,49239937,5871131,43368806,헝가리,2003-07
2003-07-31,47548333,26042956,21505377,나이지리아,2003-07
2003-07-31,47261725,79044150,-31782425,남아프리카공화국,2003-07
2003-07-31,44705520,54273176,-9567656,스웨덴,2003-07
2003-07-31,42705276,61276726,-18571450,뉴질랜드,2003-07
2003-07-31,41182641,2508111,38674530,방글라데시,2003-07
2003-07-31,40599326,96904095,-56304769,칠레,2003-07
2003-07-31,35982906,2153626,33829280,요르단,2003-07
2003-07-31,35059396,14499799,20559597,파키스탄,2003-07
2003-07-31,35023152,23072660,11950492,이집트,2003-07
2003-07-31,33728116,5173308,28554808,라이베리아,2003-07
2003-07-31,33685366,6808755,26876611,과테말라,2003-07
2003-07-31,31837537,31231128,606409,오스트리아,2003-07
2003-07-31,29836221,35465888,-5629667,우크라이나,2003-07
2003-07-31,27215537,184497,27031040,시리아,2003-07
2003-07-31,27106266,333912412,-306806146,쿠웨이트,2003-07
2003-07-31,26321041,4004654,22316387,폴란드,2003-07
2003-07-31,23034968,4287866,18747102,우즈베키스탄,2003-07
2003-07-31,21237843,2777101,18460742,스리랑카,2003-07
2003-07-31,20958883,3612130,17346753,포루투갈,2003-07
2003-07-31,20476451,5423911,15052540,콜롬비아,2003-07
2003-07-31,17729717,179425,17550292,몽골,2003-07
2003-07-31,17150043,26775430,-9625387,아르헨티나,2003-07
2003-07-31,17101564,35706361,-18604797,덴마크,2003-07
2003-07-31,17070322,89675782,-72605460,스위스,2003-07
2003-07-31,16571114,9569733,7001381,카자흐스탄,2003-07
2003-07-31,15699978,0,15699978,알제리,2003-07
2003-07-31,15673201,5399924,10273277,루마니아,2003-07
2003-07-31,14371365,24627426,-10256061,페루,2003-07
2003-07-31,13358003,1055,13356948,아프카니스탄,2003-07
2003-07-31,13177987,3279461,9898526,파나마,2003-07
2003-07-31,12865065,18486155,-5621090,에쿠아도르,2003-07
2003-07-31,12339221,805351,11533870,리비아,2003-07
2003-07-31,10823257,2525204,8298053,수단,2003-07
2003-07-31,10145482,8173,10137309,니카라과,2003-07
2003-07-31,10124131,193424384,-183300253,오만,2003-07
2003-07-31,10092656,468,10092188,북마리아나 군도,2003-07
2003-07-31,9945144,715436,9229708,온두라스,2003-07
2003-07-31,9840948,10038228,-197280,체코공화국,2003-07
2003-07-31,9209064,37815681,-28606617,노르웨이,2003-07
2003-07-31,8892575,7683,8884892,괌,2003-07
2003-07-31,8482938,3952272,4530666,기타국,2003-07
2003-07-31,7437011,1626790,5810221,모로코,2003-07
2003-07-31,7183018,275064,6907954,레바논,2003-07
2003-07-31,7146586,1888502,5258084,캄보디아,2003-07
2003-07-31,6930911,9999645,-3068734,푸에르토리코,2003-07
2003-07-31,6880287,1911240,4969047,미얀마,2003-07
2003-07-31,6709515,677826,6031689,슬로바키아,2003-07
2003-07-31,5959848,4438296,1521552,도미니카 공화국,2003-07
2003-07-31,5400540,68299,5332241,유고,2003-07
2003-07-31,5221530,33991677,-28770147,바레인,2003-07
2003-07-31,5204800,6500134,-1295334,베네주엘라,2003-07
2003-07-31,5018325,7888698,-2870373,예맨,2003-07
2003-07-31,4977652,1793706,3183946,슬로베니아,2003-07
2003-07-31,4851408,119369,4732039,엘살바도르,2003-07
2003-07-31,4716716,116174,4600542,리투아니아,2003-07
2003-07-31,4208892,9114553,-4905661,코스타리카,2003-07
2003-07-31,4037359,220541,3816818,튀니지,2003-07
2003-07-31,4017276,1014029,3003247,가나,2003-07
2003-07-31,3864679,713140,3151539,마카오,2003-07
2003-07-31,3628413,1395254,2233159,우루과이,2003-07
2003-07-31,3418650,1462007,1956643,불가리아,2003-07
2003-07-31,3328721,14268518,-10939797,앙골라,2003-07
2003-07-31,3274996,87864,3187132,케냐,2003-07
2003-07-31,3268707,207781,3060926,네팔,2003-07
2003-07-31,3104203,139666,2964537,크로아티아,2003-07
2003-07-31,2920580,49198,2871382,에티오피아,2003-07
2003-07-31,2875323,376415,2498908,코트디봐르,2003-07
2003-07-31,2770216,11641,2758575,키르기스스탄,2003-07
2003-07-31,2684812,0,2684812,지부티,2003-07
2003-07-31,2677736,102805,2574931,라트비아,2003-07
2003-07-31,2581741,714996,1866745,에스토니아,2003-07
2003-07-31,2520139,114339,2405800,파라과이,2003-07
2003-07-31,2092790,377449,1715341,탄자니아,2003-07
2003-07-31,1992640,232145,1760495,투르크멘,2003-07
2003-07-31,1767424,0,1767424,아이티,2003-07
2003-07-31,1558120,3959417,-2401297,스와질랜드,2003-07
2003-07-31,1515575,217424,1298151,세네갈,2003-07
2003-07-31,1468388,8057633,-6589245,뉴 칼레도니아,2003-07
2003-07-31,1454222,23381308,-21927086,브루나이,2003-07
2003-07-31,1418831,95372,1323459,모리셔스,2003-07
2003-07-31,1317687,293806,1023881,아이슬란드,2003-07
2003-07-31,1277749,17717,1260032,자마이카,2003-07
2003-07-31,1176189,137768,1038421,베닝,2003-07
2003-07-31,1122193,36381,1085812,도미니카,2003-07
2003-07-31,1119082,51121354,-50002272,콩고,2003-07
2003-07-31,1085481,60292,1025189,피지,2003-07
2003-07-31,1067668,52595,1015073,트리니다드 토바고,2003-07
2003-07-31,1063627,12842,1050785,불령 리유니온 코모도 제도,2003-07
2003-07-31,943887,3532,940355,토고,2003-07
2003-07-31,931406,246109,685297,카메룬,2003-07
2003-07-31,813300,186,813114,아제르바이잔,2003-07
2003-07-31,760759,356959,403800,짐바브웨,2003-07
2003-07-31,610179,0,610179,마티니크,2003-07
2003-07-31,601820,0,601820,과델로프,2003-07
2003-07-31,600891,32427,568464,마다카스카르,2003-07
2003-07-31,584864,8716680,-8131816,기니,2003-07
2003-07-31,564343,1822303,-1257960,파푸아 뉴기니,2003-07
2003-07-31,563402,0,563402,보스니아-헤르체고비나,2003-07
2003-07-31,556117,2510,553607,모잠비크,2003-07
2003-07-31,530168,386331,143837,볼리비아,2003-07
2003-07-31,515693,35597,480096,불령 폴리네시아,2003-07
2003-07-31,500842,0,500842,마이크로네시아,2003-07
2003-07-31,478638,31458,447180,라오스,2003-07
2003-07-31,451100,3855212,-3404112,잠비아,2003-07
2003-07-31,431102,296595,134507,조지아,2003-07
2003-07-31,423506,3056763,-2633257,룩셈부르그,2003-07
2003-07-31,381044,0,381044,사모아,2003-07
2003-07-31,373384,0,373384,벨리제,2003-07
2003-07-31,365081,749335,-384254,타지크,2003-07
2003-07-31,361152,1986,359166,알바니아,2003-07
2003-07-31,353126,430,352696,수리남,2003-07
2003-07-31,348820,4060,344760,모리타니,2003-07
2003-07-31,342986,26955003,-26612017,가봉,2003-07
2003-07-31,315211,51823,263388,보츠와나,2003-07
2003-07-31,295519,651646,-356127,우간다,2003-07
2003-07-31,291906,7082,284824,니제르,2003-07
2003-07-31,291367,0,291367,아루바,2003-07
2003-07-31,274199,1414,272785,아르메니아,2003-07
2003-07-31,253918,277377,-23459,말라위,2003-07
2003-07-31,253281,353478,-100197,벨라루스,2003-07
2003-07-31,238331,0,238331,감비아,2003-07
2003-07-31,236752,446,236306,시에라 리온,2003-07
2003-07-31,230693,6840,223853,콩고민주공화국,2003-07
2003-07-31,225556,1139,224417,몰도바,2003-07
2003-07-31,198077,987,197090,아메리칸 사모아,2003-07
2003-07-31,187479,29572,157907,통가,2003-07
2003-07-31,185529,44061,141468,레소토,2003-07
2003-07-31,183604,21042,162562,팔라우,2003-07
2003-07-31,181200,0,181200,바베이도스,2003-07
2003-07-31,177628,14519,163109,네덜란드 열도,2003-07
2003-07-31,173695,0,173695,세인트 빈센트 그레나딘,2003-07
2003-07-31,158560,6753,151807,팔레스타인 해방기구(구),2003-07
2003-07-31,153963,81045,72918,안티가 바부다,2003-07
2003-07-31,145388,0,145388,마이너 아우틀링 합중국 군도,2003-07
2003-07-31,142651,19475,123176,가이아나,2003-07
2003-07-31,134301,165413,-31112,말리,2003-07
2003-07-31,130001,0,130001,부탄,2003-07
2003-07-31,112050,0,112050,영령 버진군도,2003-07
2003-07-31,110266,0,110266,앙귈라,2003-07
2003-07-31,106180,0,106180,그레나다,2003-07
2003-07-31,104630,0,104630,버뮤다,2003-07
2003-07-31,81004,100989,-19985,나미비아,2003-07
2003-07-31,79806,0,79806,이라크,2003-07
2003-07-31,78788,0,78788,소말리아,2003-07
2003-07-31,69134,0,69134,챠드,2003-07
2003-07-31,68968,0,68968,몰디브,2003-07
2003-07-31,66031,0,66031,마세도니아,2003-07
2003-07-31,65991,0,65991,바누아투,2003-07
2003-07-31,57044,0,57044,불령 가이아나,2003-07
2003-07-31,54577,236179,-181602,리히텐슈타인,2003-07
2003-07-31,51080,0,51080,영령 캐이맨 군도,2003-07
2003-07-31,41758,0,41758,중앙아프리카공화국,2003-07
2003-07-31,39291,0,39291,세이쉘,2003-07
2003-07-31,37442,545,36897,에리트리아,2003-07
2003-07-31,35796,0,35796,부룬디,2003-07
2003-07-31,25460,1400400,-1374940,솔로몬 군도,2003-07
2003-07-31,25105,6900,18205,쿡 아일랜드,2003-07
2003-07-31,17612,0,17612,부르키나 파소,2003-07
2003-07-31,11700,0,11700,투르크 & 카이코스 군도,2003-07
2003-07-31,10860,11466,-606,세인트 루시아,2003-07
2003-07-31,10488,0,10488,토켈라우,2003-07
2003-07-31,10000,0,10000,카보 베르데,2003-07
2003-07-31,9279,0,9279,지브랄타,2003-07
2003-07-31,6090,629171,-623081,모나코,2003-07
2003-07-31,5210,0,5210,투발루,2003-07
2003-07-31,2795,1680,1115,키리바티,2003-07
2003-07-31,2087,0,2087,르완다,2003-07
2003-07-31,75,41359,-41284,안도라,2003-07
2003-07-31,17,0,17,세인트 키츠 네비스,2003-07
2003-07-31,0,43888,-43888,산마리노,2003-07
2003-07-31,0,156881,-156881,그린랜드,2003-07
2003-07-31,0,3956,-3956,적도 기니,2003-07
2003-08-31,3078356503,1760107607,1318248896,중국,2003-08
2003-08-31,2585265507,1831018285,754247222,미국,2003-08
2003-08-31,1298388017,2825158051,-1526770034,일본,2003-08
2003-08-31,1192550868,205887205,986663663,홍콩,2003-08
2003-08-31,597436209,483694049,113742160,대만,2003-08
2003-08-31,441912889,465635515,-23722626,호주,2003-08
2003-08-31,433604319,519714606,-86110287,독일,2003-08
2003-08-31,390425442,338437650,51987792,싱가포르,2003-08
2003-08-31,366493340,0,366493340,라이베리아,2003-08
2003-08-31,326285008,259977057,66307951,말레이시아,2003-08
2003-08-31,292029021,177144378,114884643,영국,2003-08
2003-08-31,287805741,84214073,203591668,인도,2003-08
2003-08-31,271243531,359869701,-88626170,인도네시아,2003-08
2003-08-31,196714411,145703322,51011089,태국,2003-08
2003-08-31,193332827,143420570,49912257,필리핀,2003-08
2003-08-31,192553566,21955116,170598450,멕시코,2003-08
2003-08-31,190122810,143625542,46497268,캐나다,2003-08
2003-08-31,184022785,113753196,70269589,네덜란드,2003-08
2003-08-31,164080059,40692068,123387991,베트남,2003-08
2003-08-31,157286506,411563914,-254277408,아랍에미리트 연합,2003-08
2003-08-31,151404979,197113114,-45708135,이탈리아,2003-08
2003-08-31,129905388,206765545,-76860157,러시아 연방,2003-08
2003-08-31,128509608,36298462,92211146,스페인,2003-08
2003-08-31,127301773,152994272,-25692499,프랑스,2003-08
2003-08-31,117734402,6564976,111169426,튀르키예,2003-08
2003-08-31,111530868,147691784,-36160916,이란,2003-08
2003-08-31,102047559,700524235,-598476676,사우디아라비아,2003-08
2003-08-31,101256613,22719360,78537253,핀란드,2003-08
2003-08-31,97032915,34526,96998389,바하마,2003-08
2003-08-31,90000511,61015148,28985363,벨기에,2003-08
2003-08-31,83265741,2050915,81214826,그리스,2003-08
2003-08-31,63400322,151640647,-88240325,브라질,2003-08
2003-08-31,61759526,27292850,34466676,이스라엘,2003-08
2003-08-31,60289762,4228528,56061234,헝가리,2003-08
2003-08-31,52837889,34805242,18032647,노르웨이,2003-08
2003-08-31,48025964,0,48025964,마샬군도,2003-08
2003-08-31,46091024,121773,45969251,나이지리아,2003-08
2003-08-31,41937515,87936702,-45999187,남아프리카공화국,2003-08
2003-08-31,38426655,2199426,36227229,방글라데시,2003-08
2003-08-31,35582314,451445,35130869,과테말라,2003-08
2003-08-31,34928167,58158880,-23230713,스웨덴,2003-08
2003-08-31,34537998,55699703,-21161705,칠레,2003-08
2003-08-31,33804285,567060,33237225,요르단,2003-08
2003-08-31,32779787,10561087,22218700,이집트,2003-08
2003-08-31,31330521,49330343,-17999822,뉴질랜드,2003-08
2003-08-31,30757499,22597166,8160333,우크라이나,2003-08
2003-08-31,30561744,30405856,155888,덴마크,2003-08
2003-08-31,30445377,13557844,16887533,파키스탄,2003-08
2003-08-31,29857577,39267523,-9409946,아일랜드,2003-08
2003-08-31,27981475,30698460,-2716985,오스트리아,2003-08
2003-08-31,26835611,9124150,17711461,폴란드,2003-08
2003-08-31,26023150,93747,25929403,시리아,2003-08
2003-08-31,21072975,184728259,-163655284,쿠웨이트,2003-08
2003-08-31,20554407,98687867,-78133460,스위스,2003-08
2003-08-31,19566557,2028119,17538438,스리랑카,2003-08
2003-08-31,19524840,3402623,16122217,포루투갈,2003-08
2003-08-31,16458350,5719093,10739257,콜롬비아,2003-08
2003-08-31,16448765,3282744,13166021,우즈베키스탄,2003-08
2003-08-31,16368694,16389125,-20431,카자흐스탄,2003-08
2003-08-31,15548811,22186393,-6637582,알제리,2003-08
2003-08-31,15505126,36000436,-20495310,에쿠아도르,2003-08
2003-08-31,14299513,11374811,2924702,루마니아,2003-08
2003-08-31,13243700,6957080,6286620,파나마,2003-08
2003-08-31,12494201,21751388,-9257187,아르헨티나,2003-08
2003-08-31,12376243,7764829,4611414,체코공화국,2003-08
2003-08-31,12334772,20836346,-8501574,페루,2003-08
2003-08-31,10474874,174605160,-164130286,오만,2003-08
2003-08-31,10018981,10126743,-107762,푸에르토리코,2003-08
2003-08-31,9904537,1302996,8601541,온두라스,2003-08
2003-08-31,9825600,2485858,7339742,수단,2003-08
2003-08-31,9296563,959253,8337310,슬로바키아,2003-08
2003-08-31,9169080,11550,9157530,아프카니스탄,2003-08
2003-08-31,8723881,120680,8603201,캄보디아,2003-08
2003-08-31,8464640,4048798,4415842,기타국,2003-08
2003-08-31,7913909,3049783,4864126,미얀마,2003-08
2003-08-31,7771085,252057319,-244286234,카타르,2003-08
2003-08-31,7546398,5048294,2498104,모로코,2003-08
2003-08-31,7127584,774,7126810,북마리아나 군도,2003-08
2003-08-31,6471044,879228,5591816,몽골,2003-08
2003-08-31,6311634,8059329,-1747695,베네주엘라,2003-08
2003-08-31,6280942,74,6280868,리비아,2003-08
2003-08-31,5916248,1521,5914727,니카라과,2003-08
2003-08-31,5445525,3651809,1793716,코스타리카,2003-08
2003-08-31,5434649,171720,5262929,레바논,2003-08
2003-08-31,5303546,872387,4431159,리투아니아,2003-08
2003-08-31,5126376,188154,4938222,엘살바도르,2003-08
2003-08-31,4822782,2127687,2695095,슬로베니아,2003-08
2003-08-31,4570491,973723,3596768,우루과이,2003-08
2003-08-31,4471151,14160340,-9689189,도미니카 공화국,2003-08
2003-08-31,3623026,18800761,-15177735,바레인,2003-08
2003-08-31,3604234,4914288,-1310054,스와질랜드,2003-08
2003-08-31,3404881,0,3404881,예맨,2003-08
2003-08-31,3169953,205150,2964803,크로아티아,2003-08
2003-08-31,2991343,17784,2973559,키르기스스탄,2003-08
2003-08-31,2935333,4304849,-1369516,몰타,2003-08
2003-08-31,2643094,1693250,949844,불가리아,2003-08
2003-08-31,2642619,230942,2411677,가나,2003-08
2003-08-31,2581668,563533,2018135,마카오,2003-08
2003-08-31,2419523,35372,2384151,라트비아,2003-08
2003-08-31,2270350,293382,1976968,케냐,2003-08
2003-08-31,2188244,45679,2142565,탄자니아,2003-08
2003-08-31,2171269,516670,1654599,튀니지,2003-08
2003-08-31,2055833,36208937,-34153104,브루나이,2003-08
2003-08-31,1991187,339126,1652061,코트디봐르,2003-08
2003-08-31,1971176,0,1971176,불령 리유니온 코모도 제도,2003-08
2003-08-31,1970122,55732,1914390,모리셔스,2003-08
2003-08-31,1909571,118512,1791059,파라과이,2003-08
2003-08-31,1807600,939989,867611,에스토니아,2003-08
2003-08-31,1801054,98517,1702537,에티오피아,2003-08
2003-08-31,1652738,101480,1551258,괌,2003-08
2003-08-31,1589980,167,1589813,트리니다드 토바고,2003-08
2003-08-31,1485608,110917,1374691,사이프러스,2003-08
2003-08-31,1484055,38671,1445384,피지,2003-08
2003-08-31,1359047,1899,1357148,아이티,2003-08
2003-08-31,1244886,509530,735356,아이슬란드,2003-08
2003-08-31,1234804,82612,1152192,베닝,2003-08
2003-08-31,1043425,94773,948652,네팔,2003-08
2003-08-31,1023310,0,1023310,아루바,2003-08
2003-08-31,937912,94030,843882,카메룬,2003-08
2003-08-31,921009,0,921009,토고,2003-08
2003-08-31,906165,10994,895171,마다카스카르,2003-08
2003-08-31,846687,429108,417579,투르크멘,2003-08
2003-08-31,779583,0,779583,아제르바이잔,2003-08
2003-08-31,769108,498065,271043,세네갈,2003-08
2003-08-31,731352,715,730637,마이크로네시아,2003-08
2003-08-31,695336,69637,625699,자마이카,2003-08
2003-08-31,673163,413694,259469,짐바브웨,2003-08
2003-08-31,642794,3056,639738,유고,2003-08
2003-08-31,599428,0,599428,레소토,2003-08
2003-08-31,598871,25403427,-24804556,콩고,2003-08
2003-08-31,597853,0,597853,과델로프,2003-08
2003-08-31,592061,0,592061,마세도니아,2003-08
2003-08-31,575091,48787,526304,뉴 칼레도니아,2003-08
2003-08-31,543038,5090,537948,라오스,2003-08
2003-08-31,506328,104,506224,앙골라,2003-08
2003-08-31,447890,324549,123341,조지아,2003-08
2003-08-31,435639,830715,-395076,기니,2003-08
2003-08-31,432330,2008,430322,아르메니아,2003-08
2003-08-31,427064,1710853,-1283789,벨라루스,2003-08
2003-08-31,418502,0,418502,모잠비크,2003-08
2003-08-31,391014,19368,371646,보스니아-헤르체고비나,2003-08
2003-08-31,372481,0,372481,네덜란드 열도,2003-08
2003-08-31,363333,911723,-548390,파푸아 뉴기니,2003-08
2003-08-31,347627,95044,252583,모리타니,2003-08
2003-08-31,346893,0,346893,티모르,2003-08
2003-08-31,330291,0,330291,마티니크,2003-08
2003-08-31,325849,207896,117953,타지크,2003-08
2003-08-31,302372,0,302372,벨리제,2003-08
2003-08-31,298520,112,298408,알바니아,2003-08
2003-08-31,291592,8354468,-8062876,볼리비아,2003-08
2003-08-31,255999,0,255999,바베이도스,2003-08
2003-08-31,255559,86169,169390,가봉,2003-08
2003-08-31,253043,55431,197612,니제르,2003-08
2003-08-31,244305,0,244305,팔라우,2003-08
2003-08-31,243773,10022,233751,시에라 리온,2003-08
2003-08-31,238790,238777,13,리히텐슈타인,2003-08
2003-08-31,230676,0,230676,아메리칸 사모아,2003-08
2003-08-31,226279,0,226279,안티가 바부다,2003-08
2003-08-31,218843,964,217879,몰도바,2003-08
2003-08-31,211110,0,211110,불령 가이아나,2003-08
2003-08-31,197792,0,197792,사모아,2003-08
2003-08-31,197397,4050851,-3853454,잠비아,2003-08
2003-08-31,168102,0,168102,에리트리아,2003-08
2003-08-31,161252,2477822,-2316570,룩셈부르그,2003-08
2003-08-31,154309,0,154309,불령 폴리네시아,2003-08
2003-08-31,143347,0,143347,세인트 루시아,2003-08
2003-08-31,142716,85597,57119,보츠와나,2003-08
2003-08-31,121225,9765,111460,지부티,2003-08
2003-08-31,111812,146233,-34421,콩고민주공화국,2003-08
2003-08-31,101456,0,101456,도미니카,2003-08
2003-08-31,98172,0,98172,몰디브,2003-08
2003-08-31,91426,369,91057,수리남,2003-08
2003-08-31,87296,0,87296,영령 버진군도,2003-08
2003-08-31,83937,0,83937,가이아나,2003-08
2003-08-31,78788,5899,72889,소말리아,2003-08
2003-08-31,69459,10777,58682,우간다,2003-08
2003-08-31,63298,119429,-56131,나미비아,2003-08
2003-08-31,62823,273496,-210673,말리,2003-08
2003-08-31,61414,32260,29154,감비아,2003-08
2003-08-31,60392,0,60392,말라위,2003-08
2003-08-31,59291,0,59291,중앙아프리카공화국,2003-08
2003-08-31,52169,0,52169,이라크,2003-08
2003-08-31,52155,668334,-616179,부르키나 파소,2003-08
2003-08-31,48194,31,48163,통가,2003-08
2003-08-31,46728,0,46728,세인트 빈센트 그레나딘,2003-08
2003-08-31,45638,0,45638,토켈라우,2003-08
2003-08-31,44756,0,44756,부탄,2003-08
2003-08-31,44307,1923442,-1879135,솔로몬 군도,2003-08
2003-08-31,36638,0,36638,버뮤다,2003-08
2003-08-31,35398,0,35398,영령 캐이맨 군도,2003-08
2003-08-31,32960,74,32886,바누아투,2003-08
2003-08-31,30880,0,30880,투르크 & 카이코스 군도,2003-08
2003-08-31,28878,425,28453,팔레스타인 해방기구(구),2003-08
2003-08-31,28537,0,28537,그레나다,2003-08
2003-08-31,15321,0,15321,부룬디,2003-08
2003-08-31,13691,0,13691,키리바티,2003-08
2003-08-31,5850,1042558,-1036708,모나코,2003-08
2003-08-31,4753,0,4753,르완다,2003-08
2003-08-31,4408,0,4408,지브랄타,2003-08
2003-08-31,1804,2769,-965,마이너 아우틀링 합중국 군도,2003-08
2003-08-31,1093,206551,-205458,안도라,2003-08
2003-08-31,635,1446,-811,쿡 아일랜드,2003-08
2003-08-31,55,0,55,미령 버진군도,2003-08
2003-08-31,0,185,-185,산마리노,2003-08
2003-08-31,0,576,-576,상토메 프린스페,2003-08
2003-08-31,0,4430,-4430,그린랜드,2003-08
2003-08-31,0,49316,-49316,파로에 군도,2003-08
2003-08-31,0,4469,-4469,앙귈라,2003-08
2003-08-31,0,453,-453,카보 베르데,2003-08
2003-09-30,3274210504,1894108377,1380102127,중국,2003-09
2003-09-30,3034998707,1902112040,1132886667,미국,2003-09
2003-09-30,1437461044,3084484243,-1647023199,일본,2003-09
2003-09-30,1274404786,209229854,1065174932,홍콩,2003-09
2003-09-30,612773127,486325010,126448117,대만,2003-09
2003-09-30,495096152,572862232,-77766080,독일,2003-09
2003-09-30,403206375,491674122,-88467747,호주,2003-09
2003-09-30,359848684,334417381,25431303,싱가포르,2003-09
2003-09-30,332217173,322877043,9340130,말레이시아,2003-09
2003-09-30,315847729,198610802,117236927,영국,2003-09
2003-09-30,257615359,398399331,-140783972,인도네시아,2003-09
2003-09-30,256501219,5757254,250743965,파나마,2003-09
2003-09-30,254546722,144576136,109970586,캐나다,2003-09
2003-09-30,240045212,160856164,79189048,태국,2003-09
2003-09-30,235642616,50228989,185413627,벨기에,2003-09
2003-09-30,231256537,178585833,52670704,필리핀,2003-09
2003-09-30,228928352,107804202,121124150,인도,2003-09
2003-09-30,215591042,30101103,185489939,멕시코,2003-09
2003-09-30,194711495,80228427,114483068,네덜란드,2003-09
2003-09-30,192545654,45626154,146919500,베트남,2003-09
2003-09-30,191652987,177408379,14244608,이탈리아,2003-09
2003-09-30,178440960,589449439,-411008479,아랍에미리트 연합,2003-09
2003-09-30,163883349,30084265,133799084,스페인,2003-09
2003-09-30,151394517,167373175,-15978658,프랑스,2003-09
2003-09-30,141573437,156712328,-15138891,이란,2003-09
2003-09-30,139597008,26216684,113380324,그리스,2003-09
2003-09-30,139314195,8430069,130884126,튀르키예,2003-09
2003-09-30,136783047,235126251,-98343204,러시아 연방,2003-09
2003-09-30,121736387,0,121736387,라이베리아,2003-09
2003-09-30,118199061,602473931,-484274870,사우디아라비아,2003-09
2003-09-30,109535076,32182921,77352155,핀란드,2003-09
2003-09-30,91762074,180444833,-88682759,브라질,2003-09
2003-09-30,86510009,0,86510009,마샬군도,2003-09
2003-09-30,85595190,73821182,11774008,아일랜드,2003-09
2003-09-30,61542424,8437471,53104953,헝가리,2003-09
2003-09-30,54785970,49112757,5673213,남아프리카공화국,2003-09
2003-09-30,53150400,23989,53126411,바하마,2003-09
2003-09-30,52811319,30232944,22578375,이스라엘,2003-09
2003-09-30,46552074,145311,46406763,과테말라,2003-09
2003-09-30,46041797,232638,45809159,나이지리아,2003-09
2003-09-30,44952934,37109490,7843444,스웨덴,2003-09
2003-09-30,42592759,3227282,39365477,방글라데시,2003-09
2003-09-30,39802856,25281952,14520904,우크라이나,2003-09
2003-09-30,39338778,88329796,-48991018,칠레,2003-09
2003-09-30,38468986,28682077,9786909,오스트리아,2003-09
2003-09-30,36477016,14275887,22201129,파키스탄,2003-09
2003-09-30,34462673,4514982,29947691,폴란드,2003-09
2003-09-30,31699695,47396534,-15696839,뉴질랜드,2003-09
2003-09-30,27961052,19001673,8959379,이집트,2003-09
2003-09-30,27200383,1905432,25294951,요르단,2003-09
2003-09-30,25733964,3822245,21911719,미얀마,2003-09
2003-09-30,25584989,117494,25467495,시리아,2003-09
2003-09-30,24469132,6663463,17805669,콜롬비아,2003-09
2003-09-30,24170509,3070780,21099729,우즈베키스탄,2003-09
2003-09-30,22483178,96627804,-74144626,스위스,2003-09
2003-09-30,21486613,9083973,12402640,카자흐스탄,2003-09
2003-09-30,21034090,30855482,-9821392,덴마크,2003-09
2003-09-30,20103044,2249754,17853290,스리랑카,2003-09
2003-09-30,19692740,7847104,11845636,푸에르토리코,2003-09
2003-09-30,17789433,35998246,-18208813,아르헨티나,2003-09
2003-09-30,17705600,3435558,14270042,포루투갈,2003-09
2003-09-30,16769966,17789191,-1019225,알제리,2003-09
2003-09-30,16063249,937357,15125892,에쿠아도르,2003-09
2003-09-30,15497822,304389,15193433,몽골,2003-09
2003-09-30,15366905,322335117,-306968212,쿠웨이트,2003-09
2003-09-30,14415813,4022520,10393293,페루,2003-09
2003-09-30,13949062,11564154,2384908,루마니아,2003-09
2003-09-30,13733870,9048061,4685809,체코공화국,2003-09
2003-09-30,13362584,2211708,11150876,기타국,2003-09
2003-09-30,12557083,50497,12506586,아프카니스탄,2003-09
2003-09-30,12105083,2773095,9331988,모로코,2003-09
2003-09-30,11998969,1063616,10935353,온두라스,2003-09
2003-09-30,11352030,1593478,9758552,슬로바키아,2003-09
2003-09-30,9991658,30022999,-20031341,노르웨이,2003-09
2003-09-30,9385853,185129,9200724,캄보디아,2003-09
2003-09-30,9359253,240582738,-231223485,카타르,2003-09
2003-09-30,9123691,0,9123691,리비아,2003-09
2003-09-30,8986573,7152757,1833816,몰타,2003-09
2003-09-30,8232296,185895842,-177663546,오만,2003-09
2003-09-30,7347872,1876440,5471432,베네주엘라,2003-09
2003-09-30,7053609,5650085,1403524,코스타리카,2003-09
2003-09-30,6783396,8709384,-1925988,예맨,2003-09
2003-09-30,6640252,230,6640022,니카라과,2003-09
2003-09-30,6633483,2373311,4260172,수단,2003-09
2003-09-30,6593598,165612,6427986,엘살바도르,2003-09
2003-09-30,6425158,427997,5997161,레바논,2003-09
2003-09-30,5800488,156780,5643708,케냐,2003-09
2003-09-30,5612925,20735,5592190,북마리아나 군도,2003-09
2003-09-30,5354645,7065113,-1710468,리투아니아,2003-09
2003-09-30,5042327,508518,4533809,도미니카 공화국,2003-09
2003-09-30,4685191,8430,4676761,유고,2003-09
2003-09-30,4123523,1712544,2410979,슬로베니아,2003-09
2003-09-30,4021646,1425760,2595886,가나,2003-09
2003-09-30,3744108,156843,3587265,크로아티아,2003-09
2003-09-30,3454249,27042,3427207,키르기스스탄,2003-09
2003-09-30,3417000,15680851,-12263851,바레인,2003-09
2003-09-30,3241532,0,3241532,이라크,2003-09
2003-09-30,3171449,631057,2540392,튀니지,2003-09
2003-09-30,3151809,1525420,1626389,불가리아,2003-09
2003-09-30,3112479,495,3111984,탄자니아,2003-09
2003-09-30,2549975,1489787,1060188,우루과이,2003-09
2003-09-30,2471788,641236,1830552,코트디봐르,2003-09
2003-09-30,2404625,689912,1714713,에스토니아,2003-09
2003-09-30,2391635,0,2391635,토고,2003-09
2003-09-30,2385911,36742313,-34356402,브루나이,2003-09
2003-09-30,2229735,60448,2169287,모리셔스,2003-09
2003-09-30,2204800,0,2204800,불령 리유니온 코모도 제도,2003-09
2003-09-30,2178821,435775,1743046,마카오,2003-09
2003-09-30,2121445,1225992,895453,에티오피아,2003-09
2003-09-30,2095047,23047,2072000,파라과이,2003-09
2003-09-30,2055817,248258,1807559,라트비아,2003-09
2003-09-30,2027094,0,2027094,투르크멘,2003-09
2003-09-30,1998562,93989,1904573,괌,2003-09
2003-09-30,1977234,138402,1838832,사이프러스,2003-09
2003-09-30,1850821,0,1850821,마티니크,2003-09
2003-09-30,1709332,1800,1707532,앙골라,2003-09
2003-09-30,1669653,147523,1522130,네팔,2003-09
2003-09-30,1661667,7135329,-5473662,뉴 칼레도니아,2003-09
2003-09-30,1645566,105677,1539889,트리니다드 토바고,2003-09
2003-09-30,1557497,0,1557497,아이티,2003-09
2003-09-30,1414045,764155,649890,아이슬란드,2003-09
2003-09-30,1360521,127294,1233227,벨라루스,2003-09
2003-09-30,1306906,126912,1179994,카메룬,2003-09
2003-09-30,1186423,2677258,-1490835,스와질랜드,2003-09
2003-09-30,1160417,75518,1084899,피지,2003-09
2003-09-30,1157797,0,1157797,과델로프,2003-09
2003-09-30,1021517,8293,1013224,도미니카,2003-09
2003-09-30,968934,139755,829179,베닝,2003-09
2003-09-30,905894,7077808,-6171914,기니,2003-09
2003-09-30,872787,27440,845347,레소토,2003-09
2003-09-30,864493,46838,817655,콩고,2003-09
2003-09-30,858681,77655,781026,자마이카,2003-09
2003-09-30,805489,35521,769968,보츠와나,2003-09
2003-09-30,795659,32286,763373,세네갈,2003-09
2003-09-30,775719,0,775719,아루바,2003-09
2003-09-30,748993,0,748993,아제르바이잔,2003-09
2003-09-30,735374,20746,714628,아르메니아,2003-09
2003-09-30,691811,51012,640799,마다카스카르,2003-09
2003-09-30,660461,0,660461,지부티,2003-09
2003-09-30,605656,3078380,-2472724,파푸아 뉴기니,2003-09
2003-09-30,605448,0,605448,불령 폴리네시아,2003-09
2003-09-30,560976,2724720,-2163744,잠비아,2003-09
2003-09-30,533447,3536725,-3003278,룩셈부르그,2003-09
2003-09-30,520254,54240,466014,말라위,2003-09
2003-09-30,486680,8483,478197,라오스,2003-09
2003-09-30,468023,72682,395341,볼리비아,2003-09
2003-09-30,466437,0,466437,바베이도스,2003-09
2003-09-30,433613,562620,-129007,우간다,2003-09
2003-09-30,429684,84509,345175,조지아,2003-09
2003-09-30,399290,0,399290,모리타니,2003-09
2003-09-30,386204,0,386204,영령 캐이맨 군도,2003-09
2003-09-30,386099,0,386099,알바니아,2003-09
2003-09-30,384778,2420,382358,보스니아-헤르체고비나,2003-09
2003-09-30,373636,2986040,-2612404,짐바브웨,2003-09
2003-09-30,331614,25261,306353,모잠비크,2003-09
2003-09-30,318532,982237,-663705,타지크,2003-09
2003-09-30,302847,5797,297050,니제르,2003-09
2003-09-30,267418,0,267418,세인트 루시아,2003-09
2003-09-30,248518,0,248518,팔라우,2003-09
2003-09-30,240213,3588,236625,벨리제,2003-09
2003-09-30,238587,4205,234382,사모아,2003-09
2003-09-30,227943,0,227943,마이크로네시아,2003-09
2003-09-30,224835,3349,221486,그레나다,2003-09
2003-09-30,223911,0,223911,수리남,2003-09
2003-09-30,200719,0,200719,불령 가이아나,2003-09
2003-09-30,184672,102044,82628,팔레스타인 해방기구(구),2003-09
2003-09-30,163234,452630,-289396,안티가 바부다,2003-09
2003-09-30,154627,0,154627,마세도니아,2003-09
2003-09-30,153170,0,153170,몰도바,2003-09
2003-09-30,152569,1274,151295,네덜란드 열도,2003-09
2003-09-30,148598,28045293,-27896695,가봉,2003-09
2003-09-30,142794,36597,106197,콩고민주공화국,2003-09
2003-09-30,138295,3061,135234,부탄,2003-09
2003-09-30,128059,0,128059,바누아투,2003-09
2003-09-30,116804,116444,360,세이쉘,2003-09
2003-09-30,102866,73202,29664,감비아,2003-09
2003-09-30,91193,0,91193,아메리칸 사모아,2003-09
2003-09-30,84813,256665,-171852,리히텐슈타인,2003-09
2003-09-30,78902,0,78902,가이아나,2003-09
2003-09-30,78513,393,78120,에리트리아,2003-09
2003-09-30,73320,0,73320,세인트 빈센트 그레나딘,2003-09
2003-09-30,55756,184247,-128491,몰디브,2003-09
2003-09-30,54567,0,54567,버뮤다,2003-09
2003-09-30,54284,1296134,-1241850,솔로몬 군도,2003-09
2003-09-30,54024,0,54024,부룬디,2003-09
2003-09-30,48313,312935,-264622,부르키나 파소,2003-09
2003-09-30,45848,1079,44769,시에라 리온,2003-09
2003-09-30,39662,16072,23590,토켈라우,2003-09
2003-09-30,39208,303859,-264651,말리,2003-09
2003-09-30,34294,83854,-49560,나미비아,2003-09
2003-09-30,30880,0,30880,투르크 & 카이코스 군도,2003-09
2003-09-30,29874,0,29874,영령 버진군도,2003-09
2003-09-30,19357,0,19357,앙귈라,2003-09
2003-09-30,14193,448369,-434176,모나코,2003-09
2003-09-30,13645,0,13645,세인트 키츠 네비스,2003-09
2003-09-30,12947,137518,-124571,안도라,2003-09
2003-09-30,7813,1555,6258,지브랄타,2003-09
2003-09-30,4481,57,4424,통가,2003-09
2003-09-30,2298,952,1346,마이너 아우틀링 합중국 군도,2003-09
2003-09-30,1045,0,1045,투발루,2003-09
2003-09-30,411,541,-130,코모로스,2003-09
2003-09-30,0,1107,-1107,남조지아 & 남샌드위치 군도,2003-09
2003-09-30,0,31253,-31253,교황청,2003-09
2003-09-30,0,433946,-433946,챠드,2003-09
2003-09-30,0,62947,-62947,상토메 프린스페,2003-09
2003-09-30,0,207119,-207119,그린랜드,2003-09
2003-09-30,0,4287,-4287,불령 남부지역,2003-09
2003-09-30,0,165,-165,세인트 헬레나,2003-09
2003-09-30,0,2295628,-2295628,미령 버진군도,2003-09
2003-09-30,0,3600,-3600,키리바티,2003-09
2003-10-31,3540626175,2144511517,1396114658,중국,2003-10
2003-10-31,3425960263,2232499625,1193460638,미국,2003-10
2003-10-31,1725329265,3611926733,-1886597468,일본,2003-10
2003-10-31,1518784077,277874858,1240909219,홍콩,2003-10
2003-10-31,700715085,539500100,161214985,대만,2003-10
2003-10-31,587217947,619407235,-32189288,독일,2003-10
2003-10-31,405250124,384908331,20341793,싱가포르,2003-10
2003-10-31,394545064,267450513,127094551,영국,2003-10
2003-10-31,375799610,390471947,-14672337,말레이시아,2003-10
2003-10-31,329235723,147828585,181407138,캐나다,2003-10
2003-10-31,322983309,176685962,146297347,필리핀,2003-10
2003-10-31,294160665,569648429,-275487764,호주,2003-10
2003-10-31,270201359,465784813,-195583454,인도네시아,2003-10
2003-10-31,265079925,39429818,225650107,멕시코,2003-10
2003-10-31,260356084,193151681,67204403,이탈리아,2003-10
2003-10-31,239220981,51510856,187710125,베트남,2003-10
2003-10-31,237006414,199739808,37266606,태국,2003-10
2003-10-31,224470400,146394503,78075897,네덜란드,2003-10
2003-10-31,220557488,37160926,183396562,스페인,2003-10
2003-10-31,219712915,440924746,-221211831,아랍에미리트 연합,2003-10
2003-10-31,205274486,97383461,107891025,인도,2003-10
2003-10-31,188129285,10584184,177545101,그리스,2003-10
2003-10-31,180452412,173627391,6825021,프랑스,2003-10
2003-10-31,173559802,6411363,167148439,튀르키예,2003-10
2003-10-31,171929625,184889750,-12960125,이란,2003-10
2003-10-31,161808269,283280446,-121472177,러시아 연방,2003-10
2003-10-31,156609082,701515139,-544906057,사우디아라비아,2003-10
2003-10-31,153537371,57303,153480068,라이베리아,2003-10
2003-10-31,122252002,40150029,82101973,핀란드,2003-10
2003-10-31,106265268,115946334,-9681066,브라질,2003-10
2003-10-31,100158604,73164718,26993886,벨기에,2003-10
2003-10-31,69420328,68175732,1244596,파나마,2003-10
2003-10-31,59397853,38919896,20477957,노르웨이,2003-10
2003-10-31,59319771,6243643,53076128,헝가리,2003-10
2003-10-31,59139809,76100,59063709,나이지리아,2003-10
2003-10-31,53760054,145170,53614884,과테말라,2003-10
2003-10-31,53622265,119558947,-65936682,칠레,2003-10
2003-10-31,53077921,86579228,-33501307,남아프리카공화국,2003-10
2003-10-31,51538943,2955426,48583517,방글라데시,2003-10
2003-10-31,49226223,34388583,14837640,이스라엘,2003-10
2003-10-31,44949585,48834634,-3885049,오스트리아,2003-10
2003-10-31,44008438,58534971,-14526533,스웨덴,2003-10
2003-10-31,41396385,53691904,-12295519,뉴질랜드,2003-10
2003-10-31,40968378,4729,40963649,바하마,2003-10
2003-10-31,40178761,68014477,-27835716,아일랜드,2003-10
2003-10-31,39465157,4385273,35079884,폴란드,2003-10
2003-10-31,37855778,18226003,19629775,파키스탄,2003-10
2003-10-31,33947441,7670056,26277385,이집트,2003-10
2003-10-31,31367147,9722270,21644877,카자흐스탄,2003-10
2003-10-31,31348004,9655847,21692157,콜롬비아,2003-10
2003-10-31,30405373,32598256,-2192883,덴마크,2003-10
2003-10-31,29576754,10637265,18939489,우크라이나,2003-10
2003-10-31,28692931,136484600,-107791669,스위스,2003-10
2003-10-31,28597919,357250,28240669,사이프러스,2003-10
2003-10-31,28463087,394046,28069041,시리아,2003-10
2003-10-31,27987556,1577027,26410529,요르단,2003-10
2003-10-31,25343496,5484087,19859409,우즈베키스탄,2003-10
2003-10-31,24989535,3541375,21448160,스리랑카,2003-10
2003-10-31,23728580,861434,22867146,알제리,2003-10
2003-10-31,23357467,3389811,19967656,포루투갈,2003-10
2003-10-31,22645810,3650694,18995116,미얀마,2003-10
2003-10-31,20813724,49603089,-28789365,아르헨티나,2003-10
2003-10-31,20253196,36982498,-16729302,에쿠아도르,2003-10
2003-10-31,20168014,2008856,18159158,루마니아,2003-10
2003-10-31,19409562,28780684,-9371122,페루,2003-10
2003-10-31,18136016,8053477,10082539,푸에르토리코,2003-10
2003-10-31,16355490,8926402,7429088,체코공화국,2003-10
2003-10-31,15975535,3321521,12654014,기타국,2003-10
2003-10-31,15598200,262160087,-246561887,쿠웨이트,2003-10
2003-10-31,14777675,13114769,1662906,베네주엘라,2003-10
2003-10-31,12642762,5985242,6657520,몰타,2003-10
2003-10-31,11839215,226129688,-214290473,오만,2003-10
2003-10-31,11806867,3016897,8789970,모로코,2003-10
2003-10-31,11746968,1528487,10218481,슬로바키아,2003-10
2003-10-31,11622405,2637111,8985294,슬로베니아,2003-10
2003-10-31,11548787,431593,11117194,괌,2003-10
2003-10-31,11268062,234744,11033318,캄보디아,2003-10
2003-10-31,10900673,49454,10851219,아프카니스탄,2003-10
2003-10-31,9677219,298855381,-289178162,카타르,2003-10
2003-10-31,9588918,18718,9570200,북마리아나 군도,2003-10
2003-10-31,8918984,815765,8103219,온두라스,2003-10
2003-10-31,7440570,4011228,3429342,수단,2003-10
2003-10-31,7289839,253137,7036702,레바논,2003-10
2003-10-31,6458304,430811,6027493,몽골,2003-10
2003-10-31,5877356,2474448,3402908,코스타리카,2003-10
2003-10-31,5857706,240383,5617323,리투아니아,2003-10
2003-10-31,5690870,8080776,-2389906,도미니카 공화국,2003-10
2003-10-31,5442609,445546,4997063,가나,2003-10
2003-10-31,5371049,0,5371049,리비아,2003-10
2003-10-31,5368942,360836,5008106,케냐,2003-10
2003-10-31,5338130,95071,5243059,엘살바도르,2003-10
2003-10-31,5304966,409276,4895690,우루과이,2003-10
2003-10-31,5106287,2145354,2960933,불가리아,2003-10
2003-10-31,4667747,7480555,-2812808,예맨,2003-10
2003-10-31,4474334,114216,4360118,크로아티아,2003-10
2003-10-31,4418658,133,4418525,니카라과,2003-10
2003-10-31,4317828,8170970,-3853142,바레인,2003-10
2003-10-31,4196733,0,4196733,이라크,2003-10
2003-10-31,4019967,738278,3281689,에스토니아,2003-10
2003-10-31,3954521,251134,3703387,튀니지,2003-10
2003-10-31,3767884,256889,3510995,투르크멘,2003-10
2003-10-31,3591769,58636,3533133,키르기스스탄,2003-10
2003-10-31,3348953,211556,3137397,마카오,2003-10
2003-10-31,2925623,4355890,-1430267,스와질랜드,2003-10
2003-10-31,2920456,31098123,-28177667,브루나이,2003-10
2003-10-31,2885644,0,2885644,불령 리유니온 코모도 제도,2003-10
2003-10-31,2842965,536443,2306522,코트디봐르,2003-10
2003-10-31,2576944,16499240,-13922296,탄자니아,2003-10
2003-10-31,2511736,89417,2422319,파라과이,2003-10
2003-10-31,2398282,43358,2354924,라트비아,2003-10
2003-10-31,2342451,5177,2337274,토고,2003-10
2003-10-31,2338090,0,2338090,앙골라,2003-10
2003-10-31,2048676,586,2048090,트리니다드 토바고,2003-10
2003-10-31,1950140,4402609,-2452469,뉴 칼레도니아,2003-10
2003-10-31,1928591,31226,1897365,모리셔스,2003-10
2003-10-31,1910705,0,1910705,아제르바이잔,2003-10
2003-10-31,1774825,223893,1550932,아이슬란드,2003-10
2003-10-31,1650976,599,1650377,도미니카,2003-10
2003-10-31,1650630,136264,1514366,네팔,2003-10
2003-10-31,1590202,40686,1549516,마다카스카르,2003-10
2003-10-31,1488391,17523,1470868,아이티,2003-10
2003-10-31,1350370,0,1350370,마티니크,2003-10
2003-10-31,1312751,240360,1072391,세네갈,2003-10
2003-10-31,1270556,0,1270556,과델로프,2003-10
2003-10-31,1251177,65140,1186037,벨라루스,2003-10
2003-10-31,1158279,110817,1047462,유고,2003-10
2003-10-31,1113712,0,1113712,콩고,2003-10
2003-10-31,1096662,0,1096662,베닝,2003-10
2003-10-31,1093512,89195,1004317,자마이카,2003-10
2003-10-31,996923,324048,672875,에티오피아,2003-10
2003-10-31,853930,135475,718455,카메룬,2003-10
2003-10-31,741107,0,741107,아루바,2003-10
2003-10-31,740543,5027800,-4287257,잠비아,2003-10
2003-10-31,706082,9522756,-8816674,파푸아 뉴기니,2003-10
2003-10-31,700884,4396795,-3695911,볼리비아,2003-10
2003-10-31,659573,109337,550236,피지,2003-10
2003-10-31,589208,503,588705,바베이도스,2003-10
2003-10-31,588303,0,588303,노폴크 아일랜드,2003-10
2003-10-31,567376,1712,565664,수리남,2003-10
2003-10-31,556454,0,556454,지부티,2003-10
2003-10-31,542821,21826,520995,알바니아,2003-10
2003-10-31,541810,126334,415476,조지아,2003-10
2003-10-31,535053,64605,470448,모잠비크,2003-10
2003-10-31,510130,0,510130,마이크로네시아,2003-10
2003-10-31,493829,12784,481045,팔라우,2003-10
2003-10-31,483510,462455,21055,짐바브웨,2003-10
2003-10-31,479376,0,479376,보스니아-헤르체고비나,2003-10
2003-10-31,473717,5868,467849,라오스,2003-10
2003-10-31,427765,439076,-11311,벨리제,2003-10
2003-10-31,382648,85026,297622,우간다,2003-10
2003-10-31,374324,0,374324,레소토,2003-10
2003-10-31,367385,137683,229702,말라위,2003-10
2003-10-31,351957,0,351957,안티가 바부다,2003-10
2003-10-31,345413,119186,226227,타지크,2003-10
2003-10-31,331701,7507,324194,니제르,2003-10
2003-10-31,308870,28885,279985,몰도바,2003-10
2003-10-31,300095,438163,-138068,기니,2003-10
2003-10-31,296953,2191,294762,네덜란드 열도,2003-10
2003-10-31,290372,91760,198612,가봉,2003-10
2003-10-31,288843,3046928,-2758085,룩셈부르그,2003-10
2003-10-31,287645,74180,213465,보츠와나,2003-10
2003-10-31,282499,0,282499,아메리칸 사모아,2003-10
2003-10-31,269034,0,269034,사모아,2003-10
2003-10-31,267871,0,267871,영령 버진군도,2003-10
2003-10-31,263799,0,263799,불령 폴리네시아,2003-10
2003-10-31,252619,9241,243378,모리타니,2003-10
2003-10-31,229590,11610,217980,몰디브,2003-10
2003-10-31,200185,2955,197230,시에라 리온,2003-10
2003-10-31,177600,0,177600,부룬디,2003-10
2003-10-31,177546,0,177546,부탄,2003-10
2003-10-31,173957,0,173957,버뮤다,2003-10
2003-10-31,170611,310,170301,아르메니아,2003-10
2003-10-31,141322,0,141322,에리트리아,2003-10
2003-10-31,129313,0,129313,통가,2003-10
2003-10-31,128622,0,128622,감비아,2003-10
2003-10-31,128167,152432,-24265,리히텐슈타인,2003-10
2003-10-31,125795,0,125795,마세도니아,2003-10
2003-10-31,117817,0,117817,그레나다,2003-10
2003-10-31,113186,0,113186,파로에 군도,2003-10
2003-10-31,105259,0,105259,바누아투,2003-10
2003-10-31,102718,1628210,-1525492,솔로몬 군도,2003-10
2003-10-31,102704,0,102704,마이너 아우틀링 합중국 군도,2003-10
2003-10-31,99713,0,99713,세인트 빈센트 그레나딘,2003-10
2003-10-31,98819,1840414,-1741595,안도라,2003-10
2003-10-31,96096,4721,91375,불령 가이아나,2003-10
2003-10-31,84948,206079,-121131,팔레스타인 해방기구(구),2003-10
2003-10-31,79798,73299,6499,쿡 아일랜드,2003-10
2003-10-31,75905,284689,-208784,모나코,2003-10
2003-10-31,74538,0,74538,적도 기니,2003-10
2003-10-31,72320,0,72320,영령 캐이맨 군도,2003-10
2003-10-31,71978,929407,-857429,부르키나 파소,2003-10
2003-10-31,60366,0,60366,세인트 루시아,2003-10
2003-10-31,45962,0,45962,가이아나,2003-10
2003-10-31,44187,0,44187,소말리아,2003-10
2003-10-31,38648,0,38648,세이쉘,2003-10
2003-10-31,37716,0,37716,허드 앤 맥도날드 군도,2003-10
2003-10-31,35725,0,35725,투르크 & 카이코스 군도,2003-10
2003-10-31,30904,235760,-204856,말리,2003-10
2003-10-31,25451,1207,24244,르완다,2003-10
2003-10-31,21060,319723,-298663,마샬군도,2003-10
2003-10-31,19004,0,19004,키리바티,2003-10
2003-10-31,15796,0,15796,지브랄타,2003-10
2003-10-31,14976,552,14424,나미비아,2003-10
2003-10-31,14220,0,14220,세인트 키츠 네비스,2003-10
2003-10-31,11988,0,11988,몬트세라트,2003-10
2003-10-31,6951,0,6951,교황청,2003-10
2003-10-31,5530,520,5010,토켈라우,2003-10
2003-10-31,4577,132574,-127997,콩고민주공화국,2003-10
2003-10-31,1128,433982,-432854,챠드,2003-10
2003-10-31,40,0,40,미령 버진군도,2003-10
2003-10-31,0,2602,-2602,영령 인도양,2003-10
2003-10-31,0,92036,-92036,상토메 프린스페,2003-10
2003-10-31,0,103354,-103354,보빗군도,2003-10
2003-10-31,0,1329,-1329,크리스마스 아일랜드,2003-10
2003-10-31,0,1344,-1344,나우루,2003-10
2003-10-31,0,26250,-26250,그린랜드,2003-10
2003-11-30,3448459677,2001083226,1447376451,중국,2003-11
2003-11-30,3213552727,2027584140,1185968587,미국,2003-11
2003-11-30,1698328371,3169772365,-1471443994,일본,2003-11
2003-11-30,1511066342,313698270,1197368072,홍콩,2003-11
2003-11-30,702004385,494937659,207066726,대만,2003-11
2003-11-30,589337546,562476529,26861017,독일,2003-11
2003-11-30,407788515,349060370,58728145,싱가포르,2003-11
2003-11-30,376809032,296564162,80244870,영국,2003-11
2003-11-30,351108479,367177065,-16068586,말레이시아,2003-11
2003-11-30,277383652,190259138,87124514,필리핀,2003-11
2003-11-30,267336208,563841814,-296505606,호주,2003-11
2003-11-30,252957740,78535923,174421817,인도,2003-11
2003-11-30,236972752,159886914,77085838,캐나다,2003-11
2003-11-30,224958360,162244936,62713424,태국,2003-11
2003-11-30,222750947,44968160,177782787,베트남,2003-11
2003-11-30,222497127,442211619,-219714492,인도네시아,2003-11
2003-11-30,221863391,35029373,186834018,멕시코,2003-11
2003-11-30,217329198,90171009,127158189,네덜란드,2003-11
2003-11-30,213988498,41458930,172529568,스페인,2003-11
2003-11-30,208454383,199142983,9311400,이탈리아,2003-11
2003-11-30,205857163,377614975,-171757812,아랍에미리트 연합,2003-11
2003-11-30,189911202,250523704,-60612502,러시아 연방,2003-11
2003-11-30,164966477,201785088,-36818611,프랑스,2003-11
2003-11-30,154651675,0,154651675,라이베리아,2003-11
2003-11-30,150298514,261591152,-111292638,이란,2003-11
2003-11-30,147201009,4066546,143134463,튀르키예,2003-11
2003-11-30,127588197,919705730,-792117533,사우디아라비아,2003-11
2003-11-30,118224878,183616385,-65391507,브라질,2003-11
2003-11-30,117725486,0,117725486,마샬군도,2003-11
2003-11-30,116843706,9270,116834436,바하마,2003-11
2003-11-30,112951246,57749710,55201536,벨기에,2003-11
2003-11-30,97727511,11466030,86261481,그리스,2003-11
2003-11-30,95233409,21082361,74151048,핀란드,2003-11
2003-11-30,89550412,7109781,82440631,헝가리,2003-11
2003-11-30,85066391,54624504,30441887,파나마,2003-11
2003-11-30,58307181,151254,58155927,사이프러스,2003-11
2003-11-30,52832386,10352165,42480221,몰타,2003-11
2003-11-30,52128858,27090701,25038157,이스라엘,2003-11
2003-11-30,51507631,64582880,-13075249,스웨덴,2003-11
2003-11-30,49167716,87662467,-38494751,남아프리카공화국,2003-11
2003-11-30,48692825,30552041,18140784,나이지리아,2003-11
2003-11-30,48098825,68478,48030347,과테말라,2003-11
2003-11-30,42585196,12436629,30148567,파키스탄,2003-11
2003-11-30,41096391,56425212,-15328821,아일랜드,2003-11
2003-11-30,40925974,2495230,38430744,방글라데시,2003-11
2003-11-30,40847778,94492867,-53645089,칠레,2003-11
2003-11-30,40240502,35979025,4261477,오스트리아,2003-11
2003-11-30,39323388,55025277,-15701889,뉴질랜드,2003-11
2003-11-30,36904445,3170886,33733559,이집트,2003-11
2003-11-30,36001443,6415787,29585656,폴란드,2003-11
2003-11-30,34167343,6933109,27234234,콜롬비아,2003-11
2003-11-30,32725926,28824417,3901509,덴마크,2003-11
2003-11-30,30204509,699481,29505028,요르단,2003-11
2003-11-30,30015969,5734915,24281054,우즈베키스탄,2003-11
2003-11-30,29609683,28861147,748536,우크라이나,2003-11
2003-11-30,26553135,111605411,-85052276,스위스,2003-11
2003-11-30,26271796,2609867,23661929,포루투갈,2003-11
2003-11-30,25680283,3080011,22600272,미얀마,2003-11
2003-11-30,24405260,157879,24247381,시리아,2003-11
2003-11-30,24030355,14318992,9711363,카자흐스탄,2003-11
2003-11-30,20441062,2545948,17895114,루마니아,2003-11
2003-11-30,19192972,2016524,17176448,스리랑카,2003-11
2003-11-30,18930091,1552431,17377660,베네주엘라,2003-11
2003-11-30,17210703,2344369,14866334,기타국,2003-11
2003-11-30,16478354,15039355,1438999,푸에르토리코,2003-11
2003-11-30,16153284,3356589,12796695,알제리,2003-11
2003-11-30,15658299,283009910,-267351611,쿠웨이트,2003-11
2003-11-30,15410597,14374554,1036043,아르헨티나,2003-11
2003-11-30,13059188,13619280,-560092,페루,2003-11
2003-11-30,12862845,5049487,7813358,모로코,2003-11
2003-11-30,12769602,7668860,5100742,체코공화국,2003-11
2003-11-30,12722209,34362520,-21640311,에쿠아도르,2003-11
2003-11-30,11353857,39970426,-28616569,노르웨이,2003-11
2003-11-30,11102675,21884,11080791,리비아,2003-11
2003-11-30,10185578,3089,10182489,온두라스,2003-11
2003-11-30,10105397,187585,9917812,캄보디아,2003-11
2003-11-30,9471284,2009013,7462271,불가리아,2003-11
2003-11-30,7943634,255250,7688384,몽골,2003-11
2003-11-30,7442589,310091832,-302649243,카타르,2003-11
2003-11-30,7211734,26657,7185077,수단,2003-11
2003-11-30,7127055,2613679,4513376,코스타리카,2003-11
2003-11-30,7124417,92116,7032301,엘살바도르,2003-11
2003-11-30,6933851,159846319,-152912468,오만,2003-11
2003-11-30,6707238,287129,6420109,레바논,2003-11
2003-11-30,6664285,1544992,5119293,슬로바키아,2003-11
2003-11-30,6331347,3060,6328287,아프카니스탄,2003-11
2003-11-30,5835613,2215394,3620219,슬로베니아,2003-11
2003-11-30,5483305,76604,5406701,리투아니아,2003-11
2003-11-30,5242744,0,5242744,이라크,2003-11
2003-11-30,5242558,87057,5155501,북마리아나 군도,2003-11
2003-11-30,5094429,958,5093471,니카라과,2003-11
2003-11-30,4921291,286,4921005,투르크멘,2003-11
2003-11-30,4506063,15268978,-10762915,예맨,2003-11
2003-11-30,4101255,16107276,-12006021,도미니카 공화국,2003-11
2003-11-30,4072652,206759,3865893,튀니지,2003-11
2003-11-30,4055778,0,4055778,아이티,2003-11
2003-11-30,3887465,40209,3847256,파라과이,2003-11
2003-11-30,3644870,2771847,873023,가나,2003-11
2003-11-30,3490534,35344718,-31854184,바레인,2003-11
2003-11-30,3198605,467994,2730611,마카오,2003-11
2003-11-30,3142622,44281883,-41139261,브루나이,2003-11
2003-11-30,3046305,12065,3034240,크로아티아,2003-11
2003-11-30,2861306,121592,2739714,케냐,2003-11
2003-11-30,2562197,58685,2503512,괌,2003-11
2003-11-30,2393797,658721,1735076,우루과이,2003-11
2003-11-30,2303595,1855001,448594,에스토니아,2003-11
2003-11-30,2300301,6694,2293607,토고,2003-11
2003-11-30,2289912,0,2289912,불령 리유니온 코모도 제도,2003-11
2003-11-30,2241569,11132,2230437,키르기스스탄,2003-11
2003-11-30,2202097,55566,2146531,모리셔스,2003-11
2003-11-30,2172484,31854721,-29682237,앙골라,2003-11
2003-11-30,2155982,34798,2121184,탄자니아,2003-11
2003-11-30,1993692,247618,1746074,아이슬란드,2003-11
2003-11-30,1972712,36050,1936662,라트비아,2003-11
2003-11-30,1947052,112857,1834195,네팔,2003-11
2003-11-30,1849947,1355,1848592,유고,2003-11
2003-11-30,1672085,25620,1646465,뉴 칼레도니아,2003-11
2003-11-30,1658212,186779,1471433,코트디봐르,2003-11
2003-11-30,1656718,13487050,-11830332,스와질랜드,2003-11
2003-11-30,1649768,4302,1645466,마다카스카르,2003-11
2003-11-30,1477496,1018,1476478,트리니다드 토바고,2003-11
2003-11-30,1404295,23396,1380899,벨라루스,2003-11
2003-11-30,1314107,92016,1222091,세네갈,2003-11
2003-11-30,1169737,0,1169737,베닝,2003-11
2003-11-30,1077285,0,1077285,아루바,2003-11
2003-11-30,1072963,76248,996715,콩고,2003-11
2003-11-30,1047192,0,1047192,마티니크,2003-11
2003-11-30,996507,0,996507,지부티,2003-11
2003-11-30,989511,0,989511,아제르바이잔,2003-11
2003-11-30,860067,182477,677590,자마이카,2003-11
2003-11-30,832231,182819,649412,에티오피아,2003-11
2003-11-30,830586,0,830586,과델로프,2003-11
2003-11-30,648788,0,648788,보스니아-헤르체고비나,2003-11
2003-11-30,609653,0,609653,마이크로네시아,2003-11
2003-11-30,601348,0,601348,바베이도스,2003-11
2003-11-30,599202,48415,550787,도미니카,2003-11
2003-11-30,592771,626,592145,안티가 바부다,2003-11
2003-11-30,515925,6067966,-5552041,잠비아,2003-11
2003-11-30,465810,8846,456964,불령 폴리네시아,2003-11
2003-11-30,446137,40738,405399,피지,2003-11
2003-11-30,430398,2989336,-2558938,룩셈부르그,2003-11
2003-11-30,404659,1274732,-870073,짐바브웨,2003-11
2003-11-30,402784,25653151,-25250367,카메룬,2003-11
2003-11-30,401416,12556,388860,라오스,2003-11
2003-11-30,396972,0,396972,알바니아,2003-11
2003-11-30,375375,0,375375,모잠비크,2003-11
2003-11-30,368486,120491,247995,마세도니아,2003-11
2003-11-30,338709,82,338627,아메리칸 사모아,2003-11
2003-11-30,332524,66582,265942,가봉,2003-11
2003-11-30,304552,0,304552,모리타니,2003-11
2003-11-30,285481,198481,87000,볼리비아,2003-11
2003-11-30,273357,2544,270813,불령 가이아나,2003-11
2003-11-30,270279,608167,-337888,팔라우,2003-11
2003-11-30,267293,170449,96844,타지크,2003-11
2003-11-30,264998,12112557,-11847559,파푸아 뉴기니,2003-11
2003-11-30,232761,161631,71130,몰도바,2003-11
2003-11-30,223771,0,223771,사모아,2003-11
2003-11-30,223619,13,223606,우간다,2003-11
2003-11-30,222249,197876,24373,말리,2003-11
2003-11-30,215472,0,215472,부탄,2003-11
2003-11-30,203617,0,203617,영령 캐이맨 군도,2003-11
2003-11-30,189612,752682,-563070,벨리제,2003-11
2003-11-30,177882,0,177882,세이쉘,2003-11
2003-11-30,160166,5820812,-5660646,조지아,2003-11
2003-11-30,159417,8284,151133,아르메니아,2003-11
2003-11-30,155947,0,155947,수리남,2003-11
2003-11-30,154066,0,154066,말라위,2003-11
2003-11-30,153896,0,153896,몰디브,2003-11
2003-11-30,146325,0,146325,중앙아프리카공화국,2003-11
2003-11-30,142784,126985,15799,보츠와나,2003-11
2003-11-30,141130,271932,-130802,기니,2003-11
2003-11-30,140980,0,140980,에리트리아,2003-11
2003-11-30,138973,190586,-51613,나미비아,2003-11
2003-11-30,131373,282073,-150700,리히텐슈타인,2003-11
2003-11-30,131028,0,131028,르완다,2003-11
2003-11-30,126749,15140,111609,바누아투,2003-11
2003-11-30,125677,6235,119442,니제르,2003-11
2003-11-30,124630,0,124630,시에라 리온,2003-11
2003-11-30,108317,0,108317,지브랄타,2003-11
2003-11-30,84478,1197,83281,네덜란드 열도,2003-11
2003-11-30,76184,0,76184,적도 기니,2003-11
2003-11-30,71586,0,71586,가이아나,2003-11
2003-11-30,70240,1689,68551,콩고민주공화국,2003-11
2003-11-30,66265,0,66265,부룬디,2003-11
2003-11-30,62584,0,62584,카보 베르데,2003-11
2003-11-30,60420,0,60420,버뮤다,2003-11
2003-11-30,58423,0,58423,파로에 군도,2003-11
2003-11-30,55830,189883,-134053,안도라,2003-11
2003-11-30,48525,1480615,-1432090,솔로몬 군도,2003-11
2003-11-30,41113,0,41113,통가,2003-11
2003-11-30,35520,0,35520,소말리아,2003-11
2003-11-30,32927,0,32927,세인트 루시아,2003-11
2003-11-30,32386,0,32386,투르크 & 카이코스 군도,2003-11
2003-11-30,27797,859952,-832155,부르키나 파소,2003-11
2003-11-30,26800,0,26800,그레나다,2003-11
2003-11-30,25739,564327,-538588,모나코,2003-11
2003-11-30,20721,0,20721,투발루,2003-11
2003-11-30,19671,0,19671,포클랜드 군도,2003-11
2003-11-30,17596,0,17596,메요트,2003-11
2003-11-30,15130,25663,-10533,그린랜드,2003-11
2003-11-30,10841,0,10841,쿡 아일랜드,2003-11
2003-11-30,4865,4122,743,팔레스타인 해방기구(구),2003-11
2003-11-30,4693,0,4693,세인트 헬레나,2003-11
2003-11-30,4044,24210,-20166,레소토,2003-11
2003-11-30,1331,0,1331,마이너 아우틀링 합중국 군도,2003-11
2003-11-30,24,0,24,영령 버진군도,2003-11
2003-11-30,0,730,-730,토켈라우,2003-11
2003-11-30,0,1068443,-1068443,나우루,2003-11
2003-11-30,0,433899,-433899,챠드,2003-11
2003-11-30,0,18069,-18069,감비아,2003-11
2003-12-31,3830128278,2211222331,1618905947,중국,2003-12
2003-12-31,3472926852,2211832744,1261094108,미국,2003-12
2003-12-31,1794107234,370186941,1423920293,홍콩,2003-12
2003-12-31,1664844557,3664431960,-1999587403,일본,2003-12
2003-12-31,733538230,566920891,166617339,대만,2003-12
2003-12-31,563019425,735824684,-172805259,독일,2003-12
2003-12-31,556401899,356795012,199606887,싱가포르,2003-12
2003-12-31,397575379,488711585,-91136206,말레이시아,2003-12
2003-12-31,363586574,495080280,-131493706,영국,2003-12
2003-12-31,331277555,116635710,214641845,인도,2003-12
2003-12-31,276872345,183971334,92901011,태국,2003-12
2003-12-31,264482024,193124292,71357732,필리핀,2003-12
2003-12-31,261892748,519355842,-257463094,인도네시아,2003-12
2003-12-31,261576957,0,261576957,라이베리아,2003-12
2003-12-31,248904759,46589959,202314800,베트남,2003-12
2003-12-31,244441130,178227569,66213561,캐나다,2003-12
2003-12-31,237802700,539035757,-301233057,호주,2003-12
2003-12-31,229813784,1854507,227959277,그리스,2003-12
2003-12-31,229792779,149588483,80204296,네덜란드,2003-12
2003-12-31,228806893,442475281,-213668388,아랍에미리트 연합,2003-12
2003-12-31,224808470,196574197,28234273,이탈리아,2003-12
2003-12-31,223519755,262751361,-39231606,러시아 연방,2003-12
2003-12-31,213600192,27573836,186026356,멕시코,2003-12
2003-12-31,181417769,202117234,-20699465,이란,2003-12
2003-12-31,177470969,43270284,134200685,스페인,2003-12
2003-12-31,159946863,227646820,-67699957,프랑스,2003-12
2003-12-31,136717063,6495462,130221601,튀르키예,2003-12
2003-12-31,133090318,921652434,-788562116,사우디아라비아,2003-12
2003-12-31,122242970,62258624,59984346,벨기에,2003-12
2003-12-31,112063556,7696252,104367304,헝가리,2003-12
2003-12-31,92672233,131737881,-39065648,브라질,2003-12
2003-12-31,90557475,37190436,53367039,핀란드,2003-12
2003-12-31,75645173,57008755,18636418,덴마크,2003-12
2003-12-31,61394105,59331748,2062357,스웨덴,2003-12
2003-12-31,53971212,136648,53834564,과테말라,2003-12
2003-12-31,52966866,63128909,-10162043,아일랜드,2003-12
2003-12-31,51960976,42996,51917980,파나마,2003-12
2003-12-31,51889297,0,51889297,바하마,2003-12
2003-12-31,50578819,30751728,19827091,이스라엘,2003-12
2003-12-31,50469727,2207723,48262004,방글라데시,2003-12
2003-12-31,47619366,2762193,44857173,기타국,2003-12
2003-12-31,46821916,66148298,-19326382,남아프리카공화국,2003-12
2003-12-31,45928632,90849608,-44920976,칠레,2003-12
2003-12-31,42979584,29125989,13853595,나이지리아,2003-12
2003-12-31,42880067,3219980,39660087,이집트,2003-12
2003-12-31,41641188,73938785,-32297597,뉴질랜드,2003-12
2003-12-31,41619426,435606,41183820,요르단,2003-12
2003-12-31,41275545,35780782,5494763,오스트리아,2003-12
2003-12-31,40263317,0,40263317,마샬군도,2003-12
2003-12-31,39677436,25423,39652013,사이프러스,2003-12
2003-12-31,38495928,13626632,24869296,우크라이나,2003-12
2003-12-31,38303330,21361073,16942257,파키스탄,2003-12
2003-12-31,34206644,7643208,26563436,폴란드,2003-12
2003-12-31,30154578,101150372,-70995794,스위스,2003-12
2003-12-31,28737018,5668590,23068428,우즈베키스탄,2003-12
2003-12-31,27878916,6698880,21180036,콜롬비아,2003-12
2003-12-31,27169286,15966018,11203268,알제리,2003-12
2003-12-31,25365328,2925016,22440312,미얀마,2003-12
2003-12-31,24406328,264048023,-239641695,쿠웨이트,2003-12
2003-12-31,24382045,266371,24115674,시리아,2003-12
2003-12-31,19681947,3822396,15859551,포루투갈,2003-12
2003-12-31,19279891,6281848,12998043,베네주엘라,2003-12
2003-12-31,18886561,57280411,-38393850,이라크,2003-12
2003-12-31,18660969,1788878,16872091,스리랑카,2003-12
2003-12-31,18520156,25705810,-7185654,카자흐스탄,2003-12
2003-12-31,17077129,57863467,-40786338,아르헨티나,2003-12
2003-12-31,16181957,13575112,2606845,푸에르토리코,2003-12
2003-12-31,15971248,20827610,-4856362,페루,2003-12
2003-12-31,14759760,3299999,11459761,루마니아,2003-12
2003-12-31,14542819,10550703,3992116,체코공화국,2003-12
2003-12-31,14019883,55330690,-41310807,노르웨이,2003-12
2003-12-31,13305737,19988388,-6682651,에쿠아도르,2003-12
2003-12-31,12855478,2226787,10628691,모로코,2003-12
2003-12-31,11729363,8582442,3146921,몰타,2003-12
2003-12-31,11004931,4352078,6652853,수단,2003-12
2003-12-31,10844950,1225038,9619912,온두라스,2003-12
2003-12-31,10730143,268660328,-257930185,카타르,2003-12
2003-12-31,10633143,992082,9641061,불가리아,2003-12
2003-12-31,9609843,276463783,-266853940,오만,2003-12
2003-12-31,9097621,38365,9059256,북마리아나 군도,2003-12
2003-12-31,8913169,24644,8888525,아프카니스탄,2003-12
2003-12-31,8811835,455,8811380,투르크멘,2003-12
2003-12-31,8671862,439273,8232589,캄보디아,2003-12
2003-12-31,8662214,2391888,6270326,슬로바키아,2003-12
2003-12-31,8376186,1229376,7146810,리비아,2003-12
2003-12-31,7608218,353991,7254227,리투아니아,2003-12
2003-12-31,6754853,814945,5939908,몽골,2003-12
2003-12-31,6362960,28558993,-22196033,바레인,2003-12
2003-12-31,6182047,25170,6156877,니카라과,2003-12
2003-12-31,6145468,3442734,2702734,코스타리카,2003-12
2003-12-31,5725319,494403,5230916,레바논,2003-12
2003-12-31,5326808,68392,5258416,엘살바도르,2003-12
2003-12-31,4856732,1397165,3459567,슬로베니아,2003-12
2003-12-31,4847398,47150,4800248,예맨,2003-12
2003-12-31,4769029,9285380,-4516351,도미니카 공화국,2003-12
2003-12-31,4502968,1430636,3072332,우루과이,2003-12
2003-12-31,4133519,279812,3853707,튀니지,2003-12
2003-12-31,3910196,955231,2954965,가나,2003-12
2003-12-31,3692448,89532,3602916,크로아티아,2003-12
2003-12-31,3383590,281224,3102366,파라과이,2003-12
2003-12-31,3310720,46236753,-42926033,브루나이,2003-12
2003-12-31,3095421,95331,3000090,네팔,2003-12
2003-12-31,2869880,73260,2796620,케냐,2003-12
2003-12-31,2841990,34711,2807279,키르기스스탄,2003-12
2003-12-31,2813090,1181623,1631467,에스토니아,2003-12
2003-12-31,2763195,3227187,-463992,스와질랜드,2003-12
2003-12-31,2607016,1409965,1197051,코트디봐르,2003-12
2003-12-31,2467153,404904,2062249,라트비아,2003-12
2003-12-31,2315981,11284037,-8968056,기니,2003-12
2003-12-31,2271462,191285,2080177,탄자니아,2003-12
2003-12-31,2211823,53089,2158734,괌,2003-12
2003-12-31,2174152,1158,2172994,유고,2003-12
2003-12-31,2138524,21437,2117087,불령 리유니온 코모도 제도,2003-12
2003-12-31,1937110,0,1937110,마티니크,2003-12
2003-12-31,1855854,23459,1832395,마다카스카르,2003-12
2003-12-31,1794666,30260049,-28465383,앙골라,2003-12
2003-12-31,1784304,156340,1627964,마카오,2003-12
2003-12-31,1768088,1275901,492187,벨라루스,2003-12
2003-12-31,1749568,192189,1557379,아이슬란드,2003-12
2003-12-31,1659727,5768549,-4108822,뉴 칼레도니아,2003-12
2003-12-31,1639838,132665,1507173,에티오피아,2003-12
2003-12-31,1524190,0,1524190,아이티,2003-12
2003-12-31,1343313,47434,1295879,트리니다드 토바고,2003-12
2003-12-31,1304873,720,1304153,아제르바이잔,2003-12
2003-12-31,1276126,191442,1084684,피지,2003-12
2003-12-31,1248736,91240,1157496,모리셔스,2003-12
2003-12-31,1243934,28684613,-27440679,콩고,2003-12
2003-12-31,1124247,91,1124156,토고,2003-12
2003-12-31,1026688,320498,706190,세네갈,2003-12
2003-12-31,1019989,0,1019989,베닝,2003-12
2003-12-31,836450,0,836450,아루바,2003-12
2003-12-31,830767,0,830767,지부티,2003-12
2003-12-31,830613,775508,55105,짐바브웨,2003-12
2003-12-31,795529,67253,728276,볼리비아,2003-12
2003-12-31,753103,2567,750536,자마이카,2003-12
2003-12-31,731827,1216154,-484327,파푸아 뉴기니,2003-12
2003-12-31,715147,0,715147,과델로프,2003-12
2003-12-31,707721,167699,540022,말리,2003-12
2003-12-31,692514,2052,690462,알바니아,2003-12
2003-12-31,678396,336600,341796,부르키나 파소,2003-12
2003-12-31,678133,26950,651183,불령 폴리네시아,2003-12
2003-12-31,677042,2868,674174,니제르,2003-12
2003-12-31,668066,10200,657866,라오스,2003-12
2003-12-31,661224,28465586,-27804362,카메룬,2003-12
2003-12-31,586726,47749,538977,벨리제,2003-12
2003-12-31,534768,3082804,-2548036,잠비아,2003-12
2003-12-31,492312,25236,467076,모잠비크,2003-12
2003-12-31,486692,25000,461692,레소토,2003-12
2003-12-31,485012,0,485012,불령 가이아나,2003-12
2003-12-31,466200,0,466200,보스니아-헤르체고비나,2003-12
2003-12-31,434113,0,434113,바베이도스,2003-12
2003-12-31,427273,0,427273,마이크로네시아,2003-12
2003-12-31,403689,0,403689,사모아,2003-12
2003-12-31,396754,142960,253794,네덜란드 열도,2003-12
2003-12-31,394496,34791,359705,부탄,2003-12
2003-12-31,375266,66642,308624,팔레스타인 해방기구(구),2003-12
2003-12-31,353928,198961,154967,타지크,2003-12
2003-12-31,336957,38997,297960,콩고민주공화국,2003-12
2003-12-31,323758,43295,280463,보츠와나,2003-12
2003-12-31,310193,827,309366,아메리칸 사모아,2003-12
2003-12-31,288099,54220,233879,나미비아,2003-12
2003-12-31,271777,956701,-684924,조지아,2003-12
2003-12-31,265645,6238554,-5972909,룩셈부르그,2003-12
2003-12-31,255337,70487,184850,말라위,2003-12
2003-12-31,243584,51885,191699,모리타니,2003-12
2003-12-31,227986,0,227986,수리남,2003-12
2003-12-31,218253,10406,207847,몰도바,2003-12
2003-12-31,208968,1402,207566,우간다,2003-12
2003-12-31,181637,0,181637,안티가 바부다,2003-12
2003-12-31,163952,173548,-9596,리히텐슈타인,2003-12
2003-12-31,136034,110102,25932,아르메니아,2003-12
2003-12-31,135906,610,135296,버뮤다,2003-12
2003-12-31,134211,0,134211,마세도니아,2003-12
2003-12-31,131541,0,131541,세이쉘,2003-12
2003-12-31,129656,6742,122914,시에라 리온,2003-12
2003-12-31,129065,321282,-192217,모나코,2003-12
2003-12-31,127426,0,127426,메요트,2003-12
2003-12-31,124988,4407,120581,가이아나,2003-12
2003-12-31,124792,0,124792,도미니카,2003-12
2003-12-31,120872,0,120872,적도 기니,2003-12
2003-12-31,113241,2122651,-2009410,가봉,2003-12
2003-12-31,98977,0,98977,중앙아프리카공화국,2003-12
2003-12-31,89632,0,89632,그레나다,2003-12
2003-12-31,82739,1429,81310,에리트리아,2003-12
2003-12-31,68371,0,68371,팔라우,2003-12
2003-12-31,66860,0,66860,감비아,2003-12
2003-12-31,66808,0,66808,몰디브,2003-12
2003-12-31,66571,0,66571,영령 캐이맨 군도,2003-12
2003-12-31,62321,4042986,-3980665,솔로몬 군도,2003-12
2003-12-31,58423,0,58423,파로에 군도,2003-12
2003-12-31,52148,38380,13768,토켈라우,2003-12
2003-12-31,44825,7464,37361,바누아투,2003-12
2003-12-31,42837,0,42837,코모로스,2003-12
2003-12-31,36228,0,36228,티모르,2003-12
2003-12-31,32673,70771,-38098,소말리아,2003-12
2003-12-31,32397,0,32397,키리바티,2003-12
2003-12-31,31764,1125,30639,르완다,2003-12
2003-12-31,30525,0,30525,포클랜드 군도,2003-12
2003-12-31,29973,0,29973,지브랄타,2003-12
2003-12-31,26394,0,26394,세인트 루시아,2003-12
2003-12-31,19172,0,19172,부룬디,2003-12
2003-12-31,13575,226753,-213178,안도라,2003-12
2003-12-31,10985,0,10985,산마리노,2003-12
2003-12-31,9600,0,9600,몬트세라트,2003-12
2003-12-31,6999,0,6999,투르크 & 카이코스 군도,2003-12
2003-12-31,5911,13424,-7513,쿡 아일랜드,2003-12
2003-12-31,5164,0,5164,세인트 빈센트 그레나딘,2003-12
2003-12-31,1780,0,1780,나우루,2003-12
2003-12-31,1600,0,1600,챠드,2003-12
2003-12-31,853,0,853,미령 버진군도,2003-12
2003-12-31,560,0,560,앙귈라,2003-12
2003-12-31,0,1217,-1217,보빗군도,2003-12
2003-12-31,0,4112,-4112,세인트 헬레나,2003-12
2003-12-31,0,72621,-72621,그린랜드,2003-12
2003-12-31,0,195141,-195141,마이너 아우틀링 합중국 군도,2003-12
2004-01-31,3320938836,2058886756,1262052080,중국,2004-01
2004-01-31,2644698134,1920942144,723755990,미국,2004-01
2004-01-31,1752427343,301005454,1451421889,홍콩,2004-01
2004-01-31,1552892077,3291766435,-1738874358,일본,2004-01
2004-01-31,1258693492,30108765,1228584727,앙골라,2004-01
2004-01-31,632901553,524077228,108824325,대만,2004-01
2004-01-31,573394836,634983231,-61588395,독일,2004-01
2004-01-31,425751113,358151752,67599361,싱가포르,2004-01
2004-01-31,383418455,396577500,-13159045,영국,2004-01
2004-01-31,378460665,466153628,-87692963,말레이시아,2004-01
2004-01-31,345965177,167689665,178275512,캐나다,2004-01
2004-01-31,281070770,128475602,152595168,필리핀,2004-01
2004-01-31,256877035,158037092,98839943,인도,2004-01
2004-01-31,255416221,168856603,86559618,태국,2004-01
2004-01-31,233641741,539279864,-305638123,인도네시아,2004-01
2004-01-31,228286746,100813347,127473399,네덜란드,2004-01
2004-01-31,225626491,501489632,-275863141,아랍에미리트 연합,2004-01
2004-01-31,211079229,5981125,205098104,몰타,2004-01
2004-01-31,210405145,621334133,-410928988,호주,2004-01
2004-01-31,207561710,24122,207537588,바하마,2004-01
2004-01-31,206842623,37701836,169140787,멕시코,2004-01
2004-01-31,195111667,180695312,14416355,이탈리아,2004-01
2004-01-31,190849003,189976703,872300,프랑스,2004-01
2004-01-31,184886615,72921375,111965240,스페인,2004-01
2004-01-31,163655810,47470336,116185474,베트남,2004-01
2004-01-31,154067012,175709172,-21642160,이란,2004-01
2004-01-31,153667080,61132484,92534596,벨기에,2004-01
2004-01-31,145205297,6753689,138451608,튀르키예,2004-01
2004-01-31,138996448,216532341,-77535893,러시아 연방,2004-01
2004-01-31,131037152,38907791,92129361,핀란드,2004-01
2004-01-31,120202191,16430139,103772052,그리스,2004-01
2004-01-31,105300876,143890141,-38589265,브라질,2004-01
2004-01-31,100399304,739588823,-639189519,사우디아라비아,2004-01
2004-01-31,99352804,1368379,97984425,기타국,2004-01
2004-01-31,84393048,71489,84321559,사이프러스,2004-01
2004-01-31,63751060,77508985,-13757925,남아프리카공화국,2004-01
2004-01-31,62655115,50697568,11957547,아일랜드,2004-01
2004-01-31,60184654,5472711,54711943,헝가리,2004-01
2004-01-31,57115093,177238,56937855,파나마,2004-01
2004-01-31,51243313,11162,51232151,라이베리아,2004-01
2004-01-31,50840540,26700902,24139638,덴마크,2004-01
2004-01-31,45776314,25667,45750647,마샬군도,2004-01
2004-01-31,44131009,62264172,-18133163,뉴질랜드,2004-01
2004-01-31,42787958,55789293,-13001335,스웨덴,2004-01
2004-01-31,40480373,35566688,4913685,파키스탄,2004-01
2004-01-31,40353322,5201126,35152196,폴란드,2004-01
2004-01-31,39994052,35924950,4069102,이스라엘,2004-01
2004-01-31,39841886,2140461,37701425,방글라데시,2004-01
2004-01-31,39085161,5808280,33276881,과테말라,2004-01
2004-01-31,37910421,146150716,-108240295,칠레,2004-01
2004-01-31,37666132,2422489,35243643,요르단,2004-01
2004-01-31,36972892,2611186,34361706,이집트,2004-01
2004-01-31,36945909,27853495,9092414,오스트리아,2004-01
2004-01-31,31733824,30626238,1107586,나이지리아,2004-01
2004-01-31,31619348,42291451,-10672103,우크라이나,2004-01
2004-01-31,26615716,176795,26438921,시리아,2004-01
2004-01-31,24514913,10159883,14355030,콜롬비아,2004-01
2004-01-31,24495003,210394915,-185899912,쿠웨이트,2004-01
2004-01-31,24312447,4844303,19468144,포루투갈,2004-01
2004-01-31,23060045,86422928,-63362883,스위스,2004-01
2004-01-31,22026390,1015569,21010821,불가리아,2004-01
2004-01-31,21487655,24922601,-3434946,카자흐스탄,2004-01
2004-01-31,17788983,2987726,14801257,우즈베키스탄,2004-01
2004-01-31,16345329,3878903,12466426,스리랑카,2004-01
2004-01-31,15902365,24545360,-8642995,루마니아,2004-01
2004-01-31,15402066,0,15402066,알제리,2004-01
2004-01-31,13681424,12013716,1667708,체코공화국,2004-01
2004-01-31,12959451,28713857,-15754406,페루,2004-01
2004-01-31,12749774,69383984,-56634210,아르헨티나,2004-01
2004-01-31,11967130,0,11967130,아프카니스탄,2004-01
2004-01-31,11663209,1183271,10479938,슬로바키아,2004-01
2004-01-31,11127856,57357084,-46229228,노르웨이,2004-01
2004-01-31,9674565,335975,9338590,튀니지,2004-01
2004-01-31,9628464,395604,9232860,이라크,2004-01
2004-01-31,9289409,3930388,5359021,모로코,2004-01
2004-01-31,9237975,19753382,-10515407,에쿠아도르,2004-01
2004-01-31,8976182,271013,8705169,온두라스,2004-01
2004-01-31,8591489,144653,8446836,리비아,2004-01
2004-01-31,8174880,265883,7908997,리투아니아,2004-01
2004-01-31,7553019,49760,7503259,예맨,2004-01
2004-01-31,6992177,177859,6814318,북마리아나 군도,2004-01
2004-01-31,6929676,321468873,-314539197,카타르,2004-01
2004-01-31,6764569,2204414,4560155,미얀마,2004-01
2004-01-31,6445503,192987379,-186541876,오만,2004-01
2004-01-31,6191878,1335031,4856847,베네주엘라,2004-01
2004-01-31,6175518,8725073,-2549555,푸에르토리코,2004-01
2004-01-31,5850624,0,5850624,투르크멘,2004-01
2004-01-31,5849223,2136076,3713147,슬로베니아,2004-01
2004-01-31,5818038,2879406,2938632,코스타리카,2004-01
2004-01-31,5680713,36248,5644465,수단,2004-01
2004-01-31,5345391,248954,5096437,캄보디아,2004-01
2004-01-31,5242112,459829,4782283,레바논,2004-01
2004-01-31,4476690,334670,4142020,엘살바도르,2004-01
2004-01-31,4080758,284469,3796289,케냐,2004-01
2004-01-31,3806798,22587873,-18781075,바레인,2004-01
2004-01-31,3681174,51917,3629257,몽골,2004-01
2004-01-31,3533436,223652,3309784,니카라과,2004-01
2004-01-31,3446602,9646,3436956,네팔,2004-01
2004-01-31,3367936,403643,2964293,에스토니아,2004-01
2004-01-31,3194783,1079910,2114873,코트디봐르,2004-01
2004-01-31,2887322,348848,2538474,크로아티아,2004-01
2004-01-31,2885337,291,2885046,불령 리유니온 코모도 제도,2004-01
2004-01-31,2669323,613925,2055398,가나,2004-01
2004-01-31,2627682,14422,2613260,라트비아,2004-01
2004-01-31,2391259,2430987,-39728,벨리제,2004-01
2004-01-31,2172958,9780692,-7607734,도미니카 공화국,2004-01
2004-01-31,2164165,747797,1416368,우루과이,2004-01
2004-01-31,2146590,344099,1802491,탄자니아,2004-01
2004-01-31,1916322,884,1915438,파라과이,2004-01
2004-01-31,1818150,0,1818150,팔라우,2004-01
2004-01-31,1589426,263,1589163,유고,2004-01
2004-01-31,1450565,1440821,9744,키르기스스탄,2004-01
2004-01-31,1404876,392277,1012599,마카오,2004-01
2004-01-31,1367149,53444280,-52077131,브루나이,2004-01
2004-01-31,1315661,27178,1288483,괌,2004-01
2004-01-31,1276852,0,1276852,아제르바이잔,2004-01
2004-01-31,1235836,201811,1034025,에티오피아,2004-01
2004-01-31,1148430,4639,1143791,트리니다드 토바고,2004-01
2004-01-31,1134306,0,1134306,토고,2004-01
2004-01-31,1103344,5262168,-4158824,스와질랜드,2004-01
2004-01-31,1007985,27470,980515,모리셔스,2004-01
2004-01-31,998421,0,998421,아루바,2004-01
2004-01-31,971691,126279,845412,피지,2004-01
2004-01-31,967523,38682,928841,자마이카,2004-01
2004-01-31,955552,173,955379,아메리칸 사모아,2004-01
2004-01-31,906776,245347,661429,세네갈,2004-01
2004-01-31,831053,107,830946,과델로프,2004-01
2004-01-31,822666,3725,818941,우간다,2004-01
2004-01-31,797880,0,797880,레소토,2004-01
2004-01-31,779988,464,779524,아이티,2004-01
2004-01-31,749044,0,749044,마티니크,2004-01
2004-01-31,738843,33968,704875,카메룬,2004-01
2004-01-31,714097,527813,186284,아이슬란드,2004-01
2004-01-31,620596,30035502,-29414906,콩고,2004-01
2004-01-31,616368,75523,540845,도미니카,2004-01
2004-01-31,569634,5218,564416,에리트리아,2004-01
2004-01-31,552604,0,552604,베닝,2004-01
2004-01-31,510337,4117228,-3606891,뉴 칼레도니아,2004-01
2004-01-31,501431,29098,472333,라오스,2004-01
2004-01-31,484941,6044188,-5559247,잠비아,2004-01
2004-01-31,449332,2456,446876,마다카스카르,2004-01
2004-01-31,443680,488590,-44910,짐바브웨,2004-01
2004-01-31,443056,14386,428670,세이쉘,2004-01
2004-01-31,435354,3488343,-3052989,파푸아 뉴기니,2004-01
2004-01-31,421306,0,421306,보스니아-헤르체고비나,2004-01
2004-01-31,404944,541,404403,니제르,2004-01
2004-01-31,387646,263782,123864,벨라루스,2004-01
2004-01-31,344892,899302,-554410,기니,2004-01
2004-01-31,323943,0,323943,수리남,2004-01
2004-01-31,302717,0,302717,마이크로네시아,2004-01
2004-01-31,286558,0,286558,마세도니아,2004-01
2004-01-31,276154,22535,253619,콩고민주공화국,2004-01
2004-01-31,255340,0,255340,모잠비크,2004-01
2004-01-31,251802,6835,244967,알바니아,2004-01
2004-01-31,245726,7674595,-7428869,볼리비아,2004-01
2004-01-31,241221,0,241221,바베이도스,2004-01
2004-01-31,236382,590,235792,말라위,2004-01
2004-01-31,232136,0,232136,불령 가이아나,2004-01
2004-01-31,229063,142528,86535,안도라,2004-01
2004-01-31,226954,383654,-156700,리히텐슈타인,2004-01
2004-01-31,225842,0,225842,지부티,2004-01
2004-01-31,224682,615956,-391274,타지크,2004-01
2004-01-31,212527,105099,107428,가봉,2004-01
2004-01-31,206873,0,206873,사모아,2004-01
2004-01-31,205180,112193,92987,불령 폴리네시아,2004-01
2004-01-31,194579,0,194579,몰도바,2004-01
2004-01-31,177629,38033,139596,보츠와나,2004-01
2004-01-31,168087,779405,-611318,모나코,2004-01
2004-01-31,163050,23065,139985,코스 군도,2004-01
2004-01-31,160879,18451,142428,중앙아프리카공화국,2004-01
2004-01-31,155521,962409,-806888,조지아,2004-01
2004-01-31,141665,30546386,-30404721,적도 기니,2004-01
2004-01-31,135289,0,135289,몰디브,2004-01
2004-01-31,133129,14252,118877,팔레스타인 해방기구(구),2004-01
2004-01-31,128694,0,128694,안티가 바부다,2004-01
2004-01-31,126688,820,125868,가이아나,2004-01
2004-01-31,113275,0,113275,그레나다,2004-01
2004-01-31,102967,3751,99216,모리타니,2004-01
2004-01-31,98350,0,98350,시에라 리온,2004-01
2004-01-31,93191,2842378,-2749187,룩셈부르그,2004-01
2004-01-31,92240,763,91477,세인트 루시아,2004-01
2004-01-31,89326,0,89326,영령 캐이맨 군도,2004-01
2004-01-31,86870,0,86870,버뮤다,2004-01
2004-01-31,82983,90898,-7915,소말리아,2004-01
2004-01-31,78983,0,78983,아르메니아,2004-01
2004-01-31,78442,1614105,-1535663,솔로몬 군도,2004-01
2004-01-31,75011,60857,14154,네덜란드 열도,2004-01
2004-01-31,74746,0,74746,티모르,2004-01
2004-01-31,64176,28987,35189,바누아투,2004-01
2004-01-31,60694,22730,37964,통가,2004-01
2004-01-31,54687,205161,-150474,말리,2004-01
2004-01-31,36643,23447,13196,감비아,2004-01
2004-01-31,34794,236153,-201359,나미비아,2004-01
2004-01-31,33050,0,33050,르완다,2004-01
2004-01-31,32077,626267,-594190,부르키나 파소,2004-01
2004-01-31,27820,7050,20770,쿡 아일랜드,2004-01
2004-01-31,20163,0,20163,영령 버진군도,2004-01
2004-01-31,18413,0,18413,세인트 빈센트 그레나딘,2004-01
2004-01-31,5375,0,5375,부룬디,2004-01
2004-01-31,2816,0,2816,지브랄타,2004-01
2004-01-31,89,0,89,왈라스 & 퓨투나 군도,2004-01
2004-01-31,31,0,31,피트카이른,2004-01
2004-01-31,27,0,27,부탄,2004-01
2004-01-31,0,207247,-207247,그린랜드,2004-01
2004-01-31,0,3257,-3257,키리바티,2004-01
2004-01-31,0,1463,-1463,크리스마스 아일랜드,2004-01
2004-01-31,0,48578,-48578,파로에 군도,2004-01
2004-01-31,0,2897,-2897,세인트 키츠 네비스,2004-01
2004-01-31,0,19754,-19754,미령 버진군도,2004-01
2004-01-31,0,19227,-19227,세인트 헬레나,2004-01
2004-01-31,0,32300,-32300,영령 인도양,2004-01
2004-02-29,3686545830,1812533154,1874012676,중국,2004-02
2004-02-29,3097012039,2182455351,914556688,미국,2004-02
2004-02-29,1732592270,3776313767,-2043721497,일본,2004-02
2004-02-29,1623980661,326617948,1297362713,홍콩,2004-02
2004-02-29,688148609,536117273,152031336,대만,2004-02
2004-02-29,588193156,607726213,-19533057,독일,2004-02
2004-02-29,473489806,382065961,91423845,영국,2004-02
2004-02-29,455329556,334927480,120402076,싱가포르,2004-02
2004-02-29,379149368,547434164,-168284796,말레이시아,2004-02
2004-02-29,298215795,180222680,117993115,인도,2004-02
2004-02-29,277502724,482304985,-204802261,인도네시아,2004-02
2004-02-29,273659479,212237211,61422268,태국,2004-02
2004-02-29,266279591,162583563,103696028,캐나다,2004-02
2004-02-29,247554776,206484466,41070310,이탈리아,2004-02
2004-02-29,243651122,184156515,59494607,필리핀,2004-02
2004-02-29,241920532,562414809,-320494277,호주,2004-02
2004-02-29,236829847,143867481,92962366,네덜란드,2004-02
2004-02-29,230370484,552284916,-321914432,아랍에미리트 연합,2004-02
2004-02-29,229414411,37535157,191879254,멕시코,2004-02
2004-02-29,219836657,43659735,176176922,베트남,2004-02
2004-02-29,217618072,127996,217490076,라이베리아,2004-02
2004-02-29,208248712,41758426,166490286,스페인,2004-02
2004-02-29,202450388,194954963,7495425,프랑스,2004-02
2004-02-29,160061551,241026581,-80965030,러시아 연방,2004-02
2004-02-29,153977037,8539628,145437409,사이프러스,2004-02
2004-02-29,151581269,5051200,146530069,튀르키예,2004-02
2004-02-29,147391021,25141914,122249107,그리스,2004-02
2004-02-29,137707429,37405461,100301968,핀란드,2004-02
2004-02-29,127413749,212126555,-84712806,이란,2004-02
2004-02-29,120738688,66401671,54337017,벨기에,2004-02
2004-02-29,118462994,176200640,-57737646,브라질,2004-02
2004-02-29,113273087,899228182,-785955095,사우디아라비아,2004-02
2004-02-29,111853585,87655082,24198503,파나마,2004-02
2004-02-29,81565696,59525786,22039910,아일랜드,2004-02
2004-02-29,78548490,64783246,13765244,남아프리카공화국,2004-02
2004-02-29,63316091,29060507,34255584,이스라엘,2004-02
2004-02-29,62634569,7198173,55436396,헝가리,2004-02
2004-02-29,52378757,20871735,31507022,파키스탄,2004-02
2004-02-29,52204735,35297546,16907189,오스트리아,2004-02
2004-02-29,50516106,2093161,48422945,기타국,2004-02
2004-02-29,50471517,57062638,-6591121,이집트,2004-02
2004-02-29,49840138,1017538,48822600,요르단,2004-02
2004-02-29,49428818,2564162,46864656,방글라데시,2004-02
2004-02-29,49330435,12148100,37182335,폴란드,2004-02
2004-02-29,48881491,55419670,-6538179,스웨덴,2004-02
2004-02-29,42451051,35230626,7220425,나이지리아,2004-02
2004-02-29,40678126,5631,40672495,바하마,2004-02
2004-02-29,40593035,66957643,-26364608,스위스,2004-02
2004-02-29,39775098,16018587,23756511,우크라이나,2004-02
2004-02-29,38696019,17078432,21617587,과테말라,2004-02
2004-02-29,37584718,176153884,-138569166,칠레,2004-02
2004-02-29,35858917,60574394,-24715477,뉴질랜드,2004-02
2004-02-29,35327829,11033971,24293858,콜롬비아,2004-02
2004-02-29,29420118,1441150,27978968,불가리아,2004-02
2004-02-29,28431946,1837484,26594462,미얀마,2004-02
2004-02-29,27433735,4486683,22947052,포루투갈,2004-02
2004-02-29,26913607,11479720,15433887,카자흐스탄,2004-02
2004-02-29,25087601,413035,24674566,시리아,2004-02
2004-02-29,24915017,26755812,-1840795,덴마크,2004-02
2004-02-29,20748546,3876528,16872018,우즈베키스탄,2004-02
2004-02-29,20073788,4040064,16033724,스리랑카,2004-02
2004-02-29,19559907,16220028,3339879,루마니아,2004-02
2004-02-29,18952056,1045376,17906680,슬로바키아,2004-02
2004-02-29,18772172,371558870,-352786698,쿠웨이트,2004-02
2004-02-29,18680153,6689862,11990291,체코공화국,2004-02
2004-02-29,18480337,125372,18354965,이라크,2004-02
2004-02-29,17785252,27043748,-9258496,페루,2004-02
2004-02-29,17310723,0,17310723,바베이도스,2004-02
2004-02-29,16318799,145352,16173447,리비아,2004-02
2004-02-29,16032645,73167,15959478,알제리,2004-02
2004-02-29,13410038,16952005,-3541967,푸에르토리코,2004-02
2004-02-29,12727699,1756171,10971528,모로코,2004-02
2004-02-29,12586414,320984581,-308398167,카타르,2004-02
2004-02-29,11881522,48489996,-36608474,노르웨이,2004-02
2004-02-29,11562189,27748654,-16186465,아르헨티나,2004-02
2004-02-29,11301720,7917284,3384436,베네주엘라,2004-02
2004-02-29,11101118,1848603,9252515,슬로베니아,2004-02
2004-02-29,10324853,999049,9325804,온두라스,2004-02
2004-02-29,9756513,0,9756513,아프카니스탄,2004-02
2004-02-29,9713893,40855,9673038,리투아니아,2004-02
2004-02-29,9269114,52608,9216506,크로아티아,2004-02
2004-02-29,8914509,19045486,-10130977,에쿠아도르,2004-02
2004-02-29,7725878,567551,7158327,캄보디아,2004-02
2004-02-29,7464447,655936,6808511,튀니지,2004-02
2004-02-29,7293865,10412307,-3118442,몰타,2004-02
2004-02-29,7124571,13999252,-6874681,바레인,2004-02
2004-02-29,6505993,246952458,-240446465,오만,2004-02
2004-02-29,6403469,1813830,4589639,코스타리카,2004-02
2004-02-29,6239362,1354449,4884913,레바논,2004-02
2004-02-29,6210779,44993,6165786,몽골,2004-02
2004-02-29,5964839,20897,5943942,북마리아나 군도,2004-02
2004-02-29,5870477,59712,5810765,니카라과,2004-02
2004-02-29,5761915,2049685,3712230,예맨,2004-02
2004-02-29,5475227,239134,5236093,엘살바도르,2004-02
2004-02-29,5020669,776283,4244386,가나,2004-02
2004-02-29,4750879,5705232,-954353,수단,2004-02
2004-02-29,4674184,7805767,-3131583,도미니카 공화국,2004-02
2004-02-29,3854416,110525,3743891,케냐,2004-02
2004-02-29,3729712,144002,3585710,키르기스스탄,2004-02
2004-02-29,3651409,265564,3385845,에스토니아,2004-02
2004-02-29,3583096,313645,3269451,라트비아,2004-02
2004-02-29,3402458,0,3402458,투르크멘,2004-02
2004-02-29,3020245,16316,3003929,피지,2004-02
2004-02-29,2623094,18750,2604344,파라과이,2004-02
2004-02-29,2486302,2099,2484203,괌,2004-02
2004-02-29,2443724,0,2443724,불령 리유니온 코모도 제도,2004-02
2004-02-29,2226833,0,2226833,앙골라,2004-02
2004-02-29,2183426,3304,2180122,마다카스카르,2004-02
2004-02-29,2069239,53787710,-51718471,브루나이,2004-02
2004-02-29,2062959,122754306,-120691347,콩고,2004-02
2004-02-29,2029410,341934,1687476,마카오,2004-02
2004-02-29,1927137,2337106,-409969,코트디봐르,2004-02
2004-02-29,1777529,710593,1066936,우루과이,2004-02
2004-02-29,1625270,2202,1623068,아제르바이잔,2004-02
2004-02-29,1588108,140724,1447384,아이슬란드,2004-02
2004-02-29,1573102,1842,1571260,과델로프,2004-02
2004-02-29,1564261,270182,1294079,세네갈,2004-02
2004-02-29,1534161,0,1534161,마티니크,2004-02
2004-02-29,1498899,30211,1468688,탄자니아,2004-02
2004-02-29,1464382,97000,1367382,유고,2004-02
2004-02-29,1348973,18939,1330034,보스니아-헤르체고비나,2004-02
2004-02-29,1326491,55137,1271354,네팔,2004-02
2004-02-29,1173808,174084,999724,벨라루스,2004-02
2004-02-29,1164380,3215014,-2050634,스와질랜드,2004-02
2004-02-29,1150045,219474,930571,모리셔스,2004-02
2004-02-29,1129363,6396221,-5266858,트리니다드 토바고,2004-02
2004-02-29,1102562,0,1102562,토고,2004-02
2004-02-29,1082673,8955553,-7872880,뉴 칼레도니아,2004-02
2004-02-29,1048632,0,1048632,아루바,2004-02
2004-02-29,1046690,94,1046596,레소토,2004-02
2004-02-29,1019845,0,1019845,아이티,2004-02
2004-02-29,1017906,161622,856284,자마이카,2004-02
2004-02-29,948072,0,948072,마세도니아,2004-02
2004-02-29,920218,99605,820613,에티오피아,2004-02
2004-02-29,826097,34368,791729,카메룬,2004-02
2004-02-29,794507,3473838,-2679331,룩셈부르그,2004-02
2004-02-29,749799,4548646,-3798847,잠비아,2004-02
2004-02-29,740006,0,740006,마이크로네시아,2004-02
2004-02-29,723264,0,723264,지부티,2004-02
2004-02-29,719651,1137563,-417912,짐바브웨,2004-02
2004-02-29,709286,24649,684637,라오스,2004-02
2004-02-29,588362,0,588362,우간다,2004-02
2004-02-29,575932,129938,445994,보츠와나,2004-02
2004-02-29,565715,0,565715,모잠비크,2004-02
2004-02-29,560863,4169,556694,가이아나,2004-02
2004-02-29,476752,0,476752,베닝,2004-02
2004-02-29,466132,28400,437732,불령 폴리네시아,2004-02
2004-02-29,412562,2041310,-1628748,볼리비아,2004-02
2004-02-29,389227,0,389227,안티가 바부다,2004-02
2004-02-29,388732,22120,366612,도미니카,2004-02
2004-02-29,383505,9036,374469,알바니아,2004-02
2004-02-29,379165,304685,74480,타지크,2004-02
2004-02-29,371044,0,371044,불령 가이아나,2004-02
2004-02-29,364155,5086,359069,몰도바,2004-02
2004-02-29,361198,24107,337091,니제르,2004-02
2004-02-29,360109,0,360109,영령 캐이맨 군도,2004-02
2004-02-29,352653,73298,279355,말라위,2004-02
2004-02-29,326770,2852580,-2525810,파푸아 뉴기니,2004-02
2004-02-29,302461,0,302461,수리남,2004-02
2004-02-29,288080,0,288080,사모아,2004-02
2004-02-29,281000,180146,100854,리히텐슈타인,2004-02
2004-02-29,216045,22104,193941,네덜란드 열도,2004-02
2004-02-29,207626,0,207626,벨리제,2004-02
2004-02-29,206384,0,206384,시에라 리온,2004-02
2004-02-29,200442,10450,189992,세이쉘,2004-02
2004-02-29,200284,4382,195902,아르메니아,2004-02
2004-02-29,196732,225160,-28428,조지아,2004-02
2004-02-29,186800,4456,182344,모리타니,2004-02
2004-02-29,182349,32086588,-31904239,가봉,2004-02
2004-02-29,157048,0,157048,적도 기니,2004-02
2004-02-29,146373,769218,-622845,모나코,2004-02
2004-02-29,137140,688643,-551503,기니,2004-02
2004-02-29,128627,160289,-31662,나미비아,2004-02
2004-02-29,121539,88,121451,중앙아프리카공화국,2004-02
2004-02-29,121225,0,121225,그레나다,2004-02
2004-02-29,112516,1905,110611,감비아,2004-02
2004-02-29,102035,12051,89984,콩고민주공화국,2004-02
2004-02-29,97816,3596,94220,바누아투,2004-02
2004-02-29,97802,0,97802,아메리칸 사모아,2004-02
2004-02-29,82983,0,82983,소말리아,2004-02
2004-02-29,80904,28777,52127,팔레스타인 해방기구(구),2004-02
2004-02-29,73562,0,73562,부탄,2004-02
2004-02-29,64388,392,63996,에리트리아,2004-02
2004-02-29,63823,0,63823,미령 버진군도,2004-02
2004-02-29,63608,21624,41984,팔라우,2004-02
2004-02-29,56593,0,56593,몰디브,2004-02
2004-02-29,51027,438738,-387711,부르키나 파소,2004-02
2004-02-29,42576,2715481,-2672905,솔로몬 군도,2004-02
2004-02-29,38017,0,38017,앙귈라,2004-02
2004-02-29,37435,0,37435,세인트 빈센트 그레나딘,2004-02
2004-02-29,23395,0,23395,왈라스 & 퓨투나 군도,2004-02
2004-02-29,21515,0,21515,마샬군도,2004-02
2004-02-29,16571,0,16571,세인트 루시아,2004-02
2004-02-29,15259,0,15259,투발루,2004-02
2004-02-29,15085,50487,-35402,안도라,2004-02
2004-02-29,14433,0,14433,지브랄타,2004-02
2004-02-29,14344,456,13888,키리바티,2004-02
2004-02-29,11606,0,11606,버뮤다,2004-02
2004-02-29,8354,0,8354,산마리노,2004-02
2004-02-29,6721,0,6721,부룬디,2004-02
2004-02-29,1639,0,1639,쿡 아일랜드,2004-02
2004-02-29,519,0,519,몬트세라트,2004-02
2004-02-29,71,450078,-450007,말리,2004-02
2004-02-29,0,1964,-1964,크리스마스 아일랜드,2004-02
2004-02-29,0,23750,-23750,그린랜드,2004-02
2004-02-29,0,123929,-123929,기네비소,2004-02
2004-02-29,0,384,-384,교황청,2004-02
2004-03-31,4030541099,2353103522,1677437577,중국,2004-03
2004-03-31,3534532863,2452973628,1081559235,미국,2004-03
2004-03-31,2000495364,488397184,1512098180,홍콩,2004-03
2004-03-31,1911030362,4153125008,-2242094646,일본,2004-03
2004-03-31,828087277,600694317,227392960,대만,2004-03
2004-03-31,602925169,743091043,-140165874,독일,2004-03
2004-03-31,444757000,375078347,69678653,싱가포르,2004-03
2004-03-31,436203738,506972698,-70768960,영국,2004-03
2004-03-31,343915780,527476822,-183561042,말레이시아,2004-03
2004-03-31,322918634,528980354,-206061720,인도네시아,2004-03
2004-03-31,308805004,198718827,110086177,태국,2004-03
2004-03-31,303821554,27383130,276438424,그리스,2004-03
2004-03-31,294149557,182262555,111887002,필리핀,2004-03
2004-03-31,290300792,70999712,219301080,베트남,2004-03
2004-03-31,288807769,584255723,-295447954,호주,2004-03
2004-03-31,265683419,154446474,111236945,인도,2004-03
2004-03-31,260237708,125755080,134482628,네덜란드,2004-03
2004-03-31,257943768,231718851,26224917,이탈리아,2004-03
2004-03-31,250358627,32902391,217456236,멕시코,2004-03
2004-03-31,236086456,177052232,59034224,캐나다,2004-03
2004-03-31,234563455,44447998,190115457,스페인,2004-03
2004-03-31,225221880,506874925,-281653045,아랍에미리트 연합,2004-03
2004-03-31,196362880,309270993,-112908113,러시아 연방,2004-03
2004-03-31,192511100,253680287,-61169187,프랑스,2004-03
2004-03-31,192232330,6759017,185473313,튀르키예,2004-03
2004-03-31,156773735,815818849,-659045114,사우디아라비아,2004-03
2004-03-31,156230469,1786,156228683,버뮤다,2004-03
2004-03-31,151061258,173052228,-21990970,이란,2004-03
2004-03-31,134447655,129179107,5268548,브라질,2004-03
2004-03-31,127973799,30668966,97304833,핀란드,2004-03
2004-03-31,123457211,32172204,91285007,이스라엘,2004-03
2004-03-31,120128436,74157020,45971416,벨기에,2004-03
2004-03-31,108159306,9271241,98888065,파나마,2004-03
2004-03-31,101663998,69843,101594155,사이프러스,2004-03
2004-03-31,87108984,11417448,75691536,헝가리,2004-03
2004-03-31,73084991,85566768,-12481777,남아프리카공화국,2004-03
2004-03-31,61203755,192113826,-130910071,칠레,2004-03
2004-03-31,59959968,7760966,52199002,폴란드,2004-03
2004-03-31,59044354,138084,58906270,라이베리아,2004-03
2004-03-31,57690735,1559210,56131525,요르단,2004-03
2004-03-31,57208935,14493111,42715824,과테말라,2004-03
2004-03-31,55658774,2755713,52903061,방글라데시,2004-03
2004-03-31,52086377,0,52086377,바하마,2004-03
2004-03-31,51252551,34305059,16947492,나이지리아,2004-03
2004-03-31,50377171,77604927,-27227756,뉴질랜드,2004-03
2004-03-31,48643928,38732065,9911863,파키스탄,2004-03
2004-03-31,48593197,33029712,15563485,오스트리아,2004-03
2004-03-31,44534311,30619211,13915100,이집트,2004-03
2004-03-31,42279673,90862749,-48583076,아일랜드,2004-03
2004-03-31,40527633,72241729,-31714096,스웨덴,2004-03
2004-03-31,37623055,9605564,28017491,콜롬비아,2004-03
2004-03-31,35517631,132020824,-96503193,스위스,2004-03
2004-03-31,31623259,7753884,23869375,체코공화국,2004-03
2004-03-31,30423846,1594504,28829342,불가리아,2004-03
2004-03-31,30416065,28912084,1503981,우크라이나,2004-03
2004-03-31,29543935,0,29543935,알제리,2004-03
2004-03-31,28392693,4909609,23483084,우즈베키스탄,2004-03
2004-03-31,28107184,387462,27719722,시리아,2004-03
2004-03-31,27688849,31395791,-3706942,덴마크,2004-03
2004-03-31,24792909,229583253,-204790344,쿠웨이트,2004-03
2004-03-31,24424131,10190589,14233542,포루투갈,2004-03
2004-03-31,23385630,10742086,12643544,카자흐스탄,2004-03
2004-03-31,22821231,16896420,5924811,루마니아,2004-03
2004-03-31,21642729,2146110,19496619,슬로바키아,2004-03
2004-03-31,21052235,3486476,17565759,스리랑카,2004-03
2004-03-31,20705940,363892284,-343186344,카타르,2004-03
2004-03-31,17107575,20885436,-3777861,페루,2004-03
2004-03-31,15828008,1672335,14155673,온두라스,2004-03
2004-03-31,15816983,53705268,-37888285,에쿠아도르,2004-03
2004-03-31,15633934,15274277,359657,아르헨티나,2004-03
2004-03-31,14594637,13130975,1463662,베네주엘라,2004-03
2004-03-31,13107365,2039311,11068054,기타국,2004-03
2004-03-31,12946173,7394990,5551183,모로코,2004-03
2004-03-31,12050866,5540703,6510163,몰타,2004-03
2004-03-31,11927287,487935,11439352,캄보디아,2004-03
2004-03-31,11531908,43675802,-32143894,노르웨이,2004-03
2004-03-31,11472436,769,11471667,리비아,2004-03
2004-03-31,11364877,194679898,-183315021,오만,2004-03
2004-03-31,11253128,22834,11230294,니카라과,2004-03
2004-03-31,11219927,719483,10500444,괌,2004-03
2004-03-31,11194980,11311968,-116988,푸에르토리코,2004-03
2004-03-31,10192042,1999620,8192422,코스타리카,2004-03
2004-03-31,10096864,739293,9357571,이라크,2004-03
2004-03-31,9461400,219178,9242222,크로아티아,2004-03
2004-03-31,9288853,36142,9252711,수단,2004-03
2004-03-31,8288904,2414182,5874722,미얀마,2004-03
2004-03-31,8219459,1611946,6607513,슬로베니아,2004-03
2004-03-31,8057041,531978,7525063,레바논,2004-03
2004-03-31,7785008,371349,7413659,튀니지,2004-03
2004-03-31,7248018,544517,6703501,몽골,2004-03
2004-03-31,7170500,0,7170500,아프카니스탄,2004-03
2004-03-31,6994768,769670,6225098,가나,2004-03
2004-03-31,6671607,258114,6413493,케냐,2004-03
2004-03-31,6441094,243563,6197531,엘살바도르,2004-03
2004-03-31,5862535,3129,5859406,북마리아나 군도,2004-03
2004-03-31,5735005,7583524,-1848519,도미니카 공화국,2004-03
2004-03-31,5150147,331923,4818224,리투아니아,2004-03
2004-03-31,4280300,3280311,999989,예맨,2004-03
2004-03-31,4028195,5684,4022511,키르기스스탄,2004-03
2004-03-31,3547672,30164,3517508,벨리제,2004-03
2004-03-31,3484091,26271700,-22787609,바레인,2004-03
2004-03-31,3310988,35868504,-32557516,앙골라,2004-03
2004-03-31,2784273,56893122,-54108849,브루나이,2004-03
2004-03-31,2642443,444964,2197479,마카오,2004-03
2004-03-31,2552038,66151,2485887,트리니다드 토바고,2004-03
2004-03-31,2527788,464820,2062968,에스토니아,2004-03
2004-03-31,2514997,24428,2490569,파라과이,2004-03
2004-03-31,2478352,558,2477794,불령 리유니온 코모도 제도,2004-03
2004-03-31,2470977,60422,2410555,모리셔스,2004-03
2004-03-31,2237627,64063,2173564,탄자니아,2004-03
2004-03-31,2155566,0,2155566,투르크멘,2004-03
2004-03-31,2153245,4064422,-1911177,룩셈부르그,2004-03
2004-03-31,2130534,973526,1157008,우루과이,2004-03
2004-03-31,2024646,59394,1965252,마다카스카르,2004-03
2004-03-31,1999423,9066901,-7067478,뉴 칼레도니아,2004-03
2004-03-31,1984225,200229,1783996,아이슬란드,2004-03
2004-03-31,1858336,115990,1742346,피지,2004-03
2004-03-31,1842154,200,1841954,마이크로네시아,2004-03
2004-03-31,1841363,461990,1379373,라트비아,2004-03
2004-03-31,1742503,63502644,-61760141,콩고,2004-03
2004-03-31,1711679,465861,1245818,코트디봐르,2004-03
2004-03-31,1627984,51784,1576200,네팔,2004-03
2004-03-31,1562808,0,1562808,토고,2004-03
2004-03-31,1538551,0,1538551,유고,2004-03
2004-03-31,1508431,0,1508431,과델로프,2004-03
2004-03-31,1362287,0,1362287,마티니크,2004-03
2004-03-31,1184965,153265,1031700,에티오피아,2004-03
2004-03-31,1139424,232476,906948,카메룬,2004-03
2004-03-31,1106413,99078,1007335,벨라루스,2004-03
2004-03-31,1092543,0,1092543,레소토,2004-03
2004-03-31,1047530,0,1047530,지부티,2004-03
2004-03-31,969603,9168903,-8199300,스와질랜드,2004-03
2004-03-31,955305,994163,-38858,짐바브웨,2004-03
2004-03-31,919930,3010638,-2090708,파푸아 뉴기니,2004-03
2004-03-31,899595,0,899595,보스니아-헤르체고비나,2004-03
2004-03-31,893357,16969,876388,아제르바이잔,2004-03
2004-03-31,853551,136036,717515,불령 폴리네시아,2004-03
2004-03-31,846436,329390,517046,세네갈,2004-03
2004-03-31,776793,84081,692712,라오스,2004-03
2004-03-31,769118,31343,737775,말라위,2004-03
2004-03-31,765807,31561,734246,자마이카,2004-03
2004-03-31,730583,0,730583,모잠비크,2004-03
2004-03-31,728067,1637210,-909143,마세도니아,2004-03
2004-03-31,696800,321,696479,베닝,2004-03
2004-03-31,676322,33227,643095,도미니카,2004-03
2004-03-31,489125,72041,417084,네덜란드 열도,2004-03
2004-03-31,477751,12779642,-12301891,잠비아,2004-03
2004-03-31,465499,0,465499,아루바,2004-03
2004-03-31,442564,0,442564,영령 버진군도,2004-03
2004-03-31,384220,119299,264921,보츠와나,2004-03
2004-03-31,372228,412777,-40549,타지크,2004-03
2004-03-31,359277,5634594,-5275317,볼리비아,2004-03
2004-03-31,345678,662530,-316852,기니,2004-03
2004-03-31,345213,163,345050,바베이도스,2004-03
2004-03-31,336227,4182,332045,알바니아,2004-03
2004-03-31,321378,0,321378,아이티,2004-03
2004-03-31,316474,82571,233903,우간다,2004-03
2004-03-31,314866,38825886,-38511020,니제르,2004-03
2004-03-31,313378,0,313378,세이쉘,2004-03
2004-03-31,310999,0,310999,지브랄타,2004-03
2004-03-31,307042,31286,275756,팔라우,2004-03
2004-03-31,280232,0,280232,사모아,2004-03
2004-03-31,271827,0,271827,마샬군도,2004-03
2004-03-31,267093,0,267093,수리남,2004-03
2004-03-31,255584,0,255584,몰디브,2004-03
2004-03-31,246162,21795,224367,아메리칸 사모아,2004-03
2004-03-31,231232,159390,71842,조지아,2004-03
2004-03-31,219703,0,219703,감비아,2004-03
2004-03-31,201388,0,201388,영령 캐이맨 군도,2004-03
2004-03-31,189283,3290,185993,바누아투,2004-03
2004-03-31,158399,114608,43791,리히텐슈타인,2004-03
2004-03-31,150601,196459,-45858,가이아나,2004-03
2004-03-31,147682,0,147682,불령 가이아나,2004-03
2004-03-31,140571,0,140571,안티가 바부다,2004-03
2004-03-31,140218,23805,116413,팔레스타인 해방기구(구),2004-03
2004-03-31,134136,60739,73397,콩고민주공화국,2004-03
2004-03-31,131330,412808,-281478,나미비아,2004-03
2004-03-31,119804,0,119804,세인트 루시아,2004-03
2004-03-31,118630,255519,-136889,가봉,2004-03
2004-03-31,107164,28540,78624,모리타니,2004-03
2004-03-31,100491,0,100491,소말리아,2004-03
2004-03-31,91155,0,91155,아르메니아,2004-03
2004-03-31,76244,0,76244,그레나다,2004-03
2004-03-31,70763,0,70763,적도 기니,2004-03
2004-03-31,64447,0,64447,부탄,2004-03
2004-03-31,60108,0,60108,부르키나 파소,2004-03
2004-03-31,58666,85169,-26503,몰도바,2004-03
2004-03-31,51866,0,51866,중앙아프리카공화국,2004-03
2004-03-31,49373,0,49373,투발루,2004-03
2004-03-31,46185,699565,-653380,안도라,2004-03
2004-03-31,42757,0,42757,에리트리아,2004-03
2004-03-31,37316,0,37316,투르크 & 카이코스 군도,2004-03
2004-03-31,34004,4727,29277,르완다,2004-03
2004-03-31,32110,3580217,-3548107,솔로몬 군도,2004-03
2004-03-31,30977,0,30977,쿡 아일랜드,2004-03
2004-03-31,29012,0,29012,세인트 키츠 네비스,2004-03
2004-03-31,24692,0,24692,시에라 리온,2004-03
2004-03-31,20065,1159019,-1138954,모나코,2004-03
2004-03-31,19793,0,19793,미령 버진군도,2004-03
2004-03-31,13870,0,13870,세인트 빈센트 그레나딘,2004-03
2004-03-31,7828,0,7828,통가,2004-03
2004-03-31,2306,87084,-84778,말리,2004-03
2004-03-31,1375,0,1375,포클랜드 군도,2004-03
2004-03-31,500,0,500,앙귈라,2004-03
2004-03-31,480,0,480,티모르,2004-03
2004-03-31,284,10384,-10100,산마리노,2004-03
2004-03-31,165,0,165,왈라스 & 퓨투나 군도,2004-03
2004-03-31,0,73795,-73795,파로에 군도,2004-03
2004-03-31,0,4222,-4222,마이너 아우틀링 합중국 군도,2004-03
2004-03-31,0,77247,-77247,기네비소,2004-03
2004-03-31,0,113740,-113740,교황청,2004-03
2004-03-31,0,37598,-37598,토켈라우,2004-03
2004-03-31,0,2769,-2769,세인트 헬레나,2004-03
2004-03-31,0,113612,-113612,그린랜드,2004-03
2004-04-30,4097864960,2438357879,1659507081,중국,2004-04
2004-04-30,3544622758,2273711449,1270911309,미국,2004-04
2004-04-30,1922309600,427792664,1494516936,홍콩,2004-04
2004-04-30,1818283540,4047441844,-2229158304,일본,2004-04
2004-04-30,802106167,640174031,161932136,대만,2004-04
2004-04-30,657103557,732104150,-75000593,독일,2004-04
2004-04-30,517450047,448532870,68917177,영국,2004-04
2004-04-30,451875111,363565200,88309911,싱가포르,2004-04
2004-04-30,346195233,497080430,-150885197,말레이시아,2004-04
2004-04-30,307250394,70920421,236329973,베트남,2004-04
2004-04-30,303939427,491450336,-187510909,인도네시아,2004-04
2004-04-30,303608244,200188317,103419927,필리핀,2004-04
2004-04-30,297375334,571536740,-274161406,호주,2004-04
2004-04-30,284030218,199398659,84631559,태국,2004-04
2004-04-30,262967923,43935635,219032288,멕시코,2004-04
2004-04-30,259308278,216232718,43075560,이탈리아,2004-04
2004-04-30,255034925,5270102,249764823,라이베리아,2004-04
2004-04-30,254811785,218780599,36031186,캐나다,2004-04
2004-04-30,243848928,168614670,75234258,인도,2004-04
2004-04-30,231498800,6286896,225211904,튀르키예,2004-04
2004-04-30,227935517,201434836,26500681,프랑스,2004-04
2004-04-30,227283359,467260994,-239977635,아랍에미리트 연합,2004-04
2004-04-30,224017255,109054375,114962880,네덜란드,2004-04
2004-04-30,212752917,40283760,172469157,스페인,2004-04
2004-04-30,199046441,11859211,187187230,그리스,2004-04
2004-04-30,192395025,34112171,158282854,덴마크,2004-04
2004-04-30,180596996,37309543,143287453,나이지리아,2004-04
2004-04-30,173921628,281058414,-107136786,러시아 연방,2004-04
2004-04-30,155596131,179801542,-24205411,브라질,2004-04
2004-04-30,140155180,166952390,-26797210,이란,2004-04
2004-04-30,132247888,67396921,64850967,벨기에,2004-04
2004-04-30,121797690,46922375,74875315,파나마,2004-04
2004-04-30,118560849,909824736,-791263887,사우디아라비아,2004-04
2004-04-30,117415024,35399657,82015367,핀란드,2004-04
2004-04-30,110292200,254857,110037343,사이프러스,2004-04
2004-04-30,89344015,122148684,-32804669,스위스,2004-04
2004-04-30,77588344,75025981,2562363,남아프리카공화국,2004-04
2004-04-30,72160026,79787295,-7627269,아일랜드,2004-04
2004-04-30,67551377,31319897,36231480,이스라엘,2004-04
2004-04-30,60998268,4565205,56433063,요르단,2004-04
2004-04-30,60576635,12483484,48093151,헝가리,2004-04
2004-04-30,60269340,191524059,-131254719,칠레,2004-04
2004-04-30,57802011,3687708,54114303,방글라데시,2004-04
2004-04-30,53830800,7240998,46589802,폴란드,2004-04
2004-04-30,52740362,19148906,33591456,파키스탄,2004-04
2004-04-30,50645692,42366723,8278969,이집트,2004-04
2004-04-30,49713247,13268133,36445114,과테말라,2004-04
2004-04-30,49574673,85416144,-35841471,뉴질랜드,2004-04
2004-04-30,44413104,90,44413014,바하마,2004-04
2004-04-30,44109763,32716768,11392995,오스트리아,2004-04
2004-04-30,42587601,80073851,-37486250,스웨덴,2004-04
2004-04-30,40064289,22222,40042067,마샬군도,2004-04
2004-04-30,36884945,0,36884945,보스니아-헤르체고비나,2004-04
2004-04-30,36656209,12,36656197,알제리,2004-04
2004-04-30,34103799,5843015,28260784,콜롬비아,2004-04
2004-04-30,31842156,368,31841788,영령 캐이맨 군도,2004-04
2004-04-30,29416235,17793,29398442,시리아,2004-04
2004-04-30,28338110,4806838,23531272,우즈베키스탄,2004-04
2004-04-30,28185176,2878569,25306607,스리랑카,2004-04
2004-04-30,27438978,265721361,-238282383,쿠웨이트,2004-04
2004-04-30,27399093,1957881,25441212,불가리아,2004-04
2004-04-30,26712569,2663271,24049298,미얀마,2004-04
2004-04-30,25348369,56842869,-31494500,우크라이나,2004-04
2004-04-30,24612833,8018213,16594620,체코공화국,2004-04
2004-04-30,23409166,17795686,5613480,루마니아,2004-04
2004-04-30,21384256,5359863,16024393,포루투갈,2004-04
2004-04-30,18848731,1345687,17503044,슬로바키아,2004-04
2004-04-30,17402458,1844348,15558110,모로코,2004-04
2004-04-30,17060578,17821431,-760853,카자흐스탄,2004-04
2004-04-30,15509255,0,15509255,이라크,2004-04
2004-04-30,15372272,45195662,-29823390,페루,2004-04
2004-04-30,14831131,2011978,12819153,기타국,2004-04
2004-04-30,14571779,37627777,-23055998,아르헨티나,2004-04
2004-04-30,14389257,1296,14387961,리비아,2004-04
2004-04-30,12956407,14152206,-1195799,푸에르토리코,2004-04
2004-04-30,11267451,603779,10663672,괌,2004-04
2004-04-30,11242516,7707835,3534681,베네주엘라,2004-04
2004-04-30,10733726,361195,10372531,캄보디아,2004-04
2004-04-30,10366263,237712305,-227346042,오만,2004-04
2004-04-30,10088553,42398,10046155,북마리아나 군도,2004-04
2004-04-30,9962141,1826270,8135871,온두라스,2004-04
2004-04-30,9929477,50530491,-40601014,에쿠아도르,2004-04
2004-04-30,9910250,101533,9808717,니카라과,2004-04
2004-04-30,9108200,1109824,7998376,레바논,2004-04
2004-04-30,8315987,38711209,-30395222,노르웨이,2004-04
2004-04-30,8026495,389573,7636922,가나,2004-04
2004-04-30,7829216,7613452,215764,바레인,2004-04
2004-04-30,6984287,3085129,3899158,코스타리카,2004-04
2004-04-30,6950515,9676206,-2725691,몰타,2004-04
2004-04-30,6807934,790100,6017834,몽골,2004-04
2004-04-30,6076041,243133213,-237057172,카타르,2004-04
2004-04-30,5904542,5824210,80332,수단,2004-04
2004-04-30,5827902,19594011,-13766109,도미니카 공화국,2004-04
2004-04-30,5608927,128387,5480540,엘살바도르,2004-04
2004-04-30,5599912,105319,5494593,예맨,2004-04
2004-04-30,5591827,450873,5140954,튀니지,2004-04
2004-04-30,5207946,9022,5198924,케냐,2004-04
2004-04-30,5062372,0,5062372,아프카니스탄,2004-04
2004-04-30,4979217,2191055,2788162,슬로베니아,2004-04
2004-04-30,4843729,676925,4166804,리투아니아,2004-04
2004-04-30,4333227,191449,4141778,벨리제,2004-04
2004-04-30,4172091,311638,3860453,크로아티아,2004-04
2004-04-30,3461733,13073,3448660,키르기스스탄,2004-04
2004-04-30,3286764,300733,2986031,라트비아,2004-04
2004-04-30,2901997,395508,2506489,마카오,2004-04
2004-04-30,2374674,252044,2122630,아이슬란드,2004-04
2004-04-30,2316437,43310,2273127,피지,2004-04
2004-04-30,2314292,26486126,-24171834,브루나이,2004-04
2004-04-30,2213087,70808001,-68594914,앙골라,2004-04
2004-04-30,2184124,386156,1797968,파라과이,2004-04
2004-04-30,2081273,16300,2064973,아제르바이잔,2004-04
2004-04-30,1979684,51992,1927692,모리셔스,2004-04
2004-04-30,1926670,239710,1686960,탄자니아,2004-04
2004-04-30,1877722,879741,997981,우루과이,2004-04
2004-04-30,1712067,1728667,-16600,에스토니아,2004-04
2004-04-30,1543665,374182,1169483,코트디봐르,2004-04
2004-04-30,1485988,13982713,-12496725,뉴 칼레도니아,2004-04
2004-04-30,1415982,0,1415982,레소토,2004-04
2004-04-30,1352535,6583,1345952,마다카스카르,2004-04
2004-04-30,1316076,3668,1312408,불령 리유니온 코모도 제도,2004-04
2004-04-30,1306892,388,1306504,유고,2004-04
2004-04-30,1248718,9440,1239278,트리니다드 토바고,2004-04
2004-04-30,1224740,92026,1132714,에티오피아,2004-04
2004-04-30,1200227,298406,901821,콩고,2004-04
2004-04-30,1181023,112600,1068423,네팔,2004-04
2004-04-30,1162612,0,1162612,토고,2004-04
2004-04-30,1047769,0,1047769,베닝,2004-04
2004-04-30,978629,32280,946349,불령 폴리네시아,2004-04
2004-04-30,903771,0,903771,아루바,2004-04
2004-04-30,890795,3256132,-2365337,스와질랜드,2004-04
2004-04-30,835210,0,835210,투르크멘,2004-04
2004-04-30,822103,0,822103,아이티,2004-04
2004-04-30,746061,442361,303700,콩고민주공화국,2004-04
2004-04-30,720103,33663946,-32943843,카메룬,2004-04
2004-04-30,709423,502763,206660,짐바브웨,2004-04
2004-04-30,668113,0,668113,모잠비크,2004-04
2004-04-30,660516,54000,606516,자마이카,2004-04
2004-04-30,658040,99591,558449,세네갈,2004-04
2004-04-30,654417,600,653817,마이크로네시아,2004-04
2004-04-30,638619,4131393,-3492774,볼리비아,2004-04
2004-04-30,631644,1491578,-859934,벨라루스,2004-04
2004-04-30,618851,5394,613457,과델로프,2004-04
2004-04-30,597661,386658,211003,타지크,2004-04
2004-04-30,577817,126071,451746,라오스,2004-04
2004-04-30,570291,0,570291,팔라우,2004-04
2004-04-30,509452,7499,501953,아르메니아,2004-04
2004-04-30,506604,3506209,-2999605,룩셈부르그,2004-04
2004-04-30,442209,0,442209,바베이도스,2004-04
2004-04-30,438467,3751993,-3313526,파푸아 뉴기니,2004-04
2004-04-30,418478,14844200,-14425722,기니,2004-04
2004-04-30,414976,0,414976,지브랄타,2004-04
2004-04-30,412047,0,412047,세이쉘,2004-04
2004-04-30,407570,0,407570,마티니크,2004-04
2004-04-30,380140,177,379963,도미니카,2004-04
2004-04-30,367218,7949,359269,네덜란드 열도,2004-04
2004-04-30,353151,0,353151,아메리칸 사모아,2004-04
2004-04-30,325835,81107,244728,보츠와나,2004-04
2004-04-30,306430,311703,-5273,조지아,2004-04
2004-04-30,299339,99809,199530,리히텐슈타인,2004-04
2004-04-30,296350,0,296350,지부티,2004-04
2004-04-30,292776,0,292776,시에라 리온,2004-04
2004-04-30,291632,95959,195673,가봉,2004-04
2004-04-30,256632,7786,248846,마세도니아,2004-04
2004-04-30,249846,136146,113700,말라위,2004-04
2004-04-30,244125,0,244125,서사하라,2004-04
2004-04-30,240026,0,240026,불령 가이아나,2004-04
2004-04-30,231800,0,231800,수리남,2004-04
2004-04-30,230521,3003,227518,알바니아,2004-04
2004-04-30,227428,0,227428,사모아,2004-04
2004-04-30,224655,1553,223102,몰디브,2004-04
2004-04-30,220466,30284,190182,몰도바,2004-04
2004-04-30,185126,0,185126,안티가 바부다,2004-04
2004-04-30,172530,1083561,-911031,버뮤다,2004-04
2004-04-30,169027,15892449,-15723422,잠비아,2004-04
2004-04-30,164530,21556616,-21392086,니제르,2004-04
2004-04-30,162654,3053867,-2891213,솔로몬 군도,2004-04
2004-04-30,145017,0,145017,카보 베르데,2004-04
2004-04-30,141836,1129613,-987777,가이아나,2004-04
2004-04-30,137880,0,137880,앙귈라,2004-04
2004-04-30,127951,18344,109607,바누아투,2004-04
2004-04-30,126720,0,126720,우간다,2004-04
2004-04-30,119731,0,119731,감비아,2004-04
2004-04-30,117530,0,117530,티모르,2004-04
2004-04-30,112528,0,112528,부탄,2004-04
2004-04-30,92578,28386,64192,모리타니,2004-04
2004-04-30,86479,2273,84206,토켈라우,2004-04
2004-04-30,84351,0,84351,소말리아,2004-04
2004-04-30,81864,48328,33536,키리바티,2004-04
2004-04-30,80017,0,80017,영령 버진군도,2004-04
2004-04-30,71160,0,71160,세인트 키츠 네비스,2004-04
2004-04-30,70076,349849,-279773,안도라,2004-04
2004-04-30,64242,0,64242,부룬디,2004-04
2004-04-30,60428,0,60428,세인트 루시아,2004-04
2004-04-30,50701,0,50701,그레나다,2004-04
2004-04-30,49879,0,49879,산마리노,2004-04
2004-04-30,43701,0,43701,에리트리아,2004-04
2004-04-30,43369,197210,-153841,팔레스타인 해방기구(구),2004-04
2004-04-30,39530,0,39530,적도 기니,2004-04
2004-04-30,27810,26720,1090,쿡 아일랜드,2004-04
2004-04-30,17550,491198,-473648,나미비아,2004-04
2004-04-30,16579,0,16579,몬트세라트,2004-04
2004-04-30,12852,0,12852,세인트 빈센트 그레나딘,2004-04
2004-04-30,9370,172024,-162654,부르키나 파소,2004-04
2004-04-30,4463,286109,-281646,말리,2004-04
2004-04-30,2758,0,2758,포클랜드 군도,2004-04
2004-04-30,2622,23968,-21346,통가,2004-04
2004-04-30,379,0,379,르완다,2004-04
2004-04-30,370,859748,-859378,모나코,2004-04
2004-04-30,0,49187,-49187,중앙아프리카공화국,2004-04
2004-04-30,0,43200,-43200,그린랜드,2004-04
2004-04-30,0,3212,-3212,허드 앤 맥도날드 군도,2004-04
2004-04-30,0,25129827,-25129827,챠드,2004-04
2004-04-30,0,63490,-63490,기네비소,2004-04
2004-04-30,0,2195,-2195,미령 버진군도,2004-04
2004-05-31,4296986705,2426656633,1870330072,중국,2004-05
2004-05-31,3559012806,2402012528,1157000278,미국,2004-05
2004-05-31,1863901016,3568101822,-1704200806,일본,2004-05
2004-05-31,1680079037,338010815,1342068222,홍콩,2004-05
2004-05-31,838857153,626349190,212507963,대만,2004-05
2004-05-31,611161233,649493397,-38332164,독일,2004-05
2004-05-31,459390253,370937950,88452303,싱가포르,2004-05
2004-05-31,451273473,330653213,120620260,영국,2004-05
2004-05-31,398620060,176474610,222145450,이탈리아,2004-05
2004-05-31,350019031,402190165,-52171134,말레이시아,2004-05
2004-05-31,313672210,171622024,142050186,필리핀,2004-05
2004-05-31,311578036,171140872,140437164,인도,2004-05
2004-05-31,300372044,467234191,-166862147,인도네시아,2004-05
2004-05-31,289277128,52672096,236605032,베트남,2004-05
2004-05-31,283481791,546730219,-263248428,호주,2004-05
2004-05-31,264261786,36504236,227757550,멕시코,2004-05
2004-05-31,257246443,183663123,73583320,태국,2004-05
2004-05-31,234004709,24945731,209058978,튀르키예,2004-05
2004-05-31,211861277,196303864,15557413,네덜란드,2004-05
2004-05-31,209960996,448026752,-238065756,아랍에미리트 연합,2004-05
2004-05-31,204404314,40490484,163913830,스페인,2004-05
2004-05-31,201663848,192730489,8933359,캐나다,2004-05
2004-05-31,194308615,190544819,3763796,프랑스,2004-05
2004-05-31,184233020,187034830,-2801810,이란,2004-05
2004-05-31,179420059,309212627,-129792568,러시아 연방,2004-05
2004-05-31,170553588,156123859,14429729,브라질,2004-05
2004-05-31,148926821,63110,148863711,라이베리아,2004-05
2004-05-31,135963499,886216134,-750252635,사우디아라비아,2004-05
2004-05-31,132189768,4903657,127286111,그리스,2004-05
2004-05-31,121402716,79536228,41866488,벨기에,2004-05
2004-05-31,102539226,33323692,69215534,핀란드,2004-05
2004-05-31,70599298,84131056,-13531758,남아프리카공화국,2004-05
2004-05-31,66952002,6558270,60393732,폴란드,2004-05
2004-05-31,65292702,7167995,58124707,헝가리,2004-05
2004-05-31,59091428,0,59091428,영령 캐이맨 군도,2004-05
2004-05-31,58369044,61225578,-2856534,이스라엘,2004-05
2004-05-31,58245778,33101815,25143963,덴마크,2004-05
2004-05-31,56073297,3847687,52225610,방글라데시,2004-05
2004-05-31,53222311,67959065,-14736754,스웨덴,2004-05
2004-05-31,51483392,81500465,-30017073,뉴질랜드,2004-05
2004-05-31,50406921,26176264,24230657,파키스탄,2004-05
2004-05-31,49554850,70172374,-20617524,나이지리아,2004-05
2004-05-31,49020811,131104593,-82083782,칠레,2004-05
2004-05-31,48125779,35522819,12602960,오스트리아,2004-05
2004-05-31,46613851,27916157,18697694,이집트,2004-05
2004-05-31,43488729,1807462,41681267,과테말라,2004-05
2004-05-31,40864026,277243334,-236379308,카타르,2004-05
2004-05-31,40023374,10581,40012793,마샬군도,2004-05
2004-05-31,37682767,2205,37680562,바하마,2004-05
2004-05-31,36230142,54185234,-17955092,아일랜드,2004-05
2004-05-31,35203361,22899061,12304300,알제리,2004-05
2004-05-31,35171036,18361,35152675,리비아,2004-05
2004-05-31,34321319,4365472,29955847,요르단,2004-05
2004-05-31,33680596,55813,33624783,사이프러스,2004-05
2004-05-31,32583243,1934421,30648822,콜롬비아,2004-05
2004-05-31,31539863,131707773,-100167910,스위스,2004-05
2004-05-31,28935244,9293598,19641646,시리아,2004-05
2004-05-31,28589775,4374817,24214958,우즈베키스탄,2004-05
2004-05-31,28042552,8590447,19452105,체코공화국,2004-05
2004-05-31,26586056,49444246,-22858190,우크라이나,2004-05
2004-05-31,25788813,289374437,-263585624,쿠웨이트,2004-05
2004-05-31,23411505,1475755,21935750,불가리아,2004-05
2004-05-31,23127325,4516337,18610988,포루투갈,2004-05
2004-05-31,22796609,16808495,5988114,카자흐스탄,2004-05
2004-05-31,21855964,552998,21302966,괌,2004-05
2004-05-31,21149832,3266671,17883161,스리랑카,2004-05
2004-05-31,19745026,7889444,11855582,파나마,2004-05
2004-05-31,18770487,35211150,-16440663,아르헨티나,2004-05
2004-05-31,18127422,1570898,16556524,슬로바키아,2004-05
2004-05-31,17768607,13189764,4578843,푸에르토리코,2004-05
2004-05-31,17231933,28038294,-10806361,페루,2004-05
2004-05-31,16071085,2927018,13144067,모로코,2004-05
2004-05-31,14895903,18560994,-3665091,에쿠아도르,2004-05
2004-05-31,14730160,2796104,11934056,코스타리카,2004-05
2004-05-31,13359474,48700552,-35341078,노르웨이,2004-05
2004-05-31,13015324,18897871,-5882547,베네주엘라,2004-05
2004-05-31,12636836,1831416,10805420,온두라스,2004-05
2004-05-31,12223816,24737,12199079,니카라과,2004-05
2004-05-31,12099388,8470308,3629080,바레인,2004-05
2004-05-31,11993422,1816808,10176614,기타국,2004-05
2004-05-31,11661604,0,11661604,이라크,2004-05
2004-05-31,11448233,2140832,9307401,미얀마,2004-05
2004-05-31,11142253,4722370,6419883,루마니아,2004-05
2004-05-31,9501272,192764795,-183263523,오만,2004-05
2004-05-31,8902784,266858,8635926,캄보디아,2004-05
2004-05-31,8085431,41384416,-33298985,수단,2004-05
2004-05-31,7823273,325271,7498002,마카오,2004-05
2004-05-31,7184181,1385151,5799030,레바논,2004-05
2004-05-31,6678067,20544,6657523,북마리아나 군도,2004-05
2004-05-31,6510927,2251605,4259322,슬로베니아,2004-05
2004-05-31,6031948,3706295,2325653,도미니카 공화국,2004-05
2004-05-31,5970705,464479,5506226,몽골,2004-05
2004-05-31,5819890,1553123,4266767,튀니지,2004-05
2004-05-31,5679721,126561,5553160,엘살바도르,2004-05
2004-05-31,5664524,7038547,-1374023,몰타,2004-05
2004-05-31,5585276,119547,5465729,크로아티아,2004-05
2004-05-31,5491702,548758,4942944,가나,2004-05
2004-05-31,5154180,12962827,-7808647,리투아니아,2004-05
2004-05-31,4879740,72873,4806867,케냐,2004-05
2004-05-31,4702549,0,4702549,아프카니스탄,2004-05
2004-05-31,4083904,39884628,-35800724,예맨,2004-05
2004-05-31,3643587,81569,3562018,키르기스스탄,2004-05
2004-05-31,3330910,219684,3111226,라트비아,2004-05
2004-05-31,3262785,617013,2645772,에스토니아,2004-05
2004-05-31,3074053,94579,2979474,에티오피아,2004-05
2004-05-31,2809716,1895978,913738,우루과이,2004-05
2004-05-31,2334135,3865,2330270,탄자니아,2004-05
2004-05-31,2293692,55911779,-53618087,브루나이,2004-05
2004-05-31,2199807,60342,2139465,피지,2004-05
2004-05-31,2156262,130856,2025406,파라과이,2004-05
2004-05-31,2077537,125317,1952220,코트디봐르,2004-05
2004-05-31,1913132,400,1912732,앙골라,2004-05
2004-05-31,1822844,2808,1820036,유고,2004-05
2004-05-31,1780524,0,1780524,아루바,2004-05
2004-05-31,1769411,93696,1675715,네팔,2004-05
2004-05-31,1664804,11590556,-9925752,스와질랜드,2004-05
2004-05-31,1645924,454020,1191904,벨리제,2004-05
2004-05-31,1586760,41390,1545370,모리셔스,2004-05
2004-05-31,1570144,761244,808900,아이슬란드,2004-05
2004-05-31,1548851,0,1548851,아이티,2004-05
2004-05-31,1548657,52930,1495727,트리니다드 토바고,2004-05
2004-05-31,1430702,313980,1116722,아제르바이잔,2004-05
2004-05-31,1348600,121723,1226877,벨라루스,2004-05
2004-05-31,1339207,15323110,-13983903,잠비아,2004-05
2004-05-31,1325713,0,1325713,과델로프,2004-05
2004-05-31,1257077,13157,1243920,베닝,2004-05
2004-05-31,1171096,6982,1164114,토고,2004-05
2004-05-31,1115753,0,1115753,불령 리유니온 코모도 제도,2004-05
2004-05-31,1057246,8421739,-7364493,뉴 칼레도니아,2004-05
2004-05-31,1006496,443,1006053,마티니크,2004-05
2004-05-31,990745,0,990745,네덜란드 열도,2004-05
2004-05-31,934018,18937,915081,레소토,2004-05
2004-05-31,897835,0,897835,지부티,2004-05
2004-05-31,889608,1664157,-774549,짐바브웨,2004-05
2004-05-31,873672,1842726,-969054,파푸아 뉴기니,2004-05
2004-05-31,803940,277102,526838,세네갈,2004-05
2004-05-31,760713,36071,724642,자마이카,2004-05
2004-05-31,738850,67295771,-66556921,콩고,2004-05
2004-05-31,712076,97817,614259,말라위,2004-05
2004-05-31,711001,0,711001,알바니아,2004-05
2004-05-31,698378,198528,499850,조지아,2004-05
2004-05-31,673323,57620,615703,카메룬,2004-05
2004-05-31,663584,22255,641329,보스니아-헤르체고비나,2004-05
2004-05-31,648493,76796,571697,라오스,2004-05
2004-05-31,590781,246124,344657,마다카스카르,2004-05
2004-05-31,569282,4408361,-3839079,버뮤다,2004-05
2004-05-31,537356,93381,443975,팔라우,2004-05
2004-05-31,537022,0,537022,불령 폴리네시아,2004-05
2004-05-31,528788,6918055,-6389267,볼리비아,2004-05
2004-05-31,520835,0,520835,마세도니아,2004-05
2004-05-31,497183,0,497183,안티가 바부다,2004-05
2004-05-31,469115,502,468613,모잠비크,2004-05
2004-05-31,426022,0,426022,몰도바,2004-05
2004-05-31,422292,0,422292,바베이도스,2004-05
2004-05-31,406480,0,406480,수리남,2004-05
2004-05-31,383566,11128352,-10744786,기니,2004-05
2004-05-31,371335,0,371335,마이크로네시아,2004-05
2004-05-31,346303,3460,342843,에리트리아,2004-05
2004-05-31,331149,0,331149,사모아,2004-05
2004-05-31,329371,0,329371,부탄,2004-05
2004-05-31,296024,852451,-556427,부르키나 파소,2004-05
2004-05-31,291449,2207118,-1915669,가봉,2004-05
2004-05-31,284428,22849,261579,투르크멘,2004-05
2004-05-31,283702,0,283702,우간다,2004-05
2004-05-31,271435,266896,4539,말리,2004-05
2004-05-31,269846,36500,233346,콩고민주공화국,2004-05
2004-05-31,264716,462554,-197838,안도라,2004-05
2004-05-31,247051,0,247051,도미니카,2004-05
2004-05-31,220724,1740,218984,영령 버진군도,2004-05
2004-05-31,215202,0,215202,불령 가이아나,2004-05
2004-05-31,194570,4592713,-4398143,룩셈부르그,2004-05
2004-05-31,190188,0,190188,세이쉘,2004-05
2004-05-31,177600,0,177600,부룬디,2004-05
2004-05-31,160916,74155,86761,보츠와나,2004-05
2004-05-31,159432,0,159432,지브랄타,2004-05
2004-05-31,159232,78379,80853,팔레스타인 해방기구(구),2004-05
2004-05-31,155539,0,155539,그레나다,2004-05
2004-05-31,149294,91026,58268,나미비아,2004-05
2004-05-31,137466,77,137389,가이아나,2004-05
2004-05-31,135830,218269,-82439,리히텐슈타인,2004-05
2004-05-31,132586,82233,50353,세인트 루시아,2004-05
2004-05-31,124146,6656,117490,아르메니아,2004-05
2004-05-31,93469,6000,87469,키리바티,2004-05
2004-05-31,90814,31297,59517,아메리칸 사모아,2004-05
2004-05-31,90354,776558,-686204,니제르,2004-05
2004-05-31,87512,1538,85974,몰디브,2004-05
2004-05-31,84351,0,84351,소말리아,2004-05
2004-05-31,83943,0,83943,바누아투,2004-05
2004-05-31,77503,0,77503,마이너 아우틀링 합중국 군도,2004-05
2004-05-31,57200,0,57200,세인트 헬레나,2004-05
2004-05-31,55677,39051,16626,모리타니,2004-05
2004-05-31,48995,0,48995,통가,2004-05
2004-05-31,44504,534786,-490282,타지크,2004-05
2004-05-31,41418,0,41418,카보 베르데,2004-05
2004-05-31,21886,71664,-49778,토켈라우,2004-05
2004-05-31,20846,2077229,-2056383,솔로몬 군도,2004-05
2004-05-31,16160,0,16160,중앙아프리카공화국,2004-05
2004-05-31,11399,0,11399,적도 기니,2004-05
2004-05-31,10388,851803,-841415,모나코,2004-05
2004-05-31,8122,0,8122,앙귈라,2004-05
2004-05-31,5667,0,5667,시에라 리온,2004-05
2004-05-31,4864,0,4864,미령 버진군도,2004-05
2004-05-31,4460,0,4460,산마리노,2004-05
2004-05-31,3648,84212,-80564,기네비소,2004-05
2004-05-31,1924,0,1924,감비아,2004-05
2004-05-31,1553,0,1553,영령 인도양,2004-05
2004-05-31,1331,4500,-3169,노폴크 아일랜드,2004-05
2004-05-31,1275,0,1275,코스 군도,2004-05
2004-05-31,1200,93590,-92390,그린랜드,2004-05
2004-05-31,825,0,825,세인트 빈센트 그레나딘,2004-05
2004-05-31,403,0,403,쿡 아일랜드,2004-05
2004-05-31,0,2434,-2434,남조지아 & 남샌드위치 군도,2004-05
2004-05-31,0,466,-466,교황청,2004-05
2004-05-31,0,612,-612,상토메 프린스페,2004-05
2004-05-31,0,25477,-25477,나우루,2004-05
2004-05-31,0,1184071,-1184071,챠드,2004-05
2004-06-30,4113746869,2369426220,1744320649,중국,2004-06
2004-06-30,4106098212,2538659245,1567438967,미국,2004-06
2004-06-30,1696810982,3922314579,-2225503597,일본,2004-06
2004-06-30,1396816496,222572103,1174244393,홍콩,2004-06
2004-06-30,833565280,624162321,209402959,대만,2004-06
2004-06-30,641432596,720077536,-78644940,독일,2004-06
2004-06-30,549480834,219668729,329812105,영국,2004-06
2004-06-30,438263333,376141548,62121785,싱가포르,2004-06
2004-06-30,407238934,407252435,-13501,말레이시아,2004-06
2004-06-30,380612654,45265535,335347119,스페인,2004-06
2004-06-30,326863650,212884940,113978710,이탈리아,2004-06
2004-06-30,318013315,471024467,-153011152,인도네시아,2004-06
2004-06-30,312254120,164750368,147503752,인도,2004-06
2004-06-30,285317964,586176646,-300858682,호주,2004-06
2004-06-30,270374799,208644992,61729807,프랑스,2004-06
2004-06-30,270308118,163878474,106429644,필리핀,2004-06
2004-06-30,266878237,187632607,79245630,태국,2004-06
2004-06-30,255380893,36380678,219000215,멕시코,2004-06
2004-06-30,239658240,19717677,219940563,라이베리아,2004-06
2004-06-30,236283306,49281794,187001512,베트남,2004-06
2004-06-30,233135358,189899178,43236180,캐나다,2004-06
2004-06-30,231181536,206762261,24419275,네덜란드,2004-06
2004-06-30,213808992,328784260,-114975268,러시아 연방,2004-06
2004-06-30,210127714,205116638,5011076,이란,2004-06
2004-06-30,204221513,702664491,-498442978,아랍에미리트 연합,2004-06
2004-06-30,195670051,7154666,188515385,튀르키예,2004-06
2004-06-30,178483270,19889240,158594030,파나마,2004-06
2004-06-30,174875336,168074884,6800452,브라질,2004-06
2004-06-30,165879792,0,165879792,버뮤다,2004-06
2004-06-30,155942890,1879039,154063851,그리스,2004-06
2004-06-30,150464392,972057178,-821592786,사우디아라비아,2004-06
2004-06-30,127734486,52421192,75313294,노르웨이,2004-06
2004-06-30,117758202,33161782,84596420,핀란드,2004-06
2004-06-30,102258694,91761112,10497582,벨기에,2004-06
2004-06-30,76811664,67027838,9783826,남아프리카공화국,2004-06
2004-06-30,70694095,64421074,6273021,스웨덴,2004-06
2004-06-30,68176866,34746759,33430107,이스라엘,2004-06
2004-06-30,61318215,9936084,51382131,폴란드,2004-06
2004-06-30,61002867,71972,60930895,사이프러스,2004-06
2004-06-30,58473357,38328333,20145024,오스트리아,2004-06
2004-06-30,55654770,15809311,39845459,나이지리아,2004-06
2004-06-30,54075154,168890152,-114814998,칠레,2004-06
2004-06-30,53974278,18011104,35963174,파키스탄,2004-06
2004-06-30,53710462,2740918,50969544,과테말라,2004-06
2004-06-30,49027437,9842209,39185228,헝가리,2004-06
2004-06-30,48817725,3791988,45025737,방글라데시,2004-06
2004-06-30,47236011,62364026,-15128015,이집트,2004-06
2004-06-30,45623718,64667300,-19043582,뉴질랜드,2004-06
2004-06-30,44757493,2837239,41920254,기타국,2004-06
2004-06-30,42515242,1940657,40574585,요르단,2004-06
2004-06-30,42002170,39093235,2908935,덴마크,2004-06
2004-06-30,41465962,62304498,-20838536,아일랜드,2004-06
2004-06-30,40216384,51775896,-11559512,우크라이나,2004-06
2004-06-30,39044724,15198088,23846636,콜롬비아,2004-06
2004-06-30,36842375,0,36842375,마샬군도,2004-06
2004-06-30,33493217,7330923,26162294,우즈베키스탄,2004-06
2004-06-30,33028158,22155,33006003,시리아,2004-06
2004-06-30,32792289,115254181,-82461892,스위스,2004-06
2004-06-30,31728355,12284972,19443383,알제리,2004-06
2004-06-30,31050236,309793891,-278743655,쿠웨이트,2004-06
2004-06-30,27337375,0,27337375,영령 캐이맨 군도,2004-06
2004-06-30,26333811,1949950,24383861,불가리아,2004-06
2004-06-30,26243632,18565712,7677920,아르헨티나,2004-06
2004-06-30,24045840,1213764,22832076,슬로바키아,2004-06
2004-06-30,22824123,12515897,10308226,베네주엘라,2004-06
2004-06-30,22374113,7156707,15217406,체코공화국,2004-06
2004-06-30,21796520,4562154,17234366,스리랑카,2004-06
2004-06-30,21393684,5110818,16282866,포루투갈,2004-06
2004-06-30,20704385,13279961,7424424,카자흐스탄,2004-06
2004-06-30,18705372,52403766,-33698394,에쿠아도르,2004-06
2004-06-30,17879287,8244096,9635191,페루,2004-06
2004-06-30,16333554,191795018,-175461464,오만,2004-06
2004-06-30,15869182,203414154,-187544972,카타르,2004-06
2004-06-30,15258585,0,15258585,리비아,2004-06
2004-06-30,14457157,223248,14233909,니카라과,2004-06
2004-06-30,14380959,12013049,2367910,루마니아,2004-06
2004-06-30,13883157,2489845,11393312,미얀마,2004-06
2004-06-30,12098907,5793335,6305572,푸에르토리코,2004-06
2004-06-30,11456526,2383093,9073433,코스타리카,2004-06
2004-06-30,11267089,61016,11206073,이라크,2004-06
2004-06-30,11074460,2132141,8942319,온두라스,2004-06
2004-06-30,10999840,4410601,6589239,모로코,2004-06
2004-06-30,10170072,253279,9916793,캄보디아,2004-06
2004-06-30,9948040,81913272,-71965232,수단,2004-06
2004-06-30,8255706,21326405,-13070699,도미니카 공화국,2004-06
2004-06-30,8079437,106638,7972799,북마리아나 군도,2004-06
2004-06-30,7730413,5672921,2057492,몰타,2004-06
2004-06-30,7681294,120298,7560996,몽골,2004-06
2004-06-30,7566512,1268486,6298026,레바논,2004-06
2004-06-30,7315194,747633,6567561,가나,2004-06
2004-06-30,6732984,60848,6672136,엘살바도르,2004-06
2004-06-30,6376834,565645,5811189,튀니지,2004-06
2004-06-30,6021057,1802374,4218683,슬로베니아,2004-06
2004-06-30,5276409,0,5276409,아프카니스탄,2004-06
2004-06-30,5108584,367353,4741231,우루과이,2004-06
2004-06-30,5108481,33440842,-28332361,바레인,2004-06
2004-06-30,5051902,158735,4893167,크로아티아,2004-06
2004-06-30,4754878,327071,4427807,케냐,2004-06
2004-06-30,4334689,121911,4212778,예맨,2004-06
2004-06-30,4304302,496898,3807404,파라과이,2004-06
2004-06-30,4286844,213213,4073631,키르기스스탄,2004-06
2004-06-30,4252607,583627,3668980,리투아니아,2004-06
2004-06-30,3678997,148005,3530992,라트비아,2004-06
2004-06-30,3048112,945194,2102918,코트디봐르,2004-06
2004-06-30,2857285,783735,2073550,에스토니아,2004-06
2004-06-30,2797682,31995202,-29197520,브루나이,2004-06
2004-06-30,2412792,181351,2231441,마카오,2004-06
2004-06-30,1772588,7910598,-6138010,뉴 칼레도니아,2004-06
2004-06-30,1722604,0,1722604,모리셔스,2004-06
2004-06-30,1675211,341519,1333692,벨라루스,2004-06
2004-06-30,1570067,13870806,-12300739,스와질랜드,2004-06
2004-06-30,1533536,0,1533536,유고,2004-06
2004-06-30,1526008,3214776,-1688768,파푸아 뉴기니,2004-06
2004-06-30,1524690,0,1524690,불령 리유니온 코모도 제도,2004-06
2004-06-30,1468600,0,1468600,마티니크,2004-06
2004-06-30,1414607,56584,1358023,트리니다드 토바고,2004-06
2004-06-30,1410622,626990,783632,괌,2004-06
2004-06-30,1382199,0,1382199,레소토,2004-06
2004-06-30,1359055,7612,1351443,앙골라,2004-06
2004-06-30,1283319,13230,1270089,바하마,2004-06
2004-06-30,1267006,9590559,-8323553,잠비아,2004-06
2004-06-30,1213403,247399,966004,에티오피아,2004-06
2004-06-30,1162433,0,1162433,니제르,2004-06
2004-06-30,1160547,32674,1127873,아제르바이잔,2004-06
2004-06-30,1139872,129001,1010871,자마이카,2004-06
2004-06-30,1115227,432228,682999,아이슬란드,2004-06
2004-06-30,1099359,0,1099359,모잠비크,2004-06
2004-06-30,1054970,63347,991623,콩고,2004-06
2004-06-30,1048062,0,1048062,토고,2004-06
2004-06-30,1047004,18789,1028215,마다카스카르,2004-06
2004-06-30,1043286,3765,1039521,과델로프,2004-06
2004-06-30,1021379,72597,948782,세네갈,2004-06
2004-06-30,995128,15515696,-14520568,기니,2004-06
2004-06-30,993313,215273,778040,탄자니아,2004-06
2004-06-30,990365,20035,970330,피지,2004-06
2004-06-30,943785,32289,911496,베닝,2004-06
2004-06-30,922679,0,922679,아이티,2004-06
2004-06-30,917029,1862791,-945762,짐바브웨,2004-06
2004-06-30,845733,32823,812910,네팔,2004-06
2004-06-30,826307,2000,824307,마이크로네시아,2004-06
2004-06-30,743815,3184,740631,네덜란드 열도,2004-06
2004-06-30,708829,29679712,-28970883,카메룬,2004-06
2004-06-30,689265,0,689265,알바니아,2004-06
2004-06-30,658742,0,658742,바베이도스,2004-06
2004-06-30,643754,265305,378449,나미비아,2004-06
2004-06-30,574719,0,574719,아루바,2004-06
2004-06-30,531514,8050322,-7518808,볼리비아,2004-06
2004-06-30,523724,0,523724,지부티,2004-06
2004-06-30,505588,258879,246709,조지아,2004-06
2004-06-30,484714,43567,441147,팔레스타인 해방기구(구),2004-06
2004-06-30,460369,206263,254106,라오스,2004-06
2004-06-30,452526,868,451658,투르크멘,2004-06
2004-06-30,439839,0,439839,세이쉘,2004-06
2004-06-30,420493,121813,298680,도미니카,2004-06
2004-06-30,408180,161396,246784,불령 폴리네시아,2004-06
2004-06-30,384472,275686,108786,말라위,2004-06
2004-06-30,372558,0,372558,안티가 바부다,2004-06
2004-06-30,365684,0,365684,보스니아-헤르체고비나,2004-06
2004-06-30,327015,27263,299752,아르메니아,2004-06
2004-06-30,325675,8167,317508,몰도바,2004-06
2004-06-30,308327,83099,225228,아메리칸 사모아,2004-06
2004-06-30,305158,0,305158,부탄,2004-06
2004-06-30,271929,0,271929,우간다,2004-06
2004-06-30,269321,791,268530,수리남,2004-06
2004-06-30,264996,0,264996,사모아,2004-06
2004-06-30,257054,0,257054,가이아나,2004-06
2004-06-30,253173,0,253173,시에라 리온,2004-06
2004-06-30,246164,0,246164,불령 가이아나,2004-06
2004-06-30,244261,5563303,-5319042,룩셈부르그,2004-06
2004-06-30,213887,271935,-58048,타지크,2004-06
2004-06-30,208094,0,208094,마세도니아,2004-06
2004-06-30,206132,145291,60841,가봉,2004-06
2004-06-30,205542,0,205542,벨리제,2004-06
2004-06-30,200852,2520,198332,바누아투,2004-06
2004-06-30,191442,585147,-393705,부르키나 파소,2004-06
2004-06-30,177949,6091,171858,콩고민주공화국,2004-06
2004-06-30,174629,0,174629,소말리아,2004-06
2004-06-30,165869,0,165869,지브랄타,2004-06
2004-06-30,153755,0,153755,모리타니,2004-06
2004-06-30,151780,228,151552,에리트리아,2004-06
2004-06-30,149163,840,148323,몰디브,2004-06
2004-06-30,148204,70496,77708,리히텐슈타인,2004-06
2004-06-30,135655,12180,123475,통가,2004-06
2004-06-30,132279,0,132279,말리,2004-06
2004-06-30,128746,0,128746,그레나다,2004-06
2004-06-30,123908,112286,11622,보츠와나,2004-06
2004-06-30,117131,0,117131,세인트 루시아,2004-06
2004-06-30,113112,0,113112,영령 버진군도,2004-06
2004-06-30,113012,168409,-55397,안도라,2004-06
2004-06-30,110975,0,110975,팔라우,2004-06
2004-06-30,97953,2655633,-2557680,미령 버진군도,2004-06
2004-06-30,87120,0,87120,투르크 & 카이코스 군도,2004-06
2004-06-30,82702,2418025,-2335323,솔로몬 군도,2004-06
2004-06-30,63415,847,62568,중앙아프리카공화국,2004-06
2004-06-30,56095,0,56095,티모르,2004-06
2004-06-30,46507,0,46507,토켈라우,2004-06
2004-06-30,27810,6210,21600,쿡 아일랜드,2004-06
2004-06-30,25110,4032,21078,키리바티,2004-06
2004-06-30,22892,501034,-478142,모나코,2004-06
2004-06-30,22706,0,22706,부룬디,2004-06
2004-06-30,10503,0,10503,세인트 키츠 네비스,2004-06
2004-06-30,3955,0,3955,세인트 빈센트 그레나딘,2004-06
2004-06-30,1938,0,1938,감비아,2004-06
2004-06-30,1510,0,1510,노폴크 아일랜드,2004-06
2004-06-30,1504,0,1504,몬트세라트,2004-06
2004-06-30,1383,0,1383,코모로스,2004-06
2004-06-30,904,27134,-26230,르완다,2004-06
2004-06-30,437,0,437,카보 베르데,2004-06
2004-06-30,0,6451,-6451,세인트 헬레나,2004-06
2004-06-30,0,640488,-640488,챠드,2004-06
2004-06-30,0,99437,-99437,그린랜드,2004-06
2004-06-30,0,42298,-42298,적도 기니,2004-06
2004-06-30,0,1832,-1832,포클랜드 군도,2004-06
2004-06-30,0,165597,-165597,기네비소,2004-06
2004-07-31,4479869971,2416074741,2063795230,중국,2004-07
2004-07-31,3623191685,2378641732,1244549953,미국,2004-07
2004-07-31,1836487014,4119323129,-2282836115,일본,2004-07
2004-07-31,1290155367,201214752,1088940615,홍콩,2004-07
2004-07-31,847048170,668082314,178965856,대만,2004-07
2004-07-31,782553776,689132800,93420976,독일,2004-07
2004-07-31,531906124,365935625,165970499,싱가포르,2004-07
2004-07-31,428183555,282124174,146059381,영국,2004-07
2004-07-31,370685155,385518667,-14833512,말레이시아,2004-07
2004-07-31,290209436,606979445,-316770009,호주,2004-07
2004-07-31,289382839,528522623,-239139784,인도네시아,2004-07
2004-07-31,287228479,173885315,113343164,인도,2004-07
2004-07-31,282600681,183408785,99191896,필리핀,2004-07
2004-07-31,272768726,208766497,64002229,프랑스,2004-07
2004-07-31,255246123,206880302,48365821,태국,2004-07
2004-07-31,253352341,28972601,224379740,멕시코,2004-07
2004-07-31,250245723,128750519,121495204,네덜란드,2004-07
2004-07-31,242243975,57421305,184822670,베트남,2004-07
2004-07-31,237813420,202814286,34999134,캐나다,2004-07
2004-07-31,237642974,236499150,1143824,이탈리아,2004-07
2004-07-31,208015637,450072982,-242057345,아랍에미리트 연합,2004-07
2004-07-31,196865406,331325616,-134460210,러시아 연방,2004-07
2004-07-31,188235108,6506780,181728328,튀르키예,2004-07
2004-07-31,180892007,205879541,-24987534,이란,2004-07
2004-07-31,174681493,44340154,130341339,스페인,2004-07
2004-07-31,165439935,152958815,12481120,브라질,2004-07
2004-07-31,163460910,10114551,153346359,바하마,2004-07
2004-07-31,161217140,56684975,104532165,핀란드,2004-07
2004-07-31,133791094,947420187,-813629093,사우디아라비아,2004-07
2004-07-31,132277822,89516,132188306,라이베리아,2004-07
2004-07-31,131974217,10459735,121514482,사이프러스,2004-07
2004-07-31,115278285,71450526,43827759,벨기에,2004-07
2004-07-31,105683928,275742583,-170058655,쿠웨이트,2004-07
2004-07-31,83710061,5921974,77788087,폴란드,2004-07
2004-07-31,80970774,105860286,-24889512,남아프리카공화국,2004-07
2004-07-31,71628594,34721679,36906915,이스라엘,2004-07
2004-07-31,71050140,2569192,68480948,그리스,2004-07
2004-07-31,69562202,0,69562202,마샬군도,2004-07
2004-07-31,66011723,57117131,8894592,스웨덴,2004-07
2004-07-31,62513703,36583012,25930691,오스트리아,2004-07
2004-07-31,59308108,138252411,-78944303,칠레,2004-07
2004-07-31,58534191,10816584,47717607,헝가리,2004-07
2004-07-31,49231137,9636195,39594942,나이지리아,2004-07
2004-07-31,46554532,72196872,-25642340,뉴질랜드,2004-07
2004-07-31,45560259,5748973,39811286,과테말라,2004-07
2004-07-31,43864872,1645344,42219528,불가리아,2004-07
2004-07-31,43591313,4001162,39590151,방글라데시,2004-07
2004-07-31,42601726,18182625,24419101,이집트,2004-07
2004-07-31,42459585,12638623,29820962,파키스탄,2004-07
2004-07-31,37691261,1023,37690238,알제리,2004-07
2004-07-31,36863705,80367614,-43503909,아일랜드,2004-07
2004-07-31,36824735,7013110,29811625,콜롬비아,2004-07
2004-07-31,36311722,41093238,-4781516,우크라이나,2004-07
2004-07-31,35960643,4149597,31811046,요르단,2004-07
2004-07-31,33053095,8071056,24982039,우즈베키스탄,2004-07
2004-07-31,32710497,107949735,-75239238,스위스,2004-07
2004-07-31,32409272,42730302,-10321030,덴마크,2004-07
2004-07-31,32134686,4017982,28116704,슬로바키아,2004-07
2004-07-31,30796341,59361,30736980,파나마,2004-07
2004-07-31,27169266,127672,27041594,시리아,2004-07
2004-07-31,25663559,5521,25658038,괌,2004-07
2004-07-31,25198465,4753993,20444472,포루투갈,2004-07
2004-07-31,25158952,26010670,-851718,카자흐스탄,2004-07
2004-07-31,23763628,66053686,-42290058,아르헨티나,2004-07
2004-07-31,22817832,7979015,14838817,체코공화국,2004-07
2004-07-31,20102828,7079574,13023254,베네주엘라,2004-07
2004-07-31,19610956,2944320,16666636,스리랑카,2004-07
2004-07-31,17933281,15948771,1984510,루마니아,2004-07
2004-07-31,17524099,278803858,-261279759,카타르,2004-07
2004-07-31,17217608,107125,17110483,리비아,2004-07
2004-07-31,16609779,70864086,-54254307,에쿠아도르,2004-07
2004-07-31,15034879,35595558,-20560679,페루,2004-07
2004-07-31,14795222,8121799,6673423,푸에르토리코,2004-07
2004-07-31,13653862,44854539,-31200677,노르웨이,2004-07
2004-07-31,13039033,975695,12063338,온두라스,2004-07
2004-07-31,12904002,3175888,9728114,기타국,2004-07
2004-07-31,12014614,377622,11636992,니카라과,2004-07
2004-07-31,11543586,0,11543586,이라크,2004-07
2004-07-31,10694650,1591997,9102653,캄보디아,2004-07
2004-07-31,10462672,2770554,7692118,코스타리카,2004-07
2004-07-31,10369274,181444038,-171074764,오만,2004-07
2004-07-31,9396242,2241947,7154295,모로코,2004-07
2004-07-31,9364519,37270990,-27906471,수단,2004-07
2004-07-31,8910419,2233284,6677135,미얀마,2004-07
2004-07-31,8437524,109518,8328006,북마리아나 군도,2004-07
2004-07-31,7956679,868069,7088610,레바논,2004-07
2004-07-31,7099916,118348,6981568,예맨,2004-07
2004-07-31,6911249,4019360,2891889,몰타,2004-07
2004-07-31,6479705,35850,6443855,몽골,2004-07
2004-07-31,6251113,120774,6130339,케냐,2004-07
2004-07-31,5941838,11209781,-5267943,도미니카 공화국,2004-07
2004-07-31,5619259,211160,5408099,엘살바도르,2004-07
2004-07-31,5001754,933119,4068635,리투아니아,2004-07
2004-07-31,4810272,374498,4435774,가나,2004-07
2004-07-31,4551239,2370305,2180934,슬로베니아,2004-07
2004-07-31,4510425,913403,3597022,우루과이,2004-07
2004-07-31,4445290,86344,4358946,아프카니스탄,2004-07
2004-07-31,4338852,8721289,-4382437,바레인,2004-07
2004-07-31,4276794,224828,4051966,라트비아,2004-07
2004-07-31,4201840,166222,4035618,크로아티아,2004-07
2004-07-31,4155830,9476,4146354,키르기스스탄,2004-07
2004-07-31,4066762,650267,3416495,튀니지,2004-07
2004-07-31,3004004,887989,2116015,코트디봐르,2004-07
2004-07-31,2529180,546100,1983080,에스토니아,2004-07
2004-07-31,2113431,343219,1770212,마카오,2004-07
2004-07-31,2059972,4041,2055931,앙골라,2004-07
2004-07-31,1988001,53825,1934176,탄자니아,2004-07
2004-07-31,1987971,118926,1869045,트리니다드 토바고,2004-07
2004-07-31,1984343,1209697,774646,아이슬란드,2004-07
2004-07-31,1921337,95101,1826236,네팔,2004-07
2004-07-31,1851490,11188,1840302,모리셔스,2004-07
2004-07-31,1817577,60168346,-58350769,브루나이,2004-07
2004-07-31,1795294,0,1795294,불령 리유니온 코모도 제도,2004-07
2004-07-31,1754665,3174231,-1419566,파푸아 뉴기니,2004-07
2004-07-31,1718023,408756,1309267,파라과이,2004-07
2004-07-31,1592150,6870388,-5278238,뉴 칼레도니아,2004-07
2004-07-31,1464789,17128,1447661,벨라루스,2004-07
2004-07-31,1403345,0,1403345,알바니아,2004-07
2004-07-31,1350372,386,1349986,콩고,2004-07
2004-07-31,1295061,0,1295061,토고,2004-07
2004-07-31,1290476,16968411,-15677935,잠비아,2004-07
2004-07-31,1189412,148837,1040575,세네갈,2004-07
2004-07-31,1171246,1247,1169999,도미니카,2004-07
2004-07-31,1141079,44432,1096647,에티오피아,2004-07
2004-07-31,1063112,208929,854183,아제르바이잔,2004-07
2004-07-31,985708,0,985708,베닝,2004-07
2004-07-31,958360,29707,928653,피지,2004-07
2004-07-31,947763,56832,890931,카메룬,2004-07
2004-07-31,897607,5149340,-4251733,스와질랜드,2004-07
2004-07-31,870660,0,870660,에리트리아,2004-07
2004-07-31,852157,0,852157,아이티,2004-07
2004-07-31,848500,4394,844106,마다카스카르,2004-07
2004-07-31,773074,33236,739838,자마이카,2004-07
2004-07-31,755952,910,755042,네덜란드 열도,2004-07
2004-07-31,744832,0,744832,팔라우,2004-07
2004-07-31,713447,65158,648289,짐바브웨,2004-07
2004-07-31,712224,0,712224,유고,2004-07
2004-07-31,707721,3628056,-2920335,룩셈부르그,2004-07
2004-07-31,705146,210878,494268,라오스,2004-07
2004-07-31,619289,0,619289,사모아,2004-07
2004-07-31,592028,137085,454943,불령 폴리네시아,2004-07
2004-07-31,586084,160394,425690,모리타니,2004-07
2004-07-31,554962,1815895,-1260933,볼리비아,2004-07
2004-07-31,551234,264841,286393,조지아,2004-07
2004-07-31,502316,125657,376659,말라위,2004-07
2004-07-31,499413,84755,414658,보츠와나,2004-07
2004-07-31,458551,139,458412,마티니크,2004-07
2004-07-31,430384,0,430384,아루바,2004-07
2004-07-31,425621,0,425621,바베이도스,2004-07
2004-07-31,419656,0,419656,레소토,2004-07
2004-07-31,414827,29199,385628,가봉,2004-07
2004-07-31,386191,0,386191,과델로프,2004-07
2004-07-31,375697,0,375697,모잠비크,2004-07
2004-07-31,360346,4542,355804,벨리제,2004-07
2004-07-31,334612,272,334340,불령 가이아나,2004-07
2004-07-31,332377,165432,166945,타지크,2004-07
2004-07-31,324959,1285,323674,영령 캐이맨 군도,2004-07
2004-07-31,320556,648598,-328042,기니,2004-07
2004-07-31,312521,0,312521,보스니아-헤르체고비나,2004-07
2004-07-31,286092,0,286092,마세도니아,2004-07
2004-07-31,276061,58678,217383,우간다,2004-07
2004-07-31,248568,8750,239818,바누아투,2004-07
2004-07-31,245410,0,245410,수리남,2004-07
2004-07-31,237453,0,237453,지부티,2004-07
2004-07-31,235825,182419,53406,리히텐슈타인,2004-07
2004-07-31,231572,100,231472,마이크로네시아,2004-07
2004-07-31,227085,0,227085,몰도바,2004-07
2004-07-31,202053,0,202053,르완다,2004-07
2004-07-31,179481,45751,133730,팔레스타인 해방기구(구),2004-07
2004-07-31,177998,0,177998,버뮤다,2004-07
2004-07-31,175109,5206863,-5031754,솔로몬 군도,2004-07
2004-07-31,168816,16767,152049,아르메니아,2004-07
2004-07-31,168097,281,167816,니제르,2004-07
2004-07-31,159235,4820,154415,가이아나,2004-07
2004-07-31,154174,0,154174,투르크멘,2004-07
2004-07-31,144395,3824,140571,키리바티,2004-07
2004-07-31,134147,320,133827,말리,2004-07
2004-07-31,129862,4822,125040,콩고민주공화국,2004-07
2004-07-31,128578,187814,-59236,소말리아,2004-07
2004-07-31,126281,14388,111893,몰디브,2004-07
2004-07-31,123429,0,123429,투르크 & 카이코스 군도,2004-07
2004-07-31,119323,217201,-97878,영령 버진군도,2004-07
2004-07-31,114789,404678,-289889,모나코,2004-07
2004-07-31,113190,1017122,-903932,부르키나 파소,2004-07
2004-07-31,109467,0,109467,아메리칸 사모아,2004-07
2004-07-31,100611,0,100611,카보 베르데,2004-07
2004-07-31,97455,0,97455,지브랄타,2004-07
2004-07-31,94522,490045,-395523,안도라,2004-07
2004-07-31,90337,0,90337,파로에 군도,2004-07
2004-07-31,76835,31467,45368,시에라 리온,2004-07
2004-07-31,74425,0,74425,그레나다,2004-07
2004-07-31,73712,0,73712,세이쉘,2004-07
2004-07-31,67151,0,67151,세인트 루시아,2004-07
2004-07-31,48567,222968,-174401,안티가 바부다,2004-07
2004-07-31,47434,54073,-6639,부탄,2004-07
2004-07-31,34237,0,34237,부룬디,2004-07
2004-07-31,24190,219594,-195404,나미비아,2004-07
2004-07-31,16040,0,16040,쿡 아일랜드,2004-07
2004-07-31,5745,851,4894,포클랜드 군도,2004-07
2004-07-31,4133,0,4133,감비아,2004-07
2004-07-31,2963,0,2963,세르비아 와 몬테네그로,2004-07
2004-07-31,2413,0,2413,미령 버진군도,2004-07
2004-07-31,1910,1525,385,토켈라우,2004-07
2004-07-31,1833,1564,269,통가,2004-07
2004-07-31,1823,0,1823,세인트 헬레나,2004-07
2004-07-31,1336,0,1336,몬트세라트,2004-07
2004-07-31,987,0,987,세인트 빈센트 그레나딘,2004-07
2004-07-31,953,0,953,불령 남부지역,2004-07
2004-07-31,171,1520145,-1519974,챠드,2004-07
2004-07-31,0,7900,-7900,코스 군도,2004-07
2004-07-31,0,9136,-9136,상토메 프린스페,2004-07
2004-07-31,0,233254,-233254,그린랜드,2004-07
2004-07-31,0,211719,-211719,기네비소,2004-07
2004-08-31,4101366165,2475827143,1625539022,중국,2004-08
2004-08-31,3470222358,2572313971,897908387,미국,2004-08
2004-08-31,1604839240,3561968993,-1957129753,일본,2004-08
2004-08-31,1375518159,166575132,1208943027,홍콩,2004-08
2004-08-31,823925266,633466941,190458325,대만,2004-08
2004-08-31,614903514,730307547,-115404033,독일,2004-08
2004-08-31,445171636,330357143,114814493,싱가포르,2004-08
2004-08-31,410326202,256605641,153720561,영국,2004-08
2004-08-31,392521737,496211155,-103689418,말레이시아,2004-08
2004-08-31,312293484,416958264,-104664780,인도네시아,2004-08
2004-08-31,287093726,659117900,-372024174,호주,2004-08
2004-08-31,263181556,171250236,91931320,태국,2004-08
2004-08-31,260430215,113575397,146854818,인도,2004-08
2004-08-31,256963350,167404753,89558597,필리핀,2004-08
2004-08-31,249119077,211259882,37859195,프랑스,2004-08
2004-08-31,246597101,0,246597101,라이베리아,2004-08
2004-08-31,236817680,208668548,28149132,이탈리아,2004-08
2004-08-31,232426170,144967432,87458738,네덜란드,2004-08
2004-08-31,224080686,30260017,193820669,멕시코,2004-08
2004-08-31,221873125,64080579,157792546,베트남,2004-08
2004-08-31,213722784,150101021,63621763,캐나다,2004-08
2004-08-31,197688647,638625397,-440936750,아랍에미리트 연합,2004-08
2004-08-31,191821506,297600364,-105778858,러시아 연방,2004-08
2004-08-31,180420998,7292171,173128827,튀르키예,2004-08
2004-08-31,171214711,1090104375,-918889664,사우디아라비아,2004-08
2004-08-31,165887601,21710,165865891,사이프러스,2004-08
2004-08-31,161836700,44848582,116988118,스페인,2004-08
2004-08-31,160940543,29106325,131834218,핀란드,2004-08
2004-08-31,157862157,3211821,154650336,그리스,2004-08
2004-08-31,148179592,227507495,-79327903,이란,2004-08
2004-08-31,139045364,183533087,-44487723,브라질,2004-08
2004-08-31,99765232,77444352,22320880,벨기에,2004-08
2004-08-31,97087231,36540892,60546339,이스라엘,2004-08
2004-08-31,83742576,15505491,68237085,파나마,2004-08
2004-08-31,83108614,0,83108614,마샬군도,2004-08
2004-08-31,70877027,89806942,-18929915,남아프리카공화국,2004-08
2004-08-31,68294497,5183927,63110570,폴란드,2004-08
2004-08-31,64885348,164010144,-99124796,칠레,2004-08
2004-08-31,58617857,33126251,25491606,오스트리아,2004-08
2004-08-31,53809936,12599198,41210738,파키스탄,2004-08
2004-08-31,48815035,37562785,11252250,나이지리아,2004-08
2004-08-31,47041886,52702898,-5661012,스웨덴,2004-08
2004-08-31,46276809,1934207,44342602,요르단,2004-08
2004-08-31,44190740,4313458,39877282,방글라데시,2004-08
2004-08-31,44061324,10557607,33503717,헝가리,2004-08
2004-08-31,40796007,38631170,2164837,우크라이나,2004-08
2004-08-31,40544225,2279891,38264334,슬로바키아,2004-08
2004-08-31,40536691,69790150,-29253459,뉴질랜드,2004-08
2004-08-31,40458652,38989686,1468966,이집트,2004-08
2004-08-31,38030065,2545359,35484706,바하마,2004-08
2004-08-31,36736781,325442,36411339,과테말라,2004-08
2004-08-31,36610412,40726381,-4115969,덴마크,2004-08
2004-08-31,30312676,63544991,-33232315,아일랜드,2004-08
2004-08-31,29162815,8850376,20312439,콜롬비아,2004-08
2004-08-31,27977687,331590223,-303612536,쿠웨이트,2004-08
2004-08-31,26646048,31916507,-5270459,아르헨티나,2004-08
2004-08-31,26417549,95423555,-69006006,스위스,2004-08
2004-08-31,25943065,5317087,20625978,우즈베키스탄,2004-08
2004-08-31,25853522,12067281,13786241,카자흐스탄,2004-08
2004-08-31,25370525,7235615,18134910,포루투갈,2004-08
2004-08-31,22114514,242891,21871623,시리아,2004-08
2004-08-31,20623759,7409245,13214514,베네주엘라,2004-08
2004-08-31,19984087,8677669,11306418,체코공화국,2004-08
2004-08-31,19828090,133265,19694825,알제리,2004-08
2004-08-31,19795743,1727105,18068638,불가리아,2004-08
2004-08-31,17117628,5914709,11202919,루마니아,2004-08
2004-08-31,15597231,111539437,-95942206,오만,2004-08
2004-08-31,15077191,4299630,10777561,스리랑카,2004-08
2004-08-31,13823215,628388,13194827,온두라스,2004-08
2004-08-31,13271928,2421,13269507,괌,2004-08
2004-08-31,12994101,5264724,7729377,기타국,2004-08
2004-08-31,12239922,27556228,-15316306,페루,2004-08
2004-08-31,12119729,52378308,-40258579,에쿠아도르,2004-08
2004-08-31,11910731,2549601,9361130,코스타리카,2004-08
2004-08-31,11846191,43237286,-31391095,노르웨이,2004-08
2004-08-31,10398733,1435685,8963048,모로코,2004-08
2004-08-31,9538360,923364,8614996,니카라과,2004-08
2004-08-31,8364745,178037456,-169672711,카타르,2004-08
2004-08-31,8322724,2303172,6019552,캄보디아,2004-08
2004-08-31,7982691,3781783,4200908,미얀마,2004-08
2004-08-31,7860581,424800,7435781,리비아,2004-08
2004-08-31,7677116,24437,7652679,북마리아나 군도,2004-08
2004-08-31,7386887,389923,6996964,레바논,2004-08
2004-08-31,7160993,3691090,3469903,수단,2004-08
2004-08-31,6814476,5937753,876723,푸에르토리코,2004-08
2004-08-31,6249240,555532,5693708,크로아티아,2004-08
2004-08-31,6141018,69772877,-63631859,이라크,2004-08
2004-08-31,6133892,819157,5314735,몽골,2004-08
2004-08-31,6041508,1098820,4942688,리투아니아,2004-08
2004-08-31,5907747,193928,5713819,키르기스스탄,2004-08
2004-08-31,5856811,7244541,-1387730,도미니카 공화국,2004-08
2004-08-31,5626927,4371993,1254934,몰타,2004-08
2004-08-31,5324696,612448,4712248,튀니지,2004-08
2004-08-31,5067146,146656,4920490,케냐,2004-08
2004-08-31,4651307,38077595,-33426288,바레인,2004-08
2004-08-31,4459253,10248,4449005,가나,2004-08
2004-08-31,4448532,757,4447775,아프카니스탄,2004-08
2004-08-31,4379113,10405888,-6026775,예맨,2004-08
2004-08-31,4270857,1179936,3090921,우루과이,2004-08
2004-08-31,3996127,265429,3730698,엘살바도르,2004-08
2004-08-31,3676266,787173,2889093,파라과이,2004-08
2004-08-31,3565406,0,3565406,앙골라,2004-08
2004-08-31,3310652,305443,3005209,라트비아,2004-08
2004-08-31,3233166,1528183,1704983,슬로베니아,2004-08
2004-08-31,3210735,4548,3206187,토고,2004-08
2004-08-31,2585524,61751583,-59166059,브루나이,2004-08
2004-08-31,2407672,1071705,1335967,코트디봐르,2004-08
2004-08-31,2346796,73804,2272992,벨라루스,2004-08
2004-08-31,2275998,40074,2235924,탄자니아,2004-08
2004-08-31,2182434,7473590,-5291156,뉴 칼레도니아,2004-08
2004-08-31,2167801,43408,2124393,피지,2004-08
2004-08-31,2123718,94325,2029393,트리니다드 토바고,2004-08
2004-08-31,2120310,684890,1435420,에스토니아,2004-08
2004-08-31,1987945,0,1987945,불령 리유니온 코모도 제도,2004-08
2004-08-31,1974726,47130,1927596,네팔,2004-08
2004-08-31,1895749,532480,1363269,마카오,2004-08
2004-08-31,1890541,169303,1721238,모리셔스,2004-08
2004-08-31,1542037,422324,1119713,아이슬란드,2004-08
2004-08-31,1493879,351500,1142379,짐바브웨,2004-08
2004-08-31,1452663,0,1452663,과델로프,2004-08
2004-08-31,1391052,140865,1250187,마다카스카르,2004-08
2004-08-31,1269425,36544,1232881,유고,2004-08
2004-08-31,1243396,0,1243396,마티니크,2004-08
2004-08-31,1219160,12171560,-10952400,잠비아,2004-08
2004-08-31,1199071,0,1199071,베닝,2004-08
2004-08-31,1161281,62805,1098476,콩고,2004-08
2004-08-31,1127935,194743,933192,지부티,2004-08
2004-08-31,1099122,32342,1066780,모잠비크,2004-08
2004-08-31,1059442,12702925,-11643483,스와질랜드,2004-08
2004-08-31,1036816,461,1036355,아이티,2004-08
2004-08-31,1035787,213654,822133,세네갈,2004-08
2004-08-31,1012357,62536,949821,자마이카,2004-08
2004-08-31,979794,5392,974402,도미니카,2004-08
2004-08-31,973551,149437,824114,라오스,2004-08
2004-08-31,894166,318542,575624,팔레스타인 해방기구(구),2004-08
2004-08-31,882108,0,882108,아루바,2004-08
2004-08-31,854952,32577,822375,아제르바이잔,2004-08
2004-08-31,799955,29536422,-28736467,카메룬,2004-08
2004-08-31,783194,24033,759161,에티오피아,2004-08
2004-08-31,777503,1120624,-343121,파푸아 뉴기니,2004-08
2004-08-31,704110,3573490,-2869380,룩셈부르그,2004-08
2004-08-31,613832,290641,323191,조지아,2004-08
2004-08-31,525184,0,525184,나미비아,2004-08
2004-08-31,515828,73523,442305,마이크로네시아,2004-08
2004-08-31,483215,672644,-189429,타지크,2004-08
2004-08-31,453024,0,453024,버뮤다,2004-08
2004-08-31,450902,170,450732,말리,2004-08
2004-08-31,411979,4,411975,레소토,2004-08
2004-08-31,402020,610567,-208547,볼리비아,2004-08
2004-08-31,397823,173621,224202,말라위,2004-08
2004-08-31,393120,2736,390384,알바니아,2004-08
2004-08-31,343054,0,343054,팔라우,2004-08
2004-08-31,331855,362409,-30554,벨리제,2004-08
2004-08-31,324902,0,324902,바베이도스,2004-08
2004-08-31,314123,54622,259501,불령 폴리네시아,2004-08
2004-08-31,304474,74,304400,수리남,2004-08
2004-08-31,286126,0,286126,사모아,2004-08
2004-08-31,265599,891359,-625760,우간다,2004-08
2004-08-31,247541,0,247541,니제르,2004-08
2004-08-31,233975,0,233975,모리타니,2004-08
2004-08-31,224689,0,224689,투르크멘,2004-08
2004-08-31,216009,21222,194787,안도라,2004-08
2004-08-31,214029,552089,-338060,기니,2004-08
2004-08-31,213363,2082570,-1869207,솔로몬 군도,2004-08
2004-08-31,209635,2034271,-1824636,가봉,2004-08
2004-08-31,205020,0,205020,감비아,2004-08
2004-08-31,186327,212131,-25804,리히텐슈타인,2004-08
2004-08-31,174831,0,174831,아메리칸 사모아,2004-08
2004-08-31,166270,147025,19245,보츠와나,2004-08
2004-08-31,162114,0,162114,몰도바,2004-08
2004-08-31,157399,8927,148472,아르메니아,2004-08
2004-08-31,152463,0,152463,세이쉘,2004-08
2004-08-31,140317,786,139531,불령 가이아나,2004-08
2004-08-31,131676,0,131676,시에라 리온,2004-08
2004-08-31,103218,0,103218,영령 캐이맨 군도,2004-08
2004-08-31,103217,0,103217,안티가 바부다,2004-08
2004-08-31,102315,0,102315,소말리아,2004-08
2004-08-31,97045,0,97045,네덜란드 열도,2004-08
2004-08-31,92463,0,92463,가이아나,2004-08
2004-08-31,89606,19619,69987,보스니아-헤르체고비나,2004-08
2004-08-31,85886,0,85886,지브랄타,2004-08
2004-08-31,84808,9146,75662,에리트리아,2004-08
2004-08-31,76853,21120,55733,바누아투,2004-08
2004-08-31,74066,0,74066,마세도니아,2004-08
2004-08-31,69692,23413,46279,통가,2004-08
2004-08-31,66840,3251,63589,몰디브,2004-08
2004-08-31,64959,0,64959,그레나다,2004-08
2004-08-31,64555,96126,-31571,부탄,2004-08
2004-08-31,50200,3572,46628,투르크 & 카이코스 군도,2004-08
2004-08-31,44935,0,44935,쿡 아일랜드,2004-08
2004-08-31,41420,0,41420,부룬디,2004-08
2004-08-31,38405,0,38405,르완다,2004-08
2004-08-31,33218,0,33218,세인트 루시아,2004-08
2004-08-31,31440,3536,27904,앙귈라,2004-08
2004-08-31,27835,0,27835,카보 베르데,2004-08
2004-08-31,16873,0,16873,산마리노,2004-08
2004-08-31,10604,1000784,-990180,모나코,2004-08
2004-08-31,9773,0,9773,키리바티,2004-08
2004-08-31,5200,0,5200,니우에,2004-08
2004-08-31,4522,0,4522,허드 앤 맥도날드 군도,2004-08
2004-08-31,4024,808,3216,미령 버진군도,2004-08
2004-08-31,4000,1200,2800,콩고민주공화국,2004-08
2004-08-31,2174,0,2174,코스 군도,2004-08
2004-08-31,250,0,250,티모르,2004-08
2004-08-31,0,671710,-671710,챠드,2004-08
2004-08-31,0,26804,-26804,토켈라우,2004-08
2004-08-31,0,11527,-11527,세인트 키츠 네비스,2004-08
2004-08-31,0,1420961,-1420961,부르키나 파소,2004-08
2004-08-31,0,15750,-15750,몬트세라트,2004-08
2004-08-31,0,4551,-4551,세인트 빈센트 그레나딘,2004-08
2004-08-31,0,29182,-29182,세인트 헬레나,2004-08
2004-08-31,0,77964,-77964,기네비소,2004-08
2004-08-31,0,53893,-53893,마이너 아우틀링 합중국 군도,2004-08
2004-08-31,0,466,-466,세르비아 와 몬테네그로,2004-08
2004-09-30,4167502231,2475898336,1691603895,중국,2004-09
2004-09-30,3616201442,2407137140,1209064302,미국,2004-09
2004-09-30,1728688553,3682864788,-1954176235,일본,2004-09
2004-09-30,1355963458,246915015,1109048443,홍콩,2004-09
2004-09-30,895495628,597942362,297553266,대만,2004-09
2004-09-30,720583691,657786193,62797498,독일,2004-09
2004-09-30,442573645,395889722,46683923,싱가포르,2004-09
2004-09-30,403736651,249578515,154158136,영국,2004-09
2004-09-30,387259362,394842111,-7582749,말레이시아,2004-09
2004-09-30,322401106,617834266,-295433160,호주,2004-09
2004-09-30,320109591,186449928,133659663,캐나다,2004-09
2004-09-30,315686171,51696493,263989678,베트남,2004-09
2004-09-30,313001760,112379761,200621999,인도,2004-09
2004-09-30,295671882,570985680,-275313798,인도네시아,2004-09
2004-09-30,289093646,168214494,120879152,필리핀,2004-09
2004-09-30,278641587,8602587,270039000,리비아,2004-09
2004-09-30,267696874,198541090,69155784,태국,2004-09
2004-09-30,251272735,126330395,124942340,네덜란드,2004-09
2004-09-30,242993023,27652740,215340283,멕시코,2004-09
2004-09-30,222396162,174681092,47715070,이란,2004-09
2004-09-30,214871284,498460373,-283589089,아랍에미리트 연합,2004-09
2004-09-30,211010187,191375453,19634734,이탈리아,2004-09
2004-09-30,206047698,372952405,-166904707,러시아 연방,2004-09
2004-09-30,196180421,179668606,16511815,프랑스,2004-09
2004-09-30,194275912,0,194275912,마샬군도,2004-09
2004-09-30,172259878,6937783,165322095,튀르키예,2004-09
2004-09-30,171195592,45073651,126121941,스페인,2004-09
2004-09-30,157835743,1121204559,-963368816,사우디아라비아,2004-09
2004-09-30,154612592,36359292,118253300,핀란드,2004-09
2004-09-30,151256013,214637959,-63381946,브라질,2004-09
2004-09-30,136569780,3338950,133230830,그리스,2004-09
2004-09-30,98845104,72616904,26228200,벨기에,2004-09
2004-09-30,97936369,8820,97927549,바하마,2004-09
2004-09-30,91806103,74840374,16965729,남아프리카공화국,2004-09
2004-09-30,69681582,31587778,38093804,이스라엘,2004-09
2004-09-30,69482159,50447528,19034631,스웨덴,2004-09
2004-09-30,68639857,15067679,53572178,헝가리,2004-09
2004-09-30,60173608,159963169,-99789561,칠레,2004-09
2004-09-30,59370363,16819,59353544,라이베리아,2004-09
2004-09-30,59205295,72461855,-13256560,뉴질랜드,2004-09
2004-09-30,56971319,33906468,23064851,오스트리아,2004-09
2004-09-30,54593373,5040144,49553229,폴란드,2004-09
2004-09-30,49350962,197153,49153809,과테말라,2004-09
2004-09-30,49110728,3408660,45702068,방글라데시,2004-09
2004-09-30,45739370,20462781,25276589,파키스탄,2004-09
2004-09-30,43418552,60346435,-16927883,우크라이나,2004-09
2004-09-30,41205915,1474223,39731692,요르단,2004-09
2004-09-30,39579539,1563856,38015683,슬로바키아,2004-09
2004-09-30,39283335,19044667,20238668,이집트,2004-09
2004-09-30,39141923,62452938,-23311015,아일랜드,2004-09
2004-09-30,38358398,19065451,19292947,나이지리아,2004-09
2004-09-30,36887167,28950453,7936714,노르웨이,2004-09
2004-09-30,36707096,6030519,30676577,콜롬비아,2004-09
2004-09-30,35642867,19369388,16273479,알제리,2004-09
2004-09-30,33906206,44118973,-10212767,덴마크,2004-09
2004-09-30,31459956,291682,31168274,시리아,2004-09
2004-09-30,31283411,3389410,27894001,몰타,2004-09
2004-09-30,28680373,8536884,20143489,체코공화국,2004-09
2004-09-30,26992891,72927255,-45934364,스위스,2004-09
2004-09-30,26878526,13708615,13169911,카자흐스탄,2004-09
2004-09-30,23198819,11380182,11818637,루마니아,2004-09
2004-09-30,23075664,302205553,-279129889,쿠웨이트,2004-09
2004-09-30,22921549,5689472,17232077,우즈베키스탄,2004-09
2004-09-30,22195634,4254134,17941500,스리랑카,2004-09
2004-09-30,22017423,13342621,8674802,베네주엘라,2004-09
2004-09-30,21928449,5041571,16886878,포루투갈,2004-09
2004-09-30,20663651,26754280,-6090629,아르헨티나,2004-09
2004-09-30,19320145,1323695,17996450,괌,2004-09
2004-09-30,18914766,27167219,-8252453,에쿠아도르,2004-09
2004-09-30,18755482,5139818,13615664,파나마,2004-09
2004-09-30,16966392,198319448,-181353056,오만,2004-09
2004-09-30,15752320,2365550,13386770,불가리아,2004-09
2004-09-30,15313658,4385379,10928279,기타국,2004-09
2004-09-30,14052213,2055989,11996224,모로코,2004-09
2004-09-30,12853124,6330679,6522445,푸에르토리코,2004-09
2004-09-30,12622918,238727,12384191,온두라스,2004-09
2004-09-30,12197594,10900795,1296799,페루,2004-09
2004-09-30,11319417,2452314,8867103,코스타리카,2004-09
2004-09-30,11285249,2464882,8820367,미얀마,2004-09
2004-09-30,10508399,294895883,-284387484,카타르,2004-09
2004-09-30,10104223,284434,9819789,캄보디아,2004-09
2004-09-30,9292394,965522,8326872,니카라과,2004-09
2004-09-30,8191457,73481,8117976,수단,2004-09
2004-09-30,8148314,409824,7738490,가나,2004-09
2004-09-30,7488130,21914,7466216,북마리아나 군도,2004-09
2004-09-30,7056974,620040,6436934,도미니카 공화국,2004-09
2004-09-30,7041924,71965201,-64923277,이라크,2004-09
2004-09-30,6387701,290365,6097336,레바논,2004-09
2004-09-30,6236036,637632,5598404,몽골,2004-09
2004-09-30,6010598,130,6010468,아프카니스탄,2004-09
2004-09-30,5892898,7861374,-1968476,바레인,2004-09
2004-09-30,5731365,732810,4998555,리투아니아,2004-09
2004-09-30,5618134,342044,5276090,튀니지,2004-09
2004-09-30,5583483,749163,4834320,크로아티아,2004-09
2004-09-30,5439731,35551498,-30111767,카메룬,2004-09
2004-09-30,5390560,2604173,2786387,우루과이,2004-09
2004-09-30,5363399,70667,5292732,엘살바도르,2004-09
2004-09-30,4372306,46165966,-41793660,예맨,2004-09
2004-09-30,4156275,1284620,2871655,파라과이,2004-09
2004-09-30,4120461,292057,3828404,키르기스스탄,2004-09
2004-09-30,4103185,957933,3145252,슬로베니아,2004-09
2004-09-30,3982050,135685,3846365,케냐,2004-09
2004-09-30,3434899,9922318,-6487419,에스토니아,2004-09
2004-09-30,3268487,82120738,-78852251,브루나이,2004-09
2004-09-30,2992924,252637,2740287,라트비아,2004-09
2004-09-30,2844570,124247,2720323,탄자니아,2004-09
2004-09-30,2683211,0,2683211,토고,2004-09
2004-09-30,2580872,166995,2413877,앙골라,2004-09
2004-09-30,2498833,1594,2497239,과델로프,2004-09
2004-09-30,2492942,0,2492942,불령 리유니온 코모도 제도,2004-09
2004-09-30,2361725,0,2361725,아제르바이잔,2004-09
2004-09-30,2340504,0,2340504,마티니크,2004-09
2004-09-30,2202919,51895,2151024,피지,2004-09
2004-09-30,2188843,557244,1631599,마카오,2004-09
2004-09-30,2187884,52363,2135521,트리니다드 토바고,2004-09
2004-09-30,2153753,0,2153753,유고,2004-09
2004-09-30,2124509,1850873,273636,아이슬란드,2004-09
2004-09-30,2077162,45617,2031545,네팔,2004-09
2004-09-30,1944452,8288875,-6344423,뉴 칼레도니아,2004-09
2004-09-30,1864760,62351,1802409,벨라루스,2004-09
2004-09-30,1774636,10643310,-8868674,스와질랜드,2004-09
2004-09-30,1757601,0,1757601,지부티,2004-09
2004-09-30,1720652,7247392,-5526740,사이프러스,2004-09
2004-09-30,1628365,189366,1438999,코트디봐르,2004-09
2004-09-30,1576332,74258,1502074,모리셔스,2004-09
2004-09-30,1402229,112258,1289971,에티오피아,2004-09
2004-09-30,1378419,240,1378179,도미니카,2004-09
2004-09-30,1353412,9670,1343742,네덜란드 열도,2004-09
2004-09-30,1325161,10631949,-9306788,잠비아,2004-09
2004-09-30,1237400,0,1237400,베닝,2004-09
2004-09-30,1229530,372,1229158,자마이카,2004-09
2004-09-30,1121337,0,1121337,레소토,2004-09
2004-09-30,1075879,0,1075879,가이아나,2004-09
2004-09-30,1058427,47941,1010486,콩고,2004-09
2004-09-30,1055982,0,1055982,불령 폴리네시아,2004-09
2004-09-30,967806,329112,638694,아이티,2004-09
2004-09-30,962309,528121,434188,마다카스카르,2004-09
2004-09-30,953731,188210,765521,라오스,2004-09
2004-09-30,943056,2131884,-1188828,파푸아 뉴기니,2004-09
2004-09-30,878888,6541,872347,영령 캐이맨 군도,2004-09
2004-09-30,867241,76543,790698,보츠와나,2004-09
2004-09-30,850598,831,849767,알바니아,2004-09
2004-09-30,833010,276527,556483,세네갈,2004-09
2004-09-30,826894,82114,744780,조지아,2004-09
2004-09-30,769371,0,769371,모잠비크,2004-09
2004-09-30,711972,0,711972,사모아,2004-09
2004-09-30,564207,144255,419952,팔레스타인 해방기구(구),2004-09
2004-09-30,559600,0,559600,에리트리아,2004-09
2004-09-30,554047,64465,489582,말라위,2004-09
2004-09-30,525843,0,525843,마이크로네시아,2004-09
2004-09-30,498695,49146,449549,아루바,2004-09
2004-09-30,488002,1970285,-1482283,짐바브웨,2004-09
2004-09-30,482986,5844111,-5361125,볼리비아,2004-09
2004-09-30,460518,116162,344356,가봉,2004-09
2004-09-30,459671,236154,223517,타지크,2004-09
2004-09-30,457243,0,457243,바베이도스,2004-09
2004-09-30,451923,6323579,-5871656,룩셈부르그,2004-09
2004-09-30,413828,0,413828,수리남,2004-09
2004-09-30,391216,0,391216,세이쉘,2004-09
2004-09-30,337605,14791506,-14453901,기니,2004-09
2004-09-30,333630,525318,-191688,벨리제,2004-09
2004-09-30,301673,0,301673,그레나다,2004-09
2004-09-30,289753,0,289753,세인트 루시아,2004-09
2004-09-30,242572,0,242572,지브랄타,2004-09
2004-09-30,239053,106206,132847,우간다,2004-09
2004-09-30,227864,40838,187026,팔라우,2004-09
2004-09-30,219115,0,219115,부탄,2004-09
2004-09-30,215736,0,215736,마세도니아,2004-09
2004-09-30,199622,0,199622,말리,2004-09
2004-09-30,178820,99218,79602,몰도바,2004-09
2004-09-30,175587,384,175203,모리타니,2004-09
2004-09-30,172010,35965,136045,아메리칸 사모아,2004-09
2004-09-30,157591,0,157591,감비아,2004-09
2004-09-30,147331,0,147331,불령 가이아나,2004-09
2004-09-30,139253,0,139253,버뮤다,2004-09
2004-09-30,138913,2264,136649,바누아투,2004-09
2004-09-30,137256,101175,36081,리히텐슈타인,2004-09
2004-09-30,136992,351,136641,보스니아-헤르체고비나,2004-09
2004-09-30,129854,481623,-351769,부르키나 파소,2004-09
2004-09-30,128138,2784,125354,몰디브,2004-09
2004-09-30,118159,0,118159,시에라 리온,2004-09
2004-09-30,112427,0,112427,안티가 바부다,2004-09
2004-09-30,105541,0,105541,콩고민주공화국,2004-09
2004-09-30,100650,0,100650,티모르,2004-09
2004-09-30,84807,0,84807,소말리아,2004-09
2004-09-30,65130,0,65130,부룬디,2004-09
2004-09-30,64833,198723,-133890,기네비소,2004-09
2004-09-30,53852,0,53852,르완다,2004-09
2004-09-30,51998,0,51998,니제르,2004-09
2004-09-30,50978,0,50978,아르메니아,2004-09
2004-09-30,46056,231380,-185324,안도라,2004-09
2004-09-30,43606,807,42799,상토메 프린스페,2004-09
2004-09-30,43601,68600,-24999,투르크멘,2004-09
2004-09-30,42511,1825306,-1782795,솔로몬 군도,2004-09
2004-09-30,30755,22680,8075,통가,2004-09
2004-09-30,23700,0,23700,산마리노,2004-09
2004-09-30,20778,115,20663,나미비아,2004-09
2004-09-30,9158,777601,-768443,모나코,2004-09
2004-09-30,7604,0,7604,미령 버진군도,2004-09
2004-09-30,1958,0,1958,몬트세라트,2004-09
2004-09-30,1900,0,1900,세인트 키츠 네비스,2004-09
2004-09-30,1375,0,1375,마이너 아우틀링 합중국 군도,2004-09
2004-09-30,809,0,809,코모로스,2004-09
2004-09-30,254,0,254,불령 남부지역,2004-09
2004-09-30,92,399709,-399617,챠드,2004-09
2004-09-30,0,8171,-8171,쿡 아일랜드,2004-09
2004-09-30,0,84476,-84476,그린랜드,2004-09
2004-09-30,0,8357,-8357,세인트 빈센트 그레나딘,2004-09
2004-09-30,0,2,-2,코스 군도,2004-09
2004-09-30,0,457774,-457774,나우루,2004-09
2004-10-31,4554437724,2878408475,1676029249,중국,2004-10
2004-10-31,4037437608,2712968990,1324468618,미국,2004-10
2004-10-31,1889739717,4034921083,-2145181366,일본,2004-10
2004-10-31,1243990637,181116680,1062873957,홍콩,2004-10
2004-10-31,883146264,687837879,195308385,대만,2004-10
2004-10-31,857214539,737435669,119778870,독일,2004-10
2004-10-31,573686076,400942598,172743478,싱가포르,2004-10
2004-10-31,500669375,228077585,272591790,영국,2004-10
2004-10-31,358957352,539612886,-180655534,말레이시아,2004-10
2004-10-31,354104633,136092900,218011733,인도,2004-10
2004-10-31,346900023,203906973,142993050,캐나다,2004-10
2004-10-31,326297314,598568507,-272271193,인도네시아,2004-10
2004-10-31,322247840,59990634,262257206,베트남,2004-10
2004-10-31,301945969,636976165,-335030196,호주,2004-10
2004-10-31,293948942,180065780,113883162,필리핀,2004-10
2004-10-31,289744473,32028478,257715995,멕시코,2004-10
2004-10-31,283769285,209272966,74496319,태국,2004-10
2004-10-31,277876390,199659434,78216956,이탈리아,2004-10
2004-10-31,274544158,181931093,92613065,네덜란드,2004-10
2004-10-31,266511525,36920480,229591045,스페인,2004-10
2004-10-31,248928719,316891499,-67962780,러시아 연방,2004-10
2004-10-31,224527128,291716789,-67189661,이란,2004-10
2004-10-31,223607962,950462087,-726854125,아랍에미리트 연합,2004-10
2004-10-31,201936138,196952638,4983500,프랑스,2004-10
2004-10-31,186105296,8025795,178079501,튀르키예,2004-10
2004-10-31,164981693,361,164981332,버뮤다,2004-10
2004-10-31,159784533,32845611,126938922,핀란드,2004-10
2004-10-31,157342218,211895414,-54553196,브라질,2004-10
2004-10-31,149867871,934356,148933515,라이베리아,2004-10
2004-10-31,132029472,55865,131973607,사이프러스,2004-10
2004-10-31,131225778,1051723282,-920497504,사우디아라비아,2004-10
2004-10-31,113374504,85226626,28147878,남아프리카공화국,2004-10
2004-10-31,106334844,85425782,20909062,벨기에,2004-10
2004-10-31,101878203,0,101878203,바하마,2004-10
2004-10-31,89611746,90936990,-1325244,뉴질랜드,2004-10
2004-10-31,89595702,6406891,83188811,폴란드,2004-10
2004-10-31,82290117,11237678,71052439,헝가리,2004-10
2004-10-31,80894316,64309036,16585280,스웨덴,2004-10
2004-10-31,71168327,79271467,-8103140,아일랜드,2004-10
2004-10-31,69149635,44772,69104863,마샬군도,2004-10
2004-10-31,68452830,34667559,33785271,파나마,2004-10
2004-10-31,64936201,184358226,-119422025,칠레,2004-10
2004-10-31,60037147,39583378,20453769,오스트리아,2004-10
2004-10-31,53255533,40247396,13008137,이스라엘,2004-10
2004-10-31,53100744,55702797,-2602053,우크라이나,2004-10
2004-10-31,52584071,4850186,47733885,방글라데시,2004-10
2004-10-31,52351196,23220503,29130693,페루,2004-10
2004-10-31,51406629,24478062,26928567,파키스탄,2004-10
2004-10-31,51097689,2067842,49029847,그리스,2004-10
2004-10-31,50251877,13135355,37116522,콜롬비아,2004-10
2004-10-31,48961296,2755218,46206078,슬로바키아,2004-10
2004-10-31,45939263,1535920,44403343,이집트,2004-10
2004-10-31,44804214,269596,44534618,과테말라,2004-10
2004-10-31,44410523,99876079,-55465556,스위스,2004-10
2004-10-31,42101460,2463286,39638174,요르단,2004-10
2004-10-31,41281849,351412,40930437,시리아,2004-10
2004-10-31,40423943,14919963,25503980,카자흐스탄,2004-10
2004-10-31,37467984,41845487,-4377503,나이지리아,2004-10
2004-10-31,35186727,40801728,-5615001,덴마크,2004-10
2004-10-31,34869263,28328753,6540510,에쿠아도르,2004-10
2004-10-31,30942561,6047569,24894992,우즈베키스탄,2004-10
2004-10-31,30603627,1543160,29060467,베네주엘라,2004-10
2004-10-31,30108483,331583295,-301474812,쿠웨이트,2004-10
2004-10-31,28306601,11416839,16889762,체코공화국,2004-10
2004-10-31,28129766,38183103,-10053337,알제리,2004-10
2004-10-31,27646133,0,27646133,영령 캐이맨 군도,2004-10
2004-10-31,25002769,13003219,11999550,루마니아,2004-10
2004-10-31,23390324,5273723,18116601,포루투갈,2004-10
2004-10-31,22917251,26638294,-3721043,아르헨티나,2004-10
2004-10-31,22632669,3557104,19075565,스리랑카,2004-10
2004-10-31,22452196,7846861,14605335,기타국,2004-10
2004-10-31,17085032,224782661,-207697629,오만,2004-10
2004-10-31,16836587,9396155,7440432,푸에르토리코,2004-10
2004-10-31,16332120,261050004,-244717884,카타르,2004-10
2004-10-31,14500420,54172131,-39671711,노르웨이,2004-10
2004-10-31,13331383,2982491,10348892,모로코,2004-10
2004-10-31,13032072,78381,12953691,온두라스,2004-10
2004-10-31,12453306,1312277,11141029,불가리아,2004-10
2004-10-31,11226133,3250979,7975154,미얀마,2004-10
2004-10-31,10168382,2601133,7567249,코스타리카,2004-10
2004-10-31,9986481,115191,9871290,캄보디아,2004-10
2004-10-31,9719854,322234,9397620,리투아니아,2004-10
2004-10-31,9697789,63136,9634653,북마리아나 군도,2004-10
2004-10-31,9270744,3565379,5705365,수단,2004-10
2004-10-31,9077806,347714,8730092,니카라과,2004-10
2004-10-31,9012330,11479963,-2467633,바레인,2004-10
2004-10-31,8725479,630309,8095170,레바논,2004-10
2004-10-31,7771570,583406,7188164,리비아,2004-10
2004-10-31,7058277,0,7058277,아프카니스탄,2004-10
2004-10-31,6815525,88877,6726648,크로아티아,2004-10
2004-10-31,6744436,563731,6180705,엘살바도르,2004-10
2004-10-31,6710588,753034,5957554,가나,2004-10
2004-10-31,6579288,1157308,5421980,슬로베니아,2004-10
2004-10-31,6531637,487641,6043996,몽골,2004-10
2004-10-31,6498987,125858062,-119359075,이라크,2004-10
2004-10-31,6274619,14936161,-8661542,도미니카 공화국,2004-10
2004-10-31,6206059,26539728,-20333669,예맨,2004-10
2004-10-31,6073326,477517,5595809,케냐,2004-10
2004-10-31,5606376,237856,5368520,키르기스스탄,2004-10
2004-10-31,4374504,247028,4127476,라트비아,2004-10
2004-10-31,4224723,829580,3395143,파라과이,2004-10
2004-10-31,4102018,59252446,-55150428,브루나이,2004-10
2004-10-31,3940440,4890640,-950200,몰타,2004-10
2004-10-31,3901218,175122,3726096,앙골라,2004-10
2004-10-31,3854512,950852,2903660,우루과이,2004-10
2004-10-31,3737666,841502,2896164,마카오,2004-10
2004-10-31,3634277,405151,3229126,튀니지,2004-10
2004-10-31,3466068,0,3466068,토고,2004-10
2004-10-31,3432513,652549,2779964,에스토니아,2004-10
2004-10-31,3082340,60813,3021527,탄자니아,2004-10
2004-10-31,3012893,2687499,325394,파푸아 뉴기니,2004-10
2004-10-31,2883349,10739967,-7856618,아이슬란드,2004-10
2004-10-31,2652888,108066,2544822,괌,2004-10
2004-10-31,2648535,50665,2597870,피지,2004-10
2004-10-31,2449645,208,2449437,트리니다드 토바고,2004-10
2004-10-31,2308231,31185,2277046,에티오피아,2004-10
2004-10-31,2288230,0,2288230,불령 리유니온 코모도 제도,2004-10
2004-10-31,2234764,26467,2208297,벨라루스,2004-10
2004-10-31,2147923,275875,1872048,코트디봐르,2004-10
2004-10-31,2103525,26005,2077520,모리셔스,2004-10
2004-10-31,2000897,0,2000897,마티니크,2004-10
2004-10-31,1920503,151247,1769256,네팔,2004-10
2004-10-31,1768147,7557613,-5789466,뉴 칼레도니아,2004-10
2004-10-31,1561573,6406,1555167,아이티,2004-10
2004-10-31,1389637,2900469,-1510832,스와질랜드,2004-10
2004-10-31,1277300,6907,1270393,아제르바이잔,2004-10
2004-10-31,1197633,210816,986817,유고,2004-10
2004-10-31,1127804,0,1127804,베닝,2004-10
2004-10-31,1034642,6452,1028190,자마이카,2004-10
2004-10-31,1022460,40000,982460,불령 폴리네시아,2004-10
2004-10-31,987656,65309,922347,라오스,2004-10
2004-10-31,984269,268489,715780,세네갈,2004-10
2004-10-31,982239,12380,969859,콩고,2004-10
2004-10-31,972820,0,972820,아루바,2004-10
2004-10-31,969103,55212,913891,마다카스카르,2004-10
2004-10-31,895638,398259,497379,우간다,2004-10
2004-10-31,838706,0,838706,과델로프,2004-10
2004-10-31,812596,0,812596,니제르,2004-10
2004-10-31,810764,0,810764,레소토,2004-10
2004-10-31,774254,37823,736431,알바니아,2004-10
2004-10-31,730060,35978736,-35248676,카메룬,2004-10
2004-10-31,689167,0,689167,바베이도스,2004-10
2004-10-31,682911,36301,646610,보스니아-헤르체고비나,2004-10
2004-10-31,677193,130210,546983,말라위,2004-10
2004-10-31,668300,64198,604102,보츠와나,2004-10
2004-10-31,656670,10292714,-9636044,잠비아,2004-10
2004-10-31,649474,25020,624454,조지아,2004-10
2004-10-31,633312,4037522,-3404210,짐바브웨,2004-10
2004-10-31,615285,0,615285,모잠비크,2004-10
2004-10-31,604283,5828,598455,도미니카,2004-10
2004-10-31,574144,4842889,-4268745,룩셈부르그,2004-10
2004-10-31,568618,190181,378437,타지크,2004-10
2004-10-31,549378,0,549378,사모아,2004-10
2004-10-31,513013,0,513013,영령 버진군도,2004-10
2004-10-31,482154,37101,445053,네덜란드 열도,2004-10
2004-10-31,438157,68600,369557,투르크멘,2004-10
2004-10-31,431034,137661,293373,볼리비아,2004-10
2004-10-31,390856,45061,345795,마이크로네시아,2004-10
2004-10-31,358966,0,358966,안티가 바부다,2004-10
2004-10-31,321506,277767,43739,리히텐슈타인,2004-10
2004-10-31,321450,1122446,-800996,가봉,2004-10
2004-10-31,301987,57316,244671,팔레스타인 해방기구(구),2004-10
2004-10-31,300063,0,300063,세이쉘,2004-10
2004-10-31,298053,860378,-562325,기니,2004-10
2004-10-31,297778,0,297778,지부티,2004-10
2004-10-31,295666,0,295666,수리남,2004-10
2004-10-31,280831,188899,91932,부탄,2004-10
2004-10-31,275027,1551,273476,바누아투,2004-10
2004-10-31,255204,0,255204,팔라우,2004-10
2004-10-31,250435,0,250435,불령 가이아나,2004-10
2004-10-31,245394,615922,-370528,벨리제,2004-10
2004-10-31,238199,73454,164745,몰도바,2004-10
2004-10-31,196263,24350,171913,콩고민주공화국,2004-10
2004-10-31,189937,0,189937,아메리칸 사모아,2004-10
2004-10-31,180087,2390,177697,가이아나,2004-10
2004-10-31,162241,0,162241,말리,2004-10
2004-10-31,154583,0,154583,지브랄타,2004-10
2004-10-31,153383,2192,151191,몰디브,2004-10
2004-10-31,146485,8138,138347,마세도니아,2004-10
2004-10-31,130909,0,130909,세인트 루시아,2004-10
2004-10-31,127210,0,127210,소말리아,2004-10
2004-10-31,123240,7797,115443,아르메니아,2004-10
2004-10-31,122248,42500,79748,모리타니,2004-10
2004-10-31,99330,2510,96820,그레나다,2004-10
2004-10-31,85317,2469275,-2383958,솔로몬 군도,2004-10
2004-10-31,80346,0,80346,부룬디,2004-10
2004-10-31,66764,136676,-69912,기네비소,2004-10
2004-10-31,65220,0,65220,쿡 아일랜드,2004-10
2004-10-31,62027,0,62027,감비아,2004-10
2004-10-31,60354,0,60354,키리바티,2004-10
2004-10-31,56737,794,55943,에리트리아,2004-10
2004-10-31,55754,8130,47624,적도 기니,2004-10
2004-10-31,54147,0,54147,교황청,2004-10
2004-10-31,53197,1526,51671,세인트 키츠 네비스,2004-10
2004-10-31,42165,0,42165,세인트 빈센트 그레나딘,2004-10
2004-10-31,35821,0,35821,시에라 리온,2004-10
2004-10-31,33244,717151,-683907,챠드,2004-10
2004-10-31,31381,48959,-17578,산마리노,2004-10
2004-10-31,30920,0,30920,투르크 & 카이코스 군도,2004-10
2004-10-31,28188,708978,-680790,모나코,2004-10
2004-10-31,26996,655549,-628553,부르키나 파소,2004-10
2004-10-31,24714,16575,8139,나미비아,2004-10
2004-10-31,13733,0,13733,중앙아프리카공화국,2004-10
2004-10-31,3483,36334360,-36330877,티모르,2004-10
2004-10-31,2184,0,2184,앙귈라,2004-10
2004-10-31,1221,58970,-57749,마이너 아우틀링 합중국 군도,2004-10
2004-10-31,930,0,930,불령 남부지역,2004-10
2004-10-31,606,0,606,르완다,2004-10
2004-10-31,243,3940724,-3940481,미령 버진군도,2004-10
2004-10-31,0,124,-124,통가,2004-10
2004-10-31,0,143736,-143736,세인트 헬레나,2004-10
2004-10-31,0,70,-70,코모로스,2004-10
2004-10-31,0,117970,-117970,토켈라우,2004-10
2004-10-31,0,120009,-120009,안도라,2004-10
2004-10-31,0,39100,-39100,그린랜드,2004-10
2004-10-31,0,7742,-7742,노폴크 아일랜드,2004-10
2004-10-31,0,0,0,몬트세라트,2004-10
2004-10-31,0,56960,-56960,세르비아 와 몬테네그로,2004-10
2004-11-30,4470634073,2949767850,1520866223,중국,2004-11
2004-11-30,3809459511,2313862905,1495596606,미국,2004-11
2004-11-30,2033609169,3874409208,-1840800039,일본,2004-11
2004-11-30,1255319871,188587381,1066732490,홍콩,2004-11
2004-11-30,889732054,755299428,134432626,독일,2004-11
2004-11-30,883713273,595059774,288653499,대만,2004-11
2004-11-30,501155200,390731818,110423382,싱가포르,2004-11
2004-11-30,480169193,209604151,270565042,이탈리아,2004-11
2004-11-30,437718215,237989928,199728287,영국,2004-11
2004-11-30,400951948,124082266,276869682,인도,2004-11
2004-11-30,396705035,153745931,242959104,캐나다,2004-11
2004-11-30,353390149,452285201,-98895052,말레이시아,2004-11
2004-11-30,327103186,645599155,-318495969,인도네시아,2004-11
2004-11-30,320442577,43960326,276482251,스페인,2004-11
2004-11-30,308761531,48859459,259902072,베트남,2004-11
2004-11-30,297634700,146029377,151605323,네덜란드,2004-11
2004-11-30,290347274,209223339,81123935,필리핀,2004-11
2004-11-30,267533117,725454617,-457921500,호주,2004-11
2004-11-30,264307697,33275033,231032664,멕시코,2004-11
2004-11-30,252651916,218077368,34574548,태국,2004-11
2004-11-30,225751843,10342402,215409441,튀르키예,2004-11
2004-11-30,223818282,338759976,-114941694,러시아 연방,2004-11
2004-11-30,218347633,213621942,4725691,프랑스,2004-11
2004-11-30,203665139,806697916,-603032777,아랍에미리트 연합,2004-11
2004-11-30,188790568,218116380,-29325812,이란,2004-11
2004-11-30,187073849,35171025,151902824,핀란드,2004-11
2004-11-30,183373978,13230,183360748,바하마,2004-11
2004-11-30,180289380,1154421059,-974131679,사우디아라비아,2004-11
2004-11-30,171266892,6176832,165090060,그리스,2004-11
2004-11-30,170100220,19587369,150512851,파나마,2004-11
2004-11-30,169319817,291878404,-122558587,브라질,2004-11
2004-11-30,157320568,0,157320568,버뮤다,2004-11
2004-11-30,114098350,9722204,104376146,헝가리,2004-11
2004-11-30,112480159,44903,112435256,사이프러스,2004-11
2004-11-30,109330812,75533575,33797237,벨기에,2004-11
2004-11-30,101174302,0,101174302,라이베리아,2004-11
2004-11-30,98938145,68654284,30283861,스웨덴,2004-11
2004-11-30,85653154,109927069,-24273915,칠레,2004-11
2004-11-30,81755820,61528660,20227160,아일랜드,2004-11
2004-11-30,81069431,8877776,72191655,폴란드,2004-11
2004-11-30,81044624,43746296,37298328,오스트리아,2004-11
2004-11-30,77016415,81674058,-4657643,남아프리카공화국,2004-11
2004-11-30,65134792,80319912,-15185120,우크라이나,2004-11
2004-11-30,61836623,44734948,17101675,이스라엘,2004-11
2004-11-30,56004458,52469463,3534995,덴마크,2004-11
2004-11-30,55416188,82568935,-27152747,스위스,2004-11
2004-11-30,54939217,10422124,44517093,콜롬비아,2004-11
2004-11-30,50400944,27262015,23138929,에쿠아도르,2004-11
2004-11-30,47100140,79070701,-31970561,뉴질랜드,2004-11
2004-11-30,44244875,2434477,41810398,요르단,2004-11
2004-11-30,44191250,3786658,40404592,방글라데시,2004-11
2004-11-30,44154043,480827863,-436673820,카타르,2004-11
2004-11-30,44072545,885824,43186721,이집트,2004-11
2004-11-30,43786177,50881502,-7095325,노르웨이,2004-11
2004-11-30,41769260,128529160,-86759900,나이지리아,2004-11
2004-11-30,40963871,35884006,5079865,파키스탄,2004-11
2004-11-30,40677838,19099387,21578451,우즈베키스탄,2004-11
2004-11-30,38661187,16805303,21855884,몰타,2004-11
2004-11-30,38392208,2064076,36328132,슬로바키아,2004-11
2004-11-30,38145814,153922,37991892,과테말라,2004-11
2004-11-30,36313921,19042311,17271610,카자흐스탄,2004-11
2004-11-30,35810632,475641048,-439830416,쿠웨이트,2004-11
2004-11-30,34805787,10503784,24302003,체코공화국,2004-11
2004-11-30,32785584,3734149,29051435,페루,2004-11
2004-11-30,32286373,3120668,29165705,포루투갈,2004-11
2004-11-30,32238911,250549,31988362,시리아,2004-11
2004-11-30,28368678,9885525,18483153,푸에르토리코,2004-11
2004-11-30,27109854,2426754,24683100,베네주엘라,2004-11
2004-11-30,26450275,0,26450275,세인트 빈센트 그레나딘,2004-11
2004-11-30,26250213,127977997,-101727784,알제리,2004-11
2004-11-30,24269078,38241702,-13972624,아르헨티나,2004-11
2004-11-30,24064458,5480579,18583879,루마니아,2004-11
2004-11-30,21939168,146592,21792576,리비아,2004-11
2004-11-30,18681703,2701184,15980519,모로코,2004-11
2004-11-30,17990844,1568318,16422526,불가리아,2004-11
2004-11-30,17887203,7602509,10284694,기타국,2004-11
2004-11-30,17204429,3661424,13543005,스리랑카,2004-11
2004-11-30,15138262,238115465,-222977203,오만,2004-11
2004-11-30,13890516,207676,13682840,캄보디아,2004-11
2004-11-30,12964810,99864,12864946,온두라스,2004-11
2004-11-30,11578949,822922,10756027,코스타리카,2004-11
2004-11-30,11055911,2797909,8258002,미얀마,2004-11
2004-11-30,11035770,0,11035770,모잠비크,2004-11
2004-11-30,10086239,222803,9863436,니카라과,2004-11
2004-11-30,9691089,128408,9562681,크로아티아,2004-11
2004-11-30,9218392,1154192,8064200,가나,2004-11
2004-11-30,9088965,37252610,-28163645,바레인,2004-11
2004-11-30,8801394,813,8800581,수단,2004-11
2004-11-30,7703361,6983073,720288,도미니카 공화국,2004-11
2004-11-30,6871614,1327118,5544496,레바논,2004-11
2004-11-30,6613143,543017,6070126,리투아니아,2004-11
2004-11-30,6606807,73738797,-67131990,이라크,2004-11
2004-11-30,6523512,375092,6148420,엘살바도르,2004-11
2004-11-30,6486331,122741,6363590,케냐,2004-11
2004-11-30,6356739,13897660,-7540921,예맨,2004-11
2004-11-30,6140568,1419721,4720847,슬로베니아,2004-11
2004-11-30,6059780,84244,5975536,북마리아나 군도,2004-11
2004-11-30,5366991,502480,4864511,몽골,2004-11
2004-11-30,5309530,372,5309158,아프카니스탄,2004-11
2004-11-30,4553449,34874,4518575,앙골라,2004-11
2004-11-30,4332669,590777,3741892,라트비아,2004-11
2004-11-30,3965020,343339,3621681,파라과이,2004-11
2004-11-30,3817095,8164576,-4347481,뉴 칼레도니아,2004-11
2004-11-30,3755327,636272,3119055,튀니지,2004-11
2004-11-30,3725472,1254115,2471357,우루과이,2004-11
2004-11-30,3606437,108,3606329,불령 리유니온 코모도 제도,2004-11
2004-11-30,3526494,443444,3083050,아이슬란드,2004-11
2004-11-30,3458099,91892,3366207,괌,2004-11
2004-11-30,3445652,275134,3170518,키르기스스탄,2004-11
2004-11-30,3239039,0,3239039,과델로프,2004-11
2004-11-30,3200497,88258274,-85057777,브루나이,2004-11
2004-11-30,3191886,360110,2831776,마카오,2004-11
2004-11-30,2957234,281,2956953,트리니다드 토바고,2004-11
2004-11-30,2956166,13764442,-10808276,에스토니아,2004-11
2004-11-30,2947813,77210,2870603,탄자니아,2004-11
2004-11-30,2739549,58026,2681523,에티오피아,2004-11
2004-11-30,2725483,56186,2669297,네팔,2004-11
2004-11-30,2499383,0,2499383,토고,2004-11
2004-11-30,2476653,0,2476653,도미니카,2004-11
2004-11-30,2341113,6283007,-3941894,룩셈부르그,2004-11
2004-11-30,2173787,0,2173787,마티니크,2004-11
2004-11-30,2142740,18128,2124612,모리셔스,2004-11
2004-11-30,1883796,15632,1868164,아제르바이잔,2004-11
2004-11-30,1815642,5096382,-3280740,스와질랜드,2004-11
2004-11-30,1785216,5011,1780205,자마이카,2004-11
2004-11-30,1770312,167028,1603284,세네갈,2004-11
2004-11-30,1707082,24352,1682730,마다카스카르,2004-11
2004-11-30,1590458,0,1590458,아루바,2004-11
2004-11-30,1495759,36909581,-35413822,카메룬,2004-11
2004-11-30,1442553,3679,1438874,불령 폴리네시아,2004-11
2004-11-30,1410166,2490737,-1080571,파푸아 뉴기니,2004-11
2004-11-30,1391252,0,1391252,유고,2004-11
2004-11-30,1281362,17821786,-16540424,잠비아,2004-11
2004-11-30,1264870,40192,1224678,콩고,2004-11
2004-11-30,1195488,151616,1043872,벨라루스,2004-11
2004-11-30,1067987,0,1067987,아이티,2004-11
2004-11-30,1061426,0,1061426,베닝,2004-11
2004-11-30,966704,29966847,-29000143,기니,2004-11
2004-11-30,946271,0,946271,바베이도스,2004-11
2004-11-30,883643,11201,872442,알바니아,2004-11
2004-11-30,857754,82883,774871,피지,2004-11
2004-11-30,836620,0,836620,레소토,2004-11
2004-11-30,835651,0,835651,보스니아-헤르체고비나,2004-11
2004-11-30,819943,184863,635080,코트디봐르,2004-11
2004-11-30,709385,0,709385,마이크로네시아,2004-11
2004-11-30,694304,196641,497663,말라위,2004-11
2004-11-30,670644,0,670644,사모아,2004-11
2004-11-30,663634,0,663634,지부티,2004-11
2004-11-30,619800,0,619800,영령 캐이맨 군도,2004-11
2004-11-30,616327,2729,613598,나미비아,2004-11
2004-11-30,612287,0,612287,네덜란드 열도,2004-11
2004-11-30,593522,0,593522,불령 가이아나,2004-11
2004-11-30,555472,427834,127638,벨리제,2004-11
2004-11-30,544615,252550,292065,라오스,2004-11
2004-11-30,538866,0,538866,말리,2004-11
2004-11-30,508150,1695186,-1187036,짐바브웨,2004-11
2004-11-30,454864,786548,-331684,타지크,2004-11
2004-11-30,413642,273387,140255,우간다,2004-11
2004-11-30,383717,17318,366399,팔라우,2004-11
2004-11-30,363097,87802,275295,볼리비아,2004-11
2004-11-30,322056,0,322056,세이쉘,2004-11
2004-11-30,299304,63367,235937,몰도바,2004-11
2004-11-30,290138,1646977,-1356839,조지아,2004-11
2004-11-30,284085,0,284085,콩고민주공화국,2004-11
2004-11-30,281932,47199,234733,보츠와나,2004-11
2004-11-30,278909,0,278909,영령 버진군도,2004-11
2004-11-30,278446,0,278446,수리남,2004-11
2004-11-30,262075,0,262075,감비아,2004-11
2004-11-30,245368,1292012,-1046644,리히텐슈타인,2004-11
2004-11-30,241769,1987907,-1746138,가봉,2004-11
2004-11-30,199261,0,199261,안티가 바부다,2004-11
2004-11-30,166661,27486,139175,시에라 리온,2004-11
2004-11-30,158676,0,158676,바누아투,2004-11
2004-11-30,142624,0,142624,마세도니아,2004-11
2004-11-30,129253,0,129253,세인트 루시아,2004-11
2004-11-30,129056,0,129056,부탄,2004-11
2004-11-30,124871,8531,116340,아메리칸 사모아,2004-11
2004-11-30,110855,0,110855,파로에 군도,2004-11
2004-11-30,105423,2695,102728,부룬디,2004-11
2004-11-30,99523,0,99523,모리타니,2004-11
2004-11-30,91724,312585,-220861,팔레스타인 해방기구(구),2004-11
2004-11-30,90134,70747,19387,안도라,2004-11
2004-11-30,87122,0,87122,토켈라우,2004-11
2004-11-30,87005,0,87005,투르크멘,2004-11
2004-11-30,84723,0,84723,카보 베르데,2004-11
2004-11-30,83895,0,83895,소말리아,2004-11
2004-11-30,82775,0,82775,나우루,2004-11
2004-11-30,78194,969976,-891782,모나코,2004-11
2004-11-30,76174,0,76174,몰디브,2004-11
2004-11-30,71974,16964,55010,챠드,2004-11
2004-11-30,70852,0,70852,가이아나,2004-11
2004-11-30,65412,0,65412,지브랄타,2004-11
2004-11-30,57371,0,57371,니제르,2004-11
2004-11-30,51634,0,51634,그레나다,2004-11
2004-11-30,46881,29275,17606,르완다,2004-11
2004-11-30,44806,330,44476,아르메니아,2004-11
2004-11-30,42315,0,42315,티모르,2004-11
2004-11-30,38005,0,38005,마샬군도,2004-11
2004-11-30,30191,2646908,-2616717,솔로몬 군도,2004-11
2004-11-30,25911,243111,-217200,부르키나 파소,2004-11
2004-11-30,24098,0,24098,에리트리아,2004-11
2004-11-30,23631,0,23631,쿡 아일랜드,2004-11
2004-11-30,22607,0,22607,앙귈라,2004-11
2004-11-30,22126,0,22126,투발루,2004-11
2004-11-30,19874,0,19874,중앙아프리카공화국,2004-11
2004-11-30,19250,341936,-322686,세인트 헬레나,2004-11
2004-11-30,18368,0,18368,투르크 & 카이코스 군도,2004-11
2004-11-30,7459,0,7459,적도 기니,2004-11
2004-11-30,4992,2536,2456,몬트세라트,2004-11
2004-11-30,4336,4015489,-4011153,미령 버진군도,2004-11
2004-11-30,2243,0,2243,허드 앤 맥도날드 군도,2004-11
2004-11-30,0,1034,-1034,크리스마스 아일랜드,2004-11
2004-11-30,0,20486,-20486,마이너 아우틀링 합중국 군도,2004-11
2004-11-30,0,127631,-127631,그린랜드,2004-11
2004-11-30,0,3741,-3741,세인트 키츠 네비스,2004-11
2004-11-30,0,28973,-28973,통가,2004-11
2004-11-30,0,243713,-243713,기네비소,2004-11
2004-11-30,0,3911,-3911,영령 인도양,2004-11
2004-11-30,0,5544,-5544,키리바티,2004-11
2004-12-31,4442741000,2929933519,1512807481,중국,2004-12
2004-12-31,3806703574,2626725625,1179977949,미국,2004-12
2004-12-31,2032462605,4111912468,-2079449863,일본,2004-12
2004-12-31,1230056169,179372641,1050683528,홍콩,2004-12
2004-12-31,887220732,578337453,308883279,대만,2004-12
2004-12-31,795033523,828129752,-33096229,독일,2004-12
2004-12-31,527734746,223681,527511065,앙골라,2004-12
2004-12-31,524032650,254500023,269532627,영국,2004-12
2004-12-31,483649123,397846827,85802296,싱가포르,2004-12
2004-12-31,412642135,562625918,-149983783,말레이시아,2004-12
2004-12-31,370603062,627223408,-256620346,인도네시아,2004-12
2004-12-31,338156929,56247743,281909186,베트남,2004-12
2004-12-31,329881075,182989824,146891251,캐나다,2004-12
2004-12-31,327803388,192754505,135048883,인도,2004-12
2004-12-31,308685713,118282485,190403228,네덜란드,2004-12
2004-12-31,301985039,718936656,-416951617,호주,2004-12
2004-12-31,294795936,47101646,247694290,파나마,2004-12
2004-12-31,288709503,61629290,227080213,스페인,2004-12
2004-12-31,280375862,196288373,84087489,태국,2004-12
2004-12-31,278617786,229892394,48725392,이탈리아,2004-12
2004-12-31,259782548,181060093,78722455,필리핀,2004-12
2004-12-31,253255210,7987632,245267578,튀르키예,2004-12
2004-12-31,250244379,34140655,216103724,멕시코,2004-12
2004-12-31,232455962,1941488,230514474,몰타,2004-12
2004-12-31,226833462,233338979,-6505517,프랑스,2004-12
2004-12-31,216446307,767196550,-550750243,아랍에미리트 연합,2004-12
2004-12-31,209275519,328039999,-118764480,러시아 연방,2004-12
2004-12-31,202469184,197435101,5034083,이란,2004-12
2004-12-31,158351292,1211972721,-1053621429,사우디아라비아,2004-12
2004-12-31,156223749,87384662,68839087,벨기에,2004-12
2004-12-31,143002568,187233623,-44231055,브라질,2004-12
2004-12-31,137947073,41828673,96118400,핀란드,2004-12
2004-12-31,126304428,4504882,121799546,그리스,2004-12
2004-12-31,98225393,8512358,89713035,폴란드,2004-12
2004-12-31,85004817,107422069,-22417252,남아프리카공화국,2004-12
2004-12-31,81614712,84063399,-2448687,아일랜드,2004-12
2004-12-31,79183840,2352186,76831654,방글라데시,2004-12
2004-12-31,76967516,64743383,12224133,이스라엘,2004-12
2004-12-31,74855592,97737509,-22881917,스위스,2004-12
2004-12-31,73265952,171099761,-97833809,칠레,2004-12
2004-12-31,71026216,73119686,-2093470,스웨덴,2004-12
2004-12-31,62267544,64555633,-2288089,오스트리아,2004-12
2004-12-31,60519243,62141151,-1621908,우크라이나,2004-12
2004-12-31,60123543,63071478,-2947935,뉴질랜드,2004-12
2004-12-31,57848580,15977517,41871063,파키스탄,2004-12
2004-12-31,54966003,12276900,42689103,헝가리,2004-12
2004-12-31,53564734,231506,53333228,과테말라,2004-12
2004-12-31,53285493,91096182,-37810689,나이지리아,2004-12
2004-12-31,53060309,7061673,45998636,기타국,2004-12
2004-12-31,52605693,23838454,28767239,에쿠아도르,2004-12
2004-12-31,49562233,35246708,14315525,이집트,2004-12
2004-12-31,48621163,59340859,-10719696,덴마크,2004-12
2004-12-31,48392513,7112279,41280234,콜롬비아,2004-12
2004-12-31,48158305,4433733,43724572,우즈베키스탄,2004-12
2004-12-31,47243056,1816,47241240,라이베리아,2004-12
2004-12-31,43939610,438760874,-394821264,쿠웨이트,2004-12
2004-12-31,43613541,2096874,41516667,슬로바키아,2004-12
2004-12-31,42436569,19563660,22872909,알제리,2004-12
2004-12-31,39732082,2484813,37247269,루마니아,2004-12
2004-12-31,39343403,10919913,28423490,체코공화국,2004-12
2004-12-31,33266484,1584247,31682237,요르단,2004-12
2004-12-31,32494545,5157185,27337360,포루투갈,2004-12
2004-12-31,30610689,63727,30546962,시리아,2004-12
2004-12-31,30274744,302892,29971852,베네주엘라,2004-12
2004-12-31,29182559,9453,29173106,바하마,2004-12
2004-12-31,27871285,8279,27863006,마샬군도,2004-12
2004-12-31,27318768,0,27318768,영령 캐이맨 군도,2004-12
2004-12-31,26972409,23226133,3746276,카자흐스탄,2004-12
2004-12-31,26631356,0,26631356,영령 버진군도,2004-12
2004-12-31,26043522,425946783,-399903261,카타르,2004-12
2004-12-31,23924623,12194188,11730435,푸에르토리코,2004-12
2004-12-31,22081530,23988073,-1906543,페루,2004-12
2004-12-31,21398047,263886709,-242488662,오만,2004-12
2004-12-31,21352866,28082588,-6729722,아르헨티나,2004-12
2004-12-31,18806282,802999,18003283,괌,2004-12
2004-12-31,18517382,260533,18256849,캄보디아,2004-12
2004-12-31,17967036,48858229,-30891193,노르웨이,2004-12
2004-12-31,17718347,3921429,13796918,스리랑카,2004-12
2004-12-31,16962187,7313427,9648760,모로코,2004-12
2004-12-31,15970248,1814511,14155737,미얀마,2004-12
2004-12-31,13428154,29681,13398473,수단,2004-12
2004-12-31,12492745,81063,12411682,리비아,2004-12
2004-12-31,11349533,2437229,8912304,코스타리카,2004-12
2004-12-31,10971363,65025130,-54053767,이라크,2004-12
2004-12-31,10141814,1775598,8366216,불가리아,2004-12
2004-12-31,9834194,432890,9401304,니카라과,2004-12
2004-12-31,9605163,4637187,4967976,온두라스,2004-12
2004-12-31,9517100,71824462,-62307362,바레인,2004-12
2004-12-31,8335845,11058325,-2722480,도미니카 공화국,2004-12
2004-12-31,8129279,618686,7510593,레바논,2004-12
2004-12-31,8023545,1674832,6348713,슬로베니아,2004-12
2004-12-31,7659866,19730,7640136,북마리아나 군도,2004-12
2004-12-31,7232328,3224,7229104,예맨,2004-12
2004-12-31,6971703,94846,6876857,몽골,2004-12
2004-12-31,6474052,442941,6031111,가나,2004-12
2004-12-31,6341745,503567,5838178,리투아니아,2004-12
2004-12-31,6337656,103754,6233902,키르기스스탄,2004-12
2004-12-31,5966417,406,5966011,아프카니스탄,2004-12
2004-12-31,5855232,394262,5460970,엘살바도르,2004-12
2004-12-31,5428895,3072484,2356411,크로아티아,2004-12
2004-12-31,4920192,240819,4679373,파라과이,2004-12
2004-12-31,4879320,12735556,-7856236,에스토니아,2004-12
2004-12-31,4704429,604452,4099977,튀니지,2004-12
2004-12-31,4551965,362893,4189072,케냐,2004-12
2004-12-31,3699142,601894,3097248,라트비아,2004-12
2004-12-31,3359491,188962,3170529,사이프러스,2004-12
2004-12-31,3320051,269124,3050927,마카오,2004-12
2004-12-31,3218528,2886,3215642,아제르바이잔,2004-12
2004-12-31,3038482,2208450,830032,아이슬란드,2004-12
2004-12-31,2990588,63197106,-60206518,브루나이,2004-12
2004-12-31,2933083,45670,2887413,피지,2004-12
2004-12-31,2801400,0,2801400,불령 리유니온 코모도 제도,2004-12
2004-12-31,2337149,10559264,-8222115,뉴 칼레도니아,2004-12
2004-12-31,2299226,47114,2252112,네팔,2004-12
2004-12-31,2175805,30262,2145543,트리니다드 토바고,2004-12
2004-12-31,1967043,2029109,-62066,우루과이,2004-12
2004-12-31,1957187,64325,1892862,탄자니아,2004-12
2004-12-31,1930857,0,1930857,베닝,2004-12
2004-12-31,1905328,911,1904417,유고,2004-12
2004-12-31,1858072,127050,1731022,에티오피아,2004-12
2004-12-31,1854225,0,1854225,토고,2004-12
2004-12-31,1782299,223157,1559142,코트디봐르,2004-12
2004-12-31,1682481,28910,1653571,모리셔스,2004-12
2004-12-31,1659490,6699981,-5040491,룩셈부르그,2004-12
2004-12-31,1626697,0,1626697,마티니크,2004-12
2004-12-31,1560438,9080400,-7519962,파푸아 뉴기니,2004-12
2004-12-31,1544926,0,1544926,과델로프,2004-12
2004-12-31,1535791,27488,1508303,자마이카,2004-12
2004-12-31,1485976,641859,844117,세네갈,2004-12
2004-12-31,1454877,799469,655408,벨라루스,2004-12
2004-12-31,1392327,4493710,-3101383,스와질랜드,2004-12
2004-12-31,1364919,0,1364919,불령 폴리네시아,2004-12
2004-12-31,1344863,0,1344863,아루바,2004-12
2004-12-31,1315117,25990044,-24674927,기니,2004-12
2004-12-31,1260318,5847,1254471,마다카스카르,2004-12
2004-12-31,1143399,24794,1118605,라오스,2004-12
2004-12-31,1099522,0,1099522,바베이도스,2004-12
2004-12-31,1042107,2052838,-1010731,짐바브웨,2004-12
2004-12-31,1033223,45288,987935,알바니아,2004-12
2004-12-31,1025875,67755408,-66729533,카메룬,2004-12
2004-12-31,965484,0,965484,네덜란드 열도,2004-12
2004-12-31,850389,0,850389,팔라우,2004-12
2004-12-31,824586,98,824488,콩고,2004-12
2004-12-31,816150,166013,650137,타지크,2004-12
2004-12-31,787314,36664,750650,아이티,2004-12
2004-12-31,760692,120229,640463,볼리비아,2004-12
2004-12-31,733474,109422,624052,말라위,2004-12
2004-12-31,694233,0,694233,피트카이른,2004-12
2004-12-31,667836,219083,448753,우간다,2004-12
2004-12-31,630525,50287,580238,모잠비크,2004-12
2004-12-31,578829,19129257,-18550428,잠비아,2004-12
2004-12-31,573827,10365,563462,보스니아-헤르체고비나,2004-12
2004-12-31,535751,0,535751,세이쉘,2004-12
2004-12-31,519106,46061,473045,조지아,2004-12
2004-12-31,464071,52224,411847,가이아나,2004-12
2004-12-31,437877,0,437877,수리남,2004-12
2004-12-31,421783,0,421783,도미니카,2004-12
2004-12-31,406006,320438,85568,리히텐슈타인,2004-12
2004-12-31,404125,0,404125,버뮤다,2004-12
2004-12-31,377890,4120,373770,사모아,2004-12
2004-12-31,352044,2599,349445,마세도니아,2004-12
2004-12-31,334328,23808,310520,벨리제,2004-12
2004-12-31,311427,92011,219416,보츠와나,2004-12
2004-12-31,297454,253,297201,세인트 빈센트 그레나딘,2004-12
2004-12-31,295427,0,295427,아르메니아,2004-12
2004-12-31,290850,0,290850,시에라 리온,2004-12
2004-12-31,287558,0,287558,부탄,2004-12
2004-12-31,266360,504540,-238180,모나코,2004-12
2004-12-31,256078,0,256078,불령 가이아나,2004-12
2004-12-31,255483,3683,251800,바누아투,2004-12
2004-12-31,246720,0,246720,마이크로네시아,2004-12
2004-12-31,225152,274,224878,콩고민주공화국,2004-12
2004-12-31,209393,2372044,-2162651,솔로몬 군도,2004-12
2004-12-31,202681,1008,201673,투르크멘,2004-12
2004-12-31,187464,49746,137718,모리타니,2004-12
2004-12-31,184204,21314,162890,소말리아,2004-12
2004-12-31,177050,40336,136714,팔레스타인 해방기구(구),2004-12
2004-12-31,171251,0,171251,그레나다,2004-12
2004-12-31,157423,32274,125149,안티가 바부다,2004-12
2004-12-31,156216,0,156216,지부티,2004-12
2004-12-31,146558,86391,60167,몰도바,2004-12
2004-12-31,140300,0,140300,에리트리아,2004-12
2004-12-31,121636,0,121636,아메리칸 사모아,2004-12
2004-12-31,106335,2026416,-1920081,가봉,2004-12
2004-12-31,101161,0,101161,말리,2004-12
2004-12-31,99359,0,99359,감비아,2004-12
2004-12-31,91440,3908,87532,티모르,2004-12
2004-12-31,84221,84120,101,안도라,2004-12
2004-12-31,60890,0,60890,세인트 키츠 네비스,2004-12
2004-12-31,56864,21,56843,부룬디,2004-12
2004-12-31,56164,0,56164,레소토,2004-12
2004-12-31,53715,0,53715,몰디브,2004-12
2004-12-31,52835,9205,43630,르완다,2004-12
2004-12-31,50942,0,50942,세인트 루시아,2004-12
2004-12-31,41048,48,41000,키리바티,2004-12
2004-12-31,39629,96412,-56783,나미비아,2004-12
2004-12-31,30083,0,30083,투르크 & 카이코스 군도,2004-12
2004-12-31,29163,0,29163,챠드,2004-12
2004-12-31,23966,0,23966,몬트세라트,2004-12
2004-12-31,23815,1922,21893,지브랄타,2004-12
2004-12-31,15204,0,15204,산마리노,2004-12
2004-12-31,12356,985,11371,니제르,2004-12
2004-12-31,7741,625253,-617512,부르키나 파소,2004-12
2004-12-31,5363,0,5363,코스 군도,2004-12
2004-12-31,5181,3656964,-3651783,미령 버진군도,2004-12
2004-12-31,3294,937,2357,상토메 프린스페,2004-12
2004-12-31,1257,0,1257,투발루,2004-12
2004-12-31,1062,0,1062,쿡 아일랜드,2004-12
2004-12-31,1038,0,1038,앙귈라,2004-12
2004-12-31,673,0,673,기네비소,2004-12
2004-12-31,225,4568,-4343,통가,2004-12
2004-12-31,40,0,40,불령 남부지역,2004-12
2004-12-31,0,1525,-1525,적도 기니,2004-12
2004-12-31,0,7577,-7577,남조지아 & 남샌드위치 군도,2004-12
2004-12-31,0,105044,-105044,세인트 헬레나,2004-12
2004-12-31,0,173674,-173674,그린랜드,2004-12
2004-12-31,0,21421,-21421,토켈라우,2004-12
2004-12-31,0,63379,-63379,중앙아프리카공화국,2004-12
2004-12-31,0,276,-276,포클랜드 군도,2004-12
2005-01-31,4478629894,3050959707,1427670187,중국,2005-01
2005-01-31,3478719869,2601918903,876800966,미국,2005-01
2005-01-31,1873433140,3668712517,-1795279377,일본,2005-01
2005-01-31,1119491360,172266134,947225226,홍콩,2005-01
2005-01-31,867848905,597007146,270841759,대만,2005-01
2005-01-31,844696777,775589067,69107710,독일,2005-01
2005-01-31,760653479,106803,760546676,앙골라,2005-01
2005-01-31,450592694,362121412,88471282,싱가포르,2005-01
2005-01-31,387860728,252983275,134877453,영국,2005-01
2005-01-31,377436828,592548406,-215111578,인도네시아,2005-01
2005-01-31,337161342,109532270,227629072,인도,2005-01
2005-01-31,329262933,511172532,-181909599,말레이시아,2005-01
2005-01-31,317881265,72559700,245321565,벨기에,2005-01
2005-01-31,301107782,235637725,65470057,프랑스,2005-01
2005-01-31,300012071,235383074,64628997,이탈리아,2005-01
2005-01-31,288106779,273029053,15077726,네덜란드,2005-01
2005-01-31,285542779,624021379,-338478600,호주,2005-01
2005-01-31,282021419,182192855,99828564,태국,2005-01
2005-01-31,280868483,511844440,-230975957,아랍에미리트 연합,2005-01
2005-01-31,276523190,50735146,225788044,스페인,2005-01
2005-01-31,265402104,190746389,74655715,필리핀,2005-01
2005-01-31,263408894,60116765,203292129,베트남,2005-01
2005-01-31,262811768,36948052,225863716,멕시코,2005-01
2005-01-31,261905938,4084252,257821686,그리스,2005-01
2005-01-31,260770504,213849740,46920764,캐나다,2005-01
2005-01-31,217754238,275251017,-57496779,러시아 연방,2005-01
2005-01-31,209762861,11922139,197840722,튀르키예,2005-01
2005-01-31,194148638,1168,194147470,라이베리아,2005-01
2005-01-31,173683984,305041755,-131357771,이란,2005-01
2005-01-31,172078704,47917228,124161476,핀란드,2005-01
2005-01-31,162907966,144198663,18709303,브라질,2005-01
2005-01-31,142829625,41922,142787703,사이프러스,2005-01
2005-01-31,137891214,872074663,-734183449,사우디아라비아,2005-01
2005-01-31,93907007,82431284,11475723,남아프리카공화국,2005-01
2005-01-31,90076550,202655784,-112579234,칠레,2005-01
2005-01-31,88556796,8374069,80182727,폴란드,2005-01
2005-01-31,85523529,13027,85510502,파나마,2005-01
2005-01-31,80919238,54013212,26906026,아일랜드,2005-01
2005-01-31,74695706,70976069,3719637,스웨덴,2005-01
2005-01-31,60890351,48791987,12098364,오스트리아,2005-01
2005-01-31,59141831,10868718,48273113,콜롬비아,2005-01
2005-01-31,58861599,23574152,35287447,파키스탄,2005-01
2005-01-31,53653546,3296164,50357382,우즈베키스탄,2005-01
2005-01-31,52670803,45982246,6688557,덴마크,2005-01
2005-01-31,52627435,29456554,23170881,이스라엘,2005-01
2005-01-31,50961428,11933629,39027799,헝가리,2005-01
2005-01-31,49338479,2522822,46815657,과테말라,2005-01
2005-01-31,48415365,21316440,27098925,우크라이나,2005-01
2005-01-31,46715776,30111,46685665,나이지리아,2005-01
2005-01-31,43039374,63869355,-20829981,뉴질랜드,2005-01
2005-01-31,41236289,1957769,39278520,슬로바키아,2005-01
2005-01-31,39453075,3106574,36346501,몰타,2005-01
2005-01-31,39100184,4045110,35055074,포루투갈,2005-01
2005-01-31,38951068,11121997,27829071,이집트,2005-01
2005-01-31,38937517,107466799,-68529282,스위스,2005-01
2005-01-31,38702935,3646697,35056238,방글라데시,2005-01
2005-01-31,38679258,6615,38672643,바하마,2005-01
2005-01-31,37156225,121703,37034522,시리아,2005-01
2005-01-31,33281853,1985927,31295926,요르단,2005-01
2005-01-31,31834318,35737673,-3903355,베네주엘라,2005-01
2005-01-31,30657009,24170238,6486771,카자흐스탄,2005-01
2005-01-31,28173935,7756512,20417423,체코공화국,2005-01
2005-01-31,26779469,171853,26607616,알제리,2005-01
2005-01-31,26560374,21913570,4646804,에쿠아도르,2005-01
2005-01-31,24236321,440562872,-416326551,쿠웨이트,2005-01
2005-01-31,21176968,0,21176968,리비아,2005-01
2005-01-31,20433210,3405034,17028176,루마니아,2005-01
2005-01-31,20144673,1815336,18329337,코스타리카,2005-01
2005-01-31,18359582,439882992,-421523410,카타르,2005-01
2005-01-31,17707171,9762983,7944188,페루,2005-01
2005-01-31,17048112,0,17048112,마샬군도,2005-01
2005-01-31,16859168,44315027,-27455859,아르헨티나,2005-01
2005-01-31,16490314,4270147,12220167,기타국,2005-01
2005-01-31,16121755,2538199,13583556,스리랑카,2005-01
2005-01-31,15999481,60575856,-44576375,노르웨이,2005-01
2005-01-31,14354740,14579718,-224978,푸에르토리코,2005-01
2005-01-31,13451409,2201546,11249863,불가리아,2005-01
2005-01-31,13342734,3380460,9962274,수단,2005-01
2005-01-31,13282671,1333239,11949432,모로코,2005-01
2005-01-31,12515454,205793748,-193278294,오만,2005-01
2005-01-31,10904138,1408815,9495323,슬로베니아,2005-01
2005-01-31,9686963,129395,9557568,니카라과,2005-01
2005-01-31,9192252,887688,8304564,온두라스,2005-01
2005-01-31,8492739,572055,7920684,튀니지,2005-01
2005-01-31,8253817,511201,7742616,캄보디아,2005-01
2005-01-31,8179578,628634,7550944,엘살바도르,2005-01
2005-01-31,8158852,72342222,-64183370,이라크,2005-01
2005-01-31,8108841,2601130,5507711,미얀마,2005-01
2005-01-31,8013208,402,8012806,아프카니스탄,2005-01
2005-01-31,7933127,583033,7350094,가나,2005-01
2005-01-31,7224557,1035560,6188997,레바논,2005-01
2005-01-31,6770110,18563,6751547,북마리아나 군도,2005-01
2005-01-31,6676019,4119512,2556507,도미니카 공화국,2005-01
2005-01-31,6379598,6468434,-88836,예맨,2005-01
2005-01-31,5768979,2056623,3712356,우루과이,2005-01
2005-01-31,5677833,79333,5598500,키르기스스탄,2005-01
2005-01-31,5371830,359005,5012825,크로아티아,2005-01
2005-01-31,4980546,360034,4620512,몽골,2005-01
2005-01-31,4786064,201909,4584155,리투아니아,2005-01
2005-01-31,4458524,6700066,-2241542,바레인,2005-01
2005-01-31,4157513,12248,4145265,괌,2005-01
2005-01-31,4139834,116504,4023330,케냐,2005-01
2005-01-31,4116547,45249708,-41133161,브루나이,2005-01
2005-01-31,3884883,5534,3879349,파라과이,2005-01
2005-01-31,3865306,976012,2889294,아이슬란드,2005-01
2005-01-31,3527544,81086,3446458,라트비아,2005-01
2005-01-31,2993911,974175,2019736,에스토니아,2005-01
2005-01-31,2968189,1067377,1900812,나우루,2005-01
2005-01-31,2828669,35539,2793130,탄자니아,2005-01
2005-01-31,2374335,5869986,-3495651,룩셈부르그,2005-01
2005-01-31,2326424,0,2326424,마티니크,2005-01
2005-01-31,2265390,28553,2236837,에티오피아,2005-01
2005-01-31,2088579,0,2088579,아제르바이잔,2005-01
2005-01-31,2075273,8619896,-6544623,뉴 칼레도니아,2005-01
2005-01-31,2008927,480376,1528551,마카오,2005-01
2005-01-31,2003893,12010580,-10006687,파푸아 뉴기니,2005-01
2005-01-31,1988738,5029554,-3040816,스와질랜드,2005-01
2005-01-31,1819182,0,1819182,아이티,2005-01
2005-01-31,1736945,0,1736945,불령 리유니온 코모도 제도,2005-01
2005-01-31,1676423,51707,1624716,트리니다드 토바고,2005-01
2005-01-31,1655173,45397,1609776,피지,2005-01
2005-01-31,1486002,70,1485932,과델로프,2005-01
2005-01-31,1469457,20931970,-19462513,잠비아,2005-01
2005-01-31,1410251,73619,1336632,불령 폴리네시아,2005-01
2005-01-31,1396609,74810,1321799,자마이카,2005-01
2005-01-31,1378603,0,1378603,코트디봐르,2005-01
2005-01-31,1295997,132301,1163696,모리셔스,2005-01
2005-01-31,1205393,87469,1117924,말라위,2005-01
2005-01-31,1195067,62030,1133037,콩고,2005-01
2005-01-31,1084084,13910,1070174,네팔,2005-01
2005-01-31,1019424,0,1019424,레소토,2005-01
2005-01-31,1017715,5814458,-4796743,알바니아,2005-01
2005-01-31,963584,681082,282502,기니,2005-01
2005-01-31,962098,0,962098,토고,2005-01
2005-01-31,887561,0,887561,사모아,2005-01
2005-01-31,872959,505230,367729,벨라루스,2005-01
2005-01-31,862421,0,862421,아루바,2005-01
2005-01-31,827089,0,827089,세인트 루시아,2005-01
2005-01-31,826670,121621,705049,마다카스카르,2005-01
2005-01-31,818266,0,818266,영령 캐이맨 군도,2005-01
2005-01-31,788744,0,788744,바베이도스,2005-01
2005-01-31,759395,124158,635237,유고,2005-01
2005-01-31,757282,1374930,-617648,짐바브웨,2005-01
2005-01-31,731678,676,731002,지부티,2005-01
2005-01-31,711492,2010639,-1299147,볼리비아,2005-01
2005-01-31,704319,0,704319,모잠비크,2005-01
2005-01-31,647379,0,647379,베닝,2005-01
2005-01-31,634035,22365678,-21731643,카메룬,2005-01
2005-01-31,630092,4922,625170,보스니아-헤르체고비나,2005-01
2005-01-31,555306,215773,339533,세네갈,2005-01
2005-01-31,528975,161418,367557,라오스,2005-01
2005-01-31,526975,411850,115125,타지크,2005-01
2005-01-31,503230,28068,475162,우간다,2005-01
2005-01-31,451333,192021,259312,네덜란드 열도,2005-01
2005-01-31,441360,0,441360,부룬디,2005-01
2005-01-31,441294,1590,439704,도미니카,2005-01
2005-01-31,427114,9576,417538,마이크로네시아,2005-01
2005-01-31,418548,3229643,-2811095,솔로몬 군도,2005-01
2005-01-31,415006,76360,338646,말리,2005-01
2005-01-31,410430,221324,189106,모리타니,2005-01
2005-01-31,362961,47341,315620,조지아,2005-01
2005-01-31,338862,0,338862,불령 가이아나,2005-01
2005-01-31,325319,0,325319,버뮤다,2005-01
2005-01-31,322895,0,322895,수리남,2005-01
2005-01-31,318529,204690,113839,벨리제,2005-01
2005-01-31,317294,47947,269347,보츠와나,2005-01
2005-01-31,283628,1000,282628,안티가 바부다,2005-01
2005-01-31,282551,1828,280723,콩고민주공화국,2005-01
2005-01-31,246364,0,246364,몰도바,2005-01
2005-01-31,202529,1296792,-1094263,모나코,2005-01
2005-01-31,201268,10501,190767,투르크멘,2005-01
2005-01-31,199742,0,199742,바누아투,2005-01
2005-01-31,199578,0,199578,팔라우,2005-01
2005-01-31,191184,0,191184,감비아,2005-01
2005-01-31,179099,0,179099,부탄,2005-01
2005-01-31,167454,0,167454,가이아나,2005-01
2005-01-31,160910,0,160910,그레나다,2005-01
2005-01-31,157531,17969,139562,가봉,2005-01
2005-01-31,155792,160354,-4562,리히텐슈타인,2005-01
2005-01-31,153853,5386,148467,마세도니아,2005-01
2005-01-31,148322,108996,39326,팔레스타인 해방기구(구),2005-01
2005-01-31,135134,0,135134,아메리칸 사모아,2005-01
2005-01-31,98127,77591,20536,시에라 리온,2005-01
2005-01-31,76026,2670,73356,몰디브,2005-01
2005-01-31,66313,297937,-231624,부르키나 파소,2005-01
2005-01-31,64359,0,64359,포클랜드 군도,2005-01
2005-01-31,61325,0,61325,카보 베르데,2005-01
2005-01-31,46238,0,46238,에리트리아,2005-01
2005-01-31,44097,7698,36399,쿡 아일랜드,2005-01
2005-01-31,38415,1905,36510,영령 버진군도,2005-01
2005-01-31,36867,0,36867,앙귈라,2005-01
2005-01-31,32841,0,32841,세이쉘,2005-01
2005-01-31,32154,84883,-52729,안도라,2005-01
2005-01-31,25602,77954,-52352,니제르,2005-01
2005-01-31,24658,8649,16009,아르메니아,2005-01
2005-01-31,22775,0,22775,나미비아,2005-01
2005-01-31,19424,0,19424,세르비아 와 몬테네그로,2005-01
2005-01-31,17557,0,17557,챠드,2005-01
2005-01-31,12725,0,12725,세인트 빈센트 그레나딘,2005-01
2005-01-31,10259,0,10259,적도 기니,2005-01
2005-01-31,7879,0,7879,중앙아프리카공화국,2005-01
2005-01-31,7563,0,7563,미령 버진군도,2005-01
2005-01-31,5314,11393,-6079,통가,2005-01
2005-01-31,5186,0,5186,지브랄타,2005-01
2005-01-31,2112,0,2112,르완다,2005-01
2005-01-31,1750,0,1750,파로에 군도,2005-01
2005-01-31,1580,92506,-90926,소말리아,2005-01
2005-01-31,428,0,428,코모로스,2005-01
2005-01-31,367,0,367,투발루,2005-01
2005-01-31,0,230625,-230625,기네비소,2005-01
2005-01-31,0,16524,-16524,남조지아 & 남샌드위치 군도,2005-01
2005-01-31,0,713,-713,코스 군도,2005-01
2005-01-31,0,600,-600,크리스마스 아일랜드,2005-01
2005-01-31,0,35200,-35200,노폴크 아일랜드,2005-01
2005-01-31,0,206679,-206679,그린랜드,2005-01
2005-01-31,0,24623,-24623,산마리노,2005-01
2005-01-31,0,55,-55,토켈라우,2005-01
2005-01-31,0,26011628,-26011628,티모르,2005-01
2005-01-31,0,17763,-17763,교황청,2005-01
2005-01-31,0,9,-9,세인트 헬레나,2005-01
2005-02-28,4067751554,2424721000,1643030554,중국,2005-02
2005-02-28,2943672615,2457853660,485818955,미국,2005-02
2005-02-28,1724000690,3678072200,-1954071510,일본,2005-02
2005-02-28,1040786715,140886219,899900496,홍콩,2005-02
2005-02-28,902120103,609302312,292817791,독일,2005-02
2005-02-28,815377837,517708395,297669442,대만,2005-02
2005-02-28,693801224,27505,693773719,앙골라,2005-02
2005-02-28,478215107,349218635,128996472,싱가포르,2005-02
2005-02-28,341312821,217549801,123763020,영국,2005-02
2005-02-28,329204119,498253159,-169049040,말레이시아,2005-02
2005-02-28,298365112,637674520,-339309408,인도네시아,2005-02
2005-02-28,281369450,167854855,113514595,태국,2005-02
2005-02-28,278877847,138237263,140640584,인도,2005-02
2005-02-28,270363382,186179147,84184235,이탈리아,2005-02
2005-02-28,263262039,660502259,-397240220,호주,2005-02
2005-02-28,256057494,24425453,231632041,멕시코,2005-02
2005-02-28,251076532,158515299,92561233,캐나다,2005-02
2005-02-28,246571487,146187208,100384279,필리핀,2005-02
2005-02-28,238002074,45498870,192503204,베트남,2005-02
2005-02-28,233380018,46484849,186895169,스페인,2005-02
2005-02-28,230180089,248806705,-18626616,네덜란드,2005-02
2005-02-28,226007537,4070175,221937362,바하마,2005-02
2005-02-28,221935939,251066749,-29130810,러시아 연방,2005-02
2005-02-28,209962852,662107415,-452144563,아랍에미리트 연합,2005-02
2005-02-28,208792178,4843654,203948524,파나마,2005-02
2005-02-28,177447070,9618707,167828363,튀르키예,2005-02
2005-02-28,177039462,217447493,-40408031,프랑스,2005-02
2005-02-28,173162689,45983685,127179004,핀란드,2005-02
2005-02-28,169203792,0,169203792,라이베리아,2005-02
2005-02-28,159464204,235709262,-76245058,이란,2005-02
2005-02-28,136484925,1125662306,-989177381,사우디아라비아,2005-02
2005-02-28,134128282,149345972,-15217690,브라질,2005-02
2005-02-28,118399884,55382773,63017111,벨기에,2005-02
2005-02-28,95709009,76965111,18743898,남아프리카공화국,2005-02
2005-02-28,83703289,1494147,82209142,그리스,2005-02
2005-02-28,80859198,45494363,35364835,아일랜드,2005-02
2005-02-28,74937551,6193766,68743785,폴란드,2005-02
2005-02-28,73095430,136691623,-63596193,칠레,2005-02
2005-02-28,68649467,53744107,14905360,노르웨이,2005-02
2005-02-28,68468543,185314,68283229,사이프러스,2005-02
2005-02-28,55092634,60872212,-5779578,뉴질랜드,2005-02
2005-02-28,54156110,32941062,21215048,이스라엘,2005-02
2005-02-28,54067865,67155445,-13087580,스웨덴,2005-02
2005-02-28,53757076,31212684,22544392,오스트리아,2005-02
2005-02-28,49278373,5407053,43871320,기타국,2005-02
2005-02-28,48376464,34145085,14231379,덴마크,2005-02
2005-02-28,47012817,7553274,39459543,콜롬비아,2005-02
2005-02-28,46683107,8720428,37962679,헝가리,2005-02
2005-02-28,45349987,1041,45348946,나이지리아,2005-02
2005-02-28,44703767,12854394,31849373,파키스탄,2005-02
2005-02-28,44424945,1083802,43341143,이집트,2005-02
2005-02-28,40757243,48188489,-7431246,우크라이나,2005-02
2005-02-28,40188296,80941658,-40753362,스위스,2005-02
2005-02-28,39938773,171754,39767019,리비아,2005-02
2005-02-28,38582775,3400186,35182589,포루투갈,2005-02
2005-02-28,36873108,3018582,33854526,방글라데시,2005-02
2005-02-28,34874553,7740,34866813,예맨,2005-02
2005-02-28,34261562,23633615,10627947,베네주엘라,2005-02
2005-02-28,33617424,16981714,16635710,과테말라,2005-02
2005-02-28,32556896,5454165,27102731,요르단,2005-02
2005-02-28,31638061,2691289,28946772,우즈베키스탄,2005-02
2005-02-28,28223161,959337,27263824,에쿠아도르,2005-02
2005-02-28,27540714,0,27540714,마샬군도,2005-02
2005-02-28,27363984,331444,27032540,모나코,2005-02
2005-02-28,26856120,2359349,24496771,몰타,2005-02
2005-02-28,25443118,17126515,8316603,루마니아,2005-02
2005-02-28,25424970,12818356,12606614,카자흐스탄,2005-02
2005-02-28,24117400,302170013,-278052613,쿠웨이트,2005-02
2005-02-28,23403542,7476841,15926701,체코공화국,2005-02
2005-02-28,23096967,10722263,12374704,시리아,2005-02
2005-02-28,22677767,1967590,20710177,슬로바키아,2005-02
2005-02-28,22313264,170,22313094,알제리,2005-02
2005-02-28,18883898,908172,17975726,불가리아,2005-02
2005-02-28,18830512,439309108,-420478596,카타르,2005-02
2005-02-28,18646148,26188599,-7542451,페루,2005-02
2005-02-28,17338644,75517501,-58178857,이라크,2005-02
2005-02-28,15566179,4438452,11127727,스리랑카,2005-02
2005-02-28,14995949,2340604,12655345,모로코,2005-02
2005-02-28,14195072,30711175,-16516103,아르헨티나,2005-02
2005-02-28,13378652,13896844,-518192,푸에르토리코,2005-02
2005-02-28,12517644,300106268,-287588624,오만,2005-02
2005-02-28,11513400,1621008,9892392,슬로베니아,2005-02
2005-02-28,10509683,2171608,8338075,코스타리카,2005-02
2005-02-28,10367144,44699119,-34331975,수단,2005-02
2005-02-28,10187753,14468026,-4280273,도미니카 공화국,2005-02
2005-02-28,10039750,23847,10015903,니카라과,2005-02
2005-02-28,8712505,271092,8441413,캄보디아,2005-02
2005-02-28,8284349,526020,7758329,가나,2005-02
2005-02-28,7856245,1934783,5921462,미얀마,2005-02
2005-02-28,7760348,1394268,6366080,온두라스,2005-02
2005-02-28,7626957,61694410,-54067453,브루나이,2005-02
2005-02-28,7430717,681729,6748988,튀니지,2005-02
2005-02-28,6945581,1232569,5713012,레바논,2005-02
2005-02-28,5965938,392260,5573678,크로아티아,2005-02
2005-02-28,4885191,106412,4778779,몽골,2005-02
2005-02-28,4755537,4542885,212652,바레인,2005-02
2005-02-28,4743912,344968,4398944,케냐,2005-02
2005-02-28,4621242,639295,3981947,엘살바도르,2005-02
2005-02-28,4559954,20476,4539478,북마리아나 군도,2005-02
2005-02-28,4310188,239854,4070334,키르기스스탄,2005-02
2005-02-28,3586081,4001,3582080,아프카니스탄,2005-02
2005-02-28,3279905,55298,3224607,파라과이,2005-02
2005-02-28,3152023,469853,2682170,아이슬란드,2005-02
2005-02-28,3088657,0,3088657,과델로프,2005-02
2005-02-28,2865650,599665,2265985,리투아니아,2005-02
2005-02-28,2832861,1697146,1135715,우루과이,2005-02
2005-02-28,2772443,23397,2749046,괌,2005-02
2005-02-28,2661934,413968,2247966,라트비아,2005-02
2005-02-28,2385957,28550,2357407,트리니다드 토바고,2005-02
2005-02-28,2271153,8384,2262769,탄자니아,2005-02
2005-02-28,2175055,547792,1627263,에스토니아,2005-02
2005-02-28,2049407,0,2049407,불령 리유니온 코모도 제도,2005-02
2005-02-28,1893420,290545,1602875,자마이카,2005-02
2005-02-28,1865958,0,1865958,아이티,2005-02
2005-02-28,1840962,13631,1827331,아제르바이잔,2005-02
2005-02-28,1794392,8455499,-6661107,뉴 칼레도니아,2005-02
2005-02-28,1689036,9137884,-7448848,잠비아,2005-02
2005-02-28,1639767,9185,1630582,모리셔스,2005-02
2005-02-28,1558473,51322,1507151,바베이도스,2005-02
2005-02-28,1547759,88894,1458865,에티오피아,2005-02
2005-02-28,1512479,285791,1226688,마카오,2005-02
2005-02-28,1485668,510600,975068,코트디봐르,2005-02
2005-02-28,1457171,101658,1355513,라오스,2005-02
2005-02-28,1396250,28705,1367545,토켈라우,2005-02
2005-02-28,1383869,67297,1316572,유고,2005-02
2005-02-28,1371331,0,1371331,그레나다,2005-02
2005-02-28,1350880,138435,1212445,벨라루스,2005-02
2005-02-28,1333687,55939,1277748,마다카스카르,2005-02
2005-02-28,1309620,74129,1235491,타지크,2005-02
2005-02-28,1287253,1899244,-611991,세르비아 와 몬테네그로,2005-02
2005-02-28,1271259,2566664,-1295405,짐바브웨,2005-02
2005-02-28,1256655,0,1256655,나우루,2005-02
2005-02-28,1206075,0,1206075,토고,2005-02
2005-02-28,1139240,3749423,-2610183,스와질랜드,2005-02
2005-02-28,1092959,54770,1038189,팔레스타인 해방기구(구),2005-02
2005-02-28,1055812,0,1055812,콩고,2005-02
2005-02-28,1037954,820,1037134,불령 폴리네시아,2005-02
2005-02-28,1034831,3297799,-2262968,파푸아 뉴기니,2005-02
2005-02-28,960177,0,960177,투르크멘,2005-02
2005-02-28,958880,0,958880,영령 캐이맨 군도,2005-02
2005-02-28,868571,0,868571,마티니크,2005-02
2005-02-28,865744,4584953,-3719209,룩셈부르그,2005-02
2005-02-28,864395,13265203,-12400808,기니,2005-02
2005-02-28,848055,0,848055,아루바,2005-02
2005-02-28,826150,26354,799796,피지,2005-02
2005-02-28,783422,109329,674093,세네갈,2005-02
2005-02-28,671483,0,671483,모잠비크,2005-02
2005-02-28,647401,0,647401,베닝,2005-02
2005-02-28,625319,56008,569311,조지아,2005-02
2005-02-28,619376,6519,612857,레소토,2005-02
2005-02-28,601690,0,601690,지부티,2005-02
2005-02-28,589290,29403336,-28814046,카메룬,2005-02
2005-02-28,588625,10986,577639,벨리제,2005-02
2005-02-28,563363,352596,210767,우간다,2005-02
2005-02-28,538920,0,538920,모리타니,2005-02
2005-02-28,536183,44789,491394,알바니아,2005-02
2005-02-28,523758,74928,448830,말라위,2005-02
2005-02-28,503732,4719,499013,몰도바,2005-02
2005-02-28,484300,0,484300,수리남,2005-02
2005-02-28,453505,165815,287690,보츠와나,2005-02
2005-02-28,439368,0,439368,보스니아-헤르체고비나,2005-02
2005-02-28,414558,0,414558,세인트 빈센트 그레나딘,2005-02
2005-02-28,360400,325833,34567,바누아투,2005-02
2005-02-28,345988,0,345988,버뮤다,2005-02
2005-02-28,338651,22400,316251,마세도니아,2005-02
2005-02-28,337279,0,337279,네덜란드 열도,2005-02
2005-02-28,316122,886,315236,마이크로네시아,2005-02
2005-02-28,308740,1298,307442,안티가 바부다,2005-02
2005-02-28,300547,970,299577,세이쉘,2005-02
2005-02-28,273022,95479,177543,네팔,2005-02
2005-02-28,227258,0,227258,말리,2005-02
2005-02-28,224877,155483,69394,리히텐슈타인,2005-02
2005-02-28,221591,0,221591,소말리아,2005-02
2005-02-28,216673,0,216673,부탄,2005-02
2005-02-28,197680,3909863,-3712183,볼리비아,2005-02
2005-02-28,164212,80111,84101,도미니카,2005-02
2005-02-28,159830,0,159830,감비아,2005-02
2005-02-28,158721,0,158721,팔라우,2005-02
2005-02-28,147148,0,147148,불령 가이아나,2005-02
2005-02-28,144970,0,144970,지브랄타,2005-02
2005-02-28,141403,0,141403,사모아,2005-02
2005-02-28,130993,0,130993,몰디브,2005-02
2005-02-28,130271,0,130271,아메리칸 사모아,2005-02
2005-02-28,127889,4306,123583,시에라 리온,2005-02
2005-02-28,127146,0,127146,영령 버진군도,2005-02
2005-02-28,117267,48128,69139,콩고민주공화국,2005-02
2005-02-28,114345,633,113712,파로에 군도,2005-02
2005-02-28,98420,0,98420,아르메니아,2005-02
2005-02-28,84025,36325254,-36241229,가봉,2005-02
2005-02-28,79885,0,79885,가이아나,2005-02
2005-02-28,76409,0,76409,세인트 루시아,2005-02
2005-02-28,59705,0,59705,카보 베르데,2005-02
2005-02-28,52185,0,52185,나미비아,2005-02
2005-02-28,51125,0,51125,티모르,2005-02
2005-02-28,47989,0,47989,통가,2005-02
2005-02-28,38880,0,38880,르완다,2005-02
2005-02-28,37805,3900,33905,에리트리아,2005-02
2005-02-28,35813,625748,-589935,부르키나 파소,2005-02
2005-02-28,35035,200655,-165620,니제르,2005-02
2005-02-28,29430,0,29430,세인트 키츠 네비스,2005-02
2005-02-28,22235,2978970,-2956735,솔로몬 군도,2005-02
2005-02-28,8239,9756,-1517,안도라,2005-02
2005-02-28,5200,0,5200,부룬디,2005-02
2005-02-28,4924,0,4924,중앙아프리카공화국,2005-02
2005-02-28,2907,0,2907,투르크 & 카이코스 군도,2005-02
2005-02-28,680,0,680,앙귈라,2005-02
2005-02-28,300,0,300,키리바티,2005-02
2005-02-28,282,0,282,쿡 아일랜드,2005-02
2005-02-28,274,0,274,미령 버진군도,2005-02
2005-02-28,0,3824,-3824,피트카이른,2005-02
2005-02-28,0,72486,-72486,세인트 헬레나,2005-02
2005-02-28,0,271873,-271873,교황청,2005-02
2005-02-28,0,118050,-118050,그린랜드,2005-02
2005-02-28,0,431,-431,허드 앤 맥도날드 군도,2005-02
2005-02-28,0,18615,-18615,몬트세라트,2005-02
2005-02-28,0,46619,-46619,기네비소,2005-02
2005-03-31,5100932503,3318878210,1782054293,중국,2005-03
2005-03-31,3847122869,2671754330,1175368539,미국,2005-03
2005-03-31,2090276572,4295683730,-2205407158,일본,2005-03
2005-03-31,1324503664,162303265,1162200399,홍콩,2005-03
2005-03-31,942045850,641750894,300294956,대만,2005-03
2005-03-31,776791441,856072226,-79280785,독일,2005-03
2005-03-31,643950709,399435421,244515288,싱가포르,2005-03
2005-03-31,447890934,293107849,154783085,영국,2005-03
2005-03-31,433439613,265796937,167642676,이탈리아,2005-03
2005-03-31,390945814,541131383,-150185569,인도네시아,2005-03
2005-03-31,374912940,751143483,-376230543,말레이시아,2005-03
2005-03-31,354268484,243502628,110765856,캐나다,2005-03
2005-03-31,350072866,151094684,198978182,인도,2005-03
2005-03-31,339265631,48685473,290580158,스페인,2005-03
2005-03-31,333152835,29877065,303275770,멕시코,2005-03
2005-03-31,316657050,216994567,99662483,태국,2005-03
2005-03-31,315788215,246576584,69211631,네덜란드,2005-03
2005-03-31,310554154,855646830,-545092676,호주,2005-03
2005-03-31,302120214,53144152,248976062,베트남,2005-03
2005-03-31,280798164,193443612,87354552,필리핀,2005-03
2005-03-31,277003565,419010105,-142006540,러시아 연방,2005-03
2005-03-31,248530231,6599459,241930772,튀르키예,2005-03
2005-03-31,246969341,1089989943,-843020602,아랍에미리트 연합,2005-03
2005-03-31,244494349,261836451,-17342102,프랑스,2005-03
2005-03-31,210287401,63827554,146459847,핀란드,2005-03
2005-03-31,196063348,298069803,-102006455,이란,2005-03
2005-03-31,194673997,1273656143,-1078982146,사우디아라비아,2005-03
2005-03-31,160146191,227794698,-67648507,브라질,2005-03
2005-03-31,146195816,82516061,63679755,벨기에,2005-03
2005-03-31,132097759,8820,132088939,바하마,2005-03
2005-03-31,119719885,1696,119718189,마샬군도,2005-03
2005-03-31,111973211,34997081,76976130,이스라엘,2005-03
2005-03-31,108734556,3675283,105059273,그리스,2005-03
2005-03-31,103534028,89642395,13891633,남아프리카공화국,2005-03
2005-03-31,94886063,166565297,-71679234,칠레,2005-03
2005-03-31,87549772,9508753,78041019,폴란드,2005-03
2005-03-31,80037278,164384,79872894,라이베리아,2005-03
2005-03-31,79820884,61641021,18179863,아일랜드,2005-03
2005-03-31,75667844,96732398,-21064554,스웨덴,2005-03
2005-03-31,74867350,14694573,60172777,헝가리,2005-03
2005-03-31,70700375,99831823,-29131448,오스트리아,2005-03
2005-03-31,68759642,90865163,-22105521,나이지리아,2005-03
2005-03-31,63140734,13377,63127357,리비아,2005-03
2005-03-31,60291203,41821328,18469875,파키스탄,2005-03
2005-03-31,59922854,13897533,46025321,콜롬비아,2005-03
2005-03-31,59065749,3941366,55124383,방글라데시,2005-03
2005-03-31,56749817,41852203,14897614,이집트,2005-03
2005-03-31,53466913,74963633,-21496720,뉴질랜드,2005-03
2005-03-31,47625061,3461736,44163325,요르단,2005-03
2005-03-31,47590569,103920846,-56330277,스위스,2005-03
2005-03-31,43456881,27001698,16455183,우크라이나,2005-03
2005-03-31,42217852,2192766,40025086,우즈베키스탄,2005-03
2005-03-31,41624157,21170495,20453662,과테말라,2005-03
2005-03-31,39795857,4131973,35663884,포루투갈,2005-03
2005-03-31,39413409,1074125,38339284,불가리아,2005-03
2005-03-31,38072634,51494937,-13422303,덴마크,2005-03
2005-03-31,37899581,28898717,9000864,베네주엘라,2005-03
2005-03-31,35693394,0,35693394,알제리,2005-03
2005-03-31,33953609,15455,33938154,시리아,2005-03
2005-03-31,33267823,13008427,20259396,체코공화국,2005-03
2005-03-31,31708361,452251295,-420542934,쿠웨이트,2005-03
2005-03-31,30914690,16161392,14753298,카자흐스탄,2005-03
2005-03-31,30581963,647597,29934366,에쿠아도르,2005-03
2005-03-31,27915989,6251050,21664939,파나마,2005-03
2005-03-31,26803038,2596895,24206143,슬로바키아,2005-03
2005-03-31,25215811,2068494,23147317,사이프러스,2005-03
2005-03-31,24401364,6477206,17924158,루마니아,2005-03
2005-03-31,23119807,474237306,-451117499,카타르,2005-03
2005-03-31,22094203,4963832,17130371,모로코,2005-03
2005-03-31,20783349,10313871,10469478,페루,2005-03
2005-03-31,20307317,26635752,-6328435,아르헨티나,2005-03
2005-03-31,20061866,6557786,13504080,기타국,2005-03
2005-03-31,19781148,250237,19530911,괌,2005-03
2005-03-31,18684698,56935769,-38251071,노르웨이,2005-03
2005-03-31,18292722,3699717,14593005,스리랑카,2005-03
2005-03-31,15603708,201765019,-186161311,오만,2005-03
2005-03-31,15428394,73494840,-58066446,브루나이,2005-03
2005-03-31,14681805,2843612,11838193,코스타리카,2005-03
2005-03-31,12845245,56389,12788856,니카라과,2005-03
2005-03-31,11786602,479685,11306917,캄보디아,2005-03
2005-03-31,11776491,22176679,-10400188,푸에르토리코,2005-03
2005-03-31,11269678,2767360,8502318,미얀마,2005-03
2005-03-31,11178814,51985042,-40806228,수단,2005-03
2005-03-31,9969714,2922528,7047186,온두라스,2005-03
2005-03-31,9789094,398638,9390456,크로아티아,2005-03
2005-03-31,9582627,599246,8983381,가나,2005-03
2005-03-31,9535694,0,9535694,이라크,2005-03
2005-03-31,9333969,236688,9097281,엘살바도르,2005-03
2005-03-31,9025970,55161,8970809,북마리아나 군도,2005-03
2005-03-31,8694827,152692,8542135,예맨,2005-03
2005-03-31,8520465,2163325,6357140,슬로베니아,2005-03
2005-03-31,8095847,143875,7951972,도미니카 공화국,2005-03
2005-03-31,7721488,102631,7618857,몽골,2005-03
2005-03-31,7479029,40131046,-32652017,바레인,2005-03
2005-03-31,6455192,1382937,5072255,튀니지,2005-03
2005-03-31,6454678,1090178,5364500,레바논,2005-03
2005-03-31,6138015,133911,6004104,케냐,2005-03
2005-03-31,5736935,255393,5481542,파라과이,2005-03
2005-03-31,4701803,588387,4113416,아이슬란드,2005-03
2005-03-31,4252122,85059,4167063,키르기스스탄,2005-03
2005-03-31,4042071,1287720,2754351,에스토니아,2005-03
2005-03-31,3999782,15000,3984782,아프카니스탄,2005-03
2005-03-31,3923575,0,3923575,코트디봐르,2005-03
2005-03-31,3896218,0,3896218,나우루,2005-03
2005-03-31,3885417,66452038,-62566621,카메룬,2005-03
2005-03-31,3771674,426260,3345414,리투아니아,2005-03
2005-03-31,3439256,8897470,-5458214,뉴 칼레도니아,2005-03
2005-03-31,3225718,2300106,925612,우루과이,2005-03
2005-03-31,3219909,51821,3168088,앙골라,2005-03
2005-03-31,3106186,375191,2730995,라트비아,2005-03
2005-03-31,3087994,0,3087994,불령 리유니온 코모도 제도,2005-03
2005-03-31,2939565,3498298,-558733,몰타,2005-03
2005-03-31,2931437,0,2931437,마티니크,2005-03
2005-03-31,2433221,162,2433059,과델로프,2005-03
2005-03-31,2374774,179813,2194961,탄자니아,2005-03
2005-03-31,2303242,702937,1600305,마카오,2005-03
2005-03-31,2282886,87130,2195756,트리니다드 토바고,2005-03
2005-03-31,2160121,8870,2151251,아제르바이잔,2005-03
2005-03-31,2050474,3311804,-1261330,파푸아 뉴기니,2005-03
2005-03-31,1993067,3999821,-2006754,스와질랜드,2005-03
2005-03-31,1896489,666,1895823,불령 폴리네시아,2005-03
2005-03-31,1888535,12426221,-10537686,에티오피아,2005-03
2005-03-31,1881933,1973,1879960,유고,2005-03
2005-03-31,1747501,424390,1323111,세네갈,2005-03
2005-03-31,1733984,0,1733984,아루바,2005-03
2005-03-31,1716597,39212324,-37495727,콩고,2005-03
2005-03-31,1580131,24995904,-23415773,잠비아,2005-03
2005-03-31,1520174,13684,1506490,자마이카,2005-03
2005-03-31,1500793,0,1500793,아이티,2005-03
2005-03-31,1474947,33018,1441929,피지,2005-03
2005-03-31,1458306,115872,1342434,타지크,2005-03
2005-03-31,1425550,94959,1330591,모리셔스,2005-03
2005-03-31,1394016,27458,1366558,네팔,2005-03
2005-03-31,1287266,87033,1200233,마다카스카르,2005-03
2005-03-31,1282092,0,1282092,바베이도스,2005-03
2005-03-31,1258233,0,1258233,지부티,2005-03
2005-03-31,1239433,43907,1195526,도미니카,2005-03
2005-03-31,1169288,165055,1004233,라오스,2005-03
2005-03-31,1160085,78567,1081518,니제르,2005-03
2005-03-31,1088237,7144,1081093,토고,2005-03
2005-03-31,1075339,413629,661710,벨라루스,2005-03
2005-03-31,1003879,46486,957393,네덜란드 열도,2005-03
2005-03-31,984153,0,984153,베닝,2005-03
2005-03-31,978100,17117529,-16139429,기니,2005-03
2005-03-31,915188,0,915188,모잠비크,2005-03
2005-03-31,739393,100522,638871,알바니아,2005-03
2005-03-31,733638,0,733638,말라위,2005-03
2005-03-31,703832,1734803,-1030971,짐바브웨,2005-03
2005-03-31,676718,238093,438625,볼리비아,2005-03
2005-03-31,650453,3481814,-2831361,솔로몬 군도,2005-03
2005-03-31,633118,51319,581799,보츠와나,2005-03
2005-03-31,624578,1396660,-772082,조지아,2005-03
2005-03-31,624233,5923,618310,팔라우,2005-03
2005-03-31,598286,0,598286,버뮤다,2005-03
2005-03-31,591288,0,591288,투르크멘,2005-03
2005-03-31,573772,5894591,-5320819,룩셈부르그,2005-03
2005-03-31,547327,0,547327,나미비아,2005-03
2005-03-31,534485,1486235,-951750,마세도니아,2005-03
2005-03-31,522848,33268,489580,보스니아-헤르체고비나,2005-03
2005-03-31,519477,0,519477,레소토,2005-03
2005-03-31,453520,7896,445624,마이크로네시아,2005-03
2005-03-31,442306,7547,434759,벨리제,2005-03
2005-03-31,437318,0,437318,영령 캐이맨 군도,2005-03
2005-03-31,433265,14539,418726,우간다,2005-03
2005-03-31,432115,23503,408612,콩고민주공화국,2005-03
2005-03-31,405446,3114,402332,사모아,2005-03
2005-03-31,397660,31593,366067,몰도바,2005-03
2005-03-31,385210,6005,379205,수리남,2005-03
2005-03-31,365045,9403,355642,아르메니아,2005-03
2005-03-31,351062,270993,80069,리히텐슈타인,2005-03
2005-03-31,346097,0,346097,아메리칸 사모아,2005-03
2005-03-31,343363,0,343363,안티가 바부다,2005-03
2005-03-31,327169,191368,135801,가이아나,2005-03
2005-03-31,309498,75657,233841,시에라 리온,2005-03
2005-03-31,284300,298425,-14125,팔레스타인 해방기구(구),2005-03
2005-03-31,273496,38926771,-38653275,가봉,2005-03
2005-03-31,267739,0,267739,세이쉘,2005-03
2005-03-31,262521,29449,233072,말리,2005-03
2005-03-31,241306,0,241306,불령 가이아나,2005-03
2005-03-31,225661,0,225661,모리타니,2005-03
2005-03-31,184877,5798,179079,감비아,2005-03
2005-03-31,165875,31105,134770,부탄,2005-03
2005-03-31,159338,184681,-25343,바누아투,2005-03
2005-03-31,152944,0,152944,르완다,2005-03
2005-03-31,146123,0,146123,몰디브,2005-03
2005-03-31,144945,0,144945,적도 기니,2005-03
2005-03-31,132681,0,132681,소말리아,2005-03
2005-03-31,124485,0,124485,세르비아 와 몬테네그로,2005-03
2005-03-31,116102,61475,54627,안도라,2005-03
2005-03-31,114770,19999,94771,토켈라우,2005-03
2005-03-31,112732,377506,-264774,부르키나 파소,2005-03
2005-03-31,104556,0,104556,교황청,2005-03
2005-03-31,102023,0,102023,그레나다,2005-03
2005-03-31,97039,0,97039,세인트 루시아,2005-03
2005-03-31,94313,928060,-833747,모나코,2005-03
2005-03-31,77747,0,77747,통가,2005-03
2005-03-31,56250,0,56250,티모르,2005-03
2005-03-31,52575,0,52575,세인트 키츠 네비스,2005-03
2005-03-31,44596,166429,-121833,쿡 아일랜드,2005-03
2005-03-31,41735,0,41735,왈라스 & 퓨투나 군도,2005-03
2005-03-31,31745,0,31745,세인트 헬레나,2005-03
2005-03-31,27275,15324,11951,영령 버진군도,2005-03
2005-03-31,20684,0,20684,투발루,2005-03
2005-03-31,12082,0,12082,지브랄타,2005-03
2005-03-31,6926,0,6926,카보 베르데,2005-03
2005-03-31,6400,0,6400,에리트리아,2005-03
2005-03-31,5470,78347,-72877,기네비소,2005-03
2005-03-31,3097,0,3097,산마리노,2005-03
2005-03-31,55,0,55,키리바티,2005-03
2005-03-31,0,310,-310,앙귈라,2005-03
2005-03-31,0,370,-370,크리스마스 아일랜드,2005-03
2005-03-31,0,0,0,허드 앤 맥도날드 군도,2005-03
2005-03-31,0,205045,-205045,그린랜드,2005-03
2005-04-30,4934865151,3367807467,1567057684,중국,2005-04
2005-04-30,3461143238,2474396520,986746718,미국,2005-04
2005-04-30,1927815252,4168798189,-2240982937,일본,2005-04
2005-04-30,1212049720,160063096,1051986624,홍콩,2005-04
2005-04-30,924546456,773403006,151143450,독일,2005-04
2005-04-30,832789124,673833719,158955405,대만,2005-04
2005-04-30,466652671,416999821,49652850,싱가포르,2005-04
2005-04-30,443538888,233570317,209968571,영국,2005-04
2005-04-30,414922093,641456653,-226534560,인도네시아,2005-04
2005-04-30,396092232,551383228,-155290996,말레이시아,2005-04
2005-04-30,379101357,165000358,214100999,인도,2005-04
2005-04-30,325837186,658076273,-332239087,호주,2005-04
2005-04-30,320401485,56613392,263788093,베트남,2005-04
2005-04-30,317383919,74105006,243278913,벨기에,2005-04
2005-04-30,304241604,221933349,82308255,프랑스,2005-04
2005-04-30,293251743,218454044,74797699,이탈리아,2005-04
2005-04-30,292629158,193339721,99289437,태국,2005-04
2005-04-30,289244203,329730190,-40485987,러시아 연방,2005-04
2005-04-30,286152132,169002917,117149215,캐나다,2005-04
2005-04-30,282586999,34671199,247915800,멕시코,2005-04
2005-04-30,263498617,60845575,202653042,스페인,2005-04
2005-04-30,252543843,7937855,244605988,튀르키예,2005-04
2005-04-30,245210815,239455222,5755593,네덜란드,2005-04
2005-04-30,229824068,225281697,4542371,필리핀,2005-04
2005-04-30,218252703,600945491,-382692788,아랍에미리트 연합,2005-04
2005-04-30,210280318,153745044,56535274,브라질,2005-04
2005-04-30,168396793,0,168396793,버뮤다,2005-04
2005-04-30,141091549,1295873876,-1154782327,사우디아라비아,2005-04
2005-04-30,140639434,958438,139680996,파나마,2005-04
2005-04-30,140267363,273420341,-133152978,이란,2005-04
2005-04-30,139443673,71356584,68087089,핀란드,2005-04
2005-04-30,134893915,67335,134826580,마샬군도,2005-04
2005-04-30,129481471,234182,129247289,라이베리아,2005-04
2005-04-30,106588528,88453453,18135075,남아프리카공화국,2005-04
2005-04-30,97135787,10223648,86912139,그리스,2005-04
2005-04-30,84925349,52858626,32066723,이스라엘,2005-04
2005-04-30,80229263,54057857,26171406,덴마크,2005-04
2005-04-30,79356428,7600071,71756357,폴란드,2005-04
2005-04-30,74327444,192210740,-117883296,칠레,2005-04
2005-04-30,70262022,48615,70213407,바하마,2005-04
2005-04-30,70206717,48141322,22065395,노르웨이,2005-04
2005-04-30,65454778,48058811,17395967,오스트리아,2005-04
2005-04-30,64649331,276784,64372547,사이프러스,2005-04
2005-04-30,63173410,4516822,58656588,방글라데시,2005-04
2005-04-30,62570328,17760050,44810278,파키스탄,2005-04
2005-04-30,62473505,69136878,-6663373,아일랜드,2005-04
2005-04-30,61169594,10378683,50790911,헝가리,2005-04
2005-04-30,59096527,89844356,-30747829,스웨덴,2005-04
2005-04-30,58685426,4745078,53940348,기타국,2005-04
2005-04-30,58660502,78903137,-20242635,뉴질랜드,2005-04
2005-04-30,56709500,47119096,9590404,나이지리아,2005-04
2005-04-30,51743437,2036597,49706840,이집트,2005-04
2005-04-30,51029760,14823887,36205873,우크라이나,2005-04
2005-04-30,50399580,8933236,41466344,콜롬비아,2005-04
2005-04-30,49702602,1192095,48510507,요르단,2005-04
2005-04-30,43139946,89733284,-46593338,스위스,2005-04
2005-04-30,42659594,16590593,26069001,베네주엘라,2005-04
2005-04-30,38967355,2779644,36187711,우즈베키스탄,2005-04
2005-04-30,38682925,3686572,34996353,포루투갈,2005-04
2005-04-30,36806413,13572283,23234130,과테말라,2005-04
2005-04-30,35138036,49677,35088359,시리아,2005-04
2005-04-30,34475990,1196766,33279224,불가리아,2005-04
2005-04-30,33612040,2247411,31364629,슬로바키아,2005-04
2005-04-30,31973880,0,31973880,알제리,2005-04
2005-04-30,28085998,19948899,8137099,카자흐스탄,2005-04
2005-04-30,28000423,6014925,21985498,루마니아,2005-04
2005-04-30,27561116,12298031,15263085,체코공화국,2005-04
2005-04-30,23899679,689178449,-665278770,쿠웨이트,2005-04
2005-04-30,23032678,4848990,18183688,모로코,2005-04
2005-04-30,19149707,2528938,16620769,스리랑카,2005-04
2005-04-30,19020299,455924,18564375,에쿠아도르,2005-04
2005-04-30,17886039,32125221,-14239182,아르헨티나,2005-04
2005-04-30,17852665,367442421,-349589756,카타르,2005-04
2005-04-30,16318031,185568,16132463,수단,2005-04
2005-04-30,15431988,215142228,-199710240,오만,2005-04
2005-04-30,15010179,51570,14958609,리비아,2005-04
2005-04-30,14678171,13252691,1425480,푸에르토리코,2005-04
2005-04-30,14338950,36323690,-21984740,페루,2005-04
2005-04-30,11912761,563570,11349191,캄보디아,2005-04
2005-04-30,10307699,2325177,7982522,코스타리카,2005-04
2005-04-30,9875416,198450,9676966,니카라과,2005-04
2005-04-30,9464111,3491807,5972304,온두라스,2005-04
2005-04-30,9174138,3008066,6166072,미얀마,2005-04
2005-04-30,8286791,152025,8134766,몽골,2005-04
2005-04-30,7947946,202204,7745742,크로아티아,2005-04
2005-04-30,7833472,7936737,-103265,도미니카 공화국,2005-04
2005-04-30,7724218,1485272,6238946,슬로베니아,2005-04
2005-04-30,7484885,8511983,-1027098,바레인,2005-04
2005-04-30,7244456,1009879,6234577,튀니지,2005-04
2005-04-30,7159367,38333,7121034,북마리아나 군도,2005-04
2005-04-30,6186844,181413,6005431,엘살바도르,2005-04
2005-04-30,5783748,988757,4794991,레바논,2005-04
2005-04-30,5717846,381502,5336344,가나,2005-04
2005-04-30,5415763,309949,5105814,케냐,2005-04
2005-04-30,5299958,4622,5295336,앙골라,2005-04
2005-04-30,5003442,72877,4930565,에티오피아,2005-04
2005-04-30,4872603,575,4872028,아프카니스탄,2005-04
2005-04-30,4864144,52385720,-47521576,예맨,2005-04
2005-04-30,4784335,113944,4670391,리투아니아,2005-04
2005-04-30,4102315,667845,3434470,아이슬란드,2005-04
2005-04-30,3809911,0,3809911,불령 리유니온 코모도 제도,2005-04
2005-04-30,3722359,12421,3709938,아제르바이잔,2005-04
2005-04-30,3584290,2876395,707895,몰타,2005-04
2005-04-30,3549307,40623063,-37073756,브루나이,2005-04
2005-04-30,3475973,12997852,-9521879,에스토니아,2005-04
2005-04-30,3468228,6095,3462133,키르기스스탄,2005-04
2005-04-30,3400760,9363222,-5962462,뉴 칼레도니아,2005-04
2005-04-30,3214112,59241,3154871,트리니다드 토바고,2005-04
2005-04-30,3198556,263293,2935263,파라과이,2005-04
2005-04-30,3091871,426696,2665175,마카오,2005-04
2005-04-30,2919424,80348085,-77428661,이라크,2005-04
2005-04-30,2815303,313953,2501350,과델로프,2005-04
2005-04-30,2695962,6844252,-4148290,룩셈부르그,2005-04
2005-04-30,2351366,79829,2271537,괌,2005-04
2005-04-30,2329047,580167,1748880,라트비아,2005-04
2005-04-30,2044024,8496,2035528,아이티,2005-04
2005-04-30,1949661,2452,1947209,불령 폴리네시아,2005-04
2005-04-30,1934887,288213,1646674,벨라루스,2005-04
2005-04-30,1871189,0,1871189,토고,2005-04
2005-04-30,1849091,0,1849091,코트디봐르,2005-04
2005-04-30,1834547,0,1834547,콩고,2005-04
2005-04-30,1737652,1918989,-181337,우루과이,2005-04
2005-04-30,1607338,7342,1599996,유고,2005-04
2005-04-30,1552240,178311,1373929,모리셔스,2005-04
2005-04-30,1546556,0,1546556,나우루,2005-04
2005-04-30,1424423,221684,1202739,탄자니아,2005-04
2005-04-30,1407391,2467003,-1059612,파푸아 뉴기니,2005-04
2005-04-30,1355692,0,1355692,마티니크,2005-04
2005-04-30,1303535,50145,1253390,타지크,2005-04
2005-04-30,1241382,7348,1234034,도미니카,2005-04
2005-04-30,1238704,141393,1097311,자마이카,2005-04
2005-04-30,1201975,1004974,197001,피지,2005-04
2005-04-30,1198363,11,1198352,지부티,2005-04
2005-04-30,1143879,112816,1031063,팔레스타인 해방기구(구),2005-04
2005-04-30,1129962,12696384,-11566422,스와질랜드,2005-04
2005-04-30,1092093,242,1091851,아루바,2005-04
2005-04-30,990826,0,990826,베닝,2005-04
2005-04-30,990350,10228,980122,보스니아-헤르체고비나,2005-04
2005-04-30,989082,16376,972706,알바니아,2005-04
2005-04-30,987397,0,987397,라오스,2005-04
2005-04-30,978761,0,978761,네덜란드 열도,2005-04
2005-04-30,911483,159571,751912,세네갈,2005-04
2005-04-30,894671,0,894671,르완다,2005-04
2005-04-30,885748,110434,775314,네팔,2005-04
2005-04-30,860366,41288071,-40427705,카메룬,2005-04
2005-04-30,743249,19545209,-18801960,볼리비아,2005-04
2005-04-30,723002,406,722596,바베이도스,2005-04
2005-04-30,716148,0,716148,사모아,2005-04
2005-04-30,688634,96827,591807,마다카스카르,2005-04
2005-04-30,667267,609554,57713,기니,2005-04
2005-04-30,580569,124561,456008,조지아,2005-04
2005-04-30,556693,403281,153412,짐바브웨,2005-04
2005-04-30,538374,33554,504820,보츠와나,2005-04
2005-04-30,477667,0,477667,투르크멘,2005-04
2005-04-30,469953,182271,287682,리히텐슈타인,2005-04
2005-04-30,456892,57177,399715,몰도바,2005-04
2005-04-30,456101,282,455819,모잠비크,2005-04
2005-04-30,449295,14612030,-14162735,잠비아,2005-04
2005-04-30,434730,186813,247917,우간다,2005-04
2005-04-30,360872,537,360335,불령 가이아나,2005-04
2005-04-30,353860,0,353860,마세도니아,2005-04
2005-04-30,350938,94650,256288,바누아투,2005-04
2005-04-30,343045,421366,-78321,안티가 바부다,2005-04
2005-04-30,334227,0,334227,콩고민주공화국,2005-04
2005-04-30,316570,26245,290325,중앙아프리카공화국,2005-04
2005-04-30,316208,0,316208,영령 캐이맨 군도,2005-04
2005-04-30,300818,25497,275321,수리남,2005-04
2005-04-30,297887,10400,287487,마이크로네시아,2005-04
2005-04-30,272554,20148,252406,시에라 리온,2005-04
2005-04-30,272155,160519,111636,말라위,2005-04
2005-04-30,263941,47196,216745,세이쉘,2005-04
2005-04-30,251982,0,251982,모리타니,2005-04
2005-04-30,234592,105220,129372,가봉,2005-04
2005-04-30,212158,0,212158,부탄,2005-04
2005-04-30,196189,0,196189,레소토,2005-04
2005-04-30,196162,7989,188173,아르메니아,2005-04
2005-04-30,190351,0,190351,몰디브,2005-04
2005-04-30,181288,186138,-4850,벨리제,2005-04
2005-04-30,176210,0,176210,팔라우,2005-04
2005-04-30,155223,2864067,-2708844,솔로몬 군도,2005-04
2005-04-30,143722,44810,98912,영령 버진군도,2005-04
2005-04-30,136221,0,136221,부룬디,2005-04
2005-04-30,116950,96882,20068,토켈라우,2005-04
2005-04-30,114345,450,113895,파로에 군도,2005-04
2005-04-30,112500,0,112500,티모르,2005-04
2005-04-30,85325,0,85325,그레나다,2005-04
2005-04-30,83789,5345,78444,나미비아,2005-04
2005-04-30,82054,0,82054,아메리칸 사모아,2005-04
2005-04-30,73110,1113668,-1040558,모나코,2005-04
2005-04-30,70291,0,70291,세인트 루시아,2005-04
2005-04-30,69955,0,69955,세인트 키츠 네비스,2005-04
2005-04-30,48393,749,47644,감비아,2005-04
2005-04-30,47632,20329,27303,세르비아 와 몬테네그로,2005-04
2005-04-30,42269,325,41944,지브랄타,2005-04
2005-04-30,40153,0,40153,쿡 아일랜드,2005-04
2005-04-30,37303,112985,-75682,말리,2005-04
2005-04-30,30300,0,30300,통가,2005-04
2005-04-30,19390,0,19390,앙귈라,2005-04
2005-04-30,17755,0,17755,세인트 빈센트 그레나딘,2005-04
2005-04-30,17136,195551,-178415,기네비소,2005-04
2005-04-30,9214,290014,-280800,니제르,2005-04
2005-04-30,1725,1783,-58,몬트세라트,2005-04
2005-04-30,1334,549409,-548075,부르키나 파소,2005-04
2005-04-30,400,0,400,코모로스,2005-04
2005-04-30,295,1007,-712,에리트리아,2005-04
2005-04-30,275,7057035,-7056760,미령 버진군도,2005-04
2005-04-30,0,15348,-15348,크리스마스 아일랜드,2005-04
2005-04-30,0,82552,-82552,그린랜드,2005-04
2005-04-30,0,1754987,-1754987,가이아나,2005-04
2005-04-30,0,25283,-25283,니우에,2005-04
2005-04-30,0,25253,-25253,안도라,2005-04
2005-04-30,0,25127,-25127,코스 군도,2005-04
2005-05-31,5084553831,3417803615,1666750216,중국,2005-05
2005-05-31,3049347129,2401004024,648343105,미국,2005-05
2005-05-31,2112346565,3789772483,-1677425918,일본,2005-05
2005-05-31,1205126325,167960966,1037165359,홍콩,2005-05
2005-05-31,891989984,667500527,224489457,대만,2005-05
2005-05-31,862683864,813664837,49019027,독일,2005-05
2005-05-31,710823736,440976185,269847551,싱가포르,2005-05
2005-05-31,524458134,248683570,275774564,이탈리아,2005-05
2005-05-31,436771025,424605046,12165979,말레이시아,2005-05
2005-05-31,407900641,615339363,-207438722,인도네시아,2005-05
2005-05-31,400953149,242335092,158618057,영국,2005-05
2005-05-31,359741540,205427999,154313541,인도,2005-05
2005-05-31,289966773,208443885,81522888,캐나다,2005-05
2005-05-31,285902445,60865271,225037174,베트남,2005-05
2005-05-31,283054211,218550595,64503616,태국,2005-05
2005-05-31,280713579,36160194,244553385,멕시코,2005-05
2005-05-31,277169613,955079165,-677909552,호주,2005-05
2005-05-31,265146532,312551069,-47404537,러시아 연방,2005-05
2005-05-31,248951899,204509421,44442478,필리핀,2005-05
2005-05-31,243003881,15070,242988811,바하마,2005-05
2005-05-31,242482496,186501066,55981430,프랑스,2005-05
2005-05-31,231985740,55500205,176485535,스페인,2005-05
2005-05-31,224916008,8887122,216028886,튀르키예,2005-05
2005-05-31,221498325,279774894,-58276569,네덜란드,2005-05
2005-05-31,212143003,219343308,-7200305,브라질,2005-05
2005-05-31,198464016,3213,198460803,마샬군도,2005-05
2005-05-31,198099970,882450086,-684350116,아랍에미리트 연합,2005-05
2005-05-31,186369408,1255155479,-1068786071,사우디아라비아,2005-05
2005-05-31,179934924,11140677,168794247,그리스,2005-05
2005-05-31,169361927,255292650,-85930723,이란,2005-05
2005-05-31,163366543,22508050,140858493,베네주엘라,2005-05
2005-05-31,160004014,326353,159677661,라이베리아,2005-05
2005-05-31,136905105,61413588,75491517,핀란드,2005-05
2005-05-31,134898331,34470406,100427925,파나마,2005-05
2005-05-31,126623329,87167582,39455747,벨기에,2005-05
2005-05-31,122691123,90673409,32017714,남아프리카공화국,2005-05
2005-05-31,86200579,59555885,26644694,노르웨이,2005-05
2005-05-31,84990697,92245815,-7255118,스위스,2005-05
2005-05-31,79690419,12206801,67483618,폴란드,2005-05
2005-05-31,68391446,176996810,-108605364,칠레,2005-05
2005-05-31,65843014,12181647,53661367,헝가리,2005-05
2005-05-31,63698489,41074475,22624014,이스라엘,2005-05
2005-05-31,62634685,47508443,15126242,오스트리아,2005-05
2005-05-31,60616524,43539252,17077272,덴마크,2005-05
2005-05-31,57507924,2696939,54810985,이집트,2005-05
2005-05-31,56785262,424758761,-367973499,쿠웨이트,2005-05
2005-05-31,53038218,73769757,-20731539,스웨덴,2005-05
2005-05-31,51093740,6535090,44558650,요르단,2005-05
2005-05-31,50647741,16831568,33816173,우크라이나,2005-05
2005-05-31,50543347,3991374,46551973,방글라데시,2005-05
2005-05-31,48396820,15718287,32678533,파키스탄,2005-05
2005-05-31,48003388,67546796,-19543408,아일랜드,2005-05
2005-05-31,46246042,13204379,33041663,콜롬비아,2005-05
2005-05-31,45647721,92989984,-47342263,뉴질랜드,2005-05
2005-05-31,45198284,1858026,43340258,슬로바키아,2005-05
2005-05-31,44537770,15923537,28614233,과테말라,2005-05
2005-05-31,43477712,107792,43369920,사이프러스,2005-05
2005-05-31,42593164,38507,42554657,시리아,2005-05
2005-05-31,40020434,55225926,-15205492,나이지리아,2005-05
2005-05-31,39858039,2957726,36900313,우즈베키스탄,2005-05
2005-05-31,36013606,0,36013606,알제리,2005-05
2005-05-31,34399280,14310586,20088694,루마니아,2005-05
2005-05-31,31414792,14383293,17031499,체코공화국,2005-05
2005-05-31,30350016,149764,30200252,리비아,2005-05
2005-05-31,27380353,4170303,23210050,포루투갈,2005-05
2005-05-31,26687752,42940,26644812,영령 버진군도,2005-05
2005-05-31,24665012,2048925,22616087,불가리아,2005-05
2005-05-31,23942196,445453233,-421511037,카타르,2005-05
2005-05-31,19353435,651537,18701898,에쿠아도르,2005-05
2005-05-31,19235546,29633368,-10397822,아르헨티나,2005-05
2005-05-31,18876748,12483210,6393538,페루,2005-05
2005-05-31,18775894,5928859,12847035,기타국,2005-05
2005-05-31,17936269,3135128,14801141,스리랑카,2005-05
2005-05-31,16978879,62513,16916366,수단,2005-05
2005-05-31,16884866,5581246,11303620,모로코,2005-05
2005-05-31,14598934,20775318,-6176384,카자흐스탄,2005-05
2005-05-31,14162336,176030837,-161868501,오만,2005-05
2005-05-31,13056628,50256,13006372,니카라과,2005-05
2005-05-31,12510570,15560902,-3050332,푸에르토리코,2005-05
2005-05-31,11596752,437325,11159427,캄보디아,2005-05
2005-05-31,10514333,1671113,8843220,슬로베니아,2005-05
2005-05-31,9338280,34667677,-25329397,바레인,2005-05
2005-05-31,8674336,2136721,6537615,코스타리카,2005-05
2005-05-31,8367007,8385732,-18725,도미니카 공화국,2005-05
2005-05-31,8236056,2451493,5784563,미얀마,2005-05
2005-05-31,7255444,3007847,4247597,온두라스,2005-05
2005-05-31,6958849,26588074,-19629225,예맨,2005-05
2005-05-31,6565876,332957,6232919,몽골,2005-05
2005-05-31,6317363,145960,6171403,크로아티아,2005-05
2005-05-31,5883484,402772,5480712,가나,2005-05
2005-05-31,5648548,26691,5621857,키르기스스탄,2005-05
2005-05-31,5535535,940962,4594573,튀니지,2005-05
2005-05-31,5530285,20950,5509335,북마리아나 군도,2005-05
2005-05-31,5443274,1180799,4262475,레바논,2005-05
2005-05-31,5012727,304858,4707869,리투아니아,2005-05
2005-05-31,4763086,156234,4606852,케냐,2005-05
2005-05-31,4266721,220144,4046577,엘살바도르,2005-05
2005-05-31,4227876,157325,4070551,괌,2005-05
2005-05-31,4213718,465534,3748184,아이슬란드,2005-05
2005-05-31,4179013,79,4178934,아프카니스탄,2005-05
2005-05-31,3559593,678504,2881089,에스토니아,2005-05
2005-05-31,3539877,2888357,651520,우루과이,2005-05
2005-05-31,3534533,9656,3524877,파라과이,2005-05
2005-05-31,3524033,4952471,-1428438,뉴 칼레도니아,2005-05
2005-05-31,3261733,3322375,-60642,몰타,2005-05
2005-05-31,3195551,55333,3140218,라트비아,2005-05
2005-05-31,2986711,181119,2805592,탄자니아,2005-05
2005-05-31,2880127,0,2880127,앙골라,2005-05
2005-05-31,2702709,6890760,-4188051,파푸아 뉴기니,2005-05
2005-05-31,2591490,0,2591490,코트디봐르,2005-05
2005-05-31,2549448,52325965,-49776517,브루나이,2005-05
2005-05-31,2531009,0,2531009,트리니다드 토바고,2005-05
2005-05-31,2493565,0,2493565,미령 버진군도,2005-05
2005-05-31,2424092,0,2424092,과델로프,2005-05
2005-05-31,2340690,6093,2334597,아제르바이잔,2005-05
2005-05-31,2158000,0,2158000,불령 리유니온 코모도 제도,2005-05
2005-05-31,1964575,0,1964575,유고,2005-05
2005-05-31,1817214,0,1817214,불령 폴리네시아,2005-05
2005-05-31,1796746,24131,1772615,마다카스카르,2005-05
2005-05-31,1791769,190834,1600935,마카오,2005-05
2005-05-31,1786562,55187,1731375,모리셔스,2005-05
2005-05-31,1710904,970514,740390,에티오피아,2005-05
2005-05-31,1628067,43888066,-42259999,콩고,2005-05
2005-05-31,1624087,58562,1565525,피지,2005-05
2005-05-31,1515724,82945,1432779,투르크멘,2005-05
2005-05-31,1482820,283640,1199180,세네갈,2005-05
2005-05-31,1385834,0,1385834,베닝,2005-05
2005-05-31,1382818,11806903,-10424085,기니,2005-05
2005-05-31,1311789,188243,1123546,조지아,2005-05
2005-05-31,1293877,3728508,-2434631,스와질랜드,2005-05
2005-05-31,1287307,612733,674574,카메룬,2005-05
2005-05-31,1282141,0,1282141,지부티,2005-05
2005-05-31,1245093,0,1245093,마티니크,2005-05
2005-05-31,1224268,17246,1207022,도미니카,2005-05
2005-05-31,1169478,39533,1129945,자마이카,2005-05
2005-05-31,1129583,0,1129583,이라크,2005-05
2005-05-31,1082367,0,1082367,아루바,2005-05
2005-05-31,1069722,1289,1068433,아이티,2005-05
2005-05-31,962594,0,962594,보스니아-헤르체고비나,2005-05
2005-05-31,947534,142652,804882,라오스,2005-05
2005-05-31,939994,513151,426843,벨라루스,2005-05
2005-05-31,934419,230692,703727,타지크,2005-05
2005-05-31,909237,0,909237,네덜란드 열도,2005-05
2005-05-31,821988,29996,791992,시에라 리온,2005-05
2005-05-31,796176,18869,777307,네팔,2005-05
2005-05-31,772369,10470,761899,토고,2005-05
2005-05-31,755946,0,755946,나미비아,2005-05
2005-05-31,730550,16410408,-15679858,잠비아,2005-05
2005-05-31,695123,139861,555262,보츠와나,2005-05
2005-05-31,681750,150,681600,바베이도스,2005-05
2005-05-31,670064,199232,470832,우간다,2005-05
2005-05-31,669482,0,669482,불령 가이아나,2005-05
2005-05-31,656486,117442,539044,볼리비아,2005-05
2005-05-31,635518,7337795,-6702277,룩셈부르그,2005-05
2005-05-31,575070,0,575070,모잠비크,2005-05
2005-05-31,534210,12326,521884,알바니아,2005-05
2005-05-31,528509,124490,404019,짐바브웨,2005-05
2005-05-31,523321,492,522829,마이크로네시아,2005-05
2005-05-31,505892,65864,440028,말라위,2005-05
2005-05-31,502765,1006295,-503530,벨리제,2005-05
2005-05-31,443133,0,443133,세이쉘,2005-05
2005-05-31,395245,14778,380467,수리남,2005-05
2005-05-31,361153,99374,261779,가봉,2005-05
2005-05-31,342658,0,342658,사모아,2005-05
2005-05-31,317610,0,317610,바누아투,2005-05
2005-05-31,300951,24600,276351,아메리칸 사모아,2005-05
2005-05-31,299192,696,298496,몰디브,2005-05
2005-05-31,296877,2952699,-2655822,솔로몬 군도,2005-05
2005-05-31,290167,84945,205222,몰도바,2005-05
2005-05-31,260868,127651,133217,리히텐슈타인,2005-05
2005-05-31,257546,0,257546,마세도니아,2005-05
2005-05-31,250558,0,250558,그레나다,2005-05
2005-05-31,242403,0,242403,안티가 바부다,2005-05
2005-05-31,239170,0,239170,감비아,2005-05
2005-05-31,238532,0,238532,가이아나,2005-05
2005-05-31,232295,0,232295,르완다,2005-05
2005-05-31,214612,98,214514,버뮤다,2005-05
2005-05-31,208186,32769,175417,소말리아,2005-05
2005-05-31,193504,114341,79163,모리타니,2005-05
2005-05-31,184948,0,184948,팔라우,2005-05
2005-05-31,184501,12298,172203,니제르,2005-05
2005-05-31,169016,556109,-387093,부르키나 파소,2005-05
2005-05-31,145839,0,145839,부탄,2005-05
2005-05-31,131230,0,131230,콩고민주공화국,2005-05
2005-05-31,100700,1021,99679,안도라,2005-05
2005-05-31,94322,412484,-318162,팔레스타인 해방기구(구),2005-05
2005-05-31,80865,27062,53803,중앙아프리카공화국,2005-05
2005-05-31,66770,257,66513,카보 베르데,2005-05
2005-05-31,65816,0,65816,세인트 키츠 네비스,2005-05
2005-05-31,58268,0,58268,레소토,2005-05
2005-05-31,57172,58762,-1590,파로에 군도,2005-05
2005-05-31,46904,0,46904,투르크 & 카이코스 군도,2005-05
2005-05-31,39681,0,39681,세인트 루시아,2005-05
2005-05-31,35467,0,35467,몬트세라트,2005-05
2005-05-31,19580,755840,-736260,모나코,2005-05
2005-05-31,17030,73093,-56063,세르비아 와 몬테네그로,2005-05
2005-05-31,12412,0,12412,토켈라우,2005-05
2005-05-31,12159,3658,8501,아르메니아,2005-05
2005-05-31,5378,19747,-14369,통가,2005-05
2005-05-31,5050,795877,-790827,상토메 프린스페,2005-05
2005-05-31,4498,0,4498,앙귈라,2005-05
2005-05-31,4399,8200,-3801,산마리노,2005-05
2005-05-31,2630,0,2630,지브랄타,2005-05
2005-05-31,2158,0,2158,세인트 피레 미켈론,2005-05
2005-05-31,1973,83761,-81788,말리,2005-05
2005-05-31,960,0,960,코모로스,2005-05
2005-05-31,761,0,761,투발루,2005-05
2005-05-31,364,1360,-996,크리스마스 아일랜드,2005-05
2005-05-31,353,0,353,부룬디,2005-05
2005-05-31,175,36808,-36633,영령 캐이맨 군도,2005-05
2005-05-31,60,0,60,키리바티,2005-05
2005-05-31,0,111760,-111760,세인트 헬레나,2005-05
2005-05-31,0,412,-412,코스 군도,2005-05
2005-05-31,0,218566,-218566,기네비소,2005-05
2005-05-31,0,56619,-56619,그린랜드,2005-05
2005-05-31,0,6,-6,영령 인도양,2005-05
2005-06-30,5431809725,3238832327,2192977398,중국,2005-06
2005-06-30,3281113899,2630201931,650911968,미국,2005-06
2005-06-30,2016336223,4088811722,-2072475499,일본,2005-06
2005-06-30,1274052635,172358103,1101694532,홍콩,2005-06
2005-06-30,929467046,815267991,114199055,독일,2005-06
2005-06-30,872056682,657014693,215041989,대만,2005-06
2005-06-30,599421688,431327878,168093810,러시아 연방,2005-06
2005-06-30,573585153,484270176,89314977,싱가포르,2005-06
2005-06-30,454966001,288481905,166484096,영국,2005-06
2005-06-30,401161690,406162262,-5000572,말레이시아,2005-06
2005-06-30,374204595,203536501,170668094,인도,2005-06
2005-06-30,371003002,654715486,-283712484,인도네시아,2005-06
2005-06-30,362495925,239014877,123481048,이탈리아,2005-06
2005-06-30,358098763,54786767,303311996,베트남,2005-06
2005-06-30,318000367,34369773,283630594,멕시코,2005-06
2005-06-30,310988626,726565291,-415576665,호주,2005-06
2005-06-30,298560414,213901683,84658731,태국,2005-06
2005-06-30,287885227,13994025,273891202,튀르키예,2005-06
2005-06-30,284749660,191649740,93099920,캐나다,2005-06
2005-06-30,270037366,179801887,90235479,네덜란드,2005-06
2005-06-30,269883605,2153,269881452,라이베리아,2005-06
2005-06-30,259949471,212746968,47202503,필리핀,2005-06
2005-06-30,237835418,207065855,30769563,프랑스,2005-06
2005-06-30,231438934,706776939,-475338005,아랍에미리트 연합,2005-06
2005-06-30,224928818,61890141,163038677,스페인,2005-06
2005-06-30,220051797,194727251,25324546,브라질,2005-06
2005-06-30,204194231,303921947,-99727716,이란,2005-06
2005-06-30,194050756,1067426388,-873375632,사우디아라비아,2005-06
2005-06-30,167811161,23184,167787977,바하마,2005-06
2005-06-30,162510600,18162982,144347618,파나마,2005-06
2005-06-30,150238822,78754846,71483976,핀란드,2005-06
2005-06-30,110372260,86597285,23774975,벨기에,2005-06
2005-06-30,103613523,83976334,19637189,남아프리카공화국,2005-06
2005-06-30,84499476,15613267,68886209,헝가리,2005-06
2005-06-30,81397384,38082997,43314387,이스라엘,2005-06
2005-06-30,75527941,206044022,-130516081,칠레,2005-06
2005-06-30,74713240,44085777,30627463,오스트리아,2005-06
2005-06-30,73733890,9553797,64180093,폴란드,2005-06
2005-06-30,71908742,83897959,-11989217,뉴질랜드,2005-06
2005-06-30,69501701,2756552,66745149,그리스,2005-06
2005-06-30,62589093,88716499,-26127406,스웨덴,2005-06
2005-06-30,61714309,2147554,59566755,슬로바키아,2005-06
2005-06-30,60889808,16031713,44858095,파키스탄,2005-06
2005-06-30,58333000,428212565,-369879565,쿠웨이트,2005-06
2005-06-30,57420505,19291324,38129181,몰타,2005-06
2005-06-30,56295605,2851228,53444377,이집트,2005-06
2005-06-30,53542109,33309627,20232482,우크라이나,2005-06
2005-06-30,51197372,27654,51169718,괌,2005-06
2005-06-30,45722670,6020473,39702197,방글라데시,2005-06
2005-06-30,42166343,18822657,23343686,베네주엘라,2005-06
2005-06-30,42013760,73192673,-31178913,아일랜드,2005-06
2005-06-30,41519562,46426905,-4907343,덴마크,2005-06
2005-06-30,40744444,10193485,30550959,과테말라,2005-06
2005-06-30,40512628,1732,40510896,나이지리아,2005-06
2005-06-30,39980433,101359014,-61378581,스위스,2005-06
2005-06-30,39972009,11470578,28501431,콜롬비아,2005-06
2005-06-30,39302197,2306948,36995249,요르단,2005-06
2005-06-30,36258041,18832,36239209,시리아,2005-06
2005-06-30,32939505,1367355,31572150,우즈베키스탄,2005-06
2005-06-30,32085176,3600284,28484892,루마니아,2005-06
2005-06-30,31756164,54533933,-22777769,알제리,2005-06
2005-06-30,29632017,127767,29504250,리비아,2005-06
2005-06-30,29486193,3209398,26276795,포루투갈,2005-06
2005-06-30,28300886,27498131,802755,아르헨티나,2005-06
2005-06-30,26468225,271111706,-244643481,카타르,2005-06
2005-06-30,25000138,690322,24309816,에쿠아도르,2005-06
2005-06-30,24162156,11214278,12947878,체코공화국,2005-06
2005-06-30,23116396,47167493,-24051097,페루,2005-06
2005-06-30,21059105,29455624,-8396519,카자흐스탄,2005-06
2005-06-30,20112806,53365386,-33252580,노르웨이,2005-06
2005-06-30,18423665,2775541,15648124,스리랑카,2005-06
2005-06-30,15650069,258634864,-242984795,오만,2005-06
2005-06-30,15471375,8747944,6723431,기타국,2005-06
2005-06-30,14520545,1551746,12968799,불가리아,2005-06
2005-06-30,14244198,169019,14075179,수단,2005-06
2005-06-30,12706743,2783594,9923149,미얀마,2005-06
2005-06-30,12606184,175837,12430347,캄보디아,2005-06
2005-06-30,11525974,1903625,9622349,모로코,2005-06
2005-06-30,11414903,218928,11195975,니카라과,2005-06
2005-06-30,10866935,3292275,7574660,코스타리카,2005-06
2005-06-30,10300115,296877,10003238,도미니카 공화국,2005-06
2005-06-30,9872373,36009290,-26136917,바레인,2005-06
2005-06-30,9467770,43245393,-33777623,예맨,2005-06
2005-06-30,9178497,10557710,-1379213,푸에르토리코,2005-06
2005-06-30,8848095,642485,8205610,가나,2005-06
2005-06-30,8411736,3537224,4874512,온두라스,2005-06
2005-06-30,8140436,1233078,6907358,슬로베니아,2005-06
2005-06-30,7412264,65620,7346644,북마리아나 군도,2005-06
2005-06-30,7315646,2326857,4988789,우루과이,2005-06
2005-06-30,7191975,592557,6599418,케냐,2005-06
2005-06-30,7106434,879818,6226616,몽골,2005-06
2005-06-30,6962718,697305,6265413,레바논,2005-06
2005-06-30,6397448,940645,5456803,튀니지,2005-06
2005-06-30,5926454,720726,5205728,크로아티아,2005-06
2005-06-30,5368253,160021,5208232,엘살바도르,2005-06
2005-06-30,5287650,16908463,-11620813,브루나이,2005-06
2005-06-30,5085995,277381,4808614,리투아니아,2005-06
2005-06-30,5006926,251639,4755287,파라과이,2005-06
2005-06-30,4534631,52004,4482627,키르기스스탄,2005-06
2005-06-30,4399238,1086136,3313102,에스토니아,2005-06
2005-06-30,4323764,522390,3801374,사이프러스,2005-06
2005-06-30,4144533,750165,3394368,라트비아,2005-06
2005-06-30,4112524,357,4112167,아프카니스탄,2005-06
2005-06-30,3918146,1049998,2868148,아이슬란드,2005-06
2005-06-30,3591851,11085488,-7493637,뉴 칼레도니아,2005-06
2005-06-30,3157952,0,3157952,불령 리유니온 코모도 제도,2005-06
2005-06-30,3007760,0,3007760,트리니다드 토바고,2005-06
2005-06-30,2822205,48073,2774132,앙골라,2005-06
2005-06-30,2792244,88790295,-85998051,이라크,2005-06
2005-06-30,2487962,81166,2406796,탄자니아,2005-06
2005-06-30,2451938,87391,2364547,피지,2005-06
2005-06-30,2419297,0,2419297,코트디봐르,2005-06
2005-06-30,2406190,34593327,-32187137,기니,2005-06
2005-06-30,2342640,226224,2116416,에티오피아,2005-06
2005-06-30,1951437,73170,1878267,마다카스카르,2005-06
2005-06-30,1860422,567627,1292795,마카오,2005-06
2005-06-30,1852262,12359,1839903,아제르바이잔,2005-06
2005-06-30,1836284,0,1836284,토고,2005-06
2005-06-30,1793497,51052,1742445,모리셔스,2005-06
2005-06-30,1789790,7109199,-5319409,스와질랜드,2005-06
2005-06-30,1591401,32477745,-30886344,잠비아,2005-06
2005-06-30,1553715,0,1553715,마티니크,2005-06
2005-06-30,1497525,19559,1477966,유고,2005-06
2005-06-30,1441297,0,1441297,베닝,2005-06
2005-06-30,1417711,0,1417711,과델로프,2005-06
2005-06-30,1375598,352775,1022823,세네갈,2005-06
2005-06-30,1271229,15293,1255936,조지아,2005-06
2005-06-30,1211595,337947,873648,벨라루스,2005-06
2005-06-30,1142196,137210,1004986,라오스,2005-06
2005-06-30,1135941,14534765,-13398824,파푸아 뉴기니,2005-06
2005-06-30,1080911,53896,1027015,불령 폴리네시아,2005-06
2005-06-30,1006315,333062,673253,볼리비아,2005-06
2005-06-30,957942,14449,943493,자마이카,2005-06
2005-06-30,950521,31125,919396,네팔,2005-06
2005-06-30,931248,0,931248,아루바,2005-06
2005-06-30,890355,100334,790021,타지크,2005-06
2005-06-30,886787,8149610,-7262823,도미니카,2005-06
2005-06-30,877019,124404027,-123527008,콩고,2005-06
2005-06-30,835906,0,835906,아르메니아,2005-06
2005-06-30,796679,138605,658074,팔레스타인 해방기구(구),2005-06
2005-06-30,773465,9825,763640,사모아,2005-06
2005-06-30,764712,27312,737400,모잠비크,2005-06
2005-06-30,760508,0,760508,지부티,2005-06
2005-06-30,755820,246375,509445,투르크멘,2005-06
2005-06-30,737572,108472,629100,말라위,2005-06
2005-06-30,730661,5059104,-4328443,룩셈부르그,2005-06
2005-06-30,640030,890,639140,보스니아-헤르체고비나,2005-06
2005-06-30,638594,214762,423832,우간다,2005-06
2005-06-30,617208,0,617208,아이티,2005-06
2005-06-30,604233,53266,550967,보츠와나,2005-06
2005-06-30,593800,347859,245941,짐바브웨,2005-06
2005-06-30,538288,0,538288,버뮤다,2005-06
2005-06-30,525486,950,524536,바베이도스,2005-06
2005-06-30,501155,0,501155,불령 가이아나,2005-06
2005-06-30,494626,79074,415552,네덜란드 열도,2005-06
2005-06-30,492129,153693,338436,리히텐슈타인,2005-06
2005-06-30,473390,7496,465894,통가,2005-06
2005-06-30,462408,35008343,-34545935,카메룬,2005-06
2005-06-30,440386,1793813,-1353427,가봉,2005-06
2005-06-30,369201,0,369201,수리남,2005-06
2005-06-30,366950,0,366950,세이쉘,2005-06
2005-06-30,366732,0,366732,안티가 바부다,2005-06
2005-06-30,331370,0,331370,마이크로네시아,2005-06
2005-06-30,314052,425,313627,바누아투,2005-06
2005-06-30,290458,71548,218910,모리타니,2005-06
2005-06-30,284798,0,284798,세인트 루시아,2005-06
2005-06-30,279466,1988,277478,알바니아,2005-06
2005-06-30,270062,0,270062,부탄,2005-06
2005-06-30,259068,0,259068,벨리제,2005-06
2005-06-30,234806,0,234806,팔라우,2005-06
2005-06-30,189864,142974,46890,세르비아 와 몬테네그로,2005-06
2005-06-30,180997,0,180997,영령 캐이맨 군도,2005-06
2005-06-30,180000,0,180000,니제르,2005-06
2005-06-30,178077,1237,176840,몰도바,2005-06
2005-06-30,173128,0,173128,감비아,2005-06
2005-06-30,172755,69742,103013,말리,2005-06
2005-06-30,162186,3953656,-3791470,솔로몬 군도,2005-06
2005-06-30,160966,10930,150036,가이아나,2005-06
2005-06-30,141801,6656,135145,소말리아,2005-06
2005-06-30,114344,48240,66104,파로에 군도,2005-06
2005-06-30,100253,1918526,-1818273,나미비아,2005-06
2005-06-30,92052,0,92052,부룬디,2005-06
2005-06-30,90162,564,89598,콩고민주공화국,2005-06
2005-06-30,67592,100793,-33201,아메리칸 사모아,2005-06
2005-06-30,65476,354,65122,몰디브,2005-06
2005-06-30,58754,72,58682,레소토,2005-06
2005-06-30,54983,0,54983,그레나다,2005-06
2005-06-30,51068,26078,24990,마세도니아,2005-06
2005-06-30,48083,0,48083,투르크 & 카이코스 군도,2005-06
2005-06-30,45600,64378,-18778,토켈라우,2005-06
2005-06-30,44527,0,44527,쿡 아일랜드,2005-06
2005-06-30,39701,0,39701,지브랄타,2005-06
2005-06-30,36385,222784,-186399,부르키나 파소,2005-06
2005-06-30,35683,600112,-564429,모나코,2005-06
2005-06-30,28155,0,28155,르완다,2005-06
2005-06-30,22138,0,22138,세인트 빈센트 그레나딘,2005-06
2005-06-30,18072,1140,16932,중앙아프리카공화국,2005-06
2005-06-30,13325,0,13325,에리트리아,2005-06
2005-06-30,12706,0,12706,코모로스,2005-06
2005-06-30,12500,0,12500,카보 베르데,2005-06
2005-06-30,12265,0,12265,세인트 키츠 네비스,2005-06
2005-06-30,11214,0,11214,영령 버진군도,2005-06
2005-06-30,10285,29996,-19711,시에라 리온,2005-06
2005-06-30,9493,3179,6314,키리바티,2005-06
2005-06-30,5750,0,5750,산마리노,2005-06
2005-06-30,4928,2338,2590,영령 인도양,2005-06
2005-06-30,4406,0,4406,보빗군도,2005-06
2005-06-30,3064,32095,-29031,마샬군도,2005-06
2005-06-30,3033,0,3033,티모르,2005-06
2005-06-30,0,137,-137,안타티카,2005-06
2005-06-30,0,68,-68,몬트세라트,2005-06
2005-06-30,0,135858,-135858,포클랜드 군도,2005-06
2005-06-30,0,62727,-62727,크리스마스 아일랜드,2005-06
2005-06-30,0,365,-365,마이너 아우틀링 합중국 군도,2005-06
2005-06-30,0,522,-522,상토메 프린스페,2005-06
2005-06-30,0,52875,-52875,그린랜드,2005-06
2005-06-30,0,28004,-28004,기네비소,2005-06
2005-06-30,0,94637,-94637,안도라,2005-06
2005-06-30,0,59,-59,미령 버진군도,2005-06
2005-06-30,0,2760,-2760,세인트 헬레나,2005-06
2005-07-31,5341837566,3095095316,2246742250,중국,2005-07
2005-07-31,3274528563,2571217720,703310843,미국,2005-07
2005-07-31,1947968106,3916018675,-1968050569,일본,2005-07
2005-07-31,1223363867,168064167,1055299700,홍콩,2005-07
2005-07-31,893534779,661394302,232140477,대만,2005-07
2005-07-31,819259889,806814649,12445240,독일,2005-07
2005-07-31,709763641,443579432,266184209,싱가포르,2005-07
2005-07-31,507346034,660521965,-153175931,인도네시아,2005-07
2005-07-31,437585707,169370018,268215689,인도,2005-07
2005-07-31,433626750,322587811,111038939,영국,2005-07
2005-07-31,414886667,421726006,-6839339,말레이시아,2005-07
2005-07-31,338471063,295914733,42556330,러시아 연방,2005-07
2005-07-31,335781869,251270167,84511702,이탈리아,2005-07
2005-07-31,329874826,64406257,265468569,멕시코,2005-07
2005-07-31,297149140,292104536,5044604,네덜란드,2005-07
2005-07-31,291833310,206202323,85630987,태국,2005-07
2005-07-31,288826751,52856123,235970628,베트남,2005-07
2005-07-31,282628172,924618224,-641990052,호주,2005-07
2005-07-31,272771351,54960717,217810634,스페인,2005-07
2005-07-31,261942888,213317403,48625485,필리핀,2005-07
2005-07-31,258955683,232945697,26009986,캐나다,2005-07
2005-07-31,230547564,11265795,219281769,튀르키예,2005-07
2005-07-31,216960644,194516054,22444590,브라질,2005-07
2005-07-31,211693817,234025894,-22332077,프랑스,2005-07
2005-07-31,208609018,713462595,-504853577,아랍에미리트 연합,2005-07
2005-07-31,182077980,1313215240,-1131137260,사우디아라비아,2005-07
2005-07-31,178372270,279721698,-101349428,이란,2005-07
2005-07-31,177532026,4051995,173480031,그리스,2005-07
2005-07-31,161924850,1138,161923712,마샬군도,2005-07
2005-07-31,155803544,15450,155788094,라이베리아,2005-07
2005-07-31,130426213,67109715,63316498,핀란드,2005-07
2005-07-31,121595570,93668076,27927494,남아프리카공화국,2005-07
2005-07-31,109970035,80653136,29316899,벨기에,2005-07
2005-07-31,96566879,10981649,85585230,폴란드,2005-07
2005-07-31,94123276,3009625,91113651,몰타,2005-07
2005-07-31,90531249,148684766,-58153517,칠레,2005-07
2005-07-31,89284351,11502521,77781830,헝가리,2005-07
2005-07-31,84785625,47145026,37640599,오스트리아,2005-07
2005-07-31,80317238,57688101,22629137,파나마,2005-07
2005-07-31,72408608,98894021,-26485413,스웨덴,2005-07
2005-07-31,69414710,45358976,24055734,이스라엘,2005-07
2005-07-31,64991100,76957868,-11966768,뉴질랜드,2005-07
2005-07-31,63963966,46722257,17241709,노르웨이,2005-07
2005-07-31,60350633,2334415,58016218,이집트,2005-07
2005-07-31,59958955,9616365,50342590,우크라이나,2005-07
2005-07-31,52928192,2777904,50150288,슬로바키아,2005-07
2005-07-31,52452354,14299552,38152802,파키스탄,2005-07
2005-07-31,49819659,49703515,116144,덴마크,2005-07
2005-07-31,48348588,3111285,45237303,방글라데시,2005-07
2005-07-31,44396062,62488613,-18092551,나이지리아,2005-07
2005-07-31,41975948,69037103,-27061155,아일랜드,2005-07
2005-07-31,41968577,552263332,-510294755,쿠웨이트,2005-07
2005-07-31,41797927,289128272,-247330345,오만,2005-07
2005-07-31,40493123,102826406,-62333283,스위스,2005-07
2005-07-31,40005349,11669731,28335618,콜롬비아,2005-07
2005-07-31,37809645,5162239,32647406,요르단,2005-07
2005-07-31,37528531,1124546,36403985,과테말라,2005-07
2005-07-31,37227347,593421,36633926,에쿠아도르,2005-07
2005-07-31,34443021,2196974,32246047,우즈베키스탄,2005-07
2005-07-31,33392101,37407005,-4014904,베네주엘라,2005-07
2005-07-31,33245699,24804739,8440960,바하마,2005-07
2005-07-31,32906938,42778921,-9871983,아르헨티나,2005-07
2005-07-31,29297113,135454,29161659,시리아,2005-07
2005-07-31,28641835,168193,28473642,리비아,2005-07
2005-07-31,27470853,4655545,22815308,포루투갈,2005-07
2005-07-31,25891554,10724002,15167552,체코공화국,2005-07
2005-07-31,22995234,5010093,17985141,루마니아,2005-07
2005-07-31,22375562,406905435,-384529873,카타르,2005-07
2005-07-31,22259031,16582982,5676049,페루,2005-07
2005-07-31,20683101,111498341,-90815240,알제리,2005-07
2005-07-31,17970975,31261,17939714,괌,2005-07
2005-07-31,16760877,4031047,12729830,스리랑카,2005-07
2005-07-31,16043787,2500,16041287,수단,2005-07
2005-07-31,16042999,24011259,-7968260,카자흐스탄,2005-07
2005-07-31,15779835,7680504,8099331,기타국,2005-07
2005-07-31,15641750,1344767,14296983,불가리아,2005-07
2005-07-31,14339575,2360529,11979046,모로코,2005-07
2005-07-31,11370569,2004737,9365832,코스타리카,2005-07
2005-07-31,10495119,620733,9874386,캄보디아,2005-07
2005-07-31,9908508,1938414,7970094,미얀마,2005-07
2005-07-31,9469646,159865,9309781,니카라과,2005-07
2005-07-31,9438910,12450801,-3011891,바레인,2005-07
2005-07-31,9240035,458754,8781281,도미니카 공화국,2005-07
2005-07-31,9238625,2451986,6786639,온두라스,2005-07
2005-07-31,7953458,315101,7638357,가나,2005-07
2005-07-31,7152131,1004397,6147734,레바논,2005-07
2005-07-31,6879268,44716045,-37836777,예맨,2005-07
2005-07-31,5964873,1164373,4800500,몽골,2005-07
2005-07-31,5708650,685,5707965,이라크,2005-07
2005-07-31,5629981,70599,5559382,북마리아나 군도,2005-07
2005-07-31,5389687,837477,4552210,튀니지,2005-07
2005-07-31,5174398,2162921,3011477,우루과이,2005-07
2005-07-31,4935429,380892,4554537,크로아티아,2005-07
2005-07-31,4925230,642850,4282380,에스토니아,2005-07
2005-07-31,4802944,27771,4775173,아프카니스탄,2005-07
2005-07-31,4517572,208895,4308677,라트비아,2005-07
2005-07-31,4139776,224198,3915578,에티오피아,2005-07
2005-07-31,4090000,295733,3794267,리투아니아,2005-07
2005-07-31,4058573,1729840,2328733,슬로베니아,2005-07
2005-07-31,4038755,194757,3843998,케냐,2005-07
2005-07-31,3799762,48702,3751060,키르기스스탄,2005-07
2005-07-31,3623511,106569,3516942,엘살바도르,2005-07
2005-07-31,3598511,13281968,-9683457,푸에르토리코,2005-07
2005-07-31,3329374,100,3329274,앙골라,2005-07
2005-07-31,3161866,8688,3153178,아제르바이잔,2005-07
2005-07-31,3089559,23463,3066096,피지,2005-07
2005-07-31,2990967,77348,2913619,파라과이,2005-07
2005-07-31,2902821,39955,2862866,트리니다드 토바고,2005-07
2005-07-31,2896055,7802709,-4906654,뉴 칼레도니아,2005-07
2005-07-31,2791057,65934,2725123,사이프러스,2005-07
2005-07-31,2692335,18481329,-15788994,브루나이,2005-07
2005-07-31,2564477,0,2564477,코트디봐르,2005-07
2005-07-31,2400410,922325,1478085,아이슬란드,2005-07
2005-07-31,2307380,0,2307380,불령 리유니온 코모도 제도,2005-07
2005-07-31,2246963,300206,1946757,벨라루스,2005-07
2005-07-31,2183240,109696,2073544,탄자니아,2005-07
2005-07-31,2146872,0,2146872,나우루,2005-07
2005-07-31,2098159,192376,1905783,모리셔스,2005-07
2005-07-31,1876576,3228,1873348,지부티,2005-07
2005-07-31,1591876,5700,1586176,불령 폴리네시아,2005-07
2005-07-31,1538039,498190,1039849,짐바브웨,2005-07
2005-07-31,1427527,3973878,-2546351,룩셈부르그,2005-07
2005-07-31,1390003,461407,928596,마카오,2005-07
2005-07-31,1295444,291571,1003873,세네갈,2005-07
2005-07-31,1243284,11545951,-10302667,스와질랜드,2005-07
2005-07-31,1192117,120316,1071801,네팔,2005-07
2005-07-31,1187653,0,1187653,토고,2005-07
2005-07-31,1070836,0,1070836,베닝,2005-07
2005-07-31,1060627,146472,914155,타지크,2005-07
2005-07-31,1053636,5274,1048362,과델로프,2005-07
2005-07-31,1050476,9765479,-8715003,파푸아 뉴기니,2005-07
2005-07-31,1009913,54006243,-52996330,콩고,2005-07
2005-07-31,991108,19407659,-18416551,잠비아,2005-07
2005-07-31,975749,0,975749,아루바,2005-07
2005-07-31,963180,39479089,-38515909,카메룬,2005-07
2005-07-31,953353,136168,817185,라오스,2005-07
2005-07-31,892930,434,892496,아이티,2005-07
2005-07-31,874304,1433,872871,네덜란드 열도,2005-07
2005-07-31,853974,103748,750226,자마이카,2005-07
2005-07-31,850360,1889413,-1039053,나미비아,2005-07
2005-07-31,818437,286,818151,유고,2005-07
2005-07-31,766516,506606,259910,볼리비아,2005-07
2005-07-31,721275,358857,362418,투르크멘,2005-07
2005-07-31,685910,0,685910,안티가 바부다,2005-07
2005-07-31,650053,0,650053,도미니카,2005-07
2005-07-31,649032,0,649032,모잠비크,2005-07
2005-07-31,648532,70166,578366,마다카스카르,2005-07
2005-07-31,640432,771,639661,세이쉘,2005-07
2005-07-31,612634,2065,610569,바베이도스,2005-07
2005-07-31,594535,328703,265832,말라위,2005-07
2005-07-31,576857,0,576857,부탄,2005-07
2005-07-31,571532,0,571532,마티니크,2005-07
2005-07-31,485009,33546,451463,우간다,2005-07
2005-07-31,476158,18406,457752,세르비아 와 몬테네그로,2005-07
2005-07-31,447843,528022,-80179,기니,2005-07
2005-07-31,446148,0,446148,감비아,2005-07
2005-07-31,421032,0,421032,수리남,2005-07
2005-07-31,412847,0,412847,팔라우,2005-07
2005-07-31,398686,4720,393966,마이크로네시아,2005-07
2005-07-31,396895,12837,384058,보스니아-헤르체고비나,2005-07
2005-07-31,381277,0,381277,바누아투,2005-07
2005-07-31,351181,0,351181,사모아,2005-07
2005-07-31,341696,34182,307514,조지아,2005-07
2005-07-31,335701,0,335701,세인트 루시아,2005-07
2005-07-31,332216,26022,306194,아르메니아,2005-07
2005-07-31,317221,0,317221,알바니아,2005-07
2005-07-31,290254,0,290254,버뮤다,2005-07
2005-07-31,275428,50831,224597,가이아나,2005-07
2005-07-31,231045,0,231045,레소토,2005-07
2005-07-31,229340,0,229340,지브랄타,2005-07
2005-07-31,229185,0,229185,모리타니,2005-07
2005-07-31,215345,178821,36524,가봉,2005-07
2005-07-31,205762,2413,203349,콩고민주공화국,2005-07
2005-07-31,201539,0,201539,몰디브,2005-07
2005-07-31,196426,0,196426,몰도바,2005-07
2005-07-31,179511,0,179511,영령 버진군도,2005-07
2005-07-31,176857,39688,137169,시에라 리온,2005-07
2005-07-31,144132,3128,141004,그레나다,2005-07
2005-07-31,143079,367613,-224534,팔레스타인 해방기구(구),2005-07
2005-07-31,138167,62802,75365,보츠와나,2005-07
2005-07-31,118477,253118,-134641,리히텐슈타인,2005-07
2005-07-31,104375,119241,-14866,안도라,2005-07
2005-07-31,96570,0,96570,니제르,2005-07
2005-07-31,94838,0,94838,소말리아,2005-07
2005-07-31,93231,0,93231,통가,2005-07
2005-07-31,91202,0,91202,마세도니아,2005-07
2005-07-31,88849,0,88849,부르키나 파소,2005-07
2005-07-31,75665,0,75665,영령 캐이맨 군도,2005-07
2005-07-31,70093,34416,35677,아메리칸 사모아,2005-07
2005-07-31,68342,309623,-241281,벨리제,2005-07
2005-07-31,60737,0,60737,세인트 빈센트 그레나딘,2005-07
2005-07-31,58210,51,58159,앙귈라,2005-07
2005-07-31,57430,43266,14164,말리,2005-07
2005-07-31,57300,0,57300,르완다,2005-07
2005-07-31,57145,0,57145,부룬디,2005-07
2005-07-31,50421,1717210,-1666789,솔로몬 군도,2005-07
2005-07-31,44496,8222,36274,쿡 아일랜드,2005-07
2005-07-31,42160,134363,-92203,기네비소,2005-07
2005-07-31,34664,5218,29446,세인트 키츠 네비스,2005-07
2005-07-31,28597,0,28597,에리트리아,2005-07
2005-07-31,7078,207771,-200693,챠드,2005-07
2005-07-31,6799,0,6799,몬트세라트,2005-07
2005-07-31,5074,300172,-295098,모나코,2005-07
2005-07-31,3537,0,3537,산마리노,2005-07
2005-07-31,1602,0,1602,키리바티,2005-07
2005-07-31,1358,0,1358,중앙아프리카공화국,2005-07
2005-07-31,193,0,193,메요트,2005-07
2005-07-31,0,3473926,-3473926,미령 버진군도,2005-07
2005-07-31,0,10552,-10552,상토메 프린스페,2005-07
2005-07-31,0,113,-113,코스 군도,2005-07
2005-07-31,0,104421,-104421,그린랜드,2005-07
2005-07-31,0,899,-899,노폴크 아일랜드,2005-07
2005-07-31,0,2000,-2000,티모르,2005-07
2005-07-31,0,280,-280,마이너 아우틀링 합중국 군도,2005-07
2005-08-31,5423374641,3212405789,2210968852,중국,2005-08
2005-08-31,3254946142,2647897724,607048418,미국,2005-08
2005-08-31,1904502129,3964111750,-2059609621,일본,2005-08
2005-08-31,1250952115,159408942,1091543173,홍콩,2005-08
2005-08-31,902427729,693610970,208816759,대만,2005-08
2005-08-31,846183604,836496647,9686957,독일,2005-08
2005-08-31,653612350,441639280,211973070,싱가포르,2005-08
2005-08-31,554127002,667145919,-113018917,인도네시아,2005-08
2005-08-31,426094565,338810634,87283931,영국,2005-08
2005-08-31,388549568,170103560,218446008,인도,2005-08
2005-08-31,382573520,262184666,120388854,러시아 연방,2005-08
2005-08-31,350936673,161132484,189804189,네덜란드,2005-08
2005-08-31,336915725,427997442,-91081717,말레이시아,2005-08
2005-08-31,329044106,35962936,293081170,멕시코,2005-08
2005-08-31,315838053,161156758,154681295,필리핀,2005-08
2005-08-31,302053200,745888354,-443835154,호주,2005-08
2005-08-31,273502229,247601919,25900310,태국,2005-08
2005-08-31,255814219,249445618,6368601,프랑스,2005-08
2005-08-31,244207324,250901735,-6694411,브라질,2005-08
2005-08-31,243933660,62138622,181795038,베트남,2005-08
2005-08-31,243790071,225406655,18383416,캐나다,2005-08
2005-08-31,225356853,269817268,-44460415,이탈리아,2005-08
2005-08-31,221804449,4360,221800089,바하마,2005-08
2005-08-31,201674648,13650616,188024032,튀르키예,2005-08
2005-08-31,197954460,945880454,-747925994,아랍에미리트 연합,2005-08
2005-08-31,173429261,170552235,2877026,이란,2005-08
2005-08-31,168202751,0,168202751,버뮤다,2005-08
2005-08-31,165010136,1474543326,-1309533190,사우디아라비아,2005-08
2005-08-31,149650088,56557862,93092226,스페인,2005-08
2005-08-31,145270307,8373193,136897114,그리스,2005-08
2005-08-31,142687582,52702298,89985284,핀란드,2005-08
2005-08-31,126225554,208455408,-82229854,칠레,2005-08
2005-08-31,125055362,44518686,80536676,파나마,2005-08
2005-08-31,121869867,172998,121696869,사이프러스,2005-08
2005-08-31,119584225,102734329,16849896,벨기에,2005-08
2005-08-31,110900572,95535159,15365413,남아프리카공화국,2005-08
2005-08-31,110334335,11182879,99151456,헝가리,2005-08
2005-08-31,104716495,10175698,94540797,폴란드,2005-08
2005-08-31,95615298,12244948,83370350,기타국,2005-08
2005-08-31,91486832,544456718,-452969886,카타르,2005-08
2005-08-31,84661160,29249,84631911,라이베리아,2005-08
2005-08-31,80210506,70798202,9412304,오스트리아,2005-08
2005-08-31,64006048,40193535,23812513,이스라엘,2005-08
2005-08-31,63297560,71672343,-8374783,스웨덴,2005-08
2005-08-31,55611979,24200614,31411365,우크라이나,2005-08
2005-08-31,55369940,13186165,42183775,이집트,2005-08
2005-08-31,50203414,463694719,-413491305,쿠웨이트,2005-08
2005-08-31,48641155,8658398,39982757,콜롬비아,2005-08
2005-08-31,48177026,2248290,45928736,슬로바키아,2005-08
2005-08-31,46574597,84332103,-37757506,뉴질랜드,2005-08
2005-08-31,45408857,18484918,26923939,파키스탄,2005-08
2005-08-31,44014654,65828108,-21813454,아일랜드,2005-08
2005-08-31,43188320,3152449,40035871,방글라데시,2005-08
2005-08-31,42691693,4087720,38603973,요르단,2005-08
2005-08-31,37465746,56969,37408777,나이지리아,2005-08
2005-08-31,37395404,9429668,27965736,루마니아,2005-08
2005-08-31,36688247,2634770,34053477,우즈베키스탄,2005-08
2005-08-31,35800998,562447,35238551,에쿠아도르,2005-08
2005-08-31,34336912,436613,33900299,리비아,2005-08
2005-08-31,33759847,340642919,-306883072,오만,2005-08
2005-08-31,32873398,90829453,-57956055,스위스,2005-08
2005-08-31,32023398,46450002,-14426604,덴마크,2005-08
2005-08-31,29099587,314307,28785280,과테말라,2005-08
2005-08-31,28692155,2731435,25960720,베네주엘라,2005-08
2005-08-31,26741382,32369472,-5628090,아르헨티나,2005-08
2005-08-31,25855045,12927785,12927260,체코공화국,2005-08
2005-08-31,25339322,4559,25334763,알제리,2005-08
2005-08-31,25234565,21325,25213240,시리아,2005-08
2005-08-31,22138655,2613,22136042,괌,2005-08
2005-08-31,22136610,4391787,17744823,포루투갈,2005-08
2005-08-31,18283401,80012,18203389,앙골라,2005-08
2005-08-31,18281090,27548700,-9267610,페루,2005-08
2005-08-31,16041645,5218129,10823516,코스타리카,2005-08
2005-08-31,15766649,8944214,6822435,도미니카 공화국,2005-08
2005-08-31,14959581,13278757,1680824,푸에르토리코,2005-08
2005-08-31,14624281,6973927,7650354,모로코,2005-08
2005-08-31,13631060,0,13631060,마샬군도,2005-08
2005-08-31,13407970,25601334,-12193364,카자흐스탄,2005-08
2005-08-31,13302857,2209523,11093334,스리랑카,2005-08
2005-08-31,12921231,62918667,-49997436,노르웨이,2005-08
2005-08-31,11971660,245597,11726063,니카라과,2005-08
2005-08-31,11935200,3109655,8825545,수단,2005-08
2005-08-31,11713316,444547,11268769,캄보디아,2005-08
2005-08-31,11549446,5122903,6426543,미얀마,2005-08
2005-08-31,11513254,2309954,9203300,온두라스,2005-08
2005-08-31,8680030,551955,8128075,레바논,2005-08
2005-08-31,8369708,31470557,-23100849,바레인,2005-08
2005-08-31,8215259,411601,7803658,리투아니아,2005-08
2005-08-31,7031954,556048,6475906,키르기스스탄,2005-08
2005-08-31,6722317,914389,5807928,가나,2005-08
2005-08-31,6642456,1046360,5596096,몽골,2005-08
2005-08-31,5651637,798743,4852894,튀니지,2005-08
2005-08-31,5396715,95369296,-89972581,이라크,2005-08
2005-08-31,5298939,33268,5265671,엘살바도르,2005-08
2005-08-31,5211873,2837412,2374461,불가리아,2005-08
2005-08-31,5177333,72753597,-67576264,브루나이,2005-08
2005-08-31,5176618,1216,5175402,아프카니스탄,2005-08
2005-08-31,5039502,49193379,-44153877,예맨,2005-08
2005-08-31,4836416,2243183,2593233,우루과이,2005-08
2005-08-31,4823052,1865106,2957946,슬로베니아,2005-08
2005-08-31,4721035,301069,4419966,크로아티아,2005-08
2005-08-31,4574731,0,4574731,불령 리유니온 코모도 제도,2005-08
2005-08-31,4329159,697465,3631694,케냐,2005-08
2005-08-31,3673721,213941,3459780,라트비아,2005-08
2005-08-31,3341424,663588,2677836,에티오피아,2005-08
2005-08-31,3308284,10231148,-6922864,뉴 칼레도니아,2005-08
2005-08-31,3298754,2508880,789874,몰타,2005-08
2005-08-31,3273995,739872,2534123,에스토니아,2005-08
2005-08-31,3232109,20907,3211202,아제르바이잔,2005-08
2005-08-31,3226645,40247,3186398,북마리아나 군도,2005-08
2005-08-31,3109057,122747,2986310,피지,2005-08
2005-08-31,3067718,441249,2626469,파라과이,2005-08
2005-08-31,2384523,207523,2177000,탄자니아,2005-08
2005-08-31,2299385,0,2299385,도미니카,2005-08
2005-08-31,2246403,29197,2217206,트리니다드 토바고,2005-08
2005-08-31,2103112,514473,1588639,마카오,2005-08
2005-08-31,1990753,38815776,-36825023,기니,2005-08
2005-08-31,1958558,0,1958558,과델로프,2005-08
2005-08-31,1958001,349556,1608445,코트디봐르,2005-08
2005-08-31,1926136,90510,1835626,모리셔스,2005-08
2005-08-31,1852531,5449388,-3596857,스와질랜드,2005-08
2005-08-31,1799575,92949,1706626,마다카스카르,2005-08
2005-08-31,1753536,0,1753536,지부티,2005-08
2005-08-31,1722351,0,1722351,마티니크,2005-08
2005-08-31,1636028,7310,1628718,토고,2005-08
2005-08-31,1536791,476789,1060002,아이슬란드,2005-08
2005-08-31,1478996,17610197,-16131201,잠비아,2005-08
2005-08-31,1432740,12151,1420589,불령 폴리네시아,2005-08
2005-08-31,1294187,0,1294187,네덜란드 열도,2005-08
2005-08-31,1280356,0,1280356,베닝,2005-08
2005-08-31,1238899,9011,1229888,자마이카,2005-08
2005-08-31,1215385,10281079,-9065694,파푸아 뉴기니,2005-08
2005-08-31,1158234,175075,983159,라오스,2005-08
2005-08-31,1023420,438,1022982,유고,2005-08
2005-08-31,967502,55683611,-54716109,콩고,2005-08
2005-08-31,937948,449763,488185,세네갈,2005-08
2005-08-31,921839,537,921302,아루바,2005-08
2005-08-31,909210,388210,521000,벨라루스,2005-08
2005-08-31,902707,122246,780461,네팔,2005-08
2005-08-31,893309,159861,733448,타지크,2005-08
2005-08-31,864760,298810,565950,짐바브웨,2005-08
2005-08-31,863353,629290,234063,팔레스타인 해방기구(구),2005-08
2005-08-31,801032,108735,692297,카메룬,2005-08
2005-08-31,768878,4381149,-3612271,볼리비아,2005-08
2005-08-31,765396,29,765367,수리남,2005-08
2005-08-31,732674,4538,728136,세이쉘,2005-08
2005-08-31,713070,4935882,-4222812,룩셈부르그,2005-08
2005-08-31,618433,0,618433,마이크로네시아,2005-08
2005-08-31,612700,65512,547188,아이티,2005-08
2005-08-31,595657,0,595657,영령 캐이맨 군도,2005-08
2005-08-31,578913,208431,370482,조지아,2005-08
2005-08-31,563498,420102,143396,우간다,2005-08
2005-08-31,554680,19796,534884,바베이도스,2005-08
2005-08-31,489708,0,489708,사모아,2005-08
2005-08-31,464771,27168,437603,보츠와나,2005-08
2005-08-31,447865,1680233,-1232368,가봉,2005-08
2005-08-31,443462,0,443462,에리트리아,2005-08
2005-08-31,383974,0,383974,모잠비크,2005-08
2005-08-31,372641,0,372641,콩고민주공화국,2005-08
2005-08-31,366981,7801,359180,아르메니아,2005-08
2005-08-31,309905,864,309041,알바니아,2005-08
2005-08-31,264089,42766,221323,말라위,2005-08
2005-08-31,239664,36096,203568,시에라 리온,2005-08
2005-08-31,226446,0,226446,바누아투,2005-08
2005-08-31,223272,18665,204607,아메리칸 사모아,2005-08
2005-08-31,210044,19654,190390,모리타니,2005-08
2005-08-31,203609,0,203609,감비아,2005-08
2005-08-31,169851,0,169851,몰디브,2005-08
2005-08-31,164215,0,164215,부탄,2005-08
2005-08-31,163803,261895,-98092,부르키나 파소,2005-08
2005-08-31,159909,0,159909,안티가 바부다,2005-08
2005-08-31,156601,28381,128220,보스니아-헤르체고비나,2005-08
2005-08-31,151248,30750,120498,투르크멘,2005-08
2005-08-31,149462,226838,-77376,리히텐슈타인,2005-08
2005-08-31,148771,267420,-118649,팔라우,2005-08
2005-08-31,129216,0,129216,소말리아,2005-08
2005-08-31,123774,0,123774,그레나다,2005-08
2005-08-31,123273,0,123273,불령 가이아나,2005-08
2005-08-31,121414,14853,106561,안도라,2005-08
2005-08-31,120079,26071,94008,마세도니아,2005-08
2005-08-31,118394,1375863,-1257469,솔로몬 군도,2005-08
2005-08-31,115580,0,115580,니제르,2005-08
2005-08-31,95444,1692778,-1597334,벨리제,2005-08
2005-08-31,95035,0,95035,세인트 빈센트 그레나딘,2005-08
2005-08-31,87265,0,87265,세인트 루시아,2005-08
2005-08-31,86948,389244,-302296,모나코,2005-08
2005-08-31,86604,17558,69046,세르비아 와 몬테네그로,2005-08
2005-08-31,85310,0,85310,지브랄타,2005-08
2005-08-31,82814,1982773,-1899959,나미비아,2005-08
2005-08-31,75441,0,75441,부룬디,2005-08
2005-08-31,67863,0,67863,통가,2005-08
2005-08-31,60822,0,60822,세인트 키츠 네비스,2005-08
2005-08-31,55389,0,55389,가이아나,2005-08
2005-08-31,53300,0,53300,르완다,2005-08
2005-08-31,47387,36806,10581,몰도바,2005-08
2005-08-31,27580,12857,14723,토켈라우,2005-08
2005-08-31,26657,236544,-209887,말리,2005-08
2005-08-31,25405,76037,-50632,챠드,2005-08
2005-08-31,24584,204150,-179566,영령 버진군도,2005-08
2005-08-31,21848,0,21848,투르크 & 카이코스 군도,2005-08
2005-08-31,15352,0,15352,상토메 프린스페,2005-08
2005-08-31,12803,0,12803,중앙아프리카공화국,2005-08
2005-08-31,12746,0,12746,앙귈라,2005-08
2005-08-31,12395,0,12395,투발루,2005-08
2005-08-31,10800,0,10800,적도 기니,2005-08
2005-08-31,380,0,380,세인트 헬레나,2005-08
2005-08-31,0,1800,-1800,티모르,2005-08
2005-08-31,0,31000,-31000,그린랜드,2005-08
2005-08-31,0,21456,-21456,쿡 아일랜드,2005-08
2005-08-31,0,1362,-1362,교황청,2005-08
2005-08-31,0,105600,-105600,파로에 군도,2005-08
2005-08-31,0,258375,-258375,기네비소,2005-08
2005-08-31,0,2941,-2941,키리바티,2005-08
2005-08-31,0,527,-527,코스 군도,2005-08
2005-08-31,0,27203,-27203,마이너 아우틀링 합중국 군도,2005-08
2005-08-31,0,12130608,-12130608,미령 버진군도,2005-08
2005-08-31,0,122616,-122616,크리스마스 아일랜드,2005-08
2005-09-30,5540811566,3189359496,2351452070,중국,2005-09
2005-09-30,3535927648,2357418201,1178509447,미국,2005-09
2005-09-30,2038942000,4279925886,-2240983886,일본,2005-09
2005-09-30,1398080921,164886549,1233194372,홍콩,2005-09
2005-09-30,919208079,701108459,218099620,대만,2005-09
2005-09-30,828353333,862882396,-34529063,독일,2005-09
2005-09-30,671381284,561108831,110272453,싱가포르,2005-09
2005-09-30,508297401,468708382,39589019,말레이시아,2005-09
2005-09-30,506061702,243097215,262964487,영국,2005-09
2005-09-30,445480007,701907752,-256427745,인도네시아,2005-09
2005-09-30,414605069,186505889,228099180,인도,2005-09
2005-09-30,394502276,184777929,209724347,네덜란드,2005-09
2005-09-30,355652041,886413363,-530761322,호주,2005-09
2005-09-30,329475801,305634971,23840830,러시아 연방,2005-09
2005-09-30,316001697,32151327,283850370,멕시코,2005-09
2005-09-30,306039562,58634998,247404564,베트남,2005-09
2005-09-30,278753625,229657624,49096001,태국,2005-09
2005-09-30,264238000,240805909,23432091,프랑스,2005-09
2005-09-30,263502849,57230862,206271987,나이지리아,2005-09
2005-09-30,263387293,186658384,76728909,필리핀,2005-09
2005-09-30,262026524,216745416,45281108,이탈리아,2005-09
2005-09-30,237099277,268464231,-31364954,캐나다,2005-09
2005-09-30,226295885,980101429,-753805544,아랍에미리트 연합,2005-09
2005-09-30,222933131,234898032,-11964901,브라질,2005-09
2005-09-30,212155682,1485846587,-1273690905,사우디아라비아,2005-09
2005-09-30,210199532,9338785,200860747,튀르키예,2005-09
2005-09-30,190183626,39546721,150636905,핀란드,2005-09
2005-09-30,184865365,364585053,-179719688,이란,2005-09
2005-09-30,182998334,0,182998334,마샬군도,2005-09
2005-09-30,179887951,58961990,120925961,스페인,2005-09
2005-09-30,147074547,134821,146939726,라이베리아,2005-09
2005-09-30,137013489,174089,136839400,사이프러스,2005-09
2005-09-30,123324982,12896117,110428865,헝가리,2005-09
2005-09-30,115097582,203266380,-88168798,칠레,2005-09
2005-09-30,114730581,19032015,95698566,파나마,2005-09
2005-09-30,114429535,111268243,3161292,남아프리카공화국,2005-09
2005-09-30,113103845,9180648,103923197,폴란드,2005-09
2005-09-30,105543505,3000469,102543036,그리스,2005-09
2005-09-30,103428981,57609361,45819620,스웨덴,2005-09
2005-09-30,101980437,86206587,15773850,벨기에,2005-09
2005-09-30,79641646,3112439,76529207,슬로바키아,2005-09
2005-09-30,76086883,44545004,31541879,오스트리아,2005-09
2005-09-30,71181096,52689055,18492041,이스라엘,2005-09
2005-09-30,64308829,30576730,33732099,우크라이나,2005-09
2005-09-30,63260249,14672715,48587534,이집트,2005-09
2005-09-30,62410509,772855,61637654,과테말라,2005-09
2005-09-30,61182750,3832384,57350366,방글라데시,2005-09
2005-09-30,57166730,483945947,-426779217,카타르,2005-09
2005-09-30,54080355,7503624,46576731,콜롬비아,2005-09
2005-09-30,51082054,40085817,10996237,파키스탄,2005-09
2005-09-30,49954067,4014680,45939387,페루,2005-09
2005-09-30,48288806,70515782,-22226976,뉴질랜드,2005-09
2005-09-30,45148116,1740794,43407322,우즈베키스탄,2005-09
2005-09-30,43437654,71406018,-27968364,아일랜드,2005-09
2005-09-30,36098171,117000,35981171,리비아,2005-09
2005-09-30,34219664,20109109,14110555,아르헨티나,2005-09
2005-09-30,34209957,602490660,-568280703,쿠웨이트,2005-09
2005-09-30,33884770,3238772,30645998,요르단,2005-09
2005-09-30,33724851,1249386,32475465,베네주엘라,2005-09
2005-09-30,32383047,7904020,24479027,루마니아,2005-09
2005-09-30,29531367,84961666,-55430299,스위스,2005-09
2005-09-30,28345000,7904471,20440529,모로코,2005-09
2005-09-30,27977012,53054605,-25077593,덴마크,2005-09
2005-09-30,27010050,563981295,-536971245,오만,2005-09
2005-09-30,26386353,36924,26349429,시리아,2005-09
2005-09-30,25760869,14196240,11564629,체코공화국,2005-09
2005-09-30,22706711,18314703,4392008,카자흐스탄,2005-09
2005-09-30,21478637,2391855,19086782,몰타,2005-09
2005-09-30,21346642,4677182,16669460,포루투갈,2005-09
2005-09-30,20379701,4193828,16185873,스리랑카,2005-09
2005-09-30,19632130,619241,19012889,에쿠아도르,2005-09
2005-09-30,16905141,15444,16889697,알제리,2005-09
2005-09-30,15386783,5177079,10209704,기타국,2005-09
2005-09-30,13770695,49628,13721067,수단,2005-09
2005-09-30,13744853,4252157,9492696,코스타리카,2005-09
2005-09-30,13604490,338226,13266264,캄보디아,2005-09
2005-09-30,13218786,51554543,-38335757,노르웨이,2005-09
2005-09-30,12666787,25685654,-13018867,미얀마,2005-09
2005-09-30,11543042,500134,11042908,리투아니아,2005-09
2005-09-30,9725886,1830212,7895674,온두라스,2005-09
2005-09-30,9550565,39972123,-30421558,바레인,2005-09
2005-09-30,9522016,64701,9457315,니카라과,2005-09
2005-09-30,9402602,13923827,-4521225,푸에르토리코,2005-09
2005-09-30,9164516,8757411,407105,도미니카 공화국,2005-09
2005-09-30,8878596,964923,7913673,튀니지,2005-09
2005-09-30,7767909,124885,7643024,레바논,2005-09
2005-09-30,7656296,55371497,-47715201,예맨,2005-09
2005-09-30,7394572,801006,6593566,가나,2005-09
2005-09-30,7248446,265865,6982581,몽골,2005-09
2005-09-30,6980811,29511,6951300,키르기스스탄,2005-09
2005-09-30,6906952,1553198,5353754,불가리아,2005-09
2005-09-30,6811953,1497111,5314842,우루과이,2005-09
2005-09-30,6439962,45058,6394904,북마리아나 군도,2005-09
2005-09-30,5814229,581773,5232456,케냐,2005-09
2005-09-30,4851925,513056,4338869,라트비아,2005-09
2005-09-30,4838193,1700,4836493,도미니카,2005-09
2005-09-30,4785872,76840426,-72054554,브루나이,2005-09
2005-09-30,4671790,1223080,3448710,슬로베니아,2005-09
2005-09-30,4541539,10319179,-5777640,에스토니아,2005-09
2005-09-30,4478091,312799,4165292,엘살바도르,2005-09
2005-09-30,4223281,315,4222966,아프카니스탄,2005-09
2005-09-30,4205681,0,4205681,이라크,2005-09
2005-09-30,3977021,136573,3840448,앙골라,2005-09
2005-09-30,3378614,0,3378614,불령 리유니온 코모도 제도,2005-09
2005-09-30,3273196,7909,3265287,괌,2005-09
2005-09-30,3206756,674,3206082,아제르바이잔,2005-09
2005-09-30,3116836,379084,2737752,크로아티아,2005-09
2005-09-30,3112939,289204,2823735,파라과이,2005-09
2005-09-30,2745585,102244,2643341,탄자니아,2005-09
2005-09-30,2701590,0,2701590,코트디봐르,2005-09
2005-09-30,2345391,494758,1850633,마카오,2005-09
2005-09-30,2344822,693057,1651765,아이슬란드,2005-09
2005-09-30,2331185,0,2331185,지부티,2005-09
2005-09-30,2237264,11193246,-8955982,뉴 칼레도니아,2005-09
2005-09-30,2177238,2467548,-290310,에티오피아,2005-09
2005-09-30,2176565,0,2176565,토고,2005-09
2005-09-30,2149843,0,2149843,베닝,2005-09
2005-09-30,2025684,28934,1996750,모리셔스,2005-09
2005-09-30,1936252,127,1936125,트리니다드 토바고,2005-09
2005-09-30,1835127,225701,1609426,라오스,2005-09
2005-09-30,1726109,38024,1688085,콩고,2005-09
2005-09-30,1698494,0,1698494,마티니크,2005-09
2005-09-30,1635417,173818,1461599,자마이카,2005-09
2005-09-30,1587548,270804,1316744,벨라루스,2005-09
2005-09-30,1540526,29683352,-28142826,잠비아,2005-09
2005-09-30,1516852,423256,1093596,세네갈,2005-09
2005-09-30,1241400,1638039,-396639,짐바브웨,2005-09
2005-09-30,1224615,5679820,-4455205,룩셈부르그,2005-09
2005-09-30,1204620,120400,1084220,타지크,2005-09
2005-09-30,1076075,2028779,-952704,파푸아 뉴기니,2005-09
2005-09-30,1016705,175558,841147,팔레스타인 해방기구(구),2005-09
2005-09-30,993135,127,993008,보스니아-헤르체고비나,2005-09
2005-09-30,992411,417289,575122,마다카스카르,2005-09
2005-09-30,927689,0,927689,과델로프,2005-09
2005-09-30,926652,0,926652,유고,2005-09
2005-09-30,917214,0,917214,아루바,2005-09
2005-09-30,845212,4158979,-3313767,나미비아,2005-09
2005-09-30,832501,119431,713070,바하마,2005-09
2005-09-30,785693,4923017,-4137324,조지아,2005-09
2005-09-30,773800,0,773800,불령 폴리네시아,2005-09
2005-09-30,737988,830478,-92490,피지,2005-09
2005-09-30,689966,0,689966,수리남,2005-09
2005-09-30,669648,34014937,-33345289,카메룬,2005-09
2005-09-30,651024,0,651024,네덜란드 열도,2005-09
2005-09-30,595488,3215906,-2620418,스와질랜드,2005-09
2005-09-30,580152,49905,530247,모잠비크,2005-09
2005-09-30,555588,2702844,-2147256,볼리비아,2005-09
2005-09-30,545902,1939,543963,불령 가이아나,2005-09
2005-09-30,514356,0,514356,아이티,2005-09
2005-09-30,463627,44521,419106,알바니아,2005-09
2005-09-30,458613,1180,457433,바베이도스,2005-09
2005-09-30,456102,17637,438465,네팔,2005-09
2005-09-30,449498,109862,339636,투르크멘,2005-09
2005-09-30,447924,0,447924,레소토,2005-09
2005-09-30,440656,73920,366736,니제르,2005-09
2005-09-30,417002,0,417002,챠드,2005-09
2005-09-30,412362,20975143,-20562781,기니,2005-09
2005-09-30,345279,162378,182901,리히텐슈타인,2005-09
2005-09-30,339551,0,339551,모리타니,2005-09
2005-09-30,332679,19751,312928,마세도니아,2005-09
2005-09-30,331467,0,331467,가이아나,2005-09
2005-09-30,316206,5545,310661,세이쉘,2005-09
2005-09-30,312937,0,312937,버뮤다,2005-09
2005-09-30,300611,575535,-274924,우간다,2005-09
2005-09-30,283249,0,283249,감비아,2005-09
2005-09-30,278601,0,278601,마이크로네시아,2005-09
2005-09-30,272098,0,272098,안티가 바부다,2005-09
2005-09-30,262187,2400,259787,사모아,2005-09
2005-09-30,238918,0,238918,소말리아,2005-09
2005-09-30,226988,21076,205912,보츠와나,2005-09
2005-09-30,210521,0,210521,그레나다,2005-09
2005-09-30,206310,0,206310,부탄,2005-09
2005-09-30,186864,883280,-696416,벨리제,2005-09
2005-09-30,185677,13085,172592,콩고민주공화국,2005-09
2005-09-30,178789,8172,170617,아르메니아,2005-09
2005-09-30,178179,60735,117444,안도라,2005-09
2005-09-30,175903,42766,133137,말라위,2005-09
2005-09-30,173740,0,173740,팔라우,2005-09
2005-09-30,171347,225822,-54475,몰도바,2005-09
2005-09-30,159344,0,159344,바누아투,2005-09
2005-09-30,152688,32463,120225,세르비아 와 몬테네그로,2005-09
2005-09-30,151501,33466,118035,통가,2005-09
2005-09-30,150010,0,150010,부룬디,2005-09
2005-09-30,133363,14064,119299,아메리칸 사모아,2005-09
2005-09-30,122926,0,122926,영령 캐이맨 군도,2005-09
2005-09-30,121243,126256,-5013,말리,2005-09
2005-09-30,105014,1381953,-1276939,솔로몬 군도,2005-09
2005-09-30,100363,4380588,-4280225,가봉,2005-09
2005-09-30,87809,0,87809,몰디브,2005-09
2005-09-30,67617,0,67617,스발비드 군도,2005-09
2005-09-30,66741,13751,52990,토켈라우,2005-09
2005-09-30,64203,0,64203,르완다,2005-09
2005-09-30,57915,0,57915,카보 베르데,2005-09
2005-09-30,53750,0,53750,적도 기니,2005-09
2005-09-30,50533,0,50533,쿡 아일랜드,2005-09
2005-09-30,47757,0,47757,지브랄타,2005-09
2005-09-30,43976,0,43976,상토메 프린스페,2005-09
2005-09-30,42367,39485,2882,중앙아프리카공화국,2005-09
2005-09-30,31712,0,31712,티모르,2005-09
2005-09-30,27124,0,27124,투발루,2005-09
2005-09-30,26348,0,26348,영령 버진군도,2005-09
2005-09-30,21198,343196,-321998,모나코,2005-09
2005-09-30,20332,52048,-31716,부르키나 파소,2005-09
2005-09-30,20177,0,20177,에리트리아,2005-09
2005-09-30,18720,0,18720,코모로스,2005-09
2005-09-30,15822,0,15822,투르크 & 카이코스 군도,2005-09
2005-09-30,13862,0,13862,세인트 루시아,2005-09
2005-09-30,2508,0,2508,왈라스 & 퓨투나 군도,2005-09
2005-09-30,2447,0,2447,미령 버진군도,2005-09
2005-09-30,456,189851,-189395,기네비소,2005-09
2005-09-30,395,0,395,세인트 빈센트 그레나딘,2005-09
2005-09-30,0,896,-896,마이너 아우틀링 합중국 군도,2005-09
2005-09-30,0,770,-770,크리스마스 아일랜드,2005-09
2005-09-30,0,192103,-192103,세인트 헬레나,2005-09
2005-09-30,0,1,-1,허드 앤 맥도날드 군도,2005-09
2005-09-30,0,343719,-343719,그린랜드,2005-09
2005-09-30,0,266,-266,세인트 키츠 네비스,2005-09
2005-09-30,0,3735,-3735,몬트세라트,2005-09
2005-09-30,0,24493,-24493,나우루,2005-09
2005-09-30,0,2409,-2409,시에라 리온,2005-09
2005-10-31,5493539451,3350890011,2142649440,중국,2005-10
2005-10-31,3602662419,2459470489,1143191930,미국,2005-10
2005-10-31,2052962512,4243038233,-2190075721,일본,2005-10
2005-10-31,1508431704,181056052,1327375652,홍콩,2005-10
2005-10-31,948671118,700381110,248290008,대만,2005-10
2005-10-31,838777897,812316590,26461307,독일,2005-10
2005-10-31,627184304,524130456,103053848,싱가포르,2005-10
2005-10-31,419784073,229272051,190512022,영국,2005-10
2005-10-31,416096395,887908772,-471812377,호주,2005-10
2005-10-31,414863426,223795989,191067437,인도,2005-10
2005-10-31,403408555,721467399,-318058844,인도네시아,2005-10
2005-10-31,397893245,21369,397871876,바하마,2005-10
2005-10-31,386914044,46258030,340656014,멕시코,2005-10
2005-10-31,343445362,176170699,167274663,네덜란드,2005-10
2005-10-31,339240311,191823113,147417198,이탈리아,2005-10
2005-10-31,338277923,511045387,-172767464,말레이시아,2005-10
2005-10-31,333047006,332429383,617623,러시아 연방,2005-10
2005-10-31,320130952,229853106,90277846,캐나다,2005-10
2005-10-31,292958163,175568872,117389291,필리핀,2005-10
2005-10-31,283130514,208817801,74312713,프랑스,2005-10
2005-10-31,267846501,272606247,-4759746,태국,2005-10
2005-10-31,259982890,11203794,248779096,튀르키예,2005-10
2005-10-31,259194900,64119620,195075280,베트남,2005-10
2005-10-31,254833379,3377248,251456131,그리스,2005-10
2005-10-31,237934961,836442819,-598507858,아랍에미리트 연합,2005-10
2005-10-31,236823521,43986479,192837042,스페인,2005-10
2005-10-31,224046260,60170901,163875359,핀란드,2005-10
2005-10-31,211723782,203035880,8687902,브라질,2005-10
2005-10-31,196894884,1702949649,-1506054765,사우디아라비아,2005-10
2005-10-31,174258788,286748516,-112489728,이란,2005-10
2005-10-31,158117324,0,158117324,버뮤다,2005-10
2005-10-31,143492510,3971938,139520572,슬로바키아,2005-10
2005-10-31,142626190,10605968,132020222,헝가리,2005-10
2005-10-31,124256696,71007924,53248772,남아프리카공화국,2005-10
2005-10-31,122150425,106207,122044218,사이프러스,2005-10
2005-10-31,118289833,16344,118273489,라이베리아,2005-10
2005-10-31,115785952,25599477,90186475,파나마,2005-10
2005-10-31,114784062,10353241,104430821,폴란드,2005-10
2005-10-31,100402566,81070120,19332446,벨기에,2005-10
2005-10-31,99528024,192105058,-92577034,칠레,2005-10
2005-10-31,97489407,3719187,93770220,몰타,2005-10
2005-10-31,96435201,52498994,43936207,오스트리아,2005-10
2005-10-31,82078707,0,82078707,마샬군도,2005-10
2005-10-31,75478495,12413029,63065466,이집트,2005-10
2005-10-31,73966201,73695441,270760,스웨덴,2005-10
2005-10-31,70319437,9037171,61282266,기타국,2005-10
2005-10-31,68812773,40837407,27975366,이스라엘,2005-10
2005-10-31,63725912,4069616,59656296,우크라이나,2005-10
2005-10-31,60495729,48635532,11860197,노르웨이,2005-10
2005-10-31,58342259,44197175,14145084,파키스탄,2005-10
2005-10-31,51200963,52483277,-1282314,나이지리아,2005-10
2005-10-31,50810719,65340333,-14529614,뉴질랜드,2005-10
2005-10-31,48301052,12912851,35388201,콜롬비아,2005-10
2005-10-31,46842804,2490551,44352253,우즈베키스탄,2005-10
2005-10-31,45228708,4016906,41211802,방글라데시,2005-10
2005-10-31,44727247,6127622,38599625,베네주엘라,2005-10
2005-10-31,44540002,397045237,-352505235,쿠웨이트,2005-10
2005-10-31,42275112,581359529,-539084417,카타르,2005-10
2005-10-31,40137113,44527267,-4390154,덴마크,2005-10
2005-10-31,38060797,121200082,-83139285,스위스,2005-10
2005-10-31,36958199,159797,36798402,과테말라,2005-10
2005-10-31,36223187,12574836,23648351,체코공화국,2005-10
2005-10-31,35441855,4337712,31104143,포루투갈,2005-10
2005-10-31,35428219,217175,35211044,시리아,2005-10
2005-10-31,33398994,25325359,8073635,아르헨티나,2005-10
2005-10-31,32854221,0,32854221,영령 캐이맨 군도,2005-10
2005-10-31,31851095,85466983,-53615888,아일랜드,2005-10
2005-10-31,31151891,2663099,28488792,요르단,2005-10
2005-10-31,29284682,17223903,12060779,페루,2005-10
2005-10-31,29047335,788376,28258959,에쿠아도르,2005-10
2005-10-31,28456010,2694852,25761158,루마니아,2005-10
2005-10-31,24299702,311031943,-286732241,오만,2005-10
2005-10-31,22922665,93214,22829451,괌,2005-10
2005-10-31,21434482,0,21434482,알제리,2005-10
2005-10-31,20578888,11038159,9540729,카자흐스탄,2005-10
2005-10-31,18449673,15698436,2751237,푸에르토리코,2005-10
2005-10-31,17130866,2958403,14172463,스리랑카,2005-10
2005-10-31,15925004,1135282,14789722,캄보디아,2005-10
2005-10-31,15096750,5633234,9463516,모로코,2005-10
2005-10-31,14664459,2697372,11967087,코스타리카,2005-10
2005-10-31,13038763,34180388,-21141625,바레인,2005-10
2005-10-31,12415254,176663,12238591,수단,2005-10
2005-10-31,11444050,1049278,10394772,리비아,2005-10
2005-10-31,11404387,446661,10957726,도미니카 공화국,2005-10
2005-10-31,10666731,383029,10283702,온두라스,2005-10
2005-10-31,10599033,584437,10014596,리투아니아,2005-10
2005-10-31,10239832,271027,9968805,크로아티아,2005-10
2005-10-31,9479735,14433522,-4953787,예맨,2005-10
2005-10-31,9231865,956346,8275519,레바논,2005-10
2005-10-31,9034618,6570,9028048,앙골라,2005-10
2005-10-31,8802674,31613,8771061,니카라과,2005-10
2005-10-31,8195520,368408,7827112,엘살바도르,2005-10
2005-10-31,7882922,743231,7139691,가나,2005-10
2005-10-31,7174167,3847422,3326745,미얀마,2005-10
2005-10-31,6674679,52868,6621811,북마리아나 군도,2005-10
2005-10-31,6480470,143017,6337453,몽골,2005-10
2005-10-31,6204016,8590,6195426,키르기스스탄,2005-10
2005-10-31,6059703,924630,5135073,파라과이,2005-10
2005-10-31,5873351,1878712,3994639,슬로베니아,2005-10
2005-10-31,5862741,1816291,4046450,불가리아,2005-10
2005-10-31,5536051,741510,4794541,에스토니아,2005-10
2005-10-31,5503060,596778,4906282,아이슬란드,2005-10
2005-10-31,5297003,11760702,-6463699,뉴 칼레도니아,2005-10
2005-10-31,5186236,184,5186052,아프카니스탄,2005-10
2005-10-31,4825100,735089,4090011,튀니지,2005-10
2005-10-31,4795340,222056,4573284,라트비아,2005-10
2005-10-31,4690895,253904,4436991,케냐,2005-10
2005-10-31,4644860,81502352,-76857492,브루나이,2005-10
2005-10-31,4226444,568,4225876,트리니다드 토바고,2005-10
2005-10-31,3697089,109213616,-105516527,이라크,2005-10
2005-10-31,3396417,2262671,1133746,우루과이,2005-10
2005-10-31,2811791,340978,2470813,기니,2005-10
2005-10-31,2764631,125383,2639248,네팔,2005-10
2005-10-31,2760200,0,2760200,마티니크,2005-10
2005-10-31,2615310,3853,2611457,코트디봐르,2005-10
2005-10-31,2265197,722,2264475,모리셔스,2005-10
2005-10-31,2200485,19200,2181285,아제르바이잔,2005-10
2005-10-31,2169820,7780,2162040,탄자니아,2005-10
2005-10-31,2123896,7480,2116416,베닝,2005-10
2005-10-31,1802753,51583679,-49780926,콩고,2005-10
2005-10-31,1789409,635659,1153750,마카오,2005-10
2005-10-31,1754233,70623,1683610,에티오피아,2005-10
2005-10-31,1662725,200394,1462331,세네갈,2005-10
2005-10-31,1650019,0,1650019,과델로프,2005-10
2005-10-31,1624149,31709,1592440,자마이카,2005-10
2005-10-31,1557215,64012,1493203,불령 폴리네시아,2005-10
2005-10-31,1556948,384636,1172312,벨라루스,2005-10
2005-10-31,1501411,71016,1430395,마다카스카르,2005-10
2005-10-31,1494931,0,1494931,네덜란드 열도,2005-10
2005-10-31,1487940,0,1487940,도미니카,2005-10
2005-10-31,1485157,67258,1417899,팔레스타인 해방기구(구),2005-10
2005-10-31,1447275,0,1447275,불령 리유니온 코모도 제도,2005-10
2005-10-31,1428853,0,1428853,아루바,2005-10
2005-10-31,1416720,0,1416720,토고,2005-10
2005-10-31,1286294,190377,1095917,라오스,2005-10
2005-10-31,1089899,1851,1088048,유고,2005-10
2005-10-31,1002873,97709,905164,타지크,2005-10
2005-10-31,1001874,54600070,-53598196,카메룬,2005-10
2005-10-31,986310,0,986310,바베이도스,2005-10
2005-10-31,945749,2002714,-1056965,파푸아 뉴기니,2005-10
2005-10-31,938670,0,938670,지부티,2005-10
2005-10-31,921589,0,921589,모잠비크,2005-10
2005-10-31,899348,18324,881024,아이티,2005-10
2005-10-31,892182,699196,192986,짐바브웨,2005-10
2005-10-31,851923,800,851123,안티가 바부다,2005-10
2005-10-31,736302,3695934,-2959632,스와질랜드,2005-10
2005-10-31,709589,148835,560754,피지,2005-10
2005-10-31,668452,5446641,-4778189,룩셈부르그,2005-10
2005-10-31,662532,0,662532,세이쉘,2005-10
2005-10-31,644341,82931,561410,볼리비아,2005-10
2005-10-31,599093,313129,285964,우간다,2005-10
2005-10-31,578235,5526,572709,알바니아,2005-10
2005-10-31,543950,182022,361928,조지아,2005-10
2005-10-31,503663,5200,498463,사모아,2005-10
2005-10-31,472929,0,472929,레소토,2005-10
2005-10-31,459605,77867,381738,보스니아-헤르체고비나,2005-10
2005-10-31,435965,171325,264640,리히텐슈타인,2005-10
2005-10-31,417579,371010,46569,모나코,2005-10
2005-10-31,394393,0,394393,가이아나,2005-10
2005-10-31,392954,1961242,-1568288,가봉,2005-10
2005-10-31,383673,0,383673,벨리제,2005-10
2005-10-31,379117,7909,371208,마세도니아,2005-10
2005-10-31,377891,44811,333080,모리타니,2005-10
2005-10-31,365059,49182,315877,콩고민주공화국,2005-10
2005-10-31,364186,76768,287418,몰도바,2005-10
2005-10-31,357601,0,357601,마이크로네시아,2005-10
2005-10-31,319314,7737,311577,수리남,2005-10
2005-10-31,311094,300949,10145,말라위,2005-10
2005-10-31,306512,0,306512,불령 가이아나,2005-10
2005-10-31,301518,34694,266824,보츠와나,2005-10
2005-10-31,296194,0,296194,팔라우,2005-10
2005-10-31,241312,0,241312,부탄,2005-10
2005-10-31,240344,0,240344,몰디브,2005-10
2005-10-31,232822,13377609,-13144787,나미비아,2005-10
2005-10-31,217099,0,217099,르완다,2005-10
2005-10-31,208115,413,207702,아르메니아,2005-10
2005-10-31,207243,0,207243,말리,2005-10
2005-10-31,201537,5790,195747,바누아투,2005-10
2005-10-31,176153,0,176153,그레나다,2005-10
2005-10-31,162598,1313,161285,니제르,2005-10
2005-10-31,153383,0,153383,투르크멘,2005-10
2005-10-31,140890,0,140890,에리트리아,2005-10
2005-10-31,110945,0,110945,소말리아,2005-10
2005-10-31,99598,26900013,-26800415,잠비아,2005-10
2005-10-31,96964,0,96964,감비아,2005-10
2005-10-31,92918,0,92918,지브랄타,2005-10
2005-10-31,87415,33342,54073,안도라,2005-10
2005-10-31,85463,35,85428,부르키나 파소,2005-10
2005-10-31,82179,0,82179,통가,2005-10
2005-10-31,79115,28544,50571,세르비아 와 몬테네그로,2005-10
2005-10-31,76198,621,75577,아메리칸 사모아,2005-10
2005-10-31,74346,2028,72318,쿡 아일랜드,2005-10
2005-10-31,69549,1820536,-1750987,솔로몬 군도,2005-10
2005-10-31,68598,24040,44558,세인트 루시아,2005-10
2005-10-31,60291,0,60291,적도 기니,2005-10
2005-10-31,59992,0,59992,세인트 키츠 네비스,2005-10
2005-10-31,54200,15354,38846,토켈라우,2005-10
2005-10-31,50662,42989,7673,기네비소,2005-10
2005-10-31,41532,41617,-85,시에라 리온,2005-10
2005-10-31,38700,0,38700,세인트 빈센트 그레나딘,2005-10
2005-10-31,36084,0,36084,중앙아프리카공화국,2005-10
2005-10-31,32286,0,32286,미령 버진군도,2005-10
2005-10-31,30425,3025,27400,부룬디,2005-10
2005-10-31,30062,0,30062,산마리노,2005-10
2005-10-31,29143,0,29143,투발루,2005-10
2005-10-31,27604,0,27604,영령 버진군도,2005-10
2005-10-31,23998,0,23998,파로에 군도,2005-10
2005-10-31,21558,0,21558,카보 베르데,2005-10
2005-10-31,7403,0,7403,상토메 프린스페,2005-10
2005-10-31,4948,15,4933,코스 군도,2005-10
2005-10-31,2095,0,2095,영령 인도양,2005-10
2005-10-31,0,454,-454,키리바티,2005-10
2005-10-31,0,52858790,-52858790,챠드,2005-10
2005-10-31,0,20,-20,포클랜드 군도,2005-10
2005-10-31,0,10500,-10500,티모르,2005-10
2005-10-31,0,50100,-50100,크리스마스 아일랜드,2005-10
2005-10-31,0,178495,-178495,그린랜드,2005-10
2005-11-30,5532306470,3592994437,1939312033,중국,2005-11
2005-11-30,3939417098,2567368023,1372049075,미국,2005-11
2005-11-30,2130222239,4196032126,-2065809887,일본,2005-11
2005-11-30,1518623109,213433282,1305189827,홍콩,2005-11
2005-11-30,1016462927,782319462,234143465,대만,2005-11
2005-11-30,918139983,865744666,52395317,독일,2005-11
2005-11-30,753167751,496884221,256283530,싱가포르,2005-11
2005-11-30,553087500,268290758,284796742,영국,2005-11
2005-11-30,499965816,217633828,282331988,이탈리아,2005-11
2005-11-30,408393968,158418300,249975668,인도,2005-11
2005-11-30,391888993,228054232,163834761,프랑스,2005-11
2005-11-30,384923392,847106534,-462183142,인도네시아,2005-11
2005-11-30,367230016,547074000,-179843984,말레이시아,2005-11
2005-11-30,361530903,42560554,318970349,멕시코,2005-11
2005-11-30,335296778,221889906,113406872,캐나다,2005-11
2005-11-30,317659180,985766657,-668107477,호주,2005-11
2005-11-30,308699409,347150255,-38450846,러시아 연방,2005-11
2005-11-30,305140369,63627288,241513081,베트남,2005-11
2005-11-30,302584478,235258092,67326386,네덜란드,2005-11
2005-11-30,258944966,197508909,61436057,필리핀,2005-11
2005-11-30,252636269,280107873,-27471604,태국,2005-11
2005-11-30,252501553,1040928390,-788426837,아랍에미리트 연합,2005-11
2005-11-30,241951019,9604542,232346477,튀르키예,2005-11
2005-11-30,229287124,35117914,194169210,그리스,2005-11
2005-11-30,220184014,252298326,-32114312,브라질,2005-11
2005-11-30,207201557,57213705,149987852,스페인,2005-11
2005-11-30,205438532,6684338,198754194,라이베리아,2005-11
2005-11-30,204399351,31892009,172507342,핀란드,2005-11
2005-11-30,190088405,237860084,-47771679,이란,2005-11
2005-11-30,165301678,1547431800,-1382130122,사우디아라비아,2005-11
2005-11-30,145548516,8824588,136723928,헝가리,2005-11
2005-11-30,143447841,188997813,-45549972,칠레,2005-11
2005-11-30,142326528,49291137,93035391,오스트리아,2005-11
2005-11-30,137258115,76657842,60600273,스웨덴,2005-11
2005-11-30,129347818,73270443,56077375,벨기에,2005-11
2005-11-30,124097693,89087757,35009936,남아프리카공화국,2005-11
2005-11-30,115129024,12556029,102572995,폴란드,2005-11
2005-11-30,102184121,43889987,58294134,덴마크,2005-11
2005-11-30,85181400,35912604,49268796,파나마,2005-11
2005-11-30,81184524,66424912,14759612,뉴질랜드,2005-11
2005-11-30,80983728,9857504,71126224,우크라이나,2005-11
2005-11-30,79065106,516355225,-437290119,카타르,2005-11
2005-11-30,68858686,10179,68848507,나이지리아,2005-11
2005-11-30,68418904,47924359,20494545,이스라엘,2005-11
2005-11-30,68249484,33274668,34974816,이집트,2005-11
2005-11-30,67025312,3805302,63220010,슬로바키아,2005-11
2005-11-30,66683778,0,66683778,마샬군도,2005-11
2005-11-30,61927558,26422076,35505482,파키스탄,2005-11
2005-11-30,60955992,3445403,57510589,방글라데시,2005-11
2005-11-30,54785829,10427712,44358117,콜롬비아,2005-11
2005-11-30,53298061,75149606,-21851545,아일랜드,2005-11
2005-11-30,50498715,17380,50481335,바하마,2005-11
2005-11-30,47345172,1745493,45599679,우즈베키스탄,2005-11
2005-11-30,47207529,321914,46885615,에쿠아도르,2005-11
2005-11-30,47205520,17258440,29947080,베네주엘라,2005-11
2005-11-30,46513661,466176595,-419662934,오만,2005-11
2005-11-30,40205527,4905405,35300122,루마니아,2005-11
2005-11-30,39782018,98438732,-58656714,스위스,2005-11
2005-11-30,37304059,779328293,-742024234,쿠웨이트,2005-11
2005-11-30,35130353,281737,34848616,과테말라,2005-11
2005-11-30,34706533,120362,34586171,시리아,2005-11
2005-11-30,33965675,2539810,31425865,요르단,2005-11
2005-11-30,32611253,3485682,29125571,포루투갈,2005-11
2005-11-30,32042955,1230,32041725,알제리,2005-11
2005-11-30,32041261,371544,31669717,리비아,2005-11
2005-11-30,30665416,33445197,-2779781,아르헨티나,2005-11
2005-11-30,30621827,15943297,14678530,체코공화국,2005-11
2005-11-30,28533312,5983758,22549554,페루,2005-11
2005-11-30,21149792,18437483,2712309,카자흐스탄,2005-11
2005-11-30,20996879,51004000,-30007121,바레인,2005-11
2005-11-30,19060603,3700939,15359664,기타국,2005-11
2005-11-30,17981423,301520,17679903,괌,2005-11
2005-11-30,17031351,2411187,14620164,스리랑카,2005-11
2005-11-30,16991929,7956137,9035792,모로코,2005-11
2005-11-30,16325645,3218326,13107319,코스타리카,2005-11
2005-11-30,15827600,47740106,-31912506,노르웨이,2005-11
2005-11-30,14814695,34702192,-19887497,수단,2005-11
2005-11-30,13732911,849711,12883200,캄보디아,2005-11
2005-11-30,13162512,20418246,-7255734,푸에르토리코,2005-11
2005-11-30,12416281,7152922,5263359,도미니카 공화국,2005-11
2005-11-30,11948249,227086,11721163,니카라과,2005-11
2005-11-30,11940660,51911,11888749,온두라스,2005-11
2005-11-30,10046447,843168,9203279,리투아니아,2005-11
2005-11-30,9313047,2273855,7039192,미얀마,2005-11
2005-11-30,8555687,1200161,7355526,레바논,2005-11
2005-11-30,8506366,39741,8466625,키르기스스탄,2005-11
2005-11-30,8434880,32896103,-24461223,예맨,2005-11
2005-11-30,8296151,160898,8135253,앙골라,2005-11
2005-11-30,7960924,251154,7709770,엘살바도르,2005-11
2005-11-30,7739462,1832000,5907462,슬로베니아,2005-11
2005-11-30,7591404,546866,7044538,크로아티아,2005-11
2005-11-30,6827610,59723,6767887,북마리아나 군도,2005-11
2005-11-30,6792847,3319449,3473398,불가리아,2005-11
2005-11-30,6626830,955917,5670913,파라과이,2005-11
2005-11-30,6521691,10340,6511351,아프카니스탄,2005-11
2005-11-30,6362380,465585,5896795,가나,2005-11
2005-11-30,6316615,530642,5785973,케냐,2005-11
2005-11-30,6106443,4249,6102194,에티오피아,2005-11
2005-11-30,5843478,179051,5664427,몽골,2005-11
2005-11-30,5746823,772595,4974228,튀니지,2005-11
2005-11-30,5193541,262,5193279,트리니다드 토바고,2005-11
2005-11-30,5175428,490878,4684550,라트비아,2005-11
2005-11-30,5080451,1514939,3565512,에스토니아,2005-11
2005-11-30,4298972,15263651,-10964679,뉴 칼레도니아,2005-11
2005-11-30,4228271,1934173,2294098,우루과이,2005-11
2005-11-30,4160789,1877313,2283476,기니,2005-11
2005-11-30,4018274,4032,4014242,코트디봐르,2005-11
2005-11-30,3881035,1251,3879784,불령 리유니온 코모도 제도,2005-11
2005-11-30,3324305,100890267,-97565962,브루나이,2005-11
2005-11-30,3291341,0,3291341,마티니크,2005-11
2005-11-30,2983835,481857,2501978,마카오,2005-11
2005-11-30,2777618,831106,1946512,아이슬란드,2005-11
2005-11-30,2623508,7310,2616198,모리셔스,2005-11
2005-11-30,2598519,0,2598519,아제르바이잔,2005-11
2005-11-30,2596446,1837,2594609,과델로프,2005-11
2005-11-30,2595271,429102,2166169,탄자니아,2005-11
2005-11-30,2425721,4155900,-1730179,몰타,2005-11
2005-11-30,2374925,94833,2280092,사이프러스,2005-11
2005-11-30,2319479,651603,1667876,팔레스타인 해방기구(구),2005-11
2005-11-30,2100851,134022,1966829,세네갈,2005-11
2005-11-30,1898654,0,1898654,아루바,2005-11
2005-11-30,1704059,52621487,-50917428,이라크,2005-11
2005-11-30,1611548,4009,1607539,불령 폴리네시아,2005-11
2005-11-30,1566721,4820127,-3253406,스와질랜드,2005-11
2005-11-30,1523833,0,1523833,모잠비크,2005-11
2005-11-30,1514917,41142,1473775,콩고,2005-11
2005-11-30,1497059,0,1497059,토고,2005-11
2005-11-30,1494115,56712,1437403,지부티,2005-11
2005-11-30,1449164,2326,1446838,자마이카,2005-11
2005-11-30,1399330,49573,1349757,도미니카,2005-11
2005-11-30,1256395,52933,1203462,네팔,2005-11
2005-11-30,1253633,442843,810790,라오스,2005-11
2005-11-30,1226867,55293,1171574,피지,2005-11
2005-11-30,1211819,0,1211819,베닝,2005-11
2005-11-30,1182113,1798786,-616673,짐바브웨,2005-11
2005-11-30,1155887,220103,935784,볼리비아,2005-11
2005-11-30,1123139,257184,865955,벨라루스,2005-11
2005-11-30,1112787,2106951,-994164,나미비아,2005-11
2005-11-30,1101006,0,1101006,유고,2005-11
2005-11-30,1038520,197525,840995,아이티,2005-11
2005-11-30,982245,842,981403,마다카스카르,2005-11
2005-11-30,972488,248703,723785,타지크,2005-11
2005-11-30,925350,401751,523599,카메룬,2005-11
2005-11-30,916514,456,916058,바베이도스,2005-11
2005-11-30,906110,97496,808614,조지아,2005-11
2005-11-30,804470,1035271,-230801,파푸아 뉴기니,2005-11
2005-11-30,757500,20839,736661,네덜란드 열도,2005-11
2005-11-30,665875,42486,623389,세이쉘,2005-11
2005-11-30,619551,0,619551,버뮤다,2005-11
2005-11-30,551357,0,551357,불령 가이아나,2005-11
2005-11-30,549048,48231,500817,보스니아-헤르체고비나,2005-11
2005-11-30,533852,66,533786,수리남,2005-11
2005-11-30,493683,4946,488737,우간다,2005-11
2005-11-30,490020,3590,486430,사모아,2005-11
2005-11-30,480138,233065,247073,가봉,2005-11
2005-11-30,466036,2450,463586,마이크로네시아,2005-11
2005-11-30,444915,7185566,-6740651,룩셈부르그,2005-11
2005-11-30,431782,9331,422451,아르메니아,2005-11
2005-11-30,418105,0,418105,그레나다,2005-11
2005-11-30,406380,319867,86513,바누아투,2005-11
2005-11-30,376546,0,376546,안티가 바부다,2005-11
2005-11-30,369787,443238,-73451,벨리제,2005-11
2005-11-30,368348,4910,363438,부탄,2005-11
2005-11-30,364356,172,364184,영령 캐이맨 군도,2005-11
2005-11-30,321081,133506,187575,리히텐슈타인,2005-11
2005-11-30,287947,43664,244283,보츠와나,2005-11
2005-11-30,287894,172175,115719,말라위,2005-11
2005-11-30,276134,0,276134,마세도니아,2005-11
2005-11-30,274181,1027,273154,알바니아,2005-11
2005-11-30,260273,0,260273,감비아,2005-11
2005-11-30,247236,5377,241859,가이아나,2005-11
2005-11-30,239622,19808,219814,세르비아 와 몬테네그로,2005-11
2005-11-30,235976,0,235976,몰디브,2005-11
2005-11-30,213697,2012676,-1798979,솔로몬 군도,2005-11
2005-11-30,198747,0,198747,콩고민주공화국,2005-11
2005-11-30,196797,142339,54458,몰도바,2005-11
2005-11-30,149147,0,149147,아메리칸 사모아,2005-11
2005-11-30,130485,10644,119841,팔라우,2005-11
2005-11-30,125646,0,125646,세인트 헬레나,2005-11
2005-11-30,114391,96929,17462,시에라 리온,2005-11
2005-11-30,110384,20709949,-20599565,잠비아,2005-11
2005-11-30,99556,0,99556,모리타니,2005-11
2005-11-30,91578,457630,-366052,니제르,2005-11
2005-11-30,84296,0,84296,세인트 키츠 네비스,2005-11
2005-11-30,84000,0,84000,소말리아,2005-11
2005-11-30,82279,0,82279,부르키나 파소,2005-11
2005-11-30,69809,278721,-208912,투르크멘,2005-11
2005-11-30,62981,1105,61876,안도라,2005-11
2005-11-30,43000,0,43000,중앙아프리카공화국,2005-11
2005-11-30,40585,0,40585,세인트 루시아,2005-11
2005-11-30,36056,0,36056,에리트리아,2005-11
2005-11-30,35545,0,35545,세인트 빈센트 그레나딘,2005-11
2005-11-30,21972,708,21264,지브랄타,2005-11
2005-11-30,21053,0,21053,말리,2005-11
2005-11-30,20853,215,20638,상토메 프린스페,2005-11
2005-11-30,20756,775802,-755046,모나코,2005-11
2005-11-30,20096,0,20096,적도 기니,2005-11
2005-11-30,16941,0,16941,통가,2005-11
2005-11-30,5991,0,5991,르완다,2005-11
2005-11-30,4307,0,4307,산마리노,2005-11
2005-11-30,3953,9285,-5332,토켈라우,2005-11
2005-11-30,3388,0,3388,몬트세라트,2005-11
2005-11-30,3268,0,3268,앙귈라,2005-11
2005-11-30,1374,1980277,-1978903,미령 버진군도,2005-11
2005-11-30,1255,0,1255,티모르,2005-11
2005-11-30,0,4156,-4156,카보 베르데,2005-11
2005-11-30,0,35719,-35719,기네비소,2005-11
2005-11-30,0,20570,-20570,크리스마스 아일랜드,2005-11
2005-11-30,0,105135,-105135,그린랜드,2005-11
2005-11-30,0,18225,-18225,노폴크 아일랜드,2005-11
2005-11-30,0,126,-126,코스 군도,2005-11
2005-11-30,0,192302,-192302,챠드,2005-11
2005-11-30,0,11336,-11336,레소토,2005-11
2005-12-31,5484570863,3388440992,2096129871,중국,2005-12
2005-12-31,3673982901,2745335262,928647639,미국,2005-12
2005-12-31,2208632472,4114205404,-1905572932,일본,2005-12
2005-12-31,1455630080,180426842,1275203238,홍콩,2005-12
2005-12-31,960519429,755921244,204598185,대만,2005-12
2005-12-31,812943818,946655832,-133712014,독일,2005-12
2005-12-31,667704897,397300731,270404166,싱가포르,2005-12
2005-12-31,523666444,218982534,304683910,영국,2005-12
2005-12-31,489723803,903418014,-413694211,인도네시아,2005-12
2005-12-31,454679669,231053509,223626160,인도,2005-12
2005-12-31,450552493,236887556,213664937,이탈리아,2005-12
2005-12-31,387235731,242452372,144783359,네덜란드,2005-12
2005-12-31,375158252,492368039,-117209787,말레이시아,2005-12
2005-12-31,364619763,949071060,-584451297,호주,2005-12
2005-12-31,341300155,470637,340829518,파나마,2005-12
2005-12-31,332399685,42120458,290279227,멕시코,2005-12
2005-12-31,323963405,240192568,83770837,캐나다,2005-12
2005-12-31,301396948,374371949,-72975001,러시아 연방,2005-12
2005-12-31,295145605,208911090,86234515,필리핀,2005-12
2005-12-31,273034104,776,273033328,라이베리아,2005-12
2005-12-31,261940198,259751593,2188605,태국,2005-12
2005-12-31,260584878,61641454,198943424,베트남,2005-12
2005-12-31,258346240,267347600,-9001360,프랑스,2005-12
2005-12-31,251144491,57512217,193632274,스페인,2005-12
2005-12-31,236583619,13385175,223198444,튀르키예,2005-12
2005-12-31,223843370,1047387402,-823544032,아랍에미리트 연합,2005-12
2005-12-31,197131148,523934012,-326802864,이란,2005-12
2005-12-31,195020623,275979544,-80958921,브라질,2005-12
2005-12-31,181144836,1691956977,-1510812141,사우디아라비아,2005-12
2005-12-31,163254372,194,163254178,버뮤다,2005-12
2005-12-31,148887387,355124,148532263,사이프러스,2005-12
2005-12-31,146839142,9549376,137289766,폴란드,2005-12
2005-12-31,138038346,38114564,99923782,핀란드,2005-12
2005-12-31,136089113,0,136089113,마샬군도,2005-12
2005-12-31,118738293,84642258,34096035,벨기에,2005-12
2005-12-31,104092958,22345603,81747355,헝가리,2005-12
2005-12-31,102516324,60852673,41663651,오스트리아,2005-12
2005-12-31,100474187,94076942,6397245,스위스,2005-12
2005-12-31,100323712,628792856,-528469144,카타르,2005-12
2005-12-31,99865980,256500847,-156634867,칠레,2005-12
2005-12-31,98198454,121583618,-23385164,남아프리카공화국,2005-12
2005-12-31,79499299,5461650,74037649,그리스,2005-12
2005-12-31,78413322,63832824,14580498,이집트,2005-12
2005-12-31,75092111,19695218,55396893,콜롬비아,2005-12
2005-12-31,74847187,110853384,-36006197,스웨덴,2005-12
2005-12-31,74306126,40570375,33735751,우크라이나,2005-12
2005-12-31,69220049,2599272,66620777,슬로바키아,2005-12
2005-12-31,67577604,15069,67562535,나이지리아,2005-12
2005-12-31,66104843,2759570,63345273,몰타,2005-12
2005-12-31,61053916,6076578,54977338,루마니아,2005-12
2005-12-31,59166809,47328336,11838473,이스라엘,2005-12
2005-12-31,58151211,2801410,55349801,방글라데시,2005-12
2005-12-31,56949609,44341344,12608265,파키스탄,2005-12
2005-12-31,51189861,278173,50911688,과테말라,2005-12
2005-12-31,50640451,71967110,-21326659,뉴질랜드,2005-12
2005-12-31,46968089,46724392,243697,덴마크,2005-12
2005-12-31,45047493,376678134,-331630641,오만,2005-12
2005-12-31,43353725,2734601,40619124,우즈베키스탄,2005-12
2005-12-31,42183216,97390994,-55207778,아일랜드,2005-12
2005-12-31,40840520,133854,40706666,시리아,2005-12
2005-12-31,39268141,1178,39266963,알제리,2005-12
2005-12-31,34743097,1364639,33378458,요르단,2005-12
2005-12-31,34292000,26808169,7483831,아르헨티나,2005-12
2005-12-31,30769366,445038901,-414269535,쿠웨이트,2005-12
2005-12-31,30593329,1043780,29549549,베네주엘라,2005-12
2005-12-31,28480061,4108444,24371617,포루투갈,2005-12
2005-12-31,27930809,20872139,7058670,카자흐스탄,2005-12
2005-12-31,26645801,592905,26052896,에쿠아도르,2005-12
2005-12-31,26454921,17363393,9091528,체코공화국,2005-12
2005-12-31,22899263,118360,22780903,리비아,2005-12
2005-12-31,22031863,48907970,-26876107,노르웨이,2005-12
2005-12-31,20504180,35895007,-15390827,페루,2005-12
2005-12-31,19941901,4345024,15596877,기타국,2005-12
2005-12-31,18945531,10430195,8515336,푸에르토리코,2005-12
2005-12-31,18915416,543425,18371991,괌,2005-12
2005-12-31,16699203,3148834,13550369,코스타리카,2005-12
2005-12-31,16674539,3737166,12937373,모로코,2005-12
2005-12-31,14774947,3163394,11611553,스리랑카,2005-12
2005-12-31,14511455,48964,14462491,온두라스,2005-12
2005-12-31,13940940,134761,13806179,캄보디아,2005-12
2005-12-31,13782677,202104,13580573,수단,2005-12
2005-12-31,13573416,7926378,5647038,바레인,2005-12
2005-12-31,13456647,447789,13008858,케냐,2005-12
2005-12-31,12066675,1906622,10160053,레바논,2005-12
2005-12-31,12049519,1842782,10206737,미얀마,2005-12
2005-12-31,11999199,3323,11995876,지브랄타,2005-12
2005-12-31,11206735,17816,11188919,니카라과,2005-12
2005-12-31,10984441,7432801,3551640,도미니카 공화국,2005-12
2005-12-31,10699816,353937,10345879,크로아티아,2005-12
2005-12-31,8306791,499157,7807634,튀니지,2005-12
2005-12-31,8204879,2734717,5470162,우루과이,2005-12
2005-12-31,7513904,4179440,3334464,불가리아,2005-12
2005-12-31,7509699,770082,6739617,리투아니아,2005-12
2005-12-31,7125256,2189066,4936190,슬로베니아,2005-12
2005-12-31,6605772,50077,6555695,북마리아나 군도,2005-12
2005-12-31,6281858,99967,6181891,엘살바도르,2005-12
2005-12-31,6245623,534949,5710674,가나,2005-12
2005-12-31,6102337,418489,5683848,키르기스스탄,2005-12
2005-12-31,6081498,77265,6004233,예맨,2005-12
2005-12-31,5895164,162378,5732786,몽골,2005-12
2005-12-31,5796641,58509,5738132,앙골라,2005-12
2005-12-31,5588280,101095400,-95507120,이라크,2005-12
2005-12-31,4957376,15111,4942265,아프카니스탄,2005-12
2005-12-31,4801669,0,4801669,불령 리유니온 코모도 제도,2005-12
2005-12-31,4770688,646579,4124109,파라과이,2005-12
2005-12-31,4394025,0,4394025,트리니다드 토바고,2005-12
2005-12-31,4159787,160500,3999287,탄자니아,2005-12
2005-12-31,3900205,1389102,2511103,아이슬란드,2005-12
2005-12-31,3853837,1132338,2721499,에스토니아,2005-12
2005-12-31,3835547,0,3835547,아제르바이잔,2005-12
2005-12-31,3691111,1721250,1969861,뉴 칼레도니아,2005-12
2005-12-31,3651066,14568,3636498,코트디봐르,2005-12
2005-12-31,3376851,149807,3227044,에티오피아,2005-12
2005-12-31,3219814,534411,2685403,라트비아,2005-12
2005-12-31,2910113,530662,2379451,마카오,2005-12
2005-12-31,2905346,239210,2666136,벨라루스,2005-12
2005-12-31,2606683,25199866,-22593183,스와질랜드,2005-12
2005-12-31,2311410,0,2311410,마티니크,2005-12
2005-12-31,2300700,1017,2299683,아루바,2005-12
2005-12-31,2257434,293932,1963502,세네갈,2005-12
2005-12-31,2206257,146119625,-143913368,브루나이,2005-12
2005-12-31,2187846,229148,1958698,아이티,2005-12
2005-12-31,2048685,8370503,-6321818,룩셈부르그,2005-12
2005-12-31,1869343,49935321,-48065978,콩고,2005-12
2005-12-31,1800123,42290,1757833,네팔,2005-12
2005-12-31,1790477,18711,1771766,자마이카,2005-12
2005-12-31,1787637,18,1787619,토고,2005-12
2005-12-31,1547943,158767,1389176,모리셔스,2005-12
2005-12-31,1509464,0,1509464,네덜란드 열도,2005-12
2005-12-31,1437062,4309271,-2872209,파푸아 뉴기니,2005-12
2005-12-31,1390630,48414,1342216,피지,2005-12
2005-12-31,1310950,0,1310950,바하마,2005-12
2005-12-31,1298603,0,1298603,베닝,2005-12
2005-12-31,1294819,24305803,-23010984,기니,2005-12
2005-12-31,1271627,162251,1109376,카메룬,2005-12
2005-12-31,1252510,5778,1246732,도미니카,2005-12
2005-12-31,1210742,231930,978812,라오스,2005-12
2005-12-31,1182501,470327,712174,타지크,2005-12
2005-12-31,1144783,0,1144783,지부티,2005-12
2005-12-31,1076713,757645,319068,팔레스타인 해방기구(구),2005-12
2005-12-31,981233,12888,968345,유고,2005-12
2005-12-31,953969,1180,952789,바베이도스,2005-12
2005-12-31,950789,3674281,-2723492,조지아,2005-12
2005-12-31,933086,0,933086,아메리칸 사모아,2005-12
2005-12-31,827498,0,827498,사모아,2005-12
2005-12-31,801350,0,801350,과델로프,2005-12
2005-12-31,785319,439778,345541,우간다,2005-12
2005-12-31,760809,3784,757025,가이아나,2005-12
2005-12-31,679823,0,679823,불령 폴리네시아,2005-12
2005-12-31,627102,16368,610734,세이쉘,2005-12
2005-12-31,597678,4969,592709,보스니아-헤르체고비나,2005-12
2005-12-31,582892,110479,472413,볼리비아,2005-12
2005-12-31,580449,135734,444715,마다카스카르,2005-12
2005-12-31,541936,53179,488757,모잠비크,2005-12
2005-12-31,479459,738700,-259241,마세도니아,2005-12
2005-12-31,458535,171897,286638,니제르,2005-12
2005-12-31,452512,58704,393808,세르비아 와 몬테네그로,2005-12
2005-12-31,419456,0,419456,소말리아,2005-12
2005-12-31,413662,0,413662,불령 가이아나,2005-12
2005-12-31,401435,212360,189075,투르크멘,2005-12
2005-12-31,393119,3228,389891,영령 캐이맨 군도,2005-12
2005-12-31,385506,23995,361511,몰도바,2005-12
2005-12-31,379701,0,379701,마이크로네시아,2005-12
2005-12-31,353875,60,353815,안티가 바부다,2005-12
2005-12-31,340525,0,340525,부탄,2005-12
2005-12-31,329596,3431,326165,바누아투,2005-12
2005-12-31,320308,102855,217453,말라위,2005-12
2005-12-31,319891,675,319216,몰디브,2005-12
2005-12-31,313833,0,313833,수리남,2005-12
2005-12-31,287683,8273,279410,알바니아,2005-12
2005-12-31,270442,133430,137012,리히텐슈타인,2005-12
2005-12-31,255010,21270,233740,모리타니,2005-12
2005-12-31,250313,0,250313,팔라우,2005-12
2005-12-31,239386,37284,202102,그레나다,2005-12
2005-12-31,205955,441057,-235102,벨리제,2005-12
2005-12-31,203561,0,203561,투르크 & 카이코스 군도,2005-12
2005-12-31,198267,85013,113254,보츠와나,2005-12
2005-12-31,190709,18254513,-18063804,잠비아,2005-12
2005-12-31,176229,3351854,-3175625,솔로몬 군도,2005-12
2005-12-31,157969,1230269,-1072300,짐바브웨,2005-12
2005-12-31,155439,0,155439,부르키나 파소,2005-12
2005-12-31,150139,0,150139,적도 기니,2005-12
2005-12-31,138494,0,138494,세인트 루시아,2005-12
2005-12-31,133343,0,133343,세인트 키츠 네비스,2005-12
2005-12-31,132169,0,132169,안타티카,2005-12
2005-12-31,102950,0,102950,콩고민주공화국,2005-12
2005-12-31,99364,11747,87617,아르메니아,2005-12
2005-12-31,79747,0,79747,르완다,2005-12
2005-12-31,76127,73336,2791,영령 버진군도,2005-12
2005-12-31,67617,2731,64886,에리트리아,2005-12
2005-12-31,66942,249393,-182451,가봉,2005-12
2005-12-31,65079,3544,61535,레소토,2005-12
2005-12-31,61710,0,61710,감비아,2005-12
2005-12-31,52636,0,52636,중앙아프리카공화국,2005-12
2005-12-31,52446,0,52446,카보 베르데,2005-12
2005-12-31,47100,91,47009,토켈라우,2005-12
2005-12-31,46489,43120,3369,시에라 리온,2005-12
2005-12-31,44496,0,44496,쿡 아일랜드,2005-12
2005-12-31,40018,509,39509,부룬디,2005-12
2005-12-31,39997,1071800,-1031803,모나코,2005-12
2005-12-31,33891,106658,-72767,기네비소,2005-12
2005-12-31,33318,78861,-45543,나미비아,2005-12
2005-12-31,32120,0,32120,미령 버진군도,2005-12
2005-12-31,21260,169354,-148094,안도라,2005-12
2005-12-31,2369,0,2369,키리바티,2005-12
2005-12-31,336,0,336,영령 인도양,2005-12
2005-12-31,325,0,325,세인트 헬레나,2005-12
2005-12-31,54,1058,-1004,말리,2005-12
2005-12-31,46,0,46,니우에,2005-12
2005-12-31,0,48494,-48494,통가,2005-12
2005-12-31,0,52798,-52798,코스 군도,2005-12
2005-12-31,0,16110,-16110,티모르,2005-12
2005-12-31,0,340069,-340069,그린랜드,2005-12
2005-12-31,0,19500,-19500,크리스마스 아일랜드,2005-12
2005-12-31,0,829,-829,산마리노,2005-12
2005-12-31,0,1165,-1165,마이너 아우틀링 합중국 군도,2005-12
2006-01-31,4800572773,3479305308,1321267465,중국,2006-01
2006-01-31,3260917892,2550570379,710347513,미국,2006-01
2006-01-31,2107219013,3599078718,-1491859705,일본,2006-01
2006-01-31,1416175027,194253827,1221921200,홍콩,2006-01
2006-01-31,932719002,707246625,225472377,대만,2006-01
2006-01-31,928567869,789626301,138941568,독일,2006-01
2006-01-31,704600093,473989646,230610447,싱가포르,2006-01
2006-01-31,573415247,196457238,376958009,영국,2006-01
2006-01-31,440599888,197880501,242719387,인도,2006-01
2006-01-31,376215183,936591689,-560376506,호주,2006-01
2006-01-31,341193352,49960751,291232601,멕시코,2006-01
2006-01-31,332933605,685064325,-352130720,말레이시아,2006-01
2006-01-31,314026226,307697182,6329044,러시아 연방,2006-01
2006-01-31,310460811,204166241,106294570,이탈리아,2006-01
2006-01-31,297977669,249801536,48176133,태국,2006-01
2006-01-31,284088529,193722817,90365712,캐나다,2006-01
2006-01-31,279749886,3241521,276508365,그리스,2006-01
2006-01-31,267905379,160788610,107116769,필리핀,2006-01
2006-01-31,256115736,754906268,-498790532,인도네시아,2006-01
2006-01-31,253151011,245245529,7905482,프랑스,2006-01
2006-01-31,245292093,11061165,234230928,튀르키예,2006-01
2006-01-31,239388990,154168646,85220344,네덜란드,2006-01
2006-01-31,238741948,63970470,174771478,베트남,2006-01
2006-01-31,235237255,966631257,-731394002,아랍에미리트 연합,2006-01
2006-01-31,234799315,185164332,49634983,브라질,2006-01
2006-01-31,225142837,59327670,165815167,스페인,2006-01
2006-01-31,199695296,231811295,-32115999,이란,2006-01
2006-01-31,196739128,38602,196700526,라이베리아,2006-01
2006-01-31,169852059,33540553,136311506,핀란드,2006-01
2006-01-31,167963286,11505192,156458094,폴란드,2006-01
2006-01-31,163239674,1535667490,-1372427816,사우디아라비아,2006-01
2006-01-31,130879316,72302616,58576700,벨기에,2006-01
2006-01-31,109560060,111896165,-2336105,남아프리카공화국,2006-01
2006-01-31,99374280,4413,99369867,바하마,2006-01
2006-01-31,94590879,263395781,-168804902,칠레,2006-01
2006-01-31,94152873,13466659,80686214,헝가리,2006-01
2006-01-31,90337206,81924,90255282,마샬군도,2006-01
2006-01-31,75425108,2816661,72608447,몰타,2006-01
2006-01-31,73115345,50211807,22903538,오스트리아,2006-01
2006-01-31,69316893,26647404,42669489,우크라이나,2006-01
2006-01-31,62598321,14454231,48144090,콜롬비아,2006-01
2006-01-31,61264661,38235090,23029571,이스라엘,2006-01
2006-01-31,59351468,324601,59026867,사이프러스,2006-01
2006-01-31,56477796,48821682,7656114,이집트,2006-01
2006-01-31,56142467,88749062,-32606595,스웨덴,2006-01
2006-01-31,52997156,116272476,-63275320,스위스,2006-01
2006-01-31,51908560,24860905,27047655,파키스탄,2006-01
2006-01-31,51821480,2215942,49605538,슬로바키아,2006-01
2006-01-31,49824945,64777223,-14952278,아일랜드,2006-01
2006-01-31,49787258,91547464,-41760206,파나마,2006-01
2006-01-31,49700884,1936825,47764059,우즈베키스탄,2006-01
2006-01-31,45309096,699319,44609777,에쿠아도르,2006-01
2006-01-31,45120206,3605930,41514276,방글라데시,2006-01
2006-01-31,43969982,70863328,-26893346,뉴질랜드,2006-01
2006-01-31,42602156,4636218,37965938,루마니아,2006-01
2006-01-31,42439969,17866465,24573504,베네주엘라,2006-01
2006-01-31,42041024,236102538,-194061514,나이지리아,2006-01
2006-01-31,40195873,4513653,35682220,과테말라,2006-01
2006-01-31,38505823,56110,38449713,시리아,2006-01
2006-01-31,31054729,33638032,-2583303,덴마크,2006-01
2006-01-31,28920425,4803056,24117369,요르단,2006-01
2006-01-31,27412265,3726683,23685582,포루투갈,2006-01
2006-01-31,27258476,638143847,-610885371,카타르,2006-01
2006-01-31,27058055,20940,27037115,리비아,2006-01
2006-01-31,26096404,105742022,-79645618,알제리,2006-01
2006-01-31,25797168,619411806,-593614638,쿠웨이트,2006-01
2006-01-31,25715130,61787765,-36072635,아르헨티나,2006-01
2006-01-31,25002479,17888757,7113722,체코공화국,2006-01
2006-01-31,24200165,562383451,-538183286,오만,2006-01
2006-01-31,22529430,38304327,-15774897,페루,2006-01
2006-01-31,20877957,17916113,2961844,카자흐스탄,2006-01
2006-01-31,20255067,65585449,-45330382,노르웨이,2006-01
2006-01-31,20237047,4075,20232972,괌,2006-01
2006-01-31,18419340,3109418,15309922,코스타리카,2006-01
2006-01-31,16719584,2782546,13937038,스리랑카,2006-01
2006-01-31,15812768,231624,15581144,케냐,2006-01
2006-01-31,14653053,2908774,11744279,수단,2006-01
2006-01-31,13809115,3236700,10572415,모로코,2006-01
2006-01-31,12795033,8244590,4550443,푸에르토리코,2006-01
2006-01-31,12690840,702910,11987930,온두라스,2006-01
2006-01-31,10812813,584577,10228236,캄보디아,2006-01
2006-01-31,10232891,8690408,1542483,바레인,2006-01
2006-01-31,9509347,5389856,4119491,기타국,2006-01
2006-01-31,8187731,146610,8041121,엘살바도르,2006-01
2006-01-31,8116399,1808705,6307694,도미니카 공화국,2006-01
2006-01-31,6975976,1237745,5738231,레바논,2006-01
2006-01-31,6971861,252,6971609,파라과이,2006-01
2006-01-31,6948912,659989,6288923,리투아니아,2006-01
2006-01-31,6942042,12058,6929984,니카라과,2006-01
2006-01-31,6758075,2652123,4105952,미얀마,2006-01
2006-01-31,6225234,3591633,2633601,불가리아,2006-01
2006-01-31,6010803,42301,5968502,북마리아나 군도,2006-01
2006-01-31,5755707,64106,5691601,키르기스스탄,2006-01
2006-01-31,5576600,1118,5575482,이라크,2006-01
2006-01-31,5575384,1393355,4182029,가나,2006-01
2006-01-31,5340330,6631267,-1290937,룩셈부르그,2006-01
2006-01-31,5179295,483321,4695974,튀니지,2006-01
2006-01-31,5106465,626,5105839,앙골라,2006-01
2006-01-31,4780233,845107,3935126,에스토니아,2006-01
2006-01-31,4755151,5285,4749866,아프카니스탄,2006-01
2006-01-31,4664980,3311,4661669,트리니다드 토바고,2006-01
2006-01-31,4638690,2475130,2163560,슬로베니아,2006-01
2006-01-31,4559161,2653197,1905964,라트비아,2006-01
2006-01-31,3898653,228928,3669725,몽골,2006-01
2006-01-31,3730395,22986272,-19255877,예맨,2006-01
2006-01-31,3501276,388908,3112368,크로아티아,2006-01
2006-01-31,2750883,248597,2502286,에티오피아,2006-01
2006-01-31,2724017,135392,2588625,쿠바,2006-01
2006-01-31,2331852,566133,1765719,아이슬란드,2006-01
2006-01-31,2293290,7845,2285445,탄자니아,2006-01
2006-01-31,2194379,71200,2123179,피지,2006-01
2006-01-31,2104511,0,2104511,불령 리유니온 코모도 제도,2006-01
2006-01-31,2073247,0,2073247,코트디봐르,2006-01
2006-01-31,1906021,146411,1759610,모리셔스,2006-01
2006-01-31,1803891,1496170,307721,우루과이,2006-01
2006-01-31,1784314,15738,1768576,자마이카,2006-01
2006-01-31,1546801,0,1546801,아루바,2006-01
2006-01-31,1541292,353327,1187965,마카오,2006-01
2006-01-31,1500983,161669,1339314,세네갈,2006-01
2006-01-31,1482130,169104,1313026,벨라루스,2006-01
2006-01-31,1469871,1984799,-514928,스와질랜드,2006-01
2006-01-31,1465673,7841491,-6375818,뉴 칼레도니아,2006-01
2006-01-31,1421247,7940,1413307,토고,2006-01
2006-01-31,1365669,0,1365669,아제르바이잔,2006-01
2006-01-31,1321813,231800,1090013,라오스,2006-01
2006-01-31,1254317,0,1254317,마티니크,2006-01
2006-01-31,1205386,40489,1164897,유고,2006-01
2006-01-31,1161295,123758,1037537,마다카스카르,2006-01
2006-01-31,1126962,64591,1062371,네덜란드 열도,2006-01
2006-01-31,1116529,79391,1037138,네팔,2006-01
2006-01-31,1093809,112609410,-111515601,브루나이,2006-01
2006-01-31,1029757,0,1029757,불령 폴리네시아,2006-01
2006-01-31,959623,6199,953424,과델로프,2006-01
2006-01-31,950815,57626,893189,지부티,2006-01
2006-01-31,820793,847554,-26761,타지크,2006-01
2006-01-31,814107,0,814107,베닝,2006-01
2006-01-31,811714,0,811714,아이티,2006-01
2006-01-31,808211,120984,687227,팔레스타인 해방기구(구),2006-01
2006-01-31,802240,363622,438618,조지아,2006-01
2006-01-31,726274,132682,593592,카메룬,2006-01
2006-01-31,685950,587115,98835,짐바브웨,2006-01
2006-01-31,667471,1979,665492,모잠비크,2006-01
2006-01-31,652586,0,652586,보스니아-헤르체고비나,2006-01
2006-01-31,644490,754,643736,세이쉘,2006-01
2006-01-31,628296,107518,520778,가이아나,2006-01
2006-01-31,621212,0,621212,버뮤다,2006-01
2006-01-31,619974,134,619840,바베이도스,2006-01
2006-01-31,596256,4684293,-4088037,볼리비아,2006-01
2006-01-31,583903,52089347,-51505444,콩고,2006-01
2006-01-31,539776,0,539776,수리남,2006-01
2006-01-31,539102,0,539102,불령 가이아나,2006-01
2006-01-31,514115,22611,491504,우간다,2006-01
2006-01-31,465344,720378,-255034,기니,2006-01
2006-01-31,460915,433,460482,말라위,2006-01
2006-01-31,455917,0,455917,마세도니아,2006-01
2006-01-31,444919,15865,429054,안티가 바부다,2006-01
2006-01-31,356558,4812,351746,아르메니아,2006-01
2006-01-31,353371,4041841,-3688470,파푸아 뉴기니,2006-01
2006-01-31,345696,194,345502,마이크로네시아,2006-01
2006-01-31,336729,21372,315357,세르비아 와 몬테네그로,2006-01
2006-01-31,324125,369,323756,지브랄타,2006-01
2006-01-31,291607,0,291607,도미니카,2006-01
2006-01-31,291192,4226,286966,몰디브,2006-01
2006-01-31,287974,370969,-82995,리히텐슈타인,2006-01
2006-01-31,285309,2057,283252,알바니아,2006-01
2006-01-31,266555,28944533,-28677978,잠비아,2006-01
2006-01-31,264842,39118,225724,레소토,2006-01
2006-01-31,259625,0,259625,콩고민주공화국,2006-01
2006-01-31,255674,40137,215537,벨리제,2006-01
2006-01-31,244545,0,244545,영령 캐이맨 군도,2006-01
2006-01-31,243293,647612,-404319,모나코,2006-01
2006-01-31,228087,0,228087,사모아,2006-01
2006-01-31,214573,202089,12484,보츠와나,2006-01
2006-01-31,195979,3466,192513,세인트 루시아,2006-01
2006-01-31,187782,0,187782,바누아투,2006-01
2006-01-31,167251,170,167081,니제르,2006-01
2006-01-31,150612,0,150612,부룬디,2006-01
2006-01-31,143898,49011,94887,시에라 리온,2006-01
2006-01-31,135176,0,135176,부르키나 파소,2006-01
2006-01-31,120605,600,120005,르완다,2006-01
2006-01-31,118632,1323188,-1204556,가봉,2006-01
2006-01-31,115454,161300,-45846,챠드,2006-01
2006-01-31,112996,0,112996,아메리칸 사모아,2006-01
2006-01-31,106287,157413,-51126,투르크멘,2006-01
2006-01-31,101174,0,101174,그레나다,2006-01
2006-01-31,95749,0,95749,소말리아,2006-01
2006-01-31,87268,40088,47180,중앙아프리카공화국,2006-01
2006-01-31,85867,3459,82408,세인트 빈센트 그레나딘,2006-01
2006-01-31,83989,0,83989,부탄,2006-01
2006-01-31,83869,0,83869,팔라우,2006-01
2006-01-31,77546,71988,5558,안도라,2006-01
2006-01-31,52167,0,52167,기네비소,2006-01
2006-01-31,44767,3617390,-3572623,솔로몬 군도,2006-01
2006-01-31,43082,21870,21212,모리타니,2006-01
2006-01-31,42771,5402203,-5359432,나미비아,2006-01
2006-01-31,40362,0,40362,투르크 & 카이코스 군도,2006-01
2006-01-31,28797,902,27895,말리,2006-01
2006-01-31,28332,5209,23123,몰도바,2006-01
2006-01-31,24617,65369,-40752,영령 버진군도,2006-01
2006-01-31,22961,18639,4322,파로에 군도,2006-01
2006-01-31,19500,9,19491,적도 기니,2006-01
2006-01-31,16970,0,16970,에리트리아,2006-01
2006-01-31,13528,0,13528,상토메 프린스페,2006-01
2006-01-31,5805,0,5805,몬트세라트,2006-01
2006-01-31,2040,0,2040,티모르,2006-01
2006-01-31,345,0,345,감비아,2006-01
2006-01-31,141,0,141,카보 베르데,2006-01
2006-01-31,0,70000,-70000,크리스마스 아일랜드,2006-01
2006-01-31,0,2742,-2742,마이너 아우틀링 합중국 군도,2006-01
2006-01-31,0,2985,-2985,앙귈라,2006-01
2006-01-31,0,416943,-416943,그린랜드,2006-01
2006-01-31,0,32580,-32580,통가,2006-01
2006-01-31,0,7881,-7881,쿡 아일랜드,2006-01
2006-01-31,0,1570,-1570,세인트 헬레나,2006-01
2006-02-28,4837638513,3084691196,1752947317,중국,2006-02
2006-02-28,3145899213,2584950089,560949124,미국,2006-02
2006-02-28,2061298842,4120758215,-2059459373,일본,2006-02
2006-02-28,1429481611,141513970,1287967641,홍콩,2006-02
2006-02-28,965041164,668622206,296418958,대만,2006-02
2006-02-28,764804704,852435662,-87630958,독일,2006-02
2006-02-28,683823832,469523138,214300694,싱가포르,2006-02
2006-02-28,465862715,272530098,193332617,인도,2006-02
2006-02-28,428002243,8338713,419663530,파나마,2006-02
2006-02-28,383998608,48073921,335924687,멕시코,2006-02
2006-02-28,380642290,840445788,-459803498,호주,2006-02
2006-02-28,336897361,623832581,-286935220,말레이시아,2006-02
2006-02-28,334450703,216391939,118058764,영국,2006-02
2006-02-28,320921782,250656268,70265514,태국,2006-02
2006-02-28,309528106,281315193,28212913,프랑스,2006-02
2006-02-28,300112797,256985912,43126885,이탈리아,2006-02
2006-02-28,285792167,191487910,94304257,캐나다,2006-02
2006-02-28,280734960,173621167,107113793,필리핀,2006-02
2006-02-28,276753456,581644635,-304891179,인도네시아,2006-02
2006-02-28,269917775,212252847,57664928,네덜란드,2006-02
2006-02-28,263614916,18833,263596083,라이베리아,2006-02
2006-02-28,243978469,321602292,-77623823,러시아 연방,2006-02
2006-02-28,243125673,193048855,50076818,브라질,2006-02
2006-02-28,231391367,5116789,226274578,그리스,2006-02
2006-02-28,230841555,1021028160,-790186605,아랍에미리트 연합,2006-02
2006-02-28,230751682,64620339,166131343,스페인,2006-02
2006-02-28,227271938,42704946,184566992,튀르키예,2006-02
2006-02-28,218776406,59891938,158884468,베트남,2006-02
2006-02-28,196744700,501639269,-304894569,이란,2006-02
2006-02-28,182935497,1554469051,-1371533554,사우디아라비아,2006-02
2006-02-28,177751215,37785539,139965676,핀란드,2006-02
2006-02-28,176085490,62851,176022639,앙골라,2006-02
2006-02-28,157021034,13383725,143637309,폴란드,2006-02
2006-02-28,139777766,581579655,-441801889,쿠웨이트,2006-02
2006-02-28,127496409,66494163,61002246,벨기에,2006-02
2006-02-28,106850344,86765345,20084999,남아프리카공화국,2006-02
2006-02-28,104665588,1205209,103460379,사이프러스,2006-02
2006-02-28,104551658,251404745,-146853087,칠레,2006-02
2006-02-28,101903982,900,101903082,마샬군도,2006-02
2006-02-28,89022023,15479450,73542573,헝가리,2006-02
2006-02-28,87712750,0,87712750,적도 기니,2006-02
2006-02-28,79085524,54370915,24714609,오스트리아,2006-02
2006-02-28,69006623,0,69006623,영령 버진군도,2006-02
2006-02-28,67476296,86528528,-19052232,스위스,2006-02
2006-02-28,67420500,42566680,24853820,우크라이나,2006-02
2006-02-28,64513324,50684917,13828407,노르웨이,2006-02
2006-02-28,63980402,82620668,-18640266,이집트,2006-02
2006-02-28,62581426,11303602,51277824,콜롬비아,2006-02
2006-02-28,58077754,152011111,-93933357,나이지리아,2006-02
2006-02-28,57115274,3073690,54041584,방글라데시,2006-02
2006-02-28,55035329,1645597,53389732,기타국,2006-02
2006-02-28,54133748,2712979,51420769,슬로바키아,2006-02
2006-02-28,53586012,36155988,17430024,이스라엘,2006-02
2006-02-28,52739053,12459185,40279868,베네주엘라,2006-02
2006-02-28,52271287,1113032,51158255,우즈베키스탄,2006-02
2006-02-28,51465703,70119662,-18653959,스웨덴,2006-02
2006-02-28,51122666,65382641,-14259975,아일랜드,2006-02
2006-02-28,47017233,18080459,28936774,파키스탄,2006-02
2006-02-28,40702663,168517,40534146,리비아,2006-02
2006-02-28,36610561,45880400,-9269839,덴마크,2006-02
2006-02-28,35912909,26461304,9451605,과테말라,2006-02
2006-02-28,35718249,632725449,-597007200,오만,2006-02
2006-02-28,35365840,13920309,21445531,카자흐스탄,2006-02
2006-02-28,34532920,61302545,-26769625,뉴질랜드,2006-02
2006-02-28,33027540,1852068,31175472,요르단,2006-02
2006-02-28,31799451,886338,30913113,에쿠아도르,2006-02
2006-02-28,31353717,5937648,25416069,포루투갈,2006-02
2006-02-28,28891825,5607114,23284711,루마니아,2006-02
2006-02-28,28279864,691290,27588574,시리아,2006-02
2006-02-28,28234048,30060974,-1826926,페루,2006-02
2006-02-28,28066432,18243458,9822974,체코공화국,2006-02
2006-02-28,27812395,70537471,-42725076,아르헨티나,2006-02
2006-02-28,27620200,59515119,-31894919,알제리,2006-02
2006-02-28,24835175,730111430,-705276255,카타르,2006-02
2006-02-28,21613126,5152037,16461089,모로코,2006-02
2006-02-28,18149413,4276698,13872715,코스타리카,2006-02
2006-02-28,17210576,3013950,14196626,스리랑카,2006-02
2006-02-28,13918880,42608021,-28689141,바레인,2006-02
2006-02-28,13137095,226671,12910424,수단,2006-02
2006-02-28,11730731,705399,11025332,캄보디아,2006-02
2006-02-28,11323274,109139,11214135,니카라과,2006-02
2006-02-28,11163500,9669075,1494425,푸에르토리코,2006-02
2006-02-28,10772331,562837,10209494,케냐,2006-02
2006-02-28,9813763,39043,9774720,쿠바,2006-02
2006-02-28,9265059,1951971,7313088,온두라스,2006-02
2006-02-28,8660263,862916,7797347,튀니지,2006-02
2006-02-28,8086588,5114529,2972059,도미니카 공화국,2006-02
2006-02-28,7226579,1178364,6048215,슬로베니아,2006-02
2006-02-28,7018366,80413,6937953,이라크,2006-02
2006-02-28,6809819,1766984,5042835,레바논,2006-02
2006-02-28,6798198,2710379,4087819,미얀마,2006-02
2006-02-28,6360188,267220,6092968,엘살바도르,2006-02
2006-02-28,6306221,158345,6147876,가나,2006-02
2006-02-28,6063090,229012,5834078,파라과이,2006-02
2006-02-28,5993801,14040,5979761,북마리아나 군도,2006-02
2006-02-28,5907073,3853297,2053776,크로아티아,2006-02
2006-02-28,5678975,2510602,3168373,불가리아,2006-02
2006-02-28,5587043,670387,4916656,리투아니아,2006-02
2006-02-28,5046577,43167,5003410,키르기스스탄,2006-02
2006-02-28,4885227,0,4885227,아제르바이잔,2006-02
2006-02-28,4809841,429079,4380762,몽골,2006-02
2006-02-28,4639996,172615,4467381,라트비아,2006-02
2006-02-28,4136469,6376,4130093,탄자니아,2006-02
2006-02-28,3949895,300957,3648938,예맨,2006-02
2006-02-28,3905765,0,3905765,트리니다드 토바고,2006-02
2006-02-28,3883120,10505584,-6622464,뉴 칼레도니아,2006-02
2006-02-28,3847646,0,3847646,코트디봐르,2006-02
2006-02-28,3794629,4945038,-1150409,에스토니아,2006-02
2006-02-28,3526374,37972,3488402,알바니아,2006-02
2006-02-28,3291623,16104,3275519,에티오피아,2006-02
2006-02-28,3291452,3073051,218401,몰타,2006-02
2006-02-28,3246542,0,3246542,마티니크,2006-02
2006-02-28,3140209,0,3140209,지부티,2006-02
2006-02-28,3052994,811,3052183,아프카니스탄,2006-02
2006-02-28,3022614,490739,2531875,아이슬란드,2006-02
2006-02-28,2542186,111451,2430735,불령 리유니온 코모도 제도,2006-02
2006-02-28,2421919,3093132,-671213,우루과이,2006-02
2006-02-28,2215253,30794009,-28578756,콩고,2006-02
2006-02-28,2144213,31160,2113053,자마이카,2006-02
2006-02-28,2067047,0,2067047,과델로프,2006-02
2006-02-28,2019627,623241,1396386,마카오,2006-02
2006-02-28,1935447,3168913,-1233466,스와질랜드,2006-02
2006-02-28,1883808,56907,1826901,모리셔스,2006-02
2006-02-28,1846476,6589615,-4743139,룩셈부르그,2006-02
2006-02-28,1837393,90362858,-88525465,브루나이,2006-02
2006-02-28,1717878,331550,1386328,벨라루스,2006-02
2006-02-28,1686095,0,1686095,모잠비크,2006-02
2006-02-28,1635177,378219,1256958,세네갈,2006-02
2006-02-28,1618013,0,1618013,아루바,2006-02
2006-02-28,1594698,9840,1584858,불령 폴리네시아,2006-02
2006-02-28,1540981,86600,1454381,괌,2006-02
2006-02-28,1475970,653466,822504,라오스,2006-02
2006-02-28,1417196,276912,1140284,투르크멘,2006-02
2006-02-28,1396997,1182,1395815,바베이도스,2006-02
2006-02-28,1261775,3335,1258440,유고,2006-02
2006-02-28,1186915,4317,1182598,마세도니아,2006-02
2006-02-28,1162405,0,1162405,토고,2006-02
2006-02-28,1128238,0,1128238,네덜란드 열도,2006-02
2006-02-28,1123108,23824,1099284,피지,2006-02
2006-02-28,1059704,8826,1050878,바하마,2006-02
2006-02-28,1057452,112981,944471,타지크,2006-02
2006-02-28,1051157,55363756,-54312599,카메룬,2006-02
2006-02-28,1042079,2247031,-1204952,파푸아 뉴기니,2006-02
2006-02-28,1026917,523611,503306,팔레스타인 해방기구(구),2006-02
2006-02-28,1005096,185,1004911,도미니카,2006-02
2006-02-28,932127,0,932127,베닝,2006-02
2006-02-28,924843,0,924843,사모아,2006-02
2006-02-28,881101,209687,671414,마다카스카르,2006-02
2006-02-28,799541,0,799541,아이티,2006-02
2006-02-28,790463,283,790180,버뮤다,2006-02
2006-02-28,771202,11870,759332,네팔,2006-02
2006-02-28,718980,363531,355449,조지아,2006-02
2006-02-28,712768,0,712768,불령 가이아나,2006-02
2006-02-28,673744,177922,495822,짐바브웨,2006-02
2006-02-28,666146,32562,633584,니제르,2006-02
2006-02-28,632054,13571,618483,세르비아 와 몬테네그로,2006-02
2006-02-28,601243,0,601243,세이쉘,2006-02
2006-02-28,562561,7749471,-7186910,볼리비아,2006-02
2006-02-28,558524,1880,556644,아르메니아,2006-02
2006-02-28,558370,60908,497462,우간다,2006-02
2006-02-28,529376,0,529376,팔라우,2006-02
2006-02-28,522311,18449319,-17927008,잠비아,2006-02
2006-02-28,501401,0,501401,안티가 바부다,2006-02
2006-02-28,499068,59418,439650,보스니아-헤르체고비나,2006-02
2006-02-28,483897,562,483335,수리남,2006-02
2006-02-28,472404,55811440,-55339036,챠드,2006-02
2006-02-28,438578,93566,345012,말라위,2006-02
2006-02-28,436499,0,436499,부탄,2006-02
2006-02-28,424002,25466,398536,몰도바,2006-02
2006-02-28,382981,0,382981,가이아나,2006-02
2006-02-28,382676,0,382676,영령 캐이맨 군도,2006-02
2006-02-28,379183,0,379183,콩고민주공화국,2006-02
2006-02-28,367064,4336136,-3969072,모나코,2006-02
2006-02-28,324875,0,324875,감비아,2006-02
2006-02-28,312526,0,312526,마이크로네시아,2006-02
2006-02-28,304034,8083,295951,말리,2006-02
2006-02-28,261071,0,261071,레소토,2006-02
2006-02-28,240226,0,240226,부룬디,2006-02
2006-02-28,224898,0,224898,그레나다,2006-02
2006-02-28,213707,84819,128888,보츠와나,2006-02
2006-02-28,200902,3590663,-3389761,가봉,2006-02
2006-02-28,188078,589872,-401794,리히텐슈타인,2006-02
2006-02-28,186621,0,186621,지브랄타,2006-02
2006-02-28,161869,0,161869,아메리칸 사모아,2006-02
2006-02-28,134330,0,134330,카보 베르데,2006-02
2006-02-28,124617,0,124617,몰디브,2006-02
2006-02-28,120501,0,120501,세인트 루시아,2006-02
2006-02-28,106257,3931088,-3824831,기니,2006-02
2006-02-28,104733,332,104401,부르키나 파소,2006-02
2006-02-28,104270,81772,22498,바누아투,2006-02
2006-02-28,93678,1122,92556,에리트리아,2006-02
2006-02-28,90901,0,90901,모리타니,2006-02
2006-02-28,73369,2215131,-2141762,솔로몬 군도,2006-02
2006-02-28,57214,13136241,-13079027,나미비아,2006-02
2006-02-28,57022,0,57022,벨리제,2006-02
2006-02-28,47386,0,47386,세인트 빈센트 그레나딘,2006-02
2006-02-28,44000,26421,17579,안도라,2006-02
2006-02-28,36023,0,36023,르완다,2006-02
2006-02-28,23572,21351,2221,시에라 리온,2006-02
2006-02-28,22884,0,22884,키리바티,2006-02
2006-02-28,22757,0,22757,쿡 아일랜드,2006-02
2006-02-28,13620,0,13620,세인트 키츠 네비스,2006-02
2006-02-28,12294,0,12294,티모르,2006-02
2006-02-28,6323,0,6323,통가,2006-02
2006-02-28,3946,2121,1825,세인트 헬레나,2006-02
2006-02-28,1486,101519,-100033,토켈라우,2006-02
2006-02-28,1140,436,704,서사하라,2006-02
2006-02-28,68,239442,-239374,그린랜드,2006-02
2006-02-28,0,14686,-14686,상토메 프린스페,2006-02
2006-02-28,0,550000,-550000,남조지아 & 남샌드위치 군도,2006-02
2006-02-28,0,23106,-23106,마이너 아우틀링 합중국 군도,2006-02
2006-02-28,0,14900,-14900,크리스마스 아일랜드,2006-02
2006-02-28,0,130,-130,코스 군도,2006-02
2006-02-28,0,34618,-34618,기네비소,2006-02
2006-03-31,5725007752,4071534131,1653473621,중국,2006-03
2006-03-31,3862474560,2987783751,874690809,미국,2006-03
2006-03-31,2180383012,4665547821,-2485164809,일본,2006-03
2006-03-31,1624505954,177307444,1447198510,홍콩,2006-03
2006-03-31,1004287884,777281633,227006251,대만,2006-03
2006-03-31,905262055,890349382,14912673,독일,2006-03
2006-03-31,705120882,521778163,183342719,싱가포르,2006-03
2006-03-31,535599756,788011232,-252411476,말레이시아,2006-03
2006-03-31,471285964,234106021,237179943,인도,2006-03
2006-03-31,463003714,71689496,391314218,멕시코,2006-03
2006-03-31,406679003,243428238,163250765,영국,2006-03
2006-03-31,392308122,264768061,127540061,태국,2006-03
2006-03-31,389396338,935858698,-546462360,호주,2006-03
2006-03-31,365967953,240649476,125318477,이탈리아,2006-03
2006-03-31,335136957,281661808,53475149,프랑스,2006-03
2006-03-31,333827156,268457469,65369687,캐나다,2006-03
2006-03-31,328075564,77289010,250786554,베트남,2006-03
2006-03-31,320936961,192592021,128344940,필리핀,2006-03
2006-03-31,315785744,192,315785552,버뮤다,2006-03
2006-03-31,310409589,276514807,33894782,브라질,2006-03
2006-03-31,305649274,875427716,-569778442,인도네시아,2006-03
2006-03-31,303773362,282470876,21302486,러시아 연방,2006-03
2006-03-31,271275324,19181498,252093826,튀르키예,2006-03
2006-03-31,255524877,1575517628,-1319992751,사우디아라비아,2006-03
2006-03-31,253628091,70083748,183544343,스페인,2006-03
2006-03-31,250779883,257222677,-6442794,네덜란드,2006-03
2006-03-31,230125164,13375242,216749922,폴란드,2006-03
2006-03-31,216219959,971316407,-755096448,아랍에미리트 연합,2006-03
2006-03-31,203265406,4166455,199098951,그리스,2006-03
2006-03-31,200374090,71929937,128444153,벨기에,2006-03
2006-03-31,196817915,387254970,-190437055,이란,2006-03
2006-03-31,191594865,38158075,153436790,핀란드,2006-03
2006-03-31,127813431,72581956,55231475,노르웨이,2006-03
2006-03-31,127587711,75249227,52338484,남아프리카공화국,2006-03
2006-03-31,124384683,263815056,-139430373,칠레,2006-03
2006-03-31,121214309,673846,120540463,사이프러스,2006-03
2006-03-31,119237998,61693571,57544427,오스트리아,2006-03
2006-03-31,101459819,18516222,82943597,헝가리,2006-03
2006-03-31,86739210,51908164,34831046,이스라엘,2006-03
2006-03-31,85705057,53813512,31891545,이집트,2006-03
2006-03-31,74306382,39836733,34469649,우크라이나,2006-03
2006-03-31,73806862,47607,73759255,라이베리아,2006-03
2006-03-31,72916214,14408025,58508189,콜롬비아,2006-03
2006-03-31,67410659,3583601,63827058,방글라데시,2006-03
2006-03-31,67122068,3428,67118640,마샬군도,2006-03
2006-03-31,66778475,8938944,57839531,우즈베키스탄,2006-03
2006-03-31,63785236,43399337,20385899,파나마,2006-03
2006-03-31,60291367,20429296,39862071,기타국,2006-03
2006-03-31,59316183,62551037,-3234854,아일랜드,2006-03
2006-03-31,56160900,109015190,-52854290,스웨덴,2006-03
2006-03-31,55858959,28576,55830383,나이지리아,2006-03
2006-03-31,54776820,4080725,50696095,슬로바키아,2006-03
2006-03-31,54614687,120547,54494140,케냐,2006-03
2006-03-31,53554106,31895495,21658611,파키스탄,2006-03
2006-03-31,52966816,287978,52678838,베네주엘라,2006-03
2006-03-31,51604605,178561,51426044,리비아,2006-03
2006-03-31,49613446,65833128,-16219682,뉴질랜드,2006-03
2006-03-31,48768812,39113286,9655526,덴마크,2006-03
2006-03-31,42933882,28766326,14167556,과테말라,2006-03
2006-03-31,42635337,547510013,-504874676,쿠웨이트,2006-03
2006-03-31,42171168,493014574,-450843406,카타르,2006-03
2006-03-31,41698570,140864,41557706,시리아,2006-03
2006-03-31,40811456,1350929,39460527,요르단,2006-03
2006-03-31,40551969,97185783,-56633814,스위스,2006-03
2006-03-31,37413511,28064109,9349402,체코공화국,2006-03
2006-03-31,35534885,6577404,28957481,루마니아,2006-03
2006-03-31,34553200,461184770,-426631570,오만,2006-03
2006-03-31,33912111,3426100,30486011,몰타,2006-03
2006-03-31,33798043,5440951,28357092,포루투갈,2006-03
2006-03-31,33135227,92463160,-59327933,페루,2006-03
2006-03-31,32963139,4754827,28208312,알제리,2006-03
2006-03-31,30876475,20254719,10621756,아르헨티나,2006-03
2006-03-31,30303370,677311,29626059,에쿠아도르,2006-03
2006-03-31,26071694,20595435,5476259,카자흐스탄,2006-03
2006-03-31,21744421,62459,21681962,수단,2006-03
2006-03-31,21352188,2729889,18622299,모로코,2006-03
2006-03-31,19322065,11032,19311033,바하마,2006-03
2006-03-31,18780972,8402377,10378595,코스타리카,2006-03
2006-03-31,18258606,4843842,13414764,스리랑카,2006-03
2006-03-31,16353191,354822,15998369,캄보디아,2006-03
2006-03-31,12682848,6510500,6172348,앙골라,2006-03
2006-03-31,11336725,84149,11252576,니카라과,2006-03
2006-03-31,11031229,3124713,7906516,온두라스,2006-03
2006-03-31,10654900,102026432,-91371532,이라크,2006-03
2006-03-31,9915196,5413784,4501412,도미니카 공화국,2006-03
2006-03-31,9881607,17033633,-7152026,푸에르토리코,2006-03
2006-03-31,9466537,13202172,-3735635,바레인,2006-03
2006-03-31,9371395,1234869,8136526,슬로베니아,2006-03
2006-03-31,9315678,299985,9015693,크로아티아,2006-03
2006-03-31,9242183,1504485,7737698,레바논,2006-03
2006-03-31,9188577,86186,9102391,북마리아나 군도,2006-03
2006-03-31,8885471,29174008,-20288537,미얀마,2006-03
2006-03-31,8580890,968291,7612599,가나,2006-03
2006-03-31,8124941,1688807,6436134,튀니지,2006-03
2006-03-31,7412429,63067986,-55655557,예맨,2006-03
2006-03-31,7068961,43734,7025227,엘살바도르,2006-03
2006-03-31,7009501,252274,6757227,파라과이,2006-03
2006-03-31,6833774,35093,6798681,키르기스스탄,2006-03
2006-03-31,6580557,575187,6005370,몽골,2006-03
2006-03-31,6238175,2754491,3483684,불가리아,2006-03
2006-03-31,6230686,719625,5511061,리투아니아,2006-03
2006-03-31,5836162,232,5835930,아프카니스탄,2006-03
2006-03-31,5588500,2454590,3133910,파푸아 뉴기니,2006-03
2006-03-31,4779594,1093483,3686111,에스토니아,2006-03
2006-03-31,4576190,1287616,3288574,아이슬란드,2006-03
2006-03-31,4332607,2099114,2233493,우루과이,2006-03
2006-03-31,4092143,210,4091933,트리니다드 토바고,2006-03
2006-03-31,4072134,223636,3848498,코트디봐르,2006-03
2006-03-31,4004581,800188,3204393,라트비아,2006-03
2006-03-31,3964146,15555,3948591,뉴 칼레도니아,2006-03
2006-03-31,3474275,0,3474275,불령 리유니온 코모도 제도,2006-03
2006-03-31,3447741,0,3447741,아제르바이잔,2006-03
2006-03-31,3217739,15616,3202123,감비아,2006-03
2006-03-31,2954884,0,2954884,마티니크,2006-03
2006-03-31,2790094,138132,2651962,세네갈,2006-03
2006-03-31,2684195,120254326,-117570131,브루나이,2006-03
2006-03-31,2498298,183991,2314307,쿠바,2006-03
2006-03-31,2358158,0,2358158,유고,2006-03
2006-03-31,2341055,44987,2296068,탄자니아,2006-03
2006-03-31,2216137,15099,2201038,알바니아,2006-03
2006-03-31,2203319,647885,1555434,라오스,2006-03
2006-03-31,2150256,9151803,-7001547,룩셈부르그,2006-03
2006-03-31,2088859,27553,2061306,괌,2006-03
2006-03-31,1769699,82169,1687530,자마이카,2006-03
2006-03-31,1714370,100400,1613970,마다카스카르,2006-03
2006-03-31,1704333,72655,1631678,에티오피아,2006-03
2006-03-31,1688710,71254,1617456,지부티,2006-03
2006-03-31,1654256,30665,1623591,과델로프,2006-03
2006-03-31,1637835,567508,1070327,벨라루스,2006-03
2006-03-31,1568218,77892,1490326,모리셔스,2006-03
2006-03-31,1553603,2204453,-650850,스와질랜드,2006-03
2006-03-31,1494711,61271065,-59776354,콩고,2006-03
2006-03-31,1485892,419634,1066258,마카오,2006-03
2006-03-31,1449529,0,1449529,토고,2006-03
2006-03-31,1414822,39007770,-37592948,기니,2006-03
2006-03-31,1399854,0,1399854,아루바,2006-03
2006-03-31,1291905,48215,1243690,피지,2006-03
2006-03-31,1290043,18924,1271119,네덜란드 열도,2006-03
2006-03-31,1139166,6649016,-5509850,나미비아,2006-03
2006-03-31,1108181,84729,1023452,불령 폴리네시아,2006-03
2006-03-31,1091564,0,1091564,아이티,2006-03
2006-03-31,1089916,0,1089916,베닝,2006-03
2006-03-31,1040183,11743,1028440,니제르,2006-03
2006-03-31,904116,0,904116,가이아나,2006-03
2006-03-31,900625,455681,444944,투르크멘,2006-03
2006-03-31,893539,242941,650598,가봉,2006-03
2006-03-31,893260,89178,804082,세르비아 와 몬테네그로,2006-03
2006-03-31,881522,415384,466138,말라위,2006-03
2006-03-31,872432,0,872432,모잠비크,2006-03
2006-03-31,867381,35772,831609,네팔,2006-03
2006-03-31,866339,325351,540988,조지아,2006-03
2006-03-31,843246,5692,837554,도미니카,2006-03
2006-03-31,775022,738597,36425,짐바브웨,2006-03
2006-03-31,746259,284440,461819,팔레스타인 해방기구(구),2006-03
2006-03-31,738379,47887,690492,타지크,2006-03
2006-03-31,718946,0,718946,바베이도스,2006-03
2006-03-31,714142,28308,685834,콩고민주공화국,2006-03
2006-03-31,694760,103634,591126,세이쉘,2006-03
2006-03-31,649936,15797,634139,보스니아-헤르체고비나,2006-03
2006-03-31,649204,82,649122,안티가 바부다,2006-03
2006-03-31,635331,308743,326588,마세도니아,2006-03
2006-03-31,576304,120010,456294,카메룬,2006-03
2006-03-31,530872,1469682,-938810,볼리비아,2006-03
2006-03-31,507202,0,507202,수리남,2006-03
2006-03-31,468091,0,468091,세인트 루시아,2006-03
2006-03-31,432421,0,432421,불령 가이아나,2006-03
2006-03-31,427798,6638,421160,우간다,2006-03
2006-03-31,413253,792910,-379657,아르메니아,2006-03
2006-03-31,409010,2940,406070,마이크로네시아,2006-03
2006-03-31,404953,120248,284705,보츠와나,2006-03
2006-03-31,383717,359365,24352,리히텐슈타인,2006-03
2006-03-31,377625,152994,224631,몰도바,2006-03
2006-03-31,351966,30100168,-29748202,잠비아,2006-03
2006-03-31,340103,17,340086,레소토,2006-03
2006-03-31,339431,111335,228096,벨리제,2006-03
2006-03-31,290765,0,290765,사모아,2006-03
2006-03-31,236332,292,236040,몰디브,2006-03
2006-03-31,234906,0,234906,에리트리아,2006-03
2006-03-31,210982,0,210982,적도 기니,2006-03
2006-03-31,191289,9628,181661,안도라,2006-03
2006-03-31,176429,186784,-10355,팔라우,2006-03
2006-03-31,150941,0,150941,아메리칸 사모아,2006-03
2006-03-31,150789,75508,75281,시에라 리온,2006-03
2006-03-31,130616,0,130616,바누아투,2006-03
2006-03-31,125964,0,125964,소말리아,2006-03
2006-03-31,125737,0,125737,부르키나 파소,2006-03
2006-03-31,108335,28780,79555,영령 캐이맨 군도,2006-03
2006-03-31,104651,0,104651,영령 버진군도,2006-03
2006-03-31,96631,0,96631,그레나다,2006-03
2006-03-31,93137,0,93137,세인트 빈센트 그레나딘,2006-03
2006-03-31,92350,0,92350,부탄,2006-03
2006-03-31,86452,0,86452,카보 베르데,2006-03
2006-03-31,84989,13278,71711,모리타니,2006-03
2006-03-31,75305,0,75305,르완다,2006-03
2006-03-31,66789,0,66789,지브랄타,2006-03
2006-03-31,63563,17030,46533,말리,2006-03
2006-03-31,52860,0,52860,세인트 키츠 네비스,2006-03
2006-03-31,35709,2237846,-2202137,솔로몬 군도,2006-03
2006-03-31,28128,4121144,-4093016,모나코,2006-03
2006-03-31,27348,0,27348,부룬디,2006-03
2006-03-31,26659,0,26659,쿡 아일랜드,2006-03
2006-03-31,25060,0,25060,챠드,2006-03
2006-03-31,20348,0,20348,투발루,2006-03
2006-03-31,20094,17320,2774,기네비소,2006-03
2006-03-31,13157,3156,10001,투르크 & 카이코스 군도,2006-03
2006-03-31,8427,0,8427,통가,2006-03
2006-03-31,8335,28153,-19818,코스 군도,2006-03
2006-03-31,7450,0,7450,몬트세라트,2006-03
2006-03-31,2600,0,2600,남조지아 & 남샌드위치 군도,2006-03
2006-03-31,851,0,851,코모로스,2006-03
2006-03-31,539,0,539,산마리노,2006-03
2006-03-31,205,0,205,앙귈라,2006-03
2006-03-31,0,16851,-16851,메요트,2006-03
2006-03-31,0,10303,-10303,중앙아프리카공화국,2006-03
2006-03-31,0,19500,-19500,크리스마스 아일랜드,2006-03
2006-03-31,0,1816,-1816,교황청,2006-03
2006-03-31,0,4210,-4210,키리바티,2006-03
2006-03-31,0,88798,-88798,토켈라우,2006-03
2006-03-31,0,134513,-134513,그린랜드,2006-03
2006-03-31,0,156534,-156534,세인트 헬레나,2006-03
2006-04-30,5428864647,3823923573,1604941074,중국,2006-04
2006-04-30,3538737276,2787256903,751480373,미국,2006-04
2006-04-30,1940871331,4250673342,-2309802011,일본,2006-04
2006-04-30,1406909748,164778427,1242131321,홍콩,2006-04
2006-04-30,893416753,777421647,115995106,대만,2006-04
2006-04-30,705846016,439751454,266094562,싱가포르,2006-04
2006-04-30,654233058,858859690,-204626632,독일,2006-04
2006-04-30,565740342,880157846,-314417504,호주,2006-04
2006-04-30,471059755,89021103,382038652,멕시코,2006-04
2006-04-30,458830831,221190887,237639944,캐나다,2006-04
2006-04-30,455119873,527578292,-72458419,말레이시아,2006-04
2006-04-30,429268120,200605262,228662858,영국,2006-04
2006-04-30,410592521,351380888,59211633,인도,2006-04
2006-04-30,332473756,637021749,-304547993,인도네시아,2006-04
2006-04-30,332106811,255217452,76889359,태국,2006-04
2006-04-30,332083656,248855027,83228629,프랑스,2006-04
2006-04-30,320346434,166302726,154043708,필리핀,2006-04
2006-04-30,311323929,72037218,239286711,베트남,2006-04
2006-04-30,296450507,357569729,-61119222,러시아 연방,2006-04
2006-04-30,292524752,225408831,67115921,이탈리아,2006-04
2006-04-30,287944081,208548491,79395590,브라질,2006-04
2006-04-30,273344884,50926746,222418138,스페인,2006-04
2006-04-30,273259861,44767,273215094,라이베리아,2006-04
2006-04-30,256926644,109763742,147162902,남아프리카공화국,2006-04
2006-04-30,235478261,312385014,-76906753,네덜란드,2006-04
2006-04-30,226088675,1007832421,-781743746,아랍에미리트 연합,2006-04
2006-04-30,214523490,11463546,203059944,튀르키예,2006-04
2006-04-30,210905199,16513929,194391270,그리스,2006-04
2006-04-30,198017816,461920682,-263902866,이란,2006-04
2006-04-30,196844262,1623181163,-1426336901,사우디아라비아,2006-04
2006-04-30,195108514,0,195108514,버뮤다,2006-04
2006-04-30,191019714,13424238,177595476,폴란드,2006-04
2006-04-30,177610705,43676275,133934430,덴마크,2006-04
2006-04-30,167969955,1807292,166162663,파나마,2006-04
2006-04-30,166694161,297778998,-131084837,칠레,2006-04
2006-04-30,155658829,66413222,89245607,벨기에,2006-04
2006-04-30,139868371,3230759,136637612,몰타,2006-04
2006-04-30,128694546,39669987,89024559,핀란드,2006-04
2006-04-30,120908695,1751,120906944,마샬군도,2006-04
2006-04-30,115741293,15054656,100686637,헝가리,2006-04
2006-04-30,100979392,91410112,9569280,스위스,2006-04
2006-04-30,91647273,55810935,35836338,오스트리아,2006-04
2006-04-30,77832863,452523787,-374690924,카타르,2006-04
2006-04-30,76560980,3777871,72783109,슬로바키아,2006-04
2006-04-30,75907148,12381767,63525381,콜롬비아,2006-04
2006-04-30,68261892,42335349,25926543,이스라엘,2006-04
2006-04-30,67277961,53036228,14241733,노르웨이,2006-04
2006-04-30,65906305,66522087,-615782,이집트,2006-04
2006-04-30,60761372,4994890,55766482,우크라이나,2006-04
2006-04-30,60057131,893291,59163840,케냐,2006-04
2006-04-30,55854462,39750,55814712,나이지리아,2006-04
2006-04-30,54955700,4253877,50701823,방글라데시,2006-04
2006-04-30,53955308,77926725,-23971417,스웨덴,2006-04
2006-04-30,52350892,14774673,37576219,베네주엘라,2006-04
2006-04-30,48089122,18060027,30029095,파키스탄,2006-04
2006-04-30,47012000,11344801,35667199,우즈베키스탄,2006-04
2006-04-30,45464915,669011111,-623546196,쿠웨이트,2006-04
2006-04-30,44548994,21758594,22790400,과테말라,2006-04
2006-04-30,43674040,57768,43616272,괌,2006-04
2006-04-30,38911811,22164104,16747707,알제리,2006-04
2006-04-30,37856507,3679637,34176870,포루투갈,2006-04
2006-04-30,37484840,72995197,-35510357,뉴질랜드,2006-04
2006-04-30,34746824,19809659,14937165,체코공화국,2006-04
2006-04-30,34407409,239488,34167921,리비아,2006-04
2006-04-30,33760488,784354,32976134,시리아,2006-04
2006-04-30,32944493,3504020,29440473,루마니아,2006-04
2006-04-30,31769613,242787,31526826,사이프러스,2006-04
2006-04-30,30276405,5637376,24639029,요르단,2006-04
2006-04-30,30063943,6635274,23428669,룩셈부르그,2006-04
2006-04-30,27161631,1340564,25821067,에쿠아도르,2006-04
2006-04-30,26883533,59800182,-32916649,페루,2006-04
2006-04-30,24862934,72192754,-47329820,아르헨티나,2006-04
2006-04-30,23017295,18368040,4649255,카자흐스탄,2006-04
2006-04-30,21853217,312370452,-290517235,오만,2006-04
2006-04-30,20940728,79271769,-58331041,아일랜드,2006-04
2006-04-30,20152665,3845773,16306892,모로코,2006-04
2006-04-30,19577150,90007530,-70430380,수단,2006-04
2006-04-30,18708319,2766698,15941621,스리랑카,2006-04
2006-04-30,17814217,105742323,-87928106,이라크,2006-04
2006-04-30,14889624,223612,14666012,캄보디아,2006-04
2006-04-30,14871488,4882846,9988642,코스타리카,2006-04
2006-04-30,14660050,16408886,-1748836,기타국,2006-04
2006-04-30,13837396,356874,13480522,엘살바도르,2006-04
2006-04-30,13023689,34187116,-21163427,바레인,2006-04
2006-04-30,12133666,1561458,10572208,불가리아,2006-04
2006-04-30,10184988,7431281,2753707,푸에르토리코,2006-04
2006-04-30,9985045,46236779,-36251734,예맨,2006-04
2006-04-30,9770966,2371488,7399478,앙골라,2006-04
2006-04-30,9440872,1628692,7812180,온두라스,2006-04
2006-04-30,9384283,1409,9382874,니카라과,2006-04
2006-04-30,8870555,4303456,4567099,미얀마,2006-04
2006-04-30,8619969,2095707,6524262,슬로베니아,2006-04
2006-04-30,8489318,314736,8174582,몽골,2006-04
2006-04-30,7563598,3664615,3898983,크로아티아,2006-04
2006-04-30,7160959,878778,6282181,레바논,2006-04
2006-04-30,7129829,41712,7088117,북마리아나 군도,2006-04
2006-04-30,7030792,1415744,5615048,튀니지,2006-04
2006-04-30,6882599,3864293,3018306,도미니카 공화국,2006-04
2006-04-30,6845432,462362,6383070,가나,2006-04
2006-04-30,6066774,595,6066179,아프카니스탄,2006-04
2006-04-30,4971476,135032,4836444,쿠바,2006-04
2006-04-30,4891847,5819,4886028,키르기스스탄,2006-04
2006-04-30,4871139,748902,4122237,리투아니아,2006-04
2006-04-30,4737852,231341,4506511,파라과이,2006-04
2006-04-30,4498109,1938404,2559705,우루과이,2006-04
2006-04-30,4334412,16019,4318393,뉴 칼레도니아,2006-04
2006-04-30,3861099,903056,2958043,라트비아,2006-04
2006-04-30,3508177,66172,3442005,트리니다드 토바고,2006-04
2006-04-30,3387443,0,3387443,불령 리유니온 코모도 제도,2006-04
2006-04-30,3117875,34670,3083205,모리셔스,2006-04
2006-04-30,2925408,953172,1972236,에스토니아,2006-04
2006-04-30,2666121,258916,2407205,세네갈,2006-04
2006-04-30,2494829,0,2494829,과델로프,2006-04
2006-04-30,2484358,0,2484358,아제르바이잔,2006-04
2006-04-30,2420059,162661,2257398,에티오피아,2006-04
2006-04-30,2361711,1777364,584347,아이슬란드,2006-04
2006-04-30,2299331,0,2299331,마티니크,2006-04
2006-04-30,2294021,566411,1727610,벨라루스,2006-04
2006-04-30,2215641,14152,2201489,탄자니아,2006-04
2006-04-30,2211492,0,2211492,코트디봐르,2006-04
2006-04-30,2186062,0,2186062,나우루,2006-04
2006-04-30,2167452,2094149,73303,라오스,2006-04
2006-04-30,1853005,22938,1830067,토고,2006-04
2006-04-30,1800665,0,1800665,바하마,2006-04
2006-04-30,1679169,16,1679153,유고,2006-04
2006-04-30,1663534,0,1663534,베닝,2006-04
2006-04-30,1652855,0,1652855,지부티,2006-04
2006-04-30,1600903,94681806,-93080903,콩고,2006-04
2006-04-30,1568305,2169095,-600790,스와질랜드,2006-04
2006-04-30,1561718,0,1561718,콩고민주공화국,2006-04
2006-04-30,1525192,151391,1373801,불령 폴리네시아,2006-04
2006-04-30,1471813,114204,1357609,자마이카,2006-04
2006-04-30,1470920,437310,1033610,파푸아 뉴기니,2006-04
2006-04-30,1418055,3750,1414305,아이티,2006-04
2006-04-30,1392599,46200,1346399,네덜란드 열도,2006-04
2006-04-30,1261208,288325,972883,타지크,2006-04
2006-04-30,1181331,472148,709183,마카오,2006-04
2006-04-30,1145317,285749,859568,조지아,2006-04
2006-04-30,1114308,945,1113363,알바니아,2006-04
2006-04-30,1013384,0,1013384,바베이도스,2006-04
2006-04-30,975551,58494,917057,마다카스카르,2006-04
2006-04-30,973809,0,973809,모잠비크,2006-04
2006-04-30,926428,334130,592298,카메룬,2006-04
2006-04-30,878564,4181,874383,도미니카,2006-04
2006-04-30,869833,35529701,-34659868,잠비아,2006-04
2006-04-30,858325,61696317,-60837992,브루나이,2006-04
2006-04-30,804988,9820,795168,수리남,2006-04
2006-04-30,793996,928,793068,안티가 바부다,2006-04
2006-04-30,766129,173413,592716,피지,2006-04
2006-04-30,737475,0,737475,불령 가이아나,2006-04
2006-04-30,655127,27123719,-26468592,볼리비아,2006-04
2006-04-30,639230,3515587,-2876357,기니,2006-04
2006-04-30,587137,0,587137,아루바,2006-04
2006-04-30,567475,178061,389414,투르크멘,2006-04
2006-04-30,548298,31573,516725,마세도니아,2006-04
2006-04-30,534974,130,534844,레소토,2006-04
2006-04-30,527096,940658,-413562,짐바브웨,2006-04
2006-04-30,514174,0,514174,마이크로네시아,2006-04
2006-04-30,499640,0,499640,미령 버진군도,2006-04
2006-04-30,462915,21574,441341,세르비아 와 몬테네그로,2006-04
2006-04-30,447261,3586,443675,보스니아-헤르체고비나,2006-04
2006-04-30,434145,85302,348843,가봉,2006-04
2006-04-30,422245,0,422245,말라위,2006-04
2006-04-30,417581,20477,397104,사모아,2006-04
2006-04-30,389197,418634,-29437,팔레스타인 해방기구(구),2006-04
2006-04-30,376304,33377,342927,세이쉘,2006-04
2006-04-30,360292,5504,354788,네팔,2006-04
2006-04-30,359450,0,359450,세인트 루시아,2006-04
2006-04-30,329834,564,329270,아르메니아,2006-04
2006-04-30,329435,93546,235889,우간다,2006-04
2006-04-30,326660,0,326660,부탄,2006-04
2006-04-30,321569,0,321569,모리타니,2006-04
2006-04-30,312133,0,312133,영령 캐이맨 군도,2006-04
2006-04-30,288031,147095,140936,보츠와나,2006-04
2006-04-30,230449,1446434,-1215985,리히텐슈타인,2006-04
2006-04-30,230089,0,230089,에리트리아,2006-04
2006-04-30,218191,82314,135877,몰도바,2006-04
2006-04-30,213328,457,212871,세인트 키츠 네비스,2006-04
2006-04-30,184293,0,184293,바누아투,2006-04
2006-04-30,170776,144,170632,벨리제,2006-04
2006-04-30,147844,0,147844,적도 기니,2006-04
2006-04-30,147827,1857,145970,아메리칸 사모아,2006-04
2006-04-30,139653,857643,-717990,니제르,2006-04
2006-04-30,124176,50,124126,팔라우,2006-04
2006-04-30,107000,69485,37515,토켈라우,2006-04
2006-04-30,105886,0,105886,가이아나,2006-04
2006-04-30,98835,0,98835,몰디브,2006-04
2006-04-30,94862,0,94862,부르키나 파소,2006-04
2006-04-30,88613,8701518,-8612905,나미비아,2006-04
2006-04-30,78942,0,78942,투르크 & 카이코스 군도,2006-04
2006-04-30,71616,0,71616,카보 베르데,2006-04
2006-04-30,66406,70295,-3889,시에라 리온,2006-04
2006-04-30,65841,54308,11533,중앙아프리카공화국,2006-04
2006-04-30,61664,173,61491,그레나다,2006-04
2006-04-30,59800,0,59800,세인트 빈센트 그레나딘,2006-04
2006-04-30,58216,1034243,-976027,솔로몬 군도,2006-04
2006-04-30,54740,97693,-42953,기네비소,2006-04
2006-04-30,36389,369126,-332737,모나코,2006-04
2006-04-30,33693,51217,-17524,말리,2006-04
2006-04-30,32320,0,32320,소말리아,2006-04
2006-04-30,24972,0,24972,르완다,2006-04
2006-04-30,24553,0,24553,감비아,2006-04
2006-04-30,22248,0,22248,쿡 아일랜드,2006-04
2006-04-30,16911,992,15919,통가,2006-04
2006-04-30,16631,0,16631,부룬디,2006-04
2006-04-30,16350,0,16350,포클랜드 군도,2006-04
2006-04-30,11574,0,11574,산마리노,2006-04
2006-04-30,5979,0,5979,지브랄타,2006-04
2006-04-30,1921,3081,-1160,안도라,2006-04
2006-04-30,1562,23320,-21758,허드 앤 맥도날드 군도,2006-04
2006-04-30,696,229,467,파로에 군도,2006-04
2006-04-30,561,116613,-116052,그린랜드,2006-04
2006-04-30,0,13321,-13321,상토메 프린스페,2006-04
2006-04-30,0,7800,-7800,크리스마스 아일랜드,2006-04
2006-04-30,0,1632,-1632,교황청,2006-04
2006-04-30,0,840,-840,키리바티,2006-04
2006-04-30,0,129222,-129222,챠드,2006-04
2006-04-30,0,9,-9,코스 군도,2006-04
2006-04-30,0,547,-547,마이너 아우틀링 합중국 군도,2006-04
2006-04-30,0,384865,-384865,세인트 헬레나,2006-04
2006-05-31,5768058684,3965955570,1802103114,중국,2006-05
2006-05-31,3516047123,2745301231,770745892,미국,2006-05
2006-05-31,2310335086,4338862305,-2028527219,일본,2006-05
2006-05-31,1567171438,186813180,1380358258,홍콩,2006-05
2006-05-31,1023299617,809627822,213671795,대만,2006-05
2006-05-31,977976185,1038585433,-60609248,독일,2006-05
2006-05-31,881066863,440127226,440939637,러시아 연방,2006-05
2006-05-31,862543768,514659617,347884151,싱가포르,2006-05
2006-05-31,554844944,255701373,299143571,영국,2006-05
2006-05-31,523728801,240706340,283022461,이탈리아,2006-05
2006-05-31,494482498,62876505,431605993,멕시코,2006-05
2006-05-31,478246731,221529804,256716927,인도,2006-05
2006-05-31,392481869,757455037,-364973168,인도네시아,2006-05
2006-05-31,380229046,72848819,307380227,베트남,2006-05
2006-05-31,373724563,287456114,86268449,태국,2006-05
2006-05-31,355867195,547326635,-191459440,말레이시아,2006-05
2006-05-31,340386552,801834213,-461447661,호주,2006-05
2006-05-31,315554042,5764049,309789993,그리스,2006-05
2006-05-31,315465329,241224232,74241097,캐나다,2006-05
2006-05-31,311839964,12938457,298901507,튀르키예,2006-05
2006-05-31,309860156,251691597,58168559,프랑스,2006-05
2006-05-31,309774781,166128622,143646159,브라질,2006-05
2006-05-31,307453764,165558329,141895435,필리핀,2006-05
2006-05-31,274801845,81082945,193718900,스페인,2006-05
2006-05-31,256305984,280283673,-23977689,네덜란드,2006-05
2006-05-31,242334562,1723481335,-1481146773,사우디아라비아,2006-05
2006-05-31,224622933,1166519295,-941896362,아랍에미리트 연합,2006-05
2006-05-31,220444699,5020807,215423892,파나마,2006-05
2006-05-31,217592359,9088,217583271,라이베리아,2006-05
2006-05-31,204602593,85415258,119187335,남아프리카공화국,2006-05
2006-05-31,191939992,426185612,-234245620,이란,2006-05
2006-05-31,184508624,7510530,176998094,베네주엘라,2006-05
2006-05-31,158508271,83168235,75340036,벨기에,2006-05
2006-05-31,155191061,17804134,137386927,폴란드,2006-05
2006-05-31,145754748,529372,145225376,사이프러스,2006-05
2006-05-31,134108360,55663819,78444541,핀란드,2006-05
2006-05-31,116705947,96287462,20418485,스웨덴,2006-05
2006-05-31,108141552,3600497,104541055,슬로바키아,2006-05
2006-05-31,101147854,20126361,81021493,헝가리,2006-05
2006-05-31,91495394,100297993,-8802599,스위스,2006-05
2006-05-31,84391964,84439823,-47859,뉴질랜드,2006-05
2006-05-31,83833050,753435482,-669602432,카타르,2006-05
2006-05-31,83650733,437887806,-354237073,칠레,2006-05
2006-05-31,82391113,23946758,58444355,체코공화국,2006-05
2006-05-31,76771746,18029350,58742396,콜롬비아,2006-05
2006-05-31,74477961,76322766,-1844805,오스트리아,2006-05
2006-05-31,74328166,7397,74320769,바하마,2006-05
2006-05-31,74017173,50,74017123,마샬군도,2006-05
2006-05-31,71696709,65742967,5953742,노르웨이,2006-05
2006-05-31,69665430,29929733,39735697,우크라이나,2006-05
2006-05-31,66184929,41022899,25162030,이집트,2006-05
2006-05-31,63289402,50602510,12686892,이스라엘,2006-05
2006-05-31,59646342,28768741,30877601,나이지리아,2006-05
2006-05-31,57710946,2193684,55517262,기타국,2006-05
2006-05-31,57436295,24586457,32849838,파키스탄,2006-05
2006-05-31,55330260,0,55330260,영령 캐이맨 군도,2006-05
2006-05-31,55321483,3919502,51401981,방글라데시,2006-05
2006-05-31,44822672,21062647,23760025,시리아,2006-05
2006-05-31,44332180,2351599,41980581,우즈베키스탄,2006-05
2006-05-31,43473432,50459,43422973,리비아,2006-05
2006-05-31,42332058,10603497,31728561,과테말라,2006-05
2006-05-31,40708666,63704,40644962,괌,2006-05
2006-05-31,39456538,67267560,-27811022,아일랜드,2006-05
2006-05-31,38599201,3597999,35001202,루마니아,2006-05
2006-05-31,37334543,104774180,-67439637,알제리,2006-05
2006-05-31,36697257,74080077,-37382820,덴마크,2006-05
2006-05-31,36305779,706750130,-670444351,쿠웨이트,2006-05
2006-05-31,33112366,642540,32469826,에쿠아도르,2006-05
2006-05-31,31668382,3772547,27895835,포루투갈,2006-05
2006-05-31,31655276,60870441,-29215165,페루,2006-05
2006-05-31,28057273,21906340,6150933,아르헨티나,2006-05
2006-05-31,26973905,20259819,6714086,카자흐스탄,2006-05
2006-05-31,26366030,1651887,24714143,요르단,2006-05
2006-05-31,23068099,4859908,18208191,코스타리카,2006-05
2006-05-31,21401462,116628,21284834,수단,2006-05
2006-05-31,20838743,421793517,-400954774,오만,2006-05
2006-05-31,19916416,32498192,-12581776,모로코,2006-05
2006-05-31,16357619,136436087,-120078468,예맨,2006-05
2006-05-31,15085978,170515,14915463,이라크,2006-05
2006-05-31,14401413,12200,14389213,알바니아,2006-05
2006-05-31,13740279,1067095,12673184,불가리아,2006-05
2006-05-31,13503024,160005,13343019,캄보디아,2006-05
2006-05-31,13488844,3811649,9677195,도미니카 공화국,2006-05
2006-05-31,13214957,9440623,3774334,푸에르토리코,2006-05
2006-05-31,12695453,3735695,8959758,스리랑카,2006-05
2006-05-31,12532367,2617994,9914373,온두라스,2006-05
2006-05-31,11925619,629646,11295973,튀니지,2006-05
2006-05-31,11652122,2378845,9273277,슬로베니아,2006-05
2006-05-31,11638634,1783,11636851,니카라과,2006-05
2006-05-31,11368971,1490628,9878343,레바논,2006-05
2006-05-31,10027903,372993,9654910,몽골,2006-05
2006-05-31,8277008,3748989,4528019,미얀마,2006-05
2006-05-31,8121340,145583,7975757,크로아티아,2006-05
2006-05-31,7826746,940213,6886533,케냐,2006-05
2006-05-31,7597263,26112,7571151,아프카니스탄,2006-05
2006-05-31,7463469,776381,6687088,가나,2006-05
2006-05-31,7363076,659105,6703971,리투아니아,2006-05
2006-05-31,7007092,329610,6677482,키르기스스탄,2006-05
2006-05-31,6982374,2092500,4889874,앙골라,2006-05
2006-05-31,6965017,46475663,-39510646,바레인,2006-05
2006-05-31,5754769,51850,5702919,파라과이,2006-05
2006-05-31,5504906,1113989,4390917,라트비아,2006-05
2006-05-31,5423909,243784,5180125,엘살바도르,2006-05
2006-05-31,4684323,3664558,1019765,탄자니아,2006-05
2006-05-31,4522691,2068080,2454611,우루과이,2006-05
2006-05-31,4497717,46168,4451549,북마리아나 군도,2006-05
2006-05-31,4121301,0,4121301,코트디봐르,2006-05
2006-05-31,4081020,311884,3769136,마카오,2006-05
2006-05-31,4074973,113085,3961888,쿠바,2006-05
2006-05-31,3928460,501,3927959,트리니다드 토바고,2006-05
2006-05-31,3801038,325,3800713,불령 리유니온 코모도 제도,2006-05
2006-05-31,3750382,0,3750382,아제르바이잔,2006-05
2006-05-31,3386762,4603853,-1217091,뉴 칼레도니아,2006-05
2006-05-31,3010862,1565298,1445564,아이슬란드,2006-05
2006-05-31,2876571,3754389,-877818,몰타,2006-05
2006-05-31,2653830,144522,2509308,모리셔스,2006-05
2006-05-31,2375284,0,2375284,토고,2006-05
2006-05-31,2269468,1671296,598172,에스토니아,2006-05
2006-05-31,2161602,6531315,-4369713,룩셈부르그,2006-05
2006-05-31,2113959,147373963,-145260004,브루나이,2006-05
2006-05-31,2082302,602475,1479827,벨라루스,2006-05
2006-05-31,2070927,169145,1901782,지부티,2006-05
2006-05-31,2016567,0,2016567,아이티,2006-05
2006-05-31,1835498,0,1835498,니제르,2006-05
2006-05-31,1789534,73545,1715989,자마이카,2006-05
2006-05-31,1774187,0,1774187,베닝,2006-05
2006-05-31,1730623,97603,1633020,타지크,2006-05
2006-05-31,1676419,266665,1409754,마다카스카르,2006-05
2006-05-31,1662806,23634,1639172,네덜란드 열도,2006-05
2006-05-31,1639099,54197257,-52558158,카메룬,2006-05
2006-05-31,1634265,2295861,-661596,라오스,2006-05
2006-05-31,1598100,34,1598066,모잠비크,2006-05
2006-05-31,1543407,249030,1294377,조지아,2006-05
2006-05-31,1413011,49742473,-48329462,잠비아,2006-05
2006-05-31,1311524,60063,1251461,피지,2006-05
2006-05-31,1256899,935,1255964,유고,2006-05
2006-05-31,1228346,4898638,-3670292,스와질랜드,2006-05
2006-05-31,1161054,441041,720013,말라위,2006-05
2006-05-31,1159512,292913,866599,세네갈,2006-05
2006-05-31,1126517,0,1126517,불령 가이아나,2006-05
2006-05-31,992462,190025933,-189033471,콩고,2006-05
2006-05-31,951375,14337,937038,세르비아 와 몬테네그로,2006-05
2006-05-31,949057,71,948986,마티니크,2006-05
2006-05-31,927207,47390,879817,네팔,2006-05
2006-05-31,913962,13259888,-12345926,볼리비아,2006-05
2006-05-31,908580,0,908580,레소토,2006-05
2006-05-31,905186,0,905186,불령 폴리네시아,2006-05
2006-05-31,898717,1892126,-993409,파푸아 뉴기니,2006-05
2006-05-31,830357,39399,790958,도미니카,2006-05
2006-05-31,818859,7139,811720,에티오피아,2006-05
2006-05-31,793882,0,793882,바베이도스,2006-05
2006-05-31,723423,0,723423,버뮤다,2006-05
2006-05-31,689123,0,689123,콩고민주공화국,2006-05
2006-05-31,673615,0,673615,세이쉘,2006-05
2006-05-31,639684,2299319,-1659635,기니,2006-05
2006-05-31,639293,89273,550020,아루바,2006-05
2006-05-31,611368,0,611368,과델로프,2006-05
2006-05-31,581836,1086,580750,우간다,2006-05
2006-05-31,469918,23732,446186,수리남,2006-05
2006-05-31,440021,335,439686,안티가 바부다,2006-05
2006-05-31,428551,725319,-296768,짐바브웨,2006-05
2006-05-31,415024,25046,389978,사모아,2006-05
2006-05-31,412002,352200,59802,리히텐슈타인,2006-05
2006-05-31,381806,506580,-124774,아르메니아,2006-05
2006-05-31,374068,98129,275939,몰도바,2006-05
2006-05-31,321603,648,320955,마세도니아,2006-05
2006-05-31,304809,1320594,-1015785,가봉,2006-05
2006-05-31,300476,22209,278267,벨리제,2006-05
2006-05-31,297779,0,297779,팔라우,2006-05
2006-05-31,297001,1404,295597,마이크로네시아,2006-05
2006-05-31,274750,2997,271753,모리타니,2006-05
2006-05-31,246213,0,246213,소말리아,2006-05
2006-05-31,245670,344935,-99265,팔레스타인 해방기구(구),2006-05
2006-05-31,244689,0,244689,부탄,2006-05
2006-05-31,231137,0,231137,아메리칸 사모아,2006-05
2006-05-31,202659,29925,172734,보스니아-헤르체고비나,2006-05
2006-05-31,202096,0,202096,지브랄타,2006-05
2006-05-31,191106,0,191106,몰디브,2006-05
2006-05-31,182743,0,182743,세인트 루시아,2006-05
2006-05-31,172791,0,172791,투르크멘,2006-05
2006-05-31,135800,0,135800,적도 기니,2006-05
2006-05-31,127517,34,127483,감비아,2006-05
2006-05-31,119974,0,119974,에리트리아,2006-05
2006-05-31,114570,0,114570,가이아나,2006-05
2006-05-31,108865,0,108865,그레나다,2006-05
2006-05-31,102986,7288564,-7185578,나미비아,2006-05
2006-05-31,102831,0,102831,바누아투,2006-05
2006-05-31,87368,92080,-4712,보츠와나,2006-05
2006-05-31,79067,0,79067,몬트세라트,2006-05
2006-05-31,69660,0,69660,남조지아 & 남샌드위치 군도,2006-05
2006-05-31,67721,16615,51106,시에라 리온,2006-05
2006-05-31,56015,0,56015,파로에 군도,2006-05
2006-05-31,53965,2143945,-2089980,솔로몬 군도,2006-05
2006-05-31,50696,136321,-85625,말리,2006-05
2006-05-31,44496,0,44496,쿡 아일랜드,2006-05
2006-05-31,43721,396389,-352668,챠드,2006-05
2006-05-31,40487,756188,-715701,모나코,2006-05
2006-05-31,34636,0,34636,영령 버진군도,2006-05
2006-05-31,30300,0,30300,코모로스,2006-05
2006-05-31,28340,927,27413,안도라,2006-05
2006-05-31,25488,0,25488,상토메 프린스페,2006-05
2006-05-31,15325,0,15325,부르키나 파소,2006-05
2006-05-31,12896,2995,9901,세인트 키츠 네비스,2006-05
2006-05-31,7370,0,7370,르완다,2006-05
2006-05-31,7101,0,7101,투르크 & 카이코스 군도,2006-05
2006-05-31,3020,2562,458,토켈라우,2006-05
2006-05-31,1221,0,1221,미령 버진군도,2006-05
2006-05-31,184,211112,-210928,그린랜드,2006-05
2006-05-31,19,0,19,세인트 빈센트 그레나딘,2006-05
2006-05-31,0,1278,-1278,마이너 아우틀링 합중국 군도,2006-05
2006-05-31,0,35732,-35732,기네비소,2006-05
2006-05-31,0,139479,-139479,나우루,2006-05
2006-05-31,0,4021,-4021,산마리노,2006-05
2006-05-31,0,31700,-31700,크리스마스 아일랜드,2006-05
2006-05-31,0,13702,-13702,중앙아프리카공화국,2006-05
2006-05-31,0,3522,-3522,코스 군도,2006-05
2006-06-30,5982891925,3976046155,2006845770,중국,2006-06
2006-06-30,3787495412,2721041275,1066454137,미국,2006-06
2006-06-30,2363666720,4571035461,-2207368741,일본,2006-06
2006-06-30,1650654125,184971532,1465682593,홍콩,2006-06
2006-06-30,1076872143,821848360,255023783,대만,2006-06
2006-06-30,836765441,451216289,385549152,싱가포르,2006-06
2006-06-30,725914584,982543950,-256629366,독일,2006-06
2006-06-30,694843106,396484402,298358704,러시아 연방,2006-06
2006-06-30,595111635,235981915,359129720,영국,2006-06
2006-06-30,567231979,57580546,509651433,멕시코,2006-06
2006-06-30,456897920,253004523,203893397,인도,2006-06
2006-06-30,410576950,27973924,382603026,그리스,2006-06
2006-06-30,374132417,254918038,119214379,이탈리아,2006-06
2006-06-30,358970477,77339315,281631162,베트남,2006-06
2006-06-30,358472662,272601868,85870794,태국,2006-06
2006-06-30,356117989,989575832,-633457843,호주,2006-06
2006-06-30,354267333,802865812,-448598479,인도네시아,2006-06
2006-06-30,353537234,912529,352624705,파나마,2006-06
2006-06-30,341402710,552438622,-211035912,말레이시아,2006-06
2006-06-30,333112629,220034003,113078626,필리핀,2006-06
2006-06-30,308078674,22908,308055766,라이베리아,2006-06
2006-06-30,290642425,290849023,-206598,캐나다,2006-06
2006-06-30,288054534,173731896,114322638,네덜란드,2006-06
2006-06-30,274912943,208186506,66726437,브라질,2006-06
2006-06-30,266099155,13991953,252107202,튀르키예,2006-06
2006-06-30,264406254,1103754947,-839348693,아랍에미리트 연합,2006-06
2006-06-30,252104700,1748036607,-1495931907,사우디아라비아,2006-06
2006-06-30,203761694,61899118,141862576,스페인,2006-06
2006-06-30,202670190,246561964,-43891774,프랑스,2006-06
2006-06-30,188539402,466761673,-278222271,이란,2006-06
2006-06-30,185299973,125940029,59359944,남아프리카공화국,2006-06
2006-06-30,167192227,81510796,85681431,벨기에,2006-06
2006-06-30,156892210,22812350,134079860,폴란드,2006-06
2006-06-30,153246815,189958,153056857,사이프러스,2006-06
2006-06-30,152232658,522,152232136,버뮤다,2006-06
2006-06-30,137638030,47110587,90527443,핀란드,2006-06
2006-06-30,95507330,22511426,72995904,헝가리,2006-06
2006-06-30,93457959,97327829,-3869870,스위스,2006-06
2006-06-30,89607645,260724022,-171116377,칠레,2006-06
2006-06-30,88821195,15905367,72915828,콜롬비아,2006-06
2006-06-30,75219757,117,75219640,나이지리아,2006-06
2006-06-30,71113897,54063367,17050530,노르웨이,2006-06
2006-06-30,69204812,42349885,26854927,이스라엘,2006-06
2006-06-30,68582031,8074004,60508027,우크라이나,2006-06
2006-06-30,67421111,80734142,-13313031,스웨덴,2006-06
2006-06-30,66572384,94753,66477631,베네주엘라,2006-06
2006-06-30,66561446,22317921,44243525,이집트,2006-06
2006-06-30,64073157,69916819,-5843662,오스트리아,2006-06
2006-06-30,61118513,4673781,56444732,방글라데시,2006-06
2006-06-30,60556670,4551464,56005206,몰타,2006-06
2006-06-30,58408372,72591278,-14182906,덴마크,2006-06
2006-06-30,54821216,51259985,3561231,파키스탄,2006-06
2006-06-30,54205086,3996022,50209064,슬로바키아,2006-06
2006-06-30,51790297,20576045,31214252,체코공화국,2006-06
2006-06-30,50951329,1421345,49529984,우즈베키스탄,2006-06
2006-06-30,47592923,2350457,45242466,루마니아,2006-06
2006-06-30,46967643,107262400,-60294757,뉴질랜드,2006-06
2006-06-30,46587725,72140755,-25553030,아일랜드,2006-06
2006-06-30,44817707,330799,44486908,과테말라,2006-06
2006-06-30,44617413,456655792,-412038379,카타르,2006-06
2006-06-30,43727760,759604807,-715877047,쿠웨이트,2006-06
2006-06-30,35473606,0,35473606,마샬군도,2006-06
2006-06-30,35190411,104692426,-69502015,페루,2006-06
2006-06-30,35117639,1247401,33870238,시리아,2006-06
2006-06-30,33909197,596921,33312276,에쿠아도르,2006-06
2006-06-30,33516066,0,33516066,리비아,2006-06
2006-06-30,31289757,4215636,27074121,포루투갈,2006-06
2006-06-30,30775829,58724121,-27948292,아르헨티나,2006-06
2006-06-30,30016416,455283246,-425266830,오만,2006-06
2006-06-30,28927650,194413,28733237,알제리,2006-06
2006-06-30,28689644,7407100,21282544,룩셈부르그,2006-06
2006-06-30,28538321,139108638,-110570317,수단,2006-06
2006-06-30,28329232,33114798,-4785566,카자흐스탄,2006-06
2006-06-30,27608072,59266,27548806,괌,2006-06
2006-06-30,26785606,7018051,19767555,요르단,2006-06
2006-06-30,24772841,5030074,19742767,코스타리카,2006-06
2006-06-30,22817251,387100,22430151,쿠바,2006-06
2006-06-30,18845146,3718779,15126367,모로코,2006-06
2006-06-30,18527876,4413,18523463,바하마,2006-06
2006-06-30,17457660,292926,17164734,캄보디아,2006-06
2006-06-30,15688275,2702541,12985734,스리랑카,2006-06
2006-06-30,14342360,4285602,10056758,기타국,2006-06
2006-06-30,14242094,13811719,430375,푸에르토리코,2006-06
2006-06-30,13537137,376301,13160836,몽골,2006-06
2006-06-30,13524980,81996,13442984,니카라과,2006-06
2006-06-30,12111005,9636341,2474664,도미니카 공화국,2006-06
2006-06-30,11977177,2077433,9899744,미얀마,2006-06
2006-06-30,11556301,675766,10880535,리투아니아,2006-06
2006-06-30,10889785,2201725,8688060,슬로베니아,2006-06
2006-06-30,10396536,2356947,8039589,레바논,2006-06
2006-06-30,9718310,13634568,-3916258,불가리아,2006-06
2006-06-30,9514321,816006,8698315,튀니지,2006-06
2006-06-30,9432356,89545,9342811,케냐,2006-06
2006-06-30,8765653,0,8765653,앙골라,2006-06
2006-06-30,8720230,3260398,5459832,온두라스,2006-06
2006-06-30,8712530,147434781,-138722251,이라크,2006-06
2006-06-30,8189156,167132,8022024,엘살바도르,2006-06
2006-06-30,7764170,573657,7190513,가나,2006-06
2006-06-30,7329076,14993670,-7664594,바레인,2006-06
2006-06-30,6991742,69842463,-62850721,예맨,2006-06
2006-06-30,6448978,2481,6446497,아제르바이잔,2006-06
2006-06-30,6350886,139270,6211616,북마리아나 군도,2006-06
2006-06-30,6344149,29947,6314202,뉴 칼레도니아,2006-06
2006-06-30,6008424,143801,5864623,파라과이,2006-06
2006-06-30,5943511,1233012,4710499,에스토니아,2006-06
2006-06-30,5934762,754746,5180016,라트비아,2006-06
2006-06-30,5783701,784,5782917,아프카니스탄,2006-06
2006-06-30,5721844,117393,5604451,키르기스스탄,2006-06
2006-06-30,5487026,1400031,4086995,우루과이,2006-06
2006-06-30,5358929,176349,5182580,크로아티아,2006-06
2006-06-30,4541417,0,4541417,코트디봐르,2006-06
2006-06-30,4252195,1692060,2560135,아이슬란드,2006-06
2006-06-30,3703120,24878772,-21175652,트리니다드 토바고,2006-06
2006-06-30,3509670,355,3509315,불령 리유니온 코모도 제도,2006-06
2006-06-30,3417378,208699,3208679,탄자니아,2006-06
2006-06-30,3363379,6740,3356639,마티니크,2006-06
2006-06-30,2994963,0,2994963,과델로프,2006-06
2006-06-30,2411200,215250,2195950,에티오피아,2006-06
2006-06-30,2309007,784925,1524082,짐바브웨,2006-06
2006-06-30,2065139,210946,1854193,모리셔스,2006-06
2006-06-30,1958447,0,1958447,지부티,2006-06
2006-06-30,1889646,2985641,-1095995,라오스,2006-06
2006-06-30,1830439,9983,1820456,유고,2006-06
2006-06-30,1778726,154752,1623974,베닝,2006-06
2006-06-30,1773100,700341,1072759,마카오,2006-06
2006-06-30,1759691,115166,1644525,자마이카,2006-06
2006-06-30,1633411,18959,1614452,모잠비크,2006-06
2006-06-30,1610494,471606,1138888,세네갈,2006-06
2006-06-30,1606820,4090702,-2483882,파푸아 뉴기니,2006-06
2006-06-30,1587758,342763,1244995,조지아,2006-06
2006-06-30,1581825,162455,1419370,마다카스카르,2006-06
2006-06-30,1537467,10994,1526473,콩고,2006-06
2006-06-30,1491994,3653789,-2161795,스와질랜드,2006-06
2006-06-30,1478750,631664,847086,벨라루스,2006-06
2006-06-30,1411936,195319,1216617,피지,2006-06
2006-06-30,1365883,23345,1342538,불령 폴리네시아,2006-06
2006-06-30,1319400,1075,1318325,아이티,2006-06
2006-06-30,1182839,9402,1173437,토고,2006-06
2006-06-30,1080575,125874,954701,세르비아 와 몬테네그로,2006-06
2006-06-30,1000546,14705,985841,도미니카,2006-06
2006-06-30,995960,43736,952224,타지크,2006-06
2006-06-30,988931,0,988931,마이크로네시아,2006-06
2006-06-30,929860,1183,928677,바베이도스,2006-06
2006-06-30,878861,36420,842441,안티가 바부다,2006-06
2006-06-30,856153,72552,783601,카메룬,2006-06
2006-06-30,838979,0,838979,아루바,2006-06
2006-06-30,828068,92346239,-91518171,브루나이,2006-06
2006-06-30,823902,158014,665888,우간다,2006-06
2006-06-30,802133,0,802133,네덜란드 열도,2006-06
2006-06-30,774592,0,774592,몰도바,2006-06
2006-06-30,744463,209563,534900,말라위,2006-06
2006-06-30,712365,0,712365,불령 가이아나,2006-06
2006-06-30,704763,11225261,-10520498,볼리비아,2006-06
2006-06-30,638969,14937,624032,콩고민주공화국,2006-06
2006-06-30,634835,0,634835,알바니아,2006-06
2006-06-30,628191,464138,164053,아르메니아,2006-06
2006-06-30,597741,55030,542711,네팔,2006-06
2006-06-30,554159,142557,411602,가봉,2006-06
2006-06-30,527083,34649274,-34122191,기니,2006-06
2006-06-30,524481,63529,460952,보츠와나,2006-06
2006-06-30,430940,1292,429648,몰디브,2006-06
2006-06-30,420729,373405,47324,리히텐슈타인,2006-06
2006-06-30,415478,64717,350761,레소토,2006-06
2006-06-30,400135,0,400135,부르키나 파소,2006-06
2006-06-30,393328,11945,381383,벨리제,2006-06
2006-06-30,378509,0,378509,사모아,2006-06
2006-06-30,377603,0,377603,가이아나,2006-06
2006-06-30,344871,262910,81961,니제르,2006-06
2006-06-30,320891,894823,-573932,보스니아-헤르체고비나,2006-06
2006-06-30,312615,0,312615,수리남,2006-06
2006-06-30,298370,0,298370,투르크 & 카이코스 군도,2006-06
2006-06-30,294198,12114,282084,마세도니아,2006-06
2006-06-30,285979,0,285979,세이쉘,2006-06
2006-06-30,259940,10090,249850,말리,2006-06
2006-06-30,254600,302021,-47421,투르크멘,2006-06
2006-06-30,218632,0,218632,바누아투,2006-06
2006-06-30,201333,965878,-764545,팔레스타인 해방기구(구),2006-06
2006-06-30,183982,0,183982,모리타니,2006-06
2006-06-30,178405,0,178405,에리트리아,2006-06
2006-06-30,177845,0,177845,세인트 루시아,2006-06
2006-06-30,175445,19968,155477,시에라 리온,2006-06
2006-06-30,171656,0,171656,아메리칸 사모아,2006-06
2006-06-30,156794,12035,144759,팔라우,2006-06
2006-06-30,148642,0,148642,영령 캐이맨 군도,2006-06
2006-06-30,148542,0,148542,부탄,2006-06
2006-06-30,135365,0,135365,그레나다,2006-06
2006-06-30,131974,38712780,-38580806,잠비아,2006-06
2006-06-30,95095,6014537,-5919442,나미비아,2006-06
2006-06-30,89861,379,89482,지브랄타,2006-06
2006-06-30,72028,4486454,-4414426,모나코,2006-06
2006-06-30,71792,0,71792,카보 베르데,2006-06
2006-06-30,59420,7357,52063,세인트 키츠 네비스,2006-06
2006-06-30,53150,11034,42116,상토메 프린스페,2006-06
2006-06-30,51005,2185777,-2134772,솔로몬 군도,2006-06
2006-06-30,50799,1019,49780,쿡 아일랜드,2006-06
2006-06-30,49875,0,49875,세인트 빈센트 그레나딘,2006-06
2006-06-30,44192,0,44192,적도 기니,2006-06
2006-06-30,38534,0,38534,중앙아프리카공화국,2006-06
2006-06-30,33531,4125,29406,키리바티,2006-06
2006-06-30,28288,0,28288,감비아,2006-06
2006-06-30,16557,0,16557,미령 버진군도,2006-06
2006-06-30,7401,0,7401,르완다,2006-06
2006-06-30,4338,0,4338,남조지아 & 남샌드위치 군도,2006-06
2006-06-30,3177,110123,-106946,세인트 헬레나,2006-06
2006-06-30,950,242,708,영령 버진군도,2006-06
2006-06-30,420,0,420,투발루,2006-06
2006-06-30,0,232069,-232069,그린랜드,2006-06
2006-06-30,0,1,-1,크리스마스 아일랜드,2006-06
2006-06-30,0,134013,-134013,챠드,2006-06
2006-06-30,0,3761,-3761,코모로스,2006-06
2006-06-30,0,50,-50,안타티카,2006-06
2006-06-30,0,602,-602,몬트세라트,2006-06
2006-06-30,0,56490,-56490,교황청,2006-06
2006-06-30,0,4645,-4645,산마리노,2006-06
2006-06-30,0,35918,-35918,기네비소,2006-06
2006-06-30,0,4636,-4636,안도라,2006-06
2006-06-30,0,6930,-6930,토켈라우,2006-06
2006-07-31,5644307935,3770480268,1873827667,중국,2006-07
2006-07-31,3593549623,2814719011,778830612,미국,2006-07
2006-07-31,2077096965,4295923128,-2218826163,일본,2006-07
2006-07-31,1428038248,170113133,1257925115,홍콩,2006-07
2006-07-31,1184811982,783904394,400907588,대만,2006-07
2006-07-31,872797934,500312138,372485796,싱가포르,2006-07
2006-07-31,716992687,891299969,-174307282,독일,2006-07
2006-07-31,589599286,703443702,-113844416,인도네시아,2006-07
2006-07-31,546606029,70014918,476591111,멕시코,2006-07
2006-07-31,493015976,248597584,244418392,인도,2006-07
2006-07-31,355920592,484555293,-128634701,말레이시아,2006-07
2006-07-31,345458589,37542610,307915979,파나마,2006-07
2006-07-31,344181059,292121752,52059307,네덜란드,2006-07
2006-07-31,338037691,263970126,74067565,영국,2006-07
2006-07-31,337487490,407370402,-69882912,러시아 연방,2006-07
2006-07-31,330737497,977415968,-646678471,호주,2006-07
2006-07-31,321042158,187570714,133471444,필리핀,2006-07
2006-07-31,320078907,285462459,34616448,태국,2006-07
2006-07-31,301699198,28846,301670352,라이베리아,2006-07
2006-07-31,293986773,69979045,224007728,베트남,2006-07
2006-07-31,282079095,163078855,119000240,브라질,2006-07
2006-07-31,271726253,311511058,-39784805,프랑스,2006-07
2006-07-31,253852978,276391814,-22538836,이탈리아,2006-07
2006-07-31,252645971,81728731,170917240,폴란드,2006-07
2006-07-31,235525838,2085901880,-1850376042,사우디아라비아,2006-07
2006-07-31,226551933,244769485,-18217552,캐나다,2006-07
2006-07-31,213247879,21279398,191968481,튀르키예,2006-07
2006-07-31,207421252,62253381,145167871,스페인,2006-07
2006-07-31,205591994,425854901,-220262907,이란,2006-07
2006-07-31,200597941,1258234673,-1057636732,아랍에미리트 연합,2006-07
2006-07-31,178266184,100502211,77763973,노르웨이,2006-07
2006-07-31,154622425,78344772,76277653,벨기에,2006-07
2006-07-31,147740082,340331566,-192591484,칠레,2006-07
2006-07-31,131735934,79037789,52698145,남아프리카공화국,2006-07
2006-07-31,129606015,47609723,81996292,핀란드,2006-07
2006-07-31,126068348,6035119,120033229,슬로바키아,2006-07
2006-07-31,110938825,4011418,106927407,그리스,2006-07
2006-07-31,97720607,336019940,-238299333,카타르,2006-07
2006-07-31,84172532,101856185,-17683653,스위스,2006-07
2006-07-31,81322673,16564060,64758613,헝가리,2006-07
2006-07-31,73006619,81361010,-8354391,뉴질랜드,2006-07
2006-07-31,67692409,18956935,48735474,콜롬비아,2006-07
2006-07-31,66192619,6669,66185950,바하마,2006-07
2006-07-31,62499881,73249643,-10749762,나이지리아,2006-07
2006-07-31,60777523,330706,60446817,베네주엘라,2006-07
2006-07-31,60061399,3857894,56203505,우크라이나,2006-07
2006-07-31,59969425,58483892,1485533,오스트리아,2006-07
2006-07-31,55496884,72967981,-17471097,스웨덴,2006-07
2006-07-31,54207860,2388487,51819373,우즈베키스탄,2006-07
2006-07-31,52767502,62611136,-9843634,파키스탄,2006-07
2006-07-31,49492913,664293717,-614800804,쿠웨이트,2006-07
2006-07-31,44967337,525366,44441971,과테말라,2006-07
2006-07-31,44546650,29843454,14703196,이집트,2006-07
2006-07-31,44397311,38354228,6043083,이스라엘,2006-07
2006-07-31,43416242,4501488,38914754,루마니아,2006-07
2006-07-31,42703797,4288206,38415591,방글라데시,2006-07
2006-07-31,41077332,4010895,37066437,포루투갈,2006-07
2006-07-31,38096500,346145,37750355,리비아,2006-07
2006-07-31,34352033,0,34352033,영령 캐이맨 군도,2006-07
2006-07-31,33549993,15444788,18105205,체코공화국,2006-07
2006-07-31,32420613,1350370,31070243,시리아,2006-07
2006-07-31,32169205,0,32169205,마샬군도,2006-07
2006-07-31,30895135,903535,29991600,수단,2006-07
2006-07-31,29546531,4099343,25447188,몰타,2006-07
2006-07-31,27865999,4895137,22970862,요르단,2006-07
2006-07-31,26577494,29919220,-3341726,페루,2006-07
2006-07-31,25600890,198758,25402132,괌,2006-07
2006-07-31,22429536,950030,21479506,에쿠아도르,2006-07
2006-07-31,21949347,21784959,164388,카자흐스탄,2006-07
2006-07-31,21604422,39830386,-18225964,아르헨티나,2006-07
2006-07-31,21291253,335739551,-314448298,오만,2006-07
2006-07-31,21034251,4115137,16919114,코스타리카,2006-07
2006-07-31,20792296,77689826,-56897530,아일랜드,2006-07
2006-07-31,20683969,43911798,-23227829,덴마크,2006-07
2006-07-31,20454458,4053359,16401099,모로코,2006-07
2006-07-31,20123861,304159,19819702,쿠바,2006-07
2006-07-31,17097953,27089515,-9991562,알제리,2006-07
2006-07-31,16987441,65429131,-48441690,앙골라,2006-07
2006-07-31,15765246,505264,15259982,캄보디아,2006-07
2006-07-31,15678778,3758182,11920596,스리랑카,2006-07
2006-07-31,14110665,7664978,6445687,불가리아,2006-07
2006-07-31,12849888,316,12849572,니카라과,2006-07
2006-07-31,10882925,1540773,9342152,온두라스,2006-07
2006-07-31,10551379,1021154,9530225,리투아니아,2006-07
2006-07-31,9486786,3742440,5744346,기타국,2006-07
2006-07-31,9236429,3730671,5505758,미얀마,2006-07
2006-07-31,8461669,891540,7570129,몽골,2006-07
2006-07-31,7765006,17491147,-9726141,푸에르토리코,2006-07
2006-07-31,7718378,395575,7322803,가나,2006-07
2006-07-31,7243558,1990187,5253371,슬로베니아,2006-07
2006-07-31,6863611,40884834,-34021223,예맨,2006-07
2006-07-31,6768218,912509,5855709,에스토니아,2006-07
2006-07-31,6160496,16276654,-10116158,바레인,2006-07
2006-07-31,6113420,83989,6029431,북마리아나 군도,2006-07
2006-07-31,6081087,1057,6080030,키르기스스탄,2006-07
2006-07-31,5525280,1164612,4360668,엘살바도르,2006-07
2006-07-31,5493178,521944,4971234,케냐,2006-07
2006-07-31,5437258,10430973,-4993715,도미니카 공화국,2006-07
2006-07-31,5130489,415807,4714682,라트비아,2006-07
2006-07-31,4262615,0,4262615,코트디봐르,2006-07
2006-07-31,4174566,470,4174096,아프카니스탄,2006-07
2006-07-31,4013840,123617,3890223,파라과이,2006-07
2006-07-31,3320629,2745500,575129,우루과이,2006-07
2006-07-31,3131455,52520,3078935,사이프러스,2006-07
2006-07-31,3100008,3638829,-538821,레바논,2006-07
2006-07-31,2927590,1117606,1809984,탄자니아,2006-07
2006-07-31,2865952,0,2865952,불령 리유니온 코모도 제도,2006-07
2006-07-31,2826292,265892,2560400,트리니다드 토바고,2006-07
2006-07-31,2778160,669113,2109047,마카오,2006-07
2006-07-31,2776875,2817333,-40458,튀니지,2006-07
2006-07-31,2690279,110836,2579443,베닝,2006-07
2006-07-31,2657672,605561,2052111,벨라루스,2006-07
2006-07-31,2501278,354352,2146926,세네갈,2006-07
2006-07-31,2390001,3280558,-890557,토고,2006-07
2006-07-31,2251729,563056,1688673,나우루,2006-07
2006-07-31,2244724,0,2244724,아제르바이잔,2006-07
2006-07-31,2165550,140023,2025527,모리셔스,2006-07
2006-07-31,2076806,11280,2065526,뉴 칼레도니아,2006-07
2006-07-31,2017553,289057,1728496,크로아티아,2006-07
2006-07-31,1880994,67674757,-65793763,콩고,2006-07
2006-07-31,1798570,605673,1192897,짐바브웨,2006-07
2006-07-31,1763516,23766618,-22003102,이라크,2006-07
2006-07-31,1723304,4128719,-2405415,스와질랜드,2006-07
2006-07-31,1660662,937848,722814,아이슬란드,2006-07
2006-07-31,1597033,235632,1361401,우간다,2006-07
2006-07-31,1490974,12054,1478920,라오스,2006-07
2006-07-31,1486884,852,1486032,아이티,2006-07
2006-07-31,1455022,73829,1381193,마다카스카르,2006-07
2006-07-31,1381062,54665,1326397,네덜란드 열도,2006-07
2006-07-31,1375297,5200,1370097,지부티,2006-07
2006-07-31,1332350,35613772,-34281422,카메룬,2006-07
2006-07-31,1326099,1733188,-407089,조지아,2006-07
2006-07-31,1208631,625,1208006,자마이카,2006-07
2006-07-31,1131305,0,1131305,과델로프,2006-07
2006-07-31,1096327,7350552,-6254225,룩셈부르그,2006-07
2006-07-31,1057233,0,1057233,콩고민주공화국,2006-07
2006-07-31,994608,245145,749463,에티오피아,2006-07
2006-07-31,972987,81611300,-80638313,브루나이,2006-07
2006-07-31,928387,38310,890077,유고,2006-07
2006-07-31,892869,1073152,-180283,파푸아 뉴기니,2006-07
2006-07-31,821528,0,821528,타지크,2006-07
2006-07-31,799671,200,799471,아루바,2006-07
2006-07-31,754126,36916,717210,불령 폴리네시아,2006-07
2006-07-31,724511,2980,721531,아르메니아,2006-07
2006-07-31,720158,34732,685426,세르비아 와 몬테네그로,2006-07
2006-07-31,720078,2807086,-2087008,가봉,2006-07
2006-07-31,700592,0,700592,세이쉘,2006-07
2006-07-31,654208,61511,592697,네팔,2006-07
2006-07-31,645229,909981,-264752,기니,2006-07
2006-07-31,599015,6358,592657,모잠비크,2006-07
2006-07-31,594465,24978,569487,피지,2006-07
2006-07-31,588439,12057,576382,바베이도스,2006-07
2006-07-31,569441,0,569441,알바니아,2006-07
2006-07-31,554843,39915220,-39360377,볼리비아,2006-07
2006-07-31,540252,0,540252,마티니크,2006-07
2006-07-31,536124,8274,527850,마이크로네시아,2006-07
2006-07-31,523051,107789,415262,니제르,2006-07
2006-07-31,499570,3693,495877,몰디브,2006-07
2006-07-31,479379,0,479379,가이아나,2006-07
2006-07-31,465406,40652,424754,보츠와나,2006-07
2006-07-31,444249,41002,403247,사모아,2006-07
2006-07-31,431966,169,431797,보스니아-헤르체고비나,2006-07
2006-07-31,425936,14278,411658,아메리칸 사모아,2006-07
2006-07-31,423548,0,423548,투르크멘,2006-07
2006-07-31,397127,353055,44072,리히텐슈타인,2006-07
2006-07-31,389650,148108,241542,안티가 바부다,2006-07
2006-07-31,374115,25953,348162,수리남,2006-07
2006-07-31,371384,309909,61475,말라위,2006-07
2006-07-31,327171,5534,321637,버뮤다,2006-07
2006-07-31,303180,233379,69801,벨리제,2006-07
2006-07-31,293277,0,293277,그레나다,2006-07
2006-07-31,281822,14492,267330,도미니카,2006-07
2006-07-31,225920,0,225920,모리타니,2006-07
2006-07-31,201314,0,201314,바누아투,2006-07
2006-07-31,189125,51338781,-51149656,잠비아,2006-07
2006-07-31,173505,0,173505,감비아,2006-07
2006-07-31,158931,6186,152745,마세도니아,2006-07
2006-07-31,133100,0,133100,통가,2006-07
2006-07-31,126415,0,126415,지브랄타,2006-07
2006-07-31,123127,3496,119631,말리,2006-07
2006-07-31,121841,385000,-263159,팔레스타인 해방기구(구),2006-07
2006-07-31,115038,0,115038,팔라우,2006-07
2006-07-31,105756,0,105756,몰도바,2006-07
2006-07-31,105560,0,105560,나미비아,2006-07
2006-07-31,94813,0,94813,부르키나 파소,2006-07
2006-07-31,89375,0,89375,레소토,2006-07
2006-07-31,84039,457818,-373779,모나코,2006-07
2006-07-31,78860,0,78860,세인트 루시아,2006-07
2006-07-31,77289,23010,54279,시에라 리온,2006-07
2006-07-31,75000,0,75000,적도 기니,2006-07
2006-07-31,65742,0,65742,르완다,2006-07
2006-07-31,62530,210646,-148116,기네비소,2006-07
2006-07-31,54383,63965,-9582,안도라,2006-07
2006-07-31,49985,32,49953,불령 가이아나,2006-07
2006-07-31,38705,0,38705,부룬디,2006-07
2006-07-31,35392,0,35392,투발루,2006-07
2006-07-31,33156,0,33156,영령 버진군도,2006-07
2006-07-31,22467,0,22467,세인트 빈센트 그레나딘,2006-07
2006-07-31,6438,5738,700,세인트 키츠 네비스,2006-07
2006-07-31,4909,0,4909,쿡 아일랜드,2006-07
2006-07-31,4550,19623,-15073,중앙아프리카공화국,2006-07
2006-07-31,3207,1806342,-1803135,솔로몬 군도,2006-07
2006-07-31,2478,202,2276,부탄,2006-07
2006-07-31,1895,0,1895,파로에 군도,2006-07
2006-07-31,1521,6365,-4844,미령 버진군도,2006-07
2006-07-31,650,5456,-4806,토켈라우,2006-07
2006-07-31,0,204,-204,카보 베르데,2006-07
2006-07-31,0,2238,-2238,산마리노,2006-07
2006-07-31,0,5040,-5040,세인트 헬레나,2006-07
2006-07-31,0,415351,-415351,챠드,2006-07
2006-07-31,0,27074,-27074,코스 군도,2006-07
2006-07-31,0,6254,-6254,포클랜드 군도,2006-07
2006-07-31,0,181375,-181375,그린랜드,2006-07
2006-07-31,0,21901,-21901,서사하라,2006-07
2006-07-31,0,1010,-1010,티모르,2006-07
2006-07-31,0,2528,-2528,키리바티,2006-07
2006-08-31,6221785801,4212983734,2008802067,중국,2006-08
2006-08-31,3551040488,3051999351,499041137,미국,2006-08
2006-08-31,2230652616,4207391352,-1976738736,일본,2006-08
2006-08-31,1604949314,181830281,1423119033,홍콩,2006-08
2006-08-31,1059690264,797305047,262385217,대만,2006-08
2006-08-31,780834924,471215117,309619807,싱가포르,2006-08
2006-08-31,717683259,965352743,-247669484,독일,2006-08
2006-08-31,645256317,58814836,586441481,멕시코,2006-08
2006-08-31,510715584,375180232,135535352,인도,2006-08
2006-08-31,453172082,793542809,-340370727,인도네시아,2006-08
2006-08-31,428420201,579096480,-150676279,말레이시아,2006-08
2006-08-31,427164632,83005289,344159343,베트남,2006-08
2006-08-31,413723158,268970200,144752958,영국,2006-08
2006-08-31,389414057,181810826,207603231,필리핀,2006-08
2006-08-31,373127518,261380157,111747361,태국,2006-08
2006-08-31,368810527,45758238,323052289,라이베리아,2006-08
2006-08-31,367775998,970416559,-602640561,호주,2006-08
2006-08-31,360194782,272273972,87920810,네덜란드,2006-08
2006-08-31,354839552,262849181,91990371,프랑스,2006-08
2006-08-31,345436594,402847954,-57411360,러시아 연방,2006-08
2006-08-31,317539536,17329364,300210172,폴란드,2006-08
2006-08-31,254095217,258415499,-4320282,캐나다,2006-08
2006-08-31,243910872,155526174,88384698,브라질,2006-08
2006-08-31,237436770,1165118573,-927681803,아랍에미리트 연합,2006-08
2006-08-31,233415576,266371197,-32955621,이탈리아,2006-08
2006-08-31,225695496,2157738165,-1932042669,사우디아라비아,2006-08
2006-08-31,218345311,12620391,205724920,튀르키예,2006-08
2006-08-31,217526712,401836653,-184309941,이란,2006-08
2006-08-31,214701068,62679221,152021847,스페인,2006-08
2006-08-31,190007173,3812204,186194969,그리스,2006-08
2006-08-31,180870081,396578527,-215708446,칠레,2006-08
2006-08-31,174734078,57850638,116883440,핀란드,2006-08
2006-08-31,170309838,166728,170143110,사이프러스,2006-08
2006-08-31,151699885,13938,151685947,버뮤다,2006-08
2006-08-31,148192538,86858714,61333824,벨기에,2006-08
2006-08-31,129703114,5063736,124639378,슬로바키아,2006-08
2006-08-31,122702973,16505352,106197621,파나마,2006-08
2006-08-31,119193019,80117779,39075240,남아프리카공화국,2006-08
2006-08-31,114250548,80623697,33626851,스웨덴,2006-08
2006-08-31,102350372,17868348,84482024,헝가리,2006-08
2006-08-31,82543388,500556582,-418013194,카타르,2006-08
2006-08-31,78631490,125420062,-46788572,스위스,2006-08
2006-08-31,74118620,946021,73172599,과테말라,2006-08
2006-08-31,71348561,54061698,17286863,오스트리아,2006-08
2006-08-31,71306746,299485,71007261,베네주엘라,2006-08
2006-08-31,70540875,13267558,57273317,콜롬비아,2006-08
2006-08-31,61924764,15970355,45954409,파키스탄,2006-08
2006-08-31,61435482,3546,61431936,나이지리아,2006-08
2006-08-31,59423337,4497103,54926234,루마니아,2006-08
2006-08-31,56838986,2055349,54783637,이집트,2006-08
2006-08-31,55589331,3358881,52230450,우크라이나,2006-08
2006-08-31,52613871,4865233,47748638,방글라데시,2006-08
2006-08-31,51059464,19749047,31310417,체코공화국,2006-08
2006-08-31,49500204,2395886,47104318,우즈베키스탄,2006-08
2006-08-31,47875966,50182656,-2306690,이스라엘,2006-08
2006-08-31,46719817,45739154,980663,덴마크,2006-08
2006-08-31,46481651,95589479,-49107828,뉴질랜드,2006-08
2006-08-31,43553866,949826737,-906272871,쿠웨이트,2006-08
2006-08-31,43404018,9918,43394100,마샬군도,2006-08
2006-08-31,38286669,91213,38195456,쿠바,2006-08
2006-08-31,35392109,0,35392109,영령 캐이맨 군도,2006-08
2006-08-31,31510357,67178124,-35667767,페루,2006-08
2006-08-31,29970691,1628149,28342542,시리아,2006-08
2006-08-31,29334391,1390177,27944214,에쿠아도르,2006-08
2006-08-31,28368467,45265067,-16896600,알제리,2006-08
2006-08-31,27408144,40941864,-13533720,아르헨티나,2006-08
2006-08-31,26461963,2614827,23847136,요르단,2006-08
2006-08-31,25902913,200200,25702713,리비아,2006-08
2006-08-31,25165172,36238780,-11073608,카자흐스탄,2006-08
2006-08-31,24506864,67385245,-42878381,아일랜드,2006-08
2006-08-31,23780796,4448263,19332533,포루투갈,2006-08
2006-08-31,19231009,4501806,14729203,모로코,2006-08
2006-08-31,19132488,3685416,15447072,코스타리카,2006-08
2006-08-31,18571988,20650,18551338,바하마,2006-08
2006-08-31,17792484,81488626,-63696142,노르웨이,2006-08
2006-08-31,17289358,3659604,13629754,몰타,2006-08
2006-08-31,17189089,1247166,15941923,캄보디아,2006-08
2006-08-31,16845311,355515340,-338670029,오만,2006-08
2006-08-31,16513618,2580140,13933478,스리랑카,2006-08
2006-08-31,14002490,29488325,-15485835,기타국,2006-08
2006-08-31,13003409,0,13003409,니카라과,2006-08
2006-08-31,12311082,612206,11698876,수단,2006-08
2006-08-31,11523162,4474570,7048592,미얀마,2006-08
2006-08-31,11050109,1572987,9477122,온두라스,2006-08
2006-08-31,10830037,3383467,7446570,불가리아,2006-08
2006-08-31,10396257,3406286,6989971,가나,2006-08
2006-08-31,10367993,643,10367350,아프카니스탄,2006-08
2006-08-31,9471930,2618555,6853375,슬로베니아,2006-08
2006-08-31,9171476,292073,8879403,몽골,2006-08
2006-08-31,8124161,14354304,-6230143,푸에르토리코,2006-08
2006-08-31,8066835,23482650,-15415815,도미니카 공화국,2006-08
2006-08-31,7509556,32316813,-24807257,바레인,2006-08
2006-08-31,7313143,139142,7174001,키르기스스탄,2006-08
2006-08-31,6770235,711951,6058284,리투아니아,2006-08
2006-08-31,6730695,255301,6475394,크로아티아,2006-08
2006-08-31,6667944,199830,6468114,파라과이,2006-08
2006-08-31,6575942,73476378,-66900436,앙골라,2006-08
2006-08-31,6230637,133017182,-126786545,이라크,2006-08
2006-08-31,5910056,1361329,4548727,튀니지,2006-08
2006-08-31,5462208,2087728,3374480,라트비아,2006-08
2006-08-31,5405760,2345292,3060468,엘살바도르,2006-08
2006-08-31,5280104,346736,4933368,케냐,2006-08
2006-08-31,5155571,51246543,-46090972,예맨,2006-08
2006-08-31,4789973,1600783,3189190,에스토니아,2006-08
2006-08-31,4461223,0,4461223,불령 리유니온 코모도 제도,2006-08
2006-08-31,4225054,2833325,1391729,우루과이,2006-08
2006-08-31,4180145,10658,4169487,북마리아나 군도,2006-08
2006-08-31,4154010,428,4153582,아제르바이잔,2006-08
2006-08-31,3700682,44000,3656682,코트디봐르,2006-08
2006-08-31,3471495,17592,3453903,뉴 칼레도니아,2006-08
2006-08-31,3267151,0,3267151,트리니다드 토바고,2006-08
2006-08-31,3027126,636504,2390622,벨라루스,2006-08
2006-08-31,2709597,0,2709597,베닝,2006-08
2006-08-31,2305371,43730,2261641,괌,2006-08
2006-08-31,2229419,0,2229419,나우루,2006-08
2006-08-31,2122135,63102,2059033,모리셔스,2006-08
2006-08-31,2120374,2806180,-685806,탄자니아,2006-08
2006-08-31,2110713,546155,1564558,조지아,2006-08
2006-08-31,1916800,3616894,-1700094,룩셈부르그,2006-08
2006-08-31,1912082,68404,1843678,라오스,2006-08
2006-08-31,1851321,3800990,-1949669,스와질랜드,2006-08
2006-08-31,1848396,73824262,-71975866,콩고,2006-08
2006-08-31,1580678,1032764,547914,피지,2006-08
2006-08-31,1579738,0,1579738,레소토,2006-08
2006-08-31,1557644,0,1557644,마티니크,2006-08
2006-08-31,1519804,36098,1483706,자마이카,2006-08
2006-08-31,1478842,858,1477984,아이티,2006-08
2006-08-31,1470521,799377,671144,마카오,2006-08
2006-08-31,1365620,115500,1250120,지부티,2006-08
2006-08-31,1300401,56739,1243662,투르크멘,2006-08
2006-08-31,1193324,6624,1186700,과델로프,2006-08
2006-08-31,1066890,1348636,-281746,아이슬란드,2006-08
2006-08-31,1021154,6248,1014906,타지크,2006-08
2006-08-31,1013081,240968,772113,마다카스카르,2006-08
2006-08-31,985366,111078755,-110093389,브루나이,2006-08
2006-08-31,941869,8309431,-7367562,볼리비아,2006-08
2006-08-31,934934,4199,930735,도미니카,2006-08
2006-08-31,915045,4171192,-3256147,짐바브웨,2006-08
2006-08-31,912968,7331,905637,불령 폴리네시아,2006-08
2006-08-31,890451,30806,859645,네팔,2006-08
2006-08-31,889283,696027,193256,에티오피아,2006-08
2006-08-31,883088,1184248,-301160,파푸아 뉴기니,2006-08
2006-08-31,824187,6133,818054,세르비아 와 몬테네그로,2006-08
2006-08-31,800394,1039,799355,토고,2006-08
2006-08-31,780302,28500,751802,모잠비크,2006-08
2006-08-31,755434,14354,741080,우간다,2006-08
2006-08-31,673019,0,673019,아루바,2006-08
2006-08-31,644795,43056,601739,네덜란드 열도,2006-08
2006-08-31,578107,1305559,-727452,레바논,2006-08
2006-08-31,562560,626682,-64122,세네갈,2006-08
2006-08-31,541823,105591,436232,몰도바,2006-08
2006-08-31,514935,121929,393006,보츠와나,2006-08
2006-08-31,497657,0,497657,수리남,2006-08
2006-08-31,485157,1010,484147,안티가 바부다,2006-08
2006-08-31,475360,0,475360,유고,2006-08
2006-08-31,471122,0,471122,콩고민주공화국,2006-08
2006-08-31,467540,0,467540,불령 가이아나,2006-08
2006-08-31,456093,63432296,-62976203,카메룬,2006-08
2006-08-31,446937,1884,445053,사모아,2006-08
2006-08-31,445163,263234,181929,팔레스타인 해방기구(구),2006-08
2006-08-31,415849,25483,390366,벨리제,2006-08
2006-08-31,398497,3447,395050,니제르,2006-08
2006-08-31,386067,0,386067,팔라우,2006-08
2006-08-31,384107,324,383783,세이쉘,2006-08
2006-08-31,375417,0,375417,몰디브,2006-08
2006-08-31,365166,391067,-25901,기니,2006-08
2006-08-31,358516,0,358516,마이크로네시아,2006-08
2006-08-31,354738,70010,284728,보스니아-헤르체고비나,2006-08
2006-08-31,349670,9425,340245,가이아나,2006-08
2006-08-31,347555,0,347555,바베이도스,2006-08
2006-08-31,310728,48120405,-47809677,잠비아,2006-08
2006-08-31,298686,24254,274432,알바니아,2006-08
2006-08-31,279421,373977,-94556,아르메니아,2006-08
2006-08-31,274389,7269,267120,마세도니아,2006-08
2006-08-31,264770,453454,-188684,리히텐슈타인,2006-08
2006-08-31,248264,6825079,-6576815,나미비아,2006-08
2006-08-31,247757,473905,-226148,말라위,2006-08
2006-08-31,245022,0,245022,말리,2006-08
2006-08-31,232844,0,232844,감비아,2006-08
2006-08-31,232318,43857,188461,부르키나 파소,2006-08
2006-08-31,222457,1061194,-838737,가봉,2006-08
2006-08-31,206408,307307,-100899,모리타니,2006-08
2006-08-31,189667,97036,92631,시에라 리온,2006-08
2006-08-31,165661,0,165661,그레나다,2006-08
2006-08-31,153800,102804,50996,아메리칸 사모아,2006-08
2006-08-31,150877,121031,29846,바누아투,2006-08
2006-08-31,127530,0,127530,카보 베르데,2006-08
2006-08-31,126005,0,126005,몬트세라트,2006-08
2006-08-31,100453,0,100453,세인트 루시아,2006-08
2006-08-31,93074,0,93074,적도 기니,2006-08
2006-08-31,82728,0,82728,티모르,2006-08
2006-08-31,81172,0,81172,소말리아,2006-08
2006-08-31,72447,0,72447,영령 버진군도,2006-08
2006-08-31,67583,0,67583,남조지아 & 남샌드위치 군도,2006-08
2006-08-31,58448,0,58448,부탄,2006-08
2006-08-31,55847,0,55847,부룬디,2006-08
2006-08-31,54189,0,54189,통가,2006-08
2006-08-31,45611,0,45611,에리트리아,2006-08
2006-08-31,42677,0,42677,교황청,2006-08
2006-08-31,35790,0,35790,세인트 키츠 네비스,2006-08
2006-08-31,33654,404,33250,미령 버진군도,2006-08
2006-08-31,13652,4036113,-4022461,모나코,2006-08
2006-08-31,13552,62337,-48785,안도라,2006-08
2006-08-31,10292,0,10292,파로에 군도,2006-08
2006-08-31,8710,0,8710,세인트 빈센트 그레나딘,2006-08
2006-08-31,7390,0,7390,르완다,2006-08
2006-08-31,5966,0,5966,쿡 아일랜드,2006-08
2006-08-31,4600,0,4600,코스 군도,2006-08
2006-08-31,2237,3505381,-3503144,솔로몬 군도,2006-08
2006-08-31,2064,0,2064,투발루,2006-08
2006-08-31,1477,0,1477,산마리노,2006-08
2006-08-31,1094,0,1094,지브랄타,2006-08
2006-08-31,309,175046,-174737,그린랜드,2006-08
2006-08-31,0,322,-322,투르크 & 카이코스 군도,2006-08
2006-08-31,0,118,-118,허드 앤 맥도날드 군도,2006-08
2006-08-31,0,20052,-20052,포클랜드 군도,2006-08
2006-08-31,0,17740,-17740,챠드,2006-08
2006-08-31,0,736,-736,키리바티,2006-08
2006-08-31,0,702788,-702788,기네비소,2006-08
2006-08-31,0,88147,-88147,토켈라우,2006-08
2006-08-31,0,165952,-165952,세인트 헬레나,2006-08
2006-09-30,6363844539,4682672701,1681171838,중국,2006-09
2006-09-30,3828544843,3050814381,777730462,미국,2006-09
2006-09-30,2369865037,4546858509,-2176993472,일본,2006-09
2006-09-30,1846721555,185600609,1661120946,홍콩,2006-09
2006-09-30,1202611709,815998672,386613037,대만,2006-09
2006-09-30,931134032,533367006,397767026,싱가포르,2006-09
2006-09-30,827527367,1074880227,-247352860,독일,2006-09
2006-09-30,735231595,97849997,637381598,멕시코,2006-09
2006-09-30,526778042,263890921,262887121,영국,2006-09
2006-09-30,518164349,371699646,146464703,인도,2006-09
2006-09-30,502322224,709805121,-207482897,인도네시아,2006-09
2006-09-30,496641083,958351403,-461710320,호주,2006-09
2006-09-30,450493908,68880812,381613096,스페인,2006-09
2006-09-30,439989134,438361506,1627628,러시아 연방,2006-09
2006-09-30,429160289,629660924,-200500635,말레이시아,2006-09
2006-09-30,410238010,313779143,96458867,태국,2006-09
2006-09-30,365584437,89428505,276155932,베트남,2006-09
2006-09-30,351622509,249591106,102031403,이탈리아,2006-09
2006-09-30,347997951,240170959,107826992,네덜란드,2006-09
2006-09-30,340021349,218966352,121054997,필리핀,2006-09
2006-09-30,323184322,1846411413,-1523227091,사우디아라비아,2006-09
2006-09-30,322680068,227492617,95187451,캐나다,2006-09
2006-09-30,310265982,20164681,290101301,폴란드,2006-09
2006-09-30,307304318,5286434,302017884,그리스,2006-09
2006-09-30,302327861,250583279,51744582,프랑스,2006-09
2006-09-30,292309200,16747684,275561516,튀르키예,2006-09
2006-09-30,259871636,411365910,-151494274,이란,2006-09
2006-09-30,253736986,1134900215,-881163229,아랍에미리트 연합,2006-09
2006-09-30,237734611,459235351,-221500740,브라질,2006-09
2006-09-30,210569767,35423285,175146482,핀란드,2006-09
2006-09-30,206898974,5002480,201896494,슬로바키아,2006-09
2006-09-30,191426456,80175306,111251150,벨기에,2006-09
2006-09-30,155789340,7669708,148119632,라이베리아,2006-09
2006-09-30,153356879,296763024,-143406145,칠레,2006-09
2006-09-30,150368443,19750372,130618071,헝가리,2006-09
2006-09-30,150158224,147798312,2359912,남아프리카공화국,2006-09
2006-09-30,105008035,667489,104340546,파나마,2006-09
2006-09-30,98085183,379563,97705620,베네주엘라,2006-09
2006-09-30,93729595,121773357,-28043762,스위스,2006-09
2006-09-30,90279851,11529992,78749859,이집트,2006-09
2006-09-30,87866893,26890583,60976310,콜롬비아,2006-09
2006-09-30,86264306,61834701,24429605,오스트리아,2006-09
2006-09-30,82194418,568561,81625857,과테말라,2006-09
2006-09-30,82143247,3798,82139449,나이지리아,2006-09
2006-09-30,76666693,66649613,10017080,노르웨이,2006-09
2006-09-30,71855283,3593435,68261848,루마니아,2006-09
2006-09-30,71051866,60704918,10346948,스웨덴,2006-09
2006-09-30,65580076,14307708,51272368,파키스탄,2006-09
2006-09-30,62987036,15876112,47110924,방글라데시,2006-09
2006-09-30,61302955,2790172,58512783,우즈베키스탄,2006-09
2006-09-30,60379146,22297221,38081925,우크라이나,2006-09
2006-09-30,58038165,573082110,-515043945,쿠웨이트,2006-09
2006-09-30,56994747,45396197,11598550,이스라엘,2006-09
2006-09-30,54181562,659715746,-605534184,카타르,2006-09
2006-09-30,52847081,83064304,-30217223,뉴질랜드,2006-09
2006-09-30,48464376,16668566,31795810,체코공화국,2006-09
2006-09-30,43869479,1110673,42758806,시리아,2006-09
2006-09-30,42429526,43269587,-840061,덴마크,2006-09
2006-09-30,40048640,78003456,-37954816,아일랜드,2006-09
2006-09-30,39218197,281298348,-242080151,오만,2006-09
2006-09-30,33662343,1741530,31920813,에쿠아도르,2006-09
2006-09-30,33654814,1507746,32147068,요르단,2006-09
2006-09-30,33408850,4760139,28648711,몰타,2006-09
2006-09-30,32082841,47441667,-15358826,아르헨티나,2006-09
2006-09-30,31868401,412223,31456178,사이프러스,2006-09
2006-09-30,30410556,3853,30406703,리비아,2006-09
2006-09-30,30119929,6397000,23722929,포루투갈,2006-09
2006-09-30,28835590,31122605,-2287015,카자흐스탄,2006-09
2006-09-30,27754770,86114316,-58359546,페루,2006-09
2006-09-30,27471568,2274366,25197202,알제리,2006-09
2006-09-30,25034654,0,25034654,마샬군도,2006-09
2006-09-30,24473570,5589530,18884040,코스타리카,2006-09
2006-09-30,22257686,226575,22031111,수단,2006-09
2006-09-30,22156062,167882,21988180,괌,2006-09
2006-09-30,21794774,326578,21468196,캄보디아,2006-09
2006-09-30,20850203,7056831,13793372,불가리아,2006-09
2006-09-30,20838378,7827130,13011248,모로코,2006-09
2006-09-30,20705836,3407934,17297902,기타국,2006-09
2006-09-30,19196878,0,19196878,바하마,2006-09
2006-09-30,17679966,2320289,15359677,슬로베니아,2006-09
2006-09-30,17559814,4056,17555758,앙골라,2006-09
2006-09-30,16633524,5601012,11032512,온두라스,2006-09
2006-09-30,15207857,222,15207635,니카라과,2006-09
2006-09-30,15068650,3810839,11257811,스리랑카,2006-09
2006-09-30,13772911,4795401,8977510,미얀마,2006-09
2006-09-30,12650635,11427504,1223131,푸에르토리코,2006-09
2006-09-30,12565881,563513,12002368,리투아니아,2006-09
2006-09-30,12522359,685102,11837257,몽골,2006-09
2006-09-30,12268403,175,12268228,아프카니스탄,2006-09
2006-09-30,11423474,564625,10858849,케냐,2006-09
2006-09-30,11422635,2016325,9406310,도미니카 공화국,2006-09
2006-09-30,10295107,354027,9941080,키르기스스탄,2006-09
2006-09-30,10259144,170782,10088362,에티오피아,2006-09
2006-09-30,8995888,476504,8519384,엘살바도르,2006-09
2006-09-30,8658941,3719571,4939370,크로아티아,2006-09
2006-09-30,8203740,64971,8138769,북마리아나 군도,2006-09
2006-09-30,7795972,2199572,5596400,가나,2006-09
2006-09-30,7677675,1019613,6658062,라트비아,2006-09
2006-09-30,7587533,3341184,4246349,우루과이,2006-09
2006-09-30,7240291,194670,7045621,파라과이,2006-09
2006-09-30,7067852,426587,6641265,피지,2006-09
2006-09-30,6727936,38228651,-31500715,예맨,2006-09
2006-09-30,6558485,51628804,-45070319,바레인,2006-09
2006-09-30,6184881,1690607,4494274,에스토니아,2006-09
2006-09-30,6147391,96175,6051216,레바논,2006-09
2006-09-30,6058368,0,6058368,코트디봐르,2006-09
2006-09-30,5986152,5805,5980347,뉴 칼레도니아,2006-09
2006-09-30,5514422,131124570,-125610148,이라크,2006-09
2006-09-30,4768554,593,4767961,아제르바이잔,2006-09
2006-09-30,4590561,476095,4114466,마카오,2006-09
2006-09-30,4417768,36000,4381768,도미니카,2006-09
2006-09-30,4325928,1835112,2490816,아이슬란드,2006-09
2006-09-30,4066034,1662049,2403985,튀니지,2006-09
2006-09-30,3816632,450940,3365692,벨라루스,2006-09
2006-09-30,3543538,8150,3535388,탄자니아,2006-09
2006-09-30,3499103,371515,3127588,트리니다드 토바고,2006-09
2006-09-30,3071608,62064,3009544,모리셔스,2006-09
2006-09-30,2424910,169175,2255735,마티니크,2006-09
2006-09-30,2206009,0,2206009,불령 리유니온 코모도 제도,2006-09
2006-09-30,2136012,14973,2121039,세르비아 와 몬테네그로,2006-09
2006-09-30,2123251,7031,2116220,조지아,2006-09
2006-09-30,2067605,6821226,-4753621,룩셈부르그,2006-09
2006-09-30,2018427,197855,1820572,마다카스카르,2006-09
2006-09-30,1979978,0,1979978,베닝,2006-09
2006-09-30,1973466,121585,1851881,아루바,2006-09
2006-09-30,1960795,160078,1800717,토고,2006-09
2006-09-30,1885064,556777,1328287,세네갈,2006-09
2006-09-30,1851327,109021,1742306,라오스,2006-09
2006-09-30,1840653,136789250,-134948597,콩고,2006-09
2006-09-30,1831142,2097,1829045,과델로프,2006-09
2006-09-30,1816158,2636444,-820286,짐바브웨,2006-09
2006-09-30,1786224,785555,1000669,쿠바,2006-09
2006-09-30,1784430,0,1784430,나우루,2006-09
2006-09-30,1752840,231710,1521130,타지크,2006-09
2006-09-30,1607593,77402715,-75795122,브루나이,2006-09
2006-09-30,1574261,90914,1483347,자마이카,2006-09
2006-09-30,1485267,0,1485267,사모아,2006-09
2006-09-30,1400096,2007367,-607271,스와질랜드,2006-09
2006-09-30,1331590,27,1331563,레소토,2006-09
2006-09-30,1264693,30233,1234460,유고,2006-09
2006-09-30,1262149,32332,1229817,불령 폴리네시아,2006-09
2006-09-30,1218266,0,1218266,지부티,2006-09
2006-09-30,1206061,61499,1144562,모잠비크,2006-09
2006-09-30,1193429,157655,1035774,네팔,2006-09
2006-09-30,1170327,3822,1166505,아이티,2006-09
2006-09-30,972922,5800,967122,바베이도스,2006-09
2006-09-30,917002,5723,911279,콩고민주공화국,2006-09
2006-09-30,915249,2620,912629,수리남,2006-09
2006-09-30,827759,455726,372033,아르메니아,2006-09
2006-09-30,826541,116155668,-115329127,카메룬,2006-09
2006-09-30,761257,125014,636243,네덜란드 열도,2006-09
2006-09-30,701037,37095,663942,시에라 리온,2006-09
2006-09-30,668792,655398,13394,기니,2006-09
2006-09-30,662087,37371226,-36709139,파푸아 뉴기니,2006-09
2006-09-30,642615,231264,411351,우간다,2006-09
2006-09-30,623358,28217994,-27594636,볼리비아,2006-09
2006-09-30,611874,64224,547650,보츠와나,2006-09
2006-09-30,606602,118,606484,가이아나,2006-09
2006-09-30,585004,0,585004,버뮤다,2006-09
2006-09-30,567430,1139,566291,에리트리아,2006-09
2006-09-30,563910,0,563910,몰도바,2006-09
2006-09-30,556377,159672,396705,알바니아,2006-09
2006-09-30,526796,0,526796,안티가 바부다,2006-09
2006-09-30,479647,112609,367038,보스니아-헤르체고비나,2006-09
2006-09-30,456777,0,456777,티모르,2006-09
2006-09-30,430922,0,430922,마이크로네시아,2006-09
2006-09-30,407223,36353231,-35946008,잠비아,2006-09
2006-09-30,399466,12,399454,벨리제,2006-09
2006-09-30,315225,0,315225,르완다,2006-09
2006-09-30,306466,2498068,-2191602,가봉,2006-09
2006-09-30,305975,0,305975,몰디브,2006-09
2006-09-30,299672,0,299672,바누아투,2006-09
2006-09-30,286859,0,286859,그레나다,2006-09
2006-09-30,284502,104782,179720,말라위,2006-09
2006-09-30,282498,44092,238406,모리타니,2006-09
2006-09-30,278884,3362,275522,마세도니아,2006-09
2006-09-30,267393,0,267393,불령 가이아나,2006-09
2006-09-30,254586,568691,-314105,리히텐슈타인,2006-09
2006-09-30,253644,268507,-14863,투르크멘,2006-09
2006-09-30,253438,1365,252073,아메리칸 사모아,2006-09
2006-09-30,229965,0,229965,영령 캐이맨 군도,2006-09
2006-09-30,216996,415063,-198067,챠드,2006-09
2006-09-30,206441,0,206441,세인트 루시아,2006-09
2006-09-30,205080,1977,203103,말리,2006-09
2006-09-30,189396,12736,176660,세이쉘,2006-09
2006-09-30,182474,12296,170178,영령 버진군도,2006-09
2006-09-30,144095,59012,85083,니제르,2006-09
2006-09-30,134688,0,134688,부탄,2006-09
2006-09-30,118101,0,118101,감비아,2006-09
2006-09-30,107604,0,107604,소말리아,2006-09
2006-09-30,105653,293603,-187950,팔레스타인 해방기구(구),2006-09
2006-09-30,84174,6656445,-6572271,나미비아,2006-09
2006-09-30,82888,0,82888,적도 기니,2006-09
2006-09-30,80764,1027918,-947154,솔로몬 군도,2006-09
2006-09-30,66206,0,66206,팔라우,2006-09
2006-09-30,63400,0,63400,메요트,2006-09
2006-09-30,61114,0,61114,쿡 아일랜드,2006-09
2006-09-30,43543,0,43543,세인트 빈센트 그레나딘,2006-09
2006-09-30,42982,557610,-514628,안도라,2006-09
2006-09-30,41410,0,41410,부룬디,2006-09
2006-09-30,40714,0,40714,부르키나 파소,2006-09
2006-09-30,36923,507355,-470432,모나코,2006-09
2006-09-30,31067,0,31067,중앙아프리카공화국,2006-09
2006-09-30,30195,0,30195,산마리노,2006-09
2006-09-30,24875,801,24074,지브랄타,2006-09
2006-09-30,24221,0,24221,포클랜드 군도,2006-09
2006-09-30,17994,0,17994,세인트 키츠 네비스,2006-09
2006-09-30,1640,0,1640,코스 군도,2006-09
2006-09-30,1203,204469,-203266,그린랜드,2006-09
2006-09-30,840,662,178,토켈라우,2006-09
2006-09-30,733,2367,-1634,키리바티,2006-09
2006-09-30,672,0,672,앙귈라,2006-09
2006-09-30,549,6430,-5881,세인트 헬레나,2006-09
2006-09-30,261,0,261,남조지아 & 남샌드위치 군도,2006-09
2006-09-30,0,66,-66,카보 베르데,2006-09
2006-09-30,0,3749,-3749,통가,2006-09
2006-09-30,0,23945,-23945,파로에 군도,2006-09
2006-09-30,0,184619,-184619,몬트세라트,2006-09
2006-09-30,0,154076,-154076,교황청,2006-09
2006-10-31,6058696205,4340108541,1718587664,중국,2006-10
2006-10-31,3304223107,2910673952,393549155,미국,2006-10
2006-10-31,2138081659,4292353525,-2154271866,일본,2006-10
2006-10-31,1703780761,175436441,1528344320,홍콩,2006-10
2006-10-31,1173048242,819800449,353247793,대만,2006-10
2006-10-31,1013073106,923847103,89226003,독일,2006-10
2006-10-31,772737683,513738288,258999395,싱가포르,2006-10
2006-10-31,620731367,62965341,557766026,멕시코,2006-10
2006-10-31,552312452,494461300,57851152,말레이시아,2006-10
2006-10-31,483666635,618794677,-135128042,인도네시아,2006-10
2006-10-31,448709397,60927594,387781803,스페인,2006-10
2006-10-31,418678392,344138749,74539643,인도,2006-10
2006-10-31,404756602,286597658,118158944,영국,2006-10
2006-10-31,397298143,222573332,174724811,이탈리아,2006-10
2006-10-31,397157743,350415989,46741754,러시아 연방,2006-10
2006-10-31,382287759,75009948,307277811,벨기에,2006-10
2006-10-31,352093713,849298899,-497205186,호주,2006-10
2006-10-31,348725561,171997275,176728286,필리핀,2006-10
2006-10-31,321824649,232640338,89184311,네덜란드,2006-10
2006-10-31,316712400,325689947,-8977547,태국,2006-10
2006-10-31,312596246,31277,312564969,바하마,2006-10
2006-10-31,307470638,61333,307409305,라이베리아,2006-10
2006-10-31,293295569,83271024,210024545,베트남,2006-10
2006-10-31,277796633,321492844,-43696211,캐나다,2006-10
2006-10-31,273649410,16658851,256990559,폴란드,2006-10
2006-10-31,270774890,258877052,11897838,프랑스,2006-10
2006-10-31,263034408,12925671,250108737,튀르키예,2006-10
2006-10-31,245252818,270861,244981957,파나마,2006-10
2006-10-31,239027050,144517725,94509325,브라질,2006-10
2006-10-31,236188929,1541306843,-1305117914,사우디아라비아,2006-10
2006-10-31,212591810,974542575,-761950765,아랍에미리트 연합,2006-10
2006-10-31,207298382,516486172,-309187790,이란,2006-10
2006-10-31,177074144,0,177074144,마샬군도,2006-10
2006-10-31,168915646,34689803,134225843,핀란드,2006-10
2006-10-31,164501107,5407374,159093733,슬로바키아,2006-10
2006-10-31,153093109,391075774,-237982665,칠레,2006-10
2006-10-31,146332280,2926878,143405402,그리스,2006-10
2006-10-31,119138074,214013758,-94875684,남아프리카공화국,2006-10
2006-10-31,100641081,10482390,90158691,베네주엘라,2006-10
2006-10-31,94761441,21484689,73276752,헝가리,2006-10
2006-10-31,83956454,60326,83896128,사이프러스,2006-10
2006-10-31,81013134,21601253,59411881,콜롬비아,2006-10
2006-10-31,80507895,3467747,77040148,기타국,2006-10
2006-10-31,78965563,74965375,4000188,뉴질랜드,2006-10
2006-10-31,72181390,33613635,38567755,이집트,2006-10
2006-10-31,71967285,79591833,-7624548,스웨덴,2006-10
2006-10-31,71834675,3515321,68319354,우크라이나,2006-10
2006-10-31,64845991,48141776,16704215,이스라엘,2006-10
2006-10-31,61345213,1987306,59357907,우즈베키스탄,2006-10
2006-10-31,60810088,87465928,-26655840,노르웨이,2006-10
2006-10-31,59251302,24770219,34481083,체코공화국,2006-10
2006-10-31,58138947,562317096,-504178149,카타르,2006-10
2006-10-31,56712430,32335422,24377008,파키스탄,2006-10
2006-10-31,56274964,70341594,-14066630,아일랜드,2006-10
2006-10-31,55566063,0,55566063,영령 캐이맨 군도,2006-10
2006-10-31,54655663,710483187,-655827524,쿠웨이트,2006-10
2006-10-31,54285302,66727396,-12442094,오스트리아,2006-10
2006-10-31,53428851,5283874,48144977,루마니아,2006-10
2006-10-31,48486298,215853,48270445,나이지리아,2006-10
2006-10-31,44147708,44083604,64104,덴마크,2006-10
2006-10-31,41771635,3583114,38188521,방글라데시,2006-10
2006-10-31,41701607,433057,41268550,쿠바,2006-10
2006-10-31,39072648,131204362,-92131714,스위스,2006-10
2006-10-31,36143792,101668464,-65524672,알제리,2006-10
2006-10-31,34858397,1066892,33791505,시리아,2006-10
2006-10-31,31699529,622352,31077177,과테말라,2006-10
2006-10-31,30033725,4274990,25758735,요르단,2006-10
2006-10-31,28204430,1440328,26764102,수단,2006-10
2006-10-31,28026490,35802828,-7776338,아르헨티나,2006-10
2006-10-31,27816342,1628851,26187491,에쿠아도르,2006-10
2006-10-31,26235349,40419640,-14184291,페루,2006-10
2006-10-31,26011485,23760573,2250912,카자흐스탄,2006-10
2006-10-31,25572855,6172417,19400438,포루투갈,2006-10
2006-10-31,21213463,3281703,17931760,코스타리카,2006-10
2006-10-31,19251659,32819,19218840,괌,2006-10
2006-10-31,18583719,400659626,-382075907,오만,2006-10
2006-10-31,18316022,178160,18137862,캄보디아,2006-10
2006-10-31,16984868,6288718,10696150,모로코,2006-10
2006-10-31,16674412,3108704,13565708,불가리아,2006-10
2006-10-31,16436073,1793358,14642715,슬로베니아,2006-10
2006-10-31,14629815,2441872,12187943,스리랑카,2006-10
2006-10-31,13639488,136618,13502870,리비아,2006-10
2006-10-31,12723173,1564948,11158225,앙골라,2006-10
2006-10-31,11856838,17033148,-5176310,바레인,2006-10
2006-10-31,11558634,15900358,-4341724,푸에르토리코,2006-10
2006-10-31,11492415,683254,10809161,온두라스,2006-10
2006-10-31,11114007,197751,10916256,몽골,2006-10
2006-10-31,10218422,4460,10213962,니카라과,2006-10
2006-10-31,9780070,119879,9660191,예맨,2006-10
2006-10-31,9677944,30003798,-20325854,미얀마,2006-10
2006-10-31,9167299,259322,8907977,케냐,2006-10
2006-10-31,9150083,2868269,6281814,우루과이,2006-10
2006-10-31,8818792,1124341,7694451,가나,2006-10
2006-10-31,8543037,3918037,4625000,도미니카 공화국,2006-10
2006-10-31,8235366,110692,8124674,키르기스스탄,2006-10
2006-10-31,7871986,148631,7723355,엘살바도르,2006-10
2006-10-31,7743893,0,7743893,레바논,2006-10
2006-10-31,7650125,103224,7546901,에티오피아,2006-10
2006-10-31,6327743,509953,5817790,리투아니아,2006-10
2006-10-31,6273242,706634,5566608,튀니지,2006-10
2006-10-31,5646504,1088051,4558453,라트비아,2006-10
2006-10-31,5616276,29630,5586646,탄자니아,2006-10
2006-10-31,5565409,110645119,-105079710,이라크,2006-10
2006-10-31,5505189,1242794,4262395,에스토니아,2006-10
2006-10-31,5091688,7335,5084353,아제르바이잔,2006-10
2006-10-31,5046723,431064,4615659,크로아티아,2006-10
2006-10-31,4581025,66573,4514452,북마리아나 군도,2006-10
2006-10-31,4417402,656,4416746,아프카니스탄,2006-10
2006-10-31,3844141,596282,3247859,벨라루스,2006-10
2006-10-31,3667107,569,3666538,코트디봐르,2006-10
2006-10-31,3616725,82877133,-79260408,브루나이,2006-10
2006-10-31,3538091,69186,3468905,뉴 칼레도니아,2006-10
2006-10-31,3458216,97350,3360866,파라과이,2006-10
2006-10-31,3412827,41294,3371533,네팔,2006-10
2006-10-31,3310693,0,3310693,불령 리유니온 코모도 제도,2006-10
2006-10-31,3188503,418191,2770312,트리니다드 토바고,2006-10
2006-10-31,3073151,0,3073151,과델로프,2006-10
2006-10-31,2361816,4089582,-1727766,몰타,2006-10
2006-10-31,2353803,117900,2235903,모리셔스,2006-10
2006-10-31,2243374,0,2243374,나우루,2006-10
2006-10-31,2214211,534397,1679814,세네갈,2006-10
2006-10-31,2108481,0,2108481,바베이도스,2006-10
2006-10-31,2001026,0,2001026,자마이카,2006-10
2006-10-31,1975343,0,1975343,토고,2006-10
2006-10-31,1845762,502337,1343425,마카오,2006-10
2006-10-31,1839868,2462342,-622474,라오스,2006-10
2006-10-31,1811830,23235,1788595,콩고,2006-10
2006-10-31,1710748,222594,1488154,네덜란드 열도,2006-10
2006-10-31,1537111,0,1537111,마티니크,2006-10
2006-10-31,1535175,0,1535175,베닝,2006-10
2006-10-31,1448404,958850,489554,아이슬란드,2006-10
2006-10-31,1394564,3232229,-1837665,짐바브웨,2006-10
2006-10-31,1316969,44926,1272043,세르비아 와 몬테네그로,2006-10
2006-10-31,1308090,17383,1290707,유고,2006-10
2006-10-31,1302984,39911,1263073,마다카스카르,2006-10
2006-10-31,1218626,6507056,-5288430,룩셈부르그,2006-10
2006-10-31,1214426,1825684,-611258,타지크,2006-10
2006-10-31,1200924,135,1200789,레소토,2006-10
2006-10-31,1185148,203575,981573,모잠비크,2006-10
2006-10-31,1120739,9865,1110874,보스니아-헤르체고비나,2006-10
2006-10-31,1109551,2573482,-1463931,스와질랜드,2006-10
2006-10-31,1078632,157260,921372,콩고민주공화국,2006-10
2006-10-31,1004304,0,1004304,불령 폴리네시아,2006-10
2006-10-31,986677,250165,736512,조지아,2006-10
2006-10-31,976607,10062,966545,도미니카,2006-10
2006-10-31,880168,0,880168,지부티,2006-10
2006-10-31,853200,2510776,-1657576,파푸아 뉴기니,2006-10
2006-10-31,781932,977045,-195113,피지,2006-10
2006-10-31,755595,0,755595,아이티,2006-10
2006-10-31,726103,0,726103,버뮤다,2006-10
2006-10-31,720875,1314,719561,가봉,2006-10
2006-10-31,687511,6465,681046,사모아,2006-10
2006-10-31,680247,77944,602303,우간다,2006-10
2006-10-31,639688,0,639688,마이크로네시아,2006-10
2006-10-31,626970,36343,590627,알바니아,2006-10
2006-10-31,625217,0,625217,아루바,2006-10
2006-10-31,609800,711979,-102179,카메룬,2006-10
2006-10-31,549993,672270,-122277,팔레스타인 해방기구(구),2006-10
2006-10-31,508271,0,508271,니제르,2006-10
2006-10-31,503537,3194,500343,토켈라우,2006-10
2006-10-31,494165,180538,313627,안티가 바부다,2006-10
2006-10-31,491862,77202,414660,감비아,2006-10
2006-10-31,449053,765276,-316223,아르메니아,2006-10
2006-10-31,432154,89893,342261,보츠와나,2006-10
2006-10-31,417600,206917,210683,세이쉘,2006-10
2006-10-31,406317,41741502,-41335185,잠비아,2006-10
2006-10-31,387951,134891,253060,몰도바,2006-10
2006-10-31,370677,7020,363657,마세도니아,2006-10
2006-10-31,355507,1290192,-934685,가이아나,2006-10
2006-10-31,350886,368824,-17938,기니,2006-10
2006-10-31,334606,143199,191407,볼리비아,2006-10
2006-10-31,322327,198462,123865,말라위,2006-10
2006-10-31,308104,582789,-274685,리히텐슈타인,2006-10
2006-10-31,288776,69887,218889,투르크멘,2006-10
2006-10-31,286606,1172,285434,수리남,2006-10
2006-10-31,254260,82792,171468,벨리제,2006-10
2006-10-31,212349,0,212349,불령 가이아나,2006-10
2006-10-31,204182,175394,28788,모리타니,2006-10
2006-10-31,165126,0,165126,영령 버진군도,2006-10
2006-10-31,161406,0,161406,소말리아,2006-10
2006-10-31,152055,0,152055,부탄,2006-10
2006-10-31,132189,0,132189,바누아투,2006-10
2006-10-31,130170,0,130170,그레나다,2006-10
2006-10-31,130000,0,130000,세인트 빈센트 그레나딘,2006-10
2006-10-31,120763,0,120763,지브랄타,2006-10
2006-10-31,115383,0,115383,팔라우,2006-10
2006-10-31,113834,0,113834,시에라 리온,2006-10
2006-10-31,93192,470,92722,아메리칸 사모아,2006-10
2006-10-31,90860,3494,87366,몰디브,2006-10
2006-10-31,83202,0,83202,세인트 루시아,2006-10
2006-10-31,72600,903,71697,키리바티,2006-10
2006-10-31,53627,0,53627,부르키나 파소,2006-10
2006-10-31,52325,95518,-43193,기네비소,2006-10
2006-10-31,48115,4497979,-4449864,나미비아,2006-10
2006-10-31,45727,30766,14961,통가,2006-10
2006-10-31,44550,0,44550,르완다,2006-10
2006-10-31,42714,4077,38637,카보 베르데,2006-10
2006-10-31,36229,1847170,-1810941,솔로몬 군도,2006-10
2006-10-31,28600,0,28600,적도 기니,2006-10
2006-10-31,23648,3531144,-3507496,모나코,2006-10
2006-10-31,14444,0,14444,메요트,2006-10
2006-10-31,4777,0,4777,미령 버진군도,2006-10
2006-10-31,4702,0,4702,상토메 프린스페,2006-10
2006-10-31,4559,14000,-9441,티모르,2006-10
2006-10-31,1950,107317,-105367,안도라,2006-10
2006-10-31,1913,966,947,에리트리아,2006-10
2006-10-31,1570,0,1570,쿡 아일랜드,2006-10
2006-10-31,1024,424,600,말리,2006-10
2006-10-31,660,0,660,세인트 키츠 네비스,2006-10
2006-10-31,0,29,-29,불령 남부지역,2006-10
2006-10-31,0,81410,-81410,중앙아프리카공화국,2006-10
2006-10-31,0,415035,-415035,챠드,2006-10
2006-10-31,0,15483,-15483,세인트 헬레나,2006-10
2006-10-31,0,2035,-2035,영령 인도양,2006-10
2006-10-31,0,41838,-41838,파로에 군도,2006-10
2006-10-31,0,166499,-166499,그린랜드,2006-10
2006-10-31,0,11647,-11647,투르크 & 카이코스 군도,2006-10
2006-10-31,0,22088,-22088,보빗군도,2006-10
2006-10-31,0,147272,-147272,교황청,2006-10
2006-11-30,6443253915,4705844608,1737409307,중국,2006-11
2006-11-30,4029040001,2789529919,1239510082,미국,2006-11
2006-11-30,2335096486,4349448440,-2014351954,일본,2006-11
2006-11-30,1718370478,175996167,1542374311,홍콩,2006-11
2006-11-30,1290378736,772645877,517732859,대만,2006-11
2006-11-30,1059762788,1000617616,59145172,독일,2006-11
2006-11-30,798337240,539344337,258992903,싱가포르,2006-11
2006-11-30,754291677,15775,754275902,앙골라,2006-11
2006-11-30,575699404,68641507,507057897,멕시코,2006-11
2006-11-30,537178015,287174497,250003518,영국,2006-11
2006-11-30,508078427,818293347,-310214920,인도네시아,2006-11
2006-11-30,503491436,238255395,265236041,이탈리아,2006-11
2006-11-30,475974131,371045930,104928201,러시아 연방,2006-11
2006-11-30,466014084,626584465,-160570381,말레이시아,2006-11
2006-11-30,423092330,368183050,54909280,인도,2006-11
2006-11-30,398060717,996022405,-597961688,호주,2006-11
2006-11-30,363040970,309553593,53487377,태국,2006-11
2006-11-30,357290671,77667172,279623499,스페인,2006-11
2006-11-30,354573325,264989516,89583809,네덜란드,2006-11
2006-11-30,353155172,191006406,162148766,필리핀,2006-11
2006-11-30,347815856,88148365,259667491,베트남,2006-11
2006-11-30,338254301,5594,338248707,라이베리아,2006-11
2006-11-30,330859891,318456559,12403332,캐나다,2006-11
2006-11-30,322434355,1489789172,-1167354817,사우디아라비아,2006-11
2006-11-30,298173168,1051955035,-753781867,아랍에미리트 연합,2006-11
2006-11-30,256595357,10245171,246350186,튀르키예,2006-11
2006-11-30,251555616,2603535,248952081,그리스,2006-11
2006-11-30,241394254,454794822,-213400568,이란,2006-11
2006-11-30,233798477,18736782,215061695,폴란드,2006-11
2006-11-30,227077079,297191098,-70114019,프랑스,2006-11
2006-11-30,215075679,658714,214416965,사이프러스,2006-11
2006-11-30,206562914,263965386,-57402472,브라질,2006-11
2006-11-30,194070826,86605344,107465482,벨기에,2006-11
2006-11-30,177668490,40256439,137412051,핀란드,2006-11
2006-11-30,162902964,0,162902964,버뮤다,2006-11
2006-11-30,139122206,165648167,-26525961,남아프리카공화국,2006-11
2006-11-30,130340931,305776897,-175435966,칠레,2006-11
2006-11-30,122156850,203931,121952919,베네주엘라,2006-11
2006-11-30,105238760,4328920,100909840,슬로바키아,2006-11
2006-11-30,95495691,22653086,72842605,헝가리,2006-11
2006-11-30,94560757,31061994,63498763,우크라이나,2006-11
2006-11-30,93306206,41122,93265084,바하마,2006-11
2006-11-30,90767425,221081,90546344,파나마,2006-11
2006-11-30,87414882,4541027,82873855,루마니아,2006-11
2006-11-30,82324630,24091803,58232827,콜롬비아,2006-11
2006-11-30,80564332,15326613,65237719,이집트,2006-11
2006-11-30,79542367,84447305,-4904938,스웨덴,2006-11
2006-11-30,75490312,90541192,-15050880,뉴질랜드,2006-11
2006-11-30,74942192,540015204,-465073012,카타르,2006-11
2006-11-30,71061099,51595159,19465940,이스라엘,2006-11
2006-11-30,68180631,52815530,15365101,아일랜드,2006-11
2006-11-30,65090583,56169568,8921015,나이지리아,2006-11
2006-11-30,64007680,558626,63449054,시리아,2006-11
2006-11-30,57879019,20174,57858845,리비아,2006-11
2006-11-30,57774597,28334559,29440038,체코공화국,2006-11
2006-11-30,55770223,58259364,-2489141,오스트리아,2006-11
2006-11-30,55285585,1278401,54007184,우즈베키스탄,2006-11
2006-11-30,54542698,756809069,-702266371,쿠웨이트,2006-11
2006-11-30,52506128,43621801,8884327,덴마크,2006-11
2006-11-30,51537549,4647,51532902,마샬군도,2006-11
2006-11-30,51177014,119732609,-68555595,스위스,2006-11
2006-11-30,50184640,31708390,18476250,알제리,2006-11
2006-11-30,49412607,14011111,35401496,파키스탄,2006-11
2006-11-30,47830950,13235981,34594969,방글라데시,2006-11
2006-11-30,39635273,19786243,19849030,포루투갈,2006-11
2006-11-30,39451870,436719789,-397267919,오만,2006-11
2006-11-30,37731524,3570,37727954,괌,2006-11
2006-11-30,37359942,1225651,36134291,에쿠아도르,2006-11
2006-11-30,37258030,7287201,29970829,불가리아,2006-11
2006-11-30,36679063,3285787,33393276,몰타,2006-11
2006-11-30,36061782,16736493,19325289,카자흐스탄,2006-11
2006-11-30,30272888,526805,29746083,과테말라,2006-11
2006-11-30,28700766,23690916,5009850,아르헨티나,2006-11
2006-11-30,28426010,3252070,25173940,요르단,2006-11
2006-11-30,26540958,47175194,-20634236,페루,2006-11
2006-11-30,22003961,132934,21871027,수단,2006-11
2006-11-30,20781841,191300,20590541,캄보디아,2006-11
2006-11-30,19139912,179497,18960415,쿠바,2006-11
2006-11-30,18314946,84481631,-66166685,노르웨이,2006-11
2006-11-30,17033959,2201001,14832958,슬로베니아,2006-11
2006-11-30,16865764,3083018,13782746,스리랑카,2006-11
2006-11-30,15705311,4752322,10952989,코스타리카,2006-11
2006-11-30,14632254,253790,14378464,온두라스,2006-11
2006-11-30,14372598,525,14372073,니카라과,2006-11
2006-11-30,13994736,4513183,9481553,모로코,2006-11
2006-11-30,13829489,13893212,-63723,바레인,2006-11
2006-11-30,13057873,10639288,2418585,푸에르토리코,2006-11
2006-11-30,12825627,13633256,-807629,기타국,2006-11
2006-11-30,11534694,1409440,10125254,몽골,2006-11
2006-11-30,10862235,1327720,9534515,레바논,2006-11
2006-11-30,10393614,5057896,5335718,미얀마,2006-11
2006-11-30,9990594,29658120,-19667526,예맨,2006-11
2006-11-30,9647368,3474612,6172756,크로아티아,2006-11
2006-11-30,9492917,100264,9392653,키르기스스탄,2006-11
2006-11-30,9267812,1344394,7923418,에스토니아,2006-11
2006-11-30,8420143,301217,8118926,에티오피아,2006-11
2006-11-30,8419996,16674600,-8254604,도미니카 공화국,2006-11
2006-11-30,8182104,2666143,5515961,가나,2006-11
2006-11-30,7616248,269427,7346821,케냐,2006-11
2006-11-30,6599022,30040,6568982,파라과이,2006-11
2006-11-30,5856538,797302,5059236,리투아니아,2006-11
2006-11-30,5708341,872511,4835830,튀니지,2006-11
2006-11-30,5615115,1075634,4539481,라트비아,2006-11
2006-11-30,5556073,0,5556073,불령 리유니온 코모도 제도,2006-11
2006-11-30,5469530,11624,5457906,뉴 칼레도니아,2006-11
2006-11-30,5315523,14022,5301501,북마리아나 군도,2006-11
2006-11-30,5259583,103516823,-98257240,이라크,2006-11
2006-11-30,5243956,48442,5195514,엘살바도르,2006-11
2006-11-30,5152817,25798,5127019,아프카니스탄,2006-11
2006-11-30,4695334,0,4695334,코트디봐르,2006-11
2006-11-30,4210865,82552,4128313,탄자니아,2006-11
2006-11-30,4147478,33441,4114037,보스니아-헤르체고비나,2006-11
2006-11-30,3933287,1328,3931959,유고,2006-11
2006-11-30,3813137,591377,3221760,아이슬란드,2006-11
2006-11-30,3546989,0,3546989,레소토,2006-11
2006-11-30,3455368,2650587,804781,우루과이,2006-11
2006-11-30,3273084,255920,3017164,트리니다드 토바고,2006-11
2006-11-30,3195847,128745742,-125549895,브루나이,2006-11
2006-11-30,2654782,2529299,125483,라오스,2006-11
2006-11-30,2531604,872,2530732,아제르바이잔,2006-11
2006-11-30,2311327,334412,1976915,모리셔스,2006-11
2006-11-30,2285417,724422,1560995,벨라루스,2006-11
2006-11-30,2236278,191592,2044686,지부티,2006-11
2006-11-30,2074037,415466,1658571,마카오,2006-11
2006-11-30,1970902,0,1970902,바베이도스,2006-11
2006-11-30,1967911,7165,1960746,베닝,2006-11
2006-11-30,1944489,2193140,-248651,짐바브웨,2006-11
2006-11-30,1855417,0,1855417,마티니크,2006-11
2006-11-30,1753468,0,1753468,모잠비크,2006-11
2006-11-30,1739562,1343318,396244,타지크,2006-11
2006-11-30,1711979,6368650,-4656671,룩셈부르그,2006-11
2006-11-30,1529944,311824,1218120,세네갈,2006-11
2006-11-30,1513243,262611,1250632,피지,2006-11
2006-11-30,1476211,505842,970369,조지아,2006-11
2006-11-30,1471237,50688652,-49217415,카메룬,2006-11
2006-11-30,1395345,24547,1370798,도미니카,2006-11
2006-11-30,1339943,2205645,-865702,파푸아 뉴기니,2006-11
2006-11-30,1258053,1093,1256960,토고,2006-11
2006-11-30,1253953,0,1253953,가이아나,2006-11
2006-11-30,1223765,96,1223669,세르비아 와 몬테네그로,2006-11
2006-11-30,1161975,36773,1125202,자마이카,2006-11
2006-11-30,1119335,49600,1069735,불령 폴리네시아,2006-11
2006-11-30,1057134,290268,766866,우간다,2006-11
2006-11-30,1050472,692013,358459,아르메니아,2006-11
2006-11-30,1003024,0,1003024,아루바,2006-11
2006-11-30,1002702,380007,622695,네팔,2006-11
2006-11-30,938991,3405347,-2466356,스와질랜드,2006-11
2006-11-30,922088,0,922088,과델로프,2006-11
2006-11-30,903800,1500,902300,네덜란드 열도,2006-11
2006-11-30,871246,16310,854936,콩고민주공화국,2006-11
2006-11-30,864119,390000,474119,콩고,2006-11
2006-11-30,851120,449616,401504,말라위,2006-11
2006-11-30,841059,0,841059,아이티,2006-11
2006-11-30,836604,3742,832862,수리남,2006-11
2006-11-30,781914,62367,719547,마다카스카르,2006-11
2006-11-30,764740,11111,753629,마세도니아,2006-11
2006-11-30,713039,117449,595590,세이쉘,2006-11
2006-11-30,679906,9156070,-8476164,볼리비아,2006-11
2006-11-30,672418,0,672418,티모르,2006-11
2006-11-30,622136,27303110,-26680974,잠비아,2006-11
2006-11-30,605601,358,605243,알바니아,2006-11
2006-11-30,511433,0,511433,사모아,2006-11
2006-11-30,493064,0,493064,영령 캐이맨 군도,2006-11
2006-11-30,460440,3147534,-2687094,솔로몬 군도,2006-11
2006-11-30,434286,97203,337083,니제르,2006-11
2006-11-30,389173,3120381,-2731208,가봉,2006-11
2006-11-30,386665,338,386327,벨리제,2006-11
2006-11-30,371206,336630,34576,챠드,2006-11
2006-11-30,361982,0,361982,안티가 바부다,2006-11
2006-11-30,357115,225815,131300,팔레스타인 해방기구(구),2006-11
2006-11-30,343682,0,343682,말리,2006-11
2006-11-30,274993,0,274993,몰디브,2006-11
2006-11-30,268289,162332,105957,몰도바,2006-11
2006-11-30,267406,45608926,-45341520,기니,2006-11
2006-11-30,231421,0,231421,그레나다,2006-11
2006-11-30,230742,0,230742,불령 가이아나,2006-11
2006-11-30,228994,507286,-278292,리히텐슈타인,2006-11
2006-11-30,200757,0,200757,마이크로네시아,2006-11
2006-11-30,199185,48736,150449,보츠와나,2006-11
2006-11-30,184361,0,184361,영령 버진군도,2006-11
2006-11-30,167746,14122,153624,아메리칸 사모아,2006-11
2006-11-30,167074,233932,-66858,모리타니,2006-11
2006-11-30,150064,0,150064,르완다,2006-11
2006-11-30,137011,0,137011,적도 기니,2006-11
2006-11-30,132665,16488,116177,바누아투,2006-11
2006-11-30,123829,0,123829,팔라우,2006-11
2006-11-30,122414,0,122414,부룬디,2006-11
2006-11-30,122389,0,122389,부탄,2006-11
2006-11-30,87217,18664,68553,시에라 리온,2006-11
2006-11-30,75009,0,75009,세인트 루시아,2006-11
2006-11-30,68349,6754917,-6686568,나미비아,2006-11
2006-11-30,66130,7759,58371,세인트 키츠 네비스,2006-11
2006-11-30,64180,0,64180,투르크 & 카이코스 군도,2006-11
2006-11-30,60936,1742899,-1681963,통가,2006-11
2006-11-30,57606,3379,54227,감비아,2006-11
2006-11-30,53346,0,53346,소말리아,2006-11
2006-11-30,48568,24385,24183,투르크멘,2006-11
2006-11-30,36025,28500,7525,상토메 프린스페,2006-11
2006-11-30,33903,0,33903,중앙아프리카공화국,2006-11
2006-11-30,33572,0,33572,부르키나 파소,2006-11
2006-11-30,16671,753857,-737186,모나코,2006-11
2006-11-30,14807,0,14807,지브랄타,2006-11
2006-11-30,12140,0,12140,세인트 빈센트 그레나딘,2006-11
2006-11-30,8450,49812,-41362,기네비소,2006-11
2006-11-30,8402,59578,-51176,안도라,2006-11
2006-11-30,2780,0,2780,앙귈라,2006-11
2006-11-30,2002,3000,-998,토켈라우,2006-11
2006-11-30,1161,0,1161,쿡 아일랜드,2006-11
2006-11-30,977,0,977,에리트리아,2006-11
2006-11-30,144,0,144,카보 베르데,2006-11
2006-11-30,11,71859,-71848,미령 버진군도,2006-11
2006-11-30,0,266,-266,투발루,2006-11
2006-11-30,0,210,-210,크리스마스 아일랜드,2006-11
2006-11-30,0,215067,-215067,그린랜드,2006-11
2006-11-30,0,237810,-237810,교황청,2006-11
2006-11-30,0,1140167,-1140167,나우루,2006-11
2006-11-30,0,2092,-2092,키리바티,2006-11
2006-12-31,6184255618,4443128929,1741126689,중국,2006-12
2006-12-31,3765532644,2659500254,1106032390,미국,2006-12
2006-12-31,2419448323,4688360782,-2268912459,일본,2006-12
2006-12-31,1582104456,162636990,1419467466,홍콩,2006-12
2006-12-31,1189480711,735831699,453649012,대만,2006-12
2006-12-31,834757965,457784824,376973141,싱가포르,2006-12
2006-12-31,764408865,1096180152,-331771287,독일,2006-12
2006-12-31,637529629,703855366,-66325737,말레이시아,2006-12
2006-12-31,520875499,257369275,263506224,영국,2006-12
2006-12-31,449064282,496973783,-47909501,러시아 연방,2006-12
2006-12-31,445644573,402558088,43086485,인도,2006-12
2006-12-31,440076669,60162371,379914298,멕시코,2006-12
2006-12-31,418942687,795353346,-376410659,인도네시아,2006-12
2006-12-31,401774132,45126,401729006,라이베리아,2006-12
2006-12-31,398738281,50788,398687493,바하마,2006-12
2006-12-31,387403487,252036080,135367407,태국,2006-12
2006-12-31,379650754,239539394,140111360,이탈리아,2006-12
2006-12-31,363511561,87647328,275864233,베트남,2006-12
2006-12-31,347668781,156315638,191353143,필리핀,2006-12
2006-12-31,342285756,1670609039,-1328323283,사우디아라비아,2006-12
2006-12-31,340679734,333468141,7211593,네덜란드,2006-12
2006-12-31,339194894,57732715,281462179,스페인,2006-12
2006-12-31,338278544,1173460012,-835181468,호주,2006-12
2006-12-31,296040948,1109023471,-812982523,아랍에미리트 연합,2006-12
2006-12-31,255969170,9173514,246795656,튀르키예,2006-12
2006-12-31,255874573,363244413,-107369840,이란,2006-12
2006-12-31,246291616,283042177,-36750561,프랑스,2006-12
2006-12-31,239775165,313722885,-73947720,캐나다,2006-12
2006-12-31,193150791,282989223,-89838432,브라질,2006-12
2006-12-31,175784757,90498468,85286289,벨기에,2006-12
2006-12-31,167222050,23950729,143271321,폴란드,2006-12
2006-12-31,162742117,0,162742117,버뮤다,2006-12
2006-12-31,146660095,2655,146657440,마샬군도,2006-12
2006-12-31,144056707,103417751,40638956,남아프리카공화국,2006-12
2006-12-31,143122119,79095006,64027113,나이지리아,2006-12
2006-12-31,137250053,307412392,-170162339,칠레,2006-12
2006-12-31,135008726,4108332,130900394,슬로바키아,2006-12
2006-12-31,132001749,2283249,129718500,우크라이나,2006-12
2006-12-31,110652364,2012259,108640105,그리스,2006-12
2006-12-31,103999714,42512242,61487472,이집트,2006-12
2006-12-31,96242261,45437441,50804820,핀란드,2006-12
2006-12-31,92065739,862660460,-770594721,카타르,2006-12
2006-12-31,91363672,10955455,80408217,베네주엘라,2006-12
2006-12-31,83866353,14242177,69624176,콜롬비아,2006-12
2006-12-31,79695245,4665453,75029792,몰타,2006-12
2006-12-31,79467081,25087487,54379594,헝가리,2006-12
2006-12-31,76003331,74444973,1558358,노르웨이,2006-12
2006-12-31,75630613,595115093,-519484480,쿠웨이트,2006-12
2006-12-31,73929252,32946239,40983013,파키스탄,2006-12
2006-12-31,68211706,78853921,-10642215,아일랜드,2006-12
2006-12-31,66943871,2155909,64787962,루마니아,2006-12
2006-12-31,63663789,86662495,-22998706,스웨덴,2006-12
2006-12-31,59366673,3935203,55431470,방글라데시,2006-12
2006-12-31,58605988,46726342,11879646,이스라엘,2006-12
2006-12-31,57634379,45301013,12333366,덴마크,2006-12
2006-12-31,57357168,70022218,-12665050,오스트리아,2006-12
2006-12-31,56762418,562417,56200001,시리아,2006-12
2006-12-31,56614394,2140158,54474236,우즈베키스탄,2006-12
2006-12-31,54531441,25310217,29221224,체코공화국,2006-12
2006-12-31,49229229,79259625,-30030396,뉴질랜드,2006-12
2006-12-31,46503263,130128015,-83624752,스위스,2006-12
2006-12-31,42628238,18899146,23729092,페루,2006-12
2006-12-31,41752670,473034116,-431281446,오만,2006-12
2006-12-31,39485395,72389994,-32904599,알제리,2006-12
2006-12-31,37754742,1063704,36691038,라트비아,2006-12
2006-12-31,36892054,548949,36343105,리비아,2006-12
2006-12-31,35302591,439168,34863423,쿠바,2006-12
2006-12-31,33974594,34854087,-879493,파나마,2006-12
2006-12-31,33888598,1152168,32736430,에쿠아도르,2006-12
2006-12-31,32644912,70186,32574726,사이프러스,2006-12
2006-12-31,32012605,479175,31533430,과테말라,2006-12
2006-12-31,27778296,2952983,24825313,불가리아,2006-12
2006-12-31,27492853,2034785,25458068,슬로베니아,2006-12
2006-12-31,26498671,691219,25807452,캄보디아,2006-12
2006-12-31,26451400,4325450,22125950,요르단,2006-12
2006-12-31,26195007,36577561,-10382554,포루투갈,2006-12
2006-12-31,25729343,0,25729343,수단,2006-12
2006-12-31,25156139,22063957,3092182,카자흐스탄,2006-12
2006-12-31,25013877,62910003,-37896126,아르헨티나,2006-12
2006-12-31,21401616,404719,20996897,에티오피아,2006-12
2006-12-31,19725174,48164980,-28439806,이라크,2006-12
2006-12-31,18645026,2345708,16299318,기타국,2006-12
2006-12-31,18379872,49731107,-31351235,바레인,2006-12
2006-12-31,17158625,6084400,11074225,코스타리카,2006-12
2006-12-31,15526364,8956604,6569760,모로코,2006-12
2006-12-31,15207845,3191755,12016090,스리랑카,2006-12
2006-12-31,15140100,3704482,11435618,미얀마,2006-12
2006-12-31,14245489,42893,14202596,니카라과,2006-12
2006-12-31,11860831,7031804,4829027,푸에르토리코,2006-12
2006-12-31,10535161,248530,10286631,온두라스,2006-12
2006-12-31,10158093,667316,9490777,몽골,2006-12
2006-12-31,9708756,2238498,7470258,레바논,2006-12
2006-12-31,9556415,67142686,-57586271,앙골라,2006-12
2006-12-31,9069817,4290,9065527,아프카니스탄,2006-12
2006-12-31,8778195,1281453,7496742,가나,2006-12
2006-12-31,8373889,1044146,7329743,도미니카 공화국,2006-12
2006-12-31,8037785,461582,7576203,크로아티아,2006-12
2006-12-31,7827821,969328,6858493,리투아니아,2006-12
2006-12-31,7466344,112019,7354325,트리니다드 토바고,2006-12
2006-12-31,7361409,315184,7046225,케냐,2006-12
2006-12-31,7346356,1545962,5800394,에스토니아,2006-12
2006-12-31,6693413,88809,6604604,예맨,2006-12
2006-12-31,6183941,1680,6182261,아제르바이잔,2006-12
2006-12-31,5497940,117,5497823,코트디봐르,2006-12
2006-12-31,5272263,17843,5254420,키르기스스탄,2006-12
2006-12-31,5208065,34665,5173400,북마리아나 군도,2006-12
2006-12-31,4905514,18214,4887300,보스니아-헤르체고비나,2006-12
2006-12-31,4823056,705324,4117732,벨라루스,2006-12
2006-12-31,4688397,1139343,3549054,튀니지,2006-12
2006-12-31,4677288,439131,4238157,엘살바도르,2006-12
2006-12-31,4643511,23369,4620142,탄자니아,2006-12
2006-12-31,4057190,1591,4055599,괌,2006-12
2006-12-31,3813996,2204702,1609294,뉴 칼레도니아,2006-12
2006-12-31,3776390,388886,3387504,아이슬란드,2006-12
2006-12-31,3679903,4040459,-360556,파라과이,2006-12
2006-12-31,3435965,285860,3150105,모리셔스,2006-12
2006-12-31,3432088,3500269,-68181,우루과이,2006-12
2006-12-31,3129178,0,3129178,불령 리유니온 코모도 제도,2006-12
2006-12-31,2917282,366577,2550705,마카오,2006-12
2006-12-31,2886342,3670482,-784140,라오스,2006-12
2006-12-31,2640439,99270378,-96629939,브루나이,2006-12
2006-12-31,2484383,497476,1986907,세네갈,2006-12
2006-12-31,2337449,0,2337449,지부티,2006-12
2006-12-31,2335476,0,2335476,마티니크,2006-12
2006-12-31,2273817,393373,1880444,기니,2006-12
2006-12-31,2262037,1900,2260137,유고,2006-12
2006-12-31,2052711,26177526,-24124815,잠비아,2006-12
2006-12-31,1912628,252035,1660593,모잠비크,2006-12
2006-12-31,1886476,8969,1877507,베닝,2006-12
2006-12-31,1773301,825179,948122,조지아,2006-12
2006-12-31,1725399,6069709,-4344310,룩셈부르그,2006-12
2006-12-31,1630254,2596954,-966700,짐바브웨,2006-12
2006-12-31,1627353,2560827,-933474,스와질랜드,2006-12
2006-12-31,1580503,0,1580503,영령 버진군도,2006-12
2006-12-31,1549438,0,1549438,부르키나 파소,2006-12
2006-12-31,1476639,116835,1359804,마다카스카르,2006-12
2006-12-31,1434869,20335,1414534,몰도바,2006-12
2006-12-31,1338211,3089298,-1751087,타지크,2006-12
2006-12-31,1323381,66,1323315,토고,2006-12
2006-12-31,1281293,85326,1195967,세르비아 와 몬테네그로,2006-12
2006-12-31,1227062,0,1227062,아루바,2006-12
2006-12-31,1224266,4050,1220216,네덜란드 열도,2006-12
2006-12-31,1121403,58965,1062438,자마이카,2006-12
2006-12-31,1061409,36858,1024551,도미니카,2006-12
2006-12-31,1039986,81398,958588,시에라 리온,2006-12
2006-12-31,961367,35815,925552,불령 폴리네시아,2006-12
2006-12-31,951913,1598587,-646674,말라위,2006-12
2006-12-31,946819,48993489,-48046670,카메룬,2006-12
2006-12-31,944551,121660607,-120716056,콩고,2006-12
2006-12-31,939595,1135,938460,아르메니아,2006-12
2006-12-31,910971,35520386,-34609415,파푸아 뉴기니,2006-12
2006-12-31,834824,0,834824,과델로프,2006-12
2006-12-31,802126,19280,782846,사모아,2006-12
2006-12-31,724979,407,724572,아이티,2006-12
2006-12-31,669266,500545,168721,우간다,2006-12
2006-12-31,631554,198237,433317,피지,2006-12
2006-12-31,630023,137738,492285,세이쉘,2006-12
2006-12-31,610604,78436,532168,가봉,2006-12
2006-12-31,596412,29499,566913,네팔,2006-12
2006-12-31,570425,10387109,-9816684,볼리비아,2006-12
2006-12-31,548140,0,548140,바베이도스,2006-12
2006-12-31,492044,175,491869,수리남,2006-12
2006-12-31,467076,20832,446244,보츠와나,2006-12
2006-12-31,449605,2039,447566,콩고민주공화국,2006-12
2006-12-31,448571,196746,251825,리히텐슈타인,2006-12
2006-12-31,433923,482,433441,르완다,2006-12
2006-12-31,433522,0,433522,영령 캐이맨 군도,2006-12
2006-12-31,389846,145,389701,벨리제,2006-12
2006-12-31,370221,272598,97623,모리타니,2006-12
2006-12-31,316470,0,316470,가이아나,2006-12
2006-12-31,299960,9751,290209,레소토,2006-12
2006-12-31,299535,3503,296032,몰디브,2006-12
2006-12-31,286536,0,286536,안티가 바부다,2006-12
2006-12-31,251055,4322,246733,니제르,2006-12
2006-12-31,234813,0,234813,투르크멘,2006-12
2006-12-31,234298,3256394,-3022096,솔로몬 군도,2006-12
2006-12-31,215091,17478,197613,마세도니아,2006-12
2006-12-31,209415,0,209415,마이크로네시아,2006-12
2006-12-31,208627,0,208627,불령 가이아나,2006-12
2006-12-31,177928,2000,175928,그레나다,2006-12
2006-12-31,151888,28283,123605,알바니아,2006-12
2006-12-31,151237,0,151237,세인트 루시아,2006-12
2006-12-31,150667,0,150667,적도 기니,2006-12
2006-12-31,135029,760368,-625339,안도라,2006-12
2006-12-31,134590,0,134590,팔라우,2006-12
2006-12-31,125278,64375,60903,세인트 키츠 네비스,2006-12
2006-12-31,123421,35939,87482,아메리칸 사모아,2006-12
2006-12-31,113798,16626,97172,감비아,2006-12
2006-12-31,100255,0,100255,카보 베르데,2006-12
2006-12-31,89395,78123,11272,팔레스타인 해방기구(구),2006-12
2006-12-31,89083,8753,80330,말리,2006-12
2006-12-31,87488,0,87488,바누아투,2006-12
2006-12-31,77313,0,77313,쿡 아일랜드,2006-12
2006-12-31,72512,9405766,-9333254,나미비아,2006-12
2006-12-31,37420,0,37420,중앙아프리카공화국,2006-12
2006-12-31,31441,163,31278,세인트 빈센트 그레나딘,2006-12
2006-12-31,28080,19507,8573,투르크 & 카이코스 군도,2006-12
2006-12-31,23247,921047,-897800,모나코,2006-12
2006-12-31,19076,0,19076,키리바티,2006-12
2006-12-31,18319,0,18319,부탄,2006-12
2006-12-31,15691,3496,12195,에리트리아,2006-12
2006-12-31,15201,0,15201,메요트,2006-12
2006-12-31,12488,0,12488,챠드,2006-12
2006-12-31,2996,0,2996,지브랄타,2006-12
2006-12-31,1200,0,1200,앙귈라,2006-12
2006-12-31,0,398976,-398976,통가,2006-12
2006-12-31,0,37862,-37862,세인트 헬레나,2006-12
2006-12-31,0,180326,-180326,그린랜드,2006-12
2006-12-31,0,37,-37,크리스마스 아일랜드,2006-12
2006-12-31,0,154779,-154779,교황청,2006-12
2006-12-31,0,21676,-21676,파로에 군도,2006-12
2006-12-31,0,258,-258,몬트세라트,2006-12
2006-12-31,0,2910,-2910,나우루,2006-12
2006-12-31,0,141870,-141870,피트카이른,2006-12
2006-12-31,0,12902,-12902,토켈라우,2006-12
2007-01-31,6401707958,4890704353,1511003605,중국,2007-01
2007-01-31,3635618824,3017019904,618598920,미국,2007-01
2007-01-31,2011463900,4226394131,-2214930231,일본,2007-01
2007-01-31,1603570068,173056636,1430513432,홍콩,2007-01
2007-01-31,1080048014,832088462,247959552,대만,2007-01
2007-01-31,1028574399,1089400468,-60826069,독일,2007-01
2007-01-31,850972437,551673283,299299154,싱가포르,2007-01
2007-01-31,556578435,263024292,293554143,영국,2007-01
2007-01-31,540372664,841189681,-300817017,말레이시아,2007-01
2007-01-31,505646613,523040922,-17394309,러시아 연방,2007-01
2007-01-31,471606898,64765143,406841755,멕시코,2007-01
2007-01-31,454077459,372800797,81276662,인도,2007-01
2007-01-31,414769901,715677036,-300907135,인도네시아,2007-01
2007-01-31,393193256,97432299,295760957,베트남,2007-01
2007-01-31,386259150,254978204,131280946,이탈리아,2007-01
2007-01-31,370331586,74445,370257141,바하마,2007-01
2007-01-31,358606293,1152421715,-793815422,호주,2007-01
2007-01-31,328850717,323435221,5415496,태국,2007-01
2007-01-31,312547004,170428031,142118973,필리핀,2007-01
2007-01-31,310013914,665734,309348180,파나마,2007-01
2007-01-31,298960899,92279300,206681599,스페인,2007-01
2007-01-31,279908170,13909321,265998849,튀르키예,2007-01
2007-01-31,276679451,1521833405,-1245153954,사우디아라비아,2007-01
2007-01-31,269510383,276942392,-7432009,네덜란드,2007-01
2007-01-31,263470744,1598,263469146,마샬군도,2007-01
2007-01-31,259545439,888284596,-628739157,아랍에미리트 연합,2007-01
2007-01-31,258676090,305092341,-46416251,프랑스,2007-01
2007-01-31,231866472,295384906,-63518434,캐나다,2007-01
2007-01-31,219434455,479765680,-260331225,쿠웨이트,2007-01
2007-01-31,219114919,395944445,-176829526,이란,2007-01
2007-01-31,204115470,192380223,11735247,브라질,2007-01
2007-01-31,195788658,38052032,157736626,폴란드,2007-01
2007-01-31,195212448,114254097,80958351,벨기에,2007-01
2007-01-31,180869195,6150,180863045,라이베리아,2007-01
2007-01-31,168572056,3996570,164575486,슬로바키아,2007-01
2007-01-31,150241726,369097858,-218856132,칠레,2007-01
2007-01-31,112756982,175622642,-62865660,남아프리카공화국,2007-01
2007-01-31,99630687,51758712,47871975,핀란드,2007-01
2007-01-31,97851092,18222041,79629051,헝가리,2007-01
2007-01-31,93630437,94619685,-989248,이집트,2007-01
2007-01-31,89008896,62867278,26141618,아일랜드,2007-01
2007-01-31,84766187,10654693,74111494,베네주엘라,2007-01
2007-01-31,82683972,16081318,66602654,콜롬비아,2007-01
2007-01-31,79860319,105915646,-26055327,노르웨이,2007-01
2007-01-31,68014638,24703798,43310840,체코공화국,2007-01
2007-01-31,66561097,12381191,54179906,우크라이나,2007-01
2007-01-31,65842292,652570351,-586728059,카타르,2007-01
2007-01-31,58014621,74451870,-16437249,이스라엘,2007-01
2007-01-31,56195045,5988330,50206715,방글라데시,2007-01
2007-01-31,55486459,3023129,52463330,우즈베키스탄,2007-01
2007-01-31,55171109,91742767,-36571658,스웨덴,2007-01
2007-01-31,52989898,1573914,51415984,그리스,2007-01
2007-01-31,49943341,21711491,28231850,파키스탄,2007-01
2007-01-31,48672341,1189487,47482854,나이지리아,2007-01
2007-01-31,47922032,92997894,-45075862,뉴질랜드,2007-01
2007-01-31,45448171,53138526,-7690355,덴마크,2007-01
2007-01-31,45208451,70742607,-25534156,알제리,2007-01
2007-01-31,45206851,54938852,-9732001,오스트리아,2007-01
2007-01-31,42548432,3458195,39090237,루마니아,2007-01
2007-01-31,37183451,739704,36443747,에쿠아도르,2007-01
2007-01-31,36203759,211015,35992744,시리아,2007-01
2007-01-31,34896967,684593,34212374,사이프러스,2007-01
2007-01-31,33728639,138305944,-104577305,스위스,2007-01
2007-01-31,32532761,72641084,-40108323,페루,2007-01
2007-01-31,32213441,7896209,24317232,과테말라,2007-01
2007-01-31,31839316,429776001,-397936685,오만,2007-01
2007-01-31,31067042,153746,30913296,리비아,2007-01
2007-01-31,30394095,23044878,7349217,포루투갈,2007-01
2007-01-31,27929261,2861819,25067442,요르단,2007-01
2007-01-31,26404688,13792377,12612311,카자흐스탄,2007-01
2007-01-31,26304151,31105842,-4801691,아르헨티나,2007-01
2007-01-31,25785251,2349306,23435945,슬로베니아,2007-01
2007-01-31,25431723,2727324,22704399,불가리아,2007-01
2007-01-31,24609586,4586174,20023412,모로코,2007-01
2007-01-31,23472388,13781612,9690776,바레인,2007-01
2007-01-31,18190007,4086022,14103985,코스타리카,2007-01
2007-01-31,17630565,3333516,14297049,기타국,2007-01
2007-01-31,17335500,756053,16579447,캄보디아,2007-01
2007-01-31,16991305,3906665,13084640,스리랑카,2007-01
2007-01-31,14507699,35618552,-21110853,수단,2007-01
2007-01-31,11613284,1483267,10130017,온두라스,2007-01
2007-01-31,11019517,2492800,8526717,도미니카 공화국,2007-01
2007-01-31,10886721,0,10886721,앙골라,2007-01
2007-01-31,10849379,125482,10723897,니카라과,2007-01
2007-01-31,10389278,52593068,-42203790,예맨,2007-01
2007-01-31,9980858,5236881,4743977,미얀마,2007-01
2007-01-31,9510244,11958667,-2448423,푸에르토리코,2007-01
2007-01-31,9103960,69674,9034286,키르기스스탄,2007-01
2007-01-31,8831593,94856,8736737,케냐,2007-01
2007-01-31,8801611,127926,8673685,몽골,2007-01
2007-01-31,8055923,231080,7824843,쿠바,2007-01
2007-01-31,7520100,1175958,6344142,가나,2007-01
2007-01-31,7266578,867823,6398755,리투아니아,2007-01
2007-01-31,7213819,81617,7132202,엘살바도르,2007-01
2007-01-31,7006344,1231019,5775325,에스토니아,2007-01
2007-01-31,6859711,1717428,5142283,튀니지,2007-01
2007-01-31,6756389,2826053,3930336,레바논,2007-01
2007-01-31,6262824,139050969,-132788145,이라크,2007-01
2007-01-31,6052631,3593412,2459219,몰타,2007-01
2007-01-31,5364757,18044,5346713,유고,2007-01
2007-01-31,5206884,3757838,1449046,크로아티아,2007-01
2007-01-31,4501807,219155,4282652,모리셔스,2007-01
2007-01-31,4437172,9852851,-5415679,트리니다드 토바고,2007-01
2007-01-31,4380200,10938,4369262,뉴 칼레도니아,2007-01
2007-01-31,4332919,553564,3779355,벨라루스,2007-01
2007-01-31,4076221,27255,4048966,북마리아나 군도,2007-01
2007-01-31,4064338,6662,4057676,탄자니아,2007-01
2007-01-31,4021089,1362160,2658929,라트비아,2007-01
2007-01-31,3996899,0,3996899,불령 리유니온 코모도 제도,2007-01
2007-01-31,3846115,0,3846115,아제르바이잔,2007-01
2007-01-31,3595456,4168376,-572920,우루과이,2007-01
2007-01-31,3326464,348376,2978088,카메룬,2007-01
2007-01-31,3230363,192453,3037910,에티오피아,2007-01
2007-01-31,3156331,29700,3126631,파라과이,2007-01
2007-01-31,2946135,7760107,-4813972,라오스,2007-01
2007-01-31,2694210,765,2693445,아프카니스탄,2007-01
2007-01-31,2616491,202748,2413743,코트디봐르,2007-01
2007-01-31,2504022,21450,2482572,자마이카,2007-01
2007-01-31,2443758,732766,1710992,베닝,2007-01
2007-01-31,2428519,4690,2423829,괌,2007-01
2007-01-31,2230437,155794,2074643,조지아,2007-01
2007-01-31,2196964,98082927,-95885963,브루나이,2007-01
2007-01-31,2181074,103979,2077095,피지,2007-01
2007-01-31,2045481,2707635,-662154,아이슬란드,2007-01
2007-01-31,2013162,96031,1917131,세르비아 와 몬테네그로,2007-01
2007-01-31,1762211,579645,1182566,세네갈,2007-01
2007-01-31,1733026,13750,1719276,레소토,2007-01
2007-01-31,1706240,446639,1259601,콩고,2007-01
2007-01-31,1649342,678921,970421,마카오,2007-01
2007-01-31,1532504,9091,1523413,과델로프,2007-01
2007-01-31,1510265,4212645,-2702380,룩셈부르그,2007-01
2007-01-31,1496726,525913,970813,토고,2007-01
2007-01-31,1467026,8946574,-7479548,파푸아 뉴기니,2007-01
2007-01-31,1314837,43750,1271087,마티니크,2007-01
2007-01-31,1238438,6711620,-5473182,타지크,2007-01
2007-01-31,1234749,41747,1193002,네덜란드 열도,2007-01
2007-01-31,1192783,2559722,-1366939,스와질랜드,2007-01
2007-01-31,1188836,10976,1177860,모잠비크,2007-01
2007-01-31,1186054,32862962,-31676908,볼리비아,2007-01
2007-01-31,1185620,0,1185620,버뮤다,2007-01
2007-01-31,1119774,16543,1103231,네팔,2007-01
2007-01-31,1097282,207670,889612,우간다,2007-01
2007-01-31,1088874,78761,1010113,마다카스카르,2007-01
2007-01-31,1080863,29888,1050975,불령 폴리네시아,2007-01
2007-01-31,1023187,500,1022687,안티가 바부다,2007-01
2007-01-31,916677,0,916677,지부티,2007-01
2007-01-31,886505,1966,884539,바베이도스,2007-01
2007-01-31,881587,0,881587,아이티,2007-01
2007-01-31,872483,8001,864482,콩고민주공화국,2007-01
2007-01-31,768495,0,768495,아루바,2007-01
2007-01-31,722875,1906205,-1183330,짐바브웨,2007-01
2007-01-31,670084,0,670084,세이쉘,2007-01
2007-01-31,606791,647,606144,알바니아,2007-01
2007-01-31,604518,3153381,-2548863,가봉,2007-01
2007-01-31,600143,46246833,-45646690,기니,2007-01
2007-01-31,591867,178953,412914,마세도니아,2007-01
2007-01-31,591748,492172,99576,팔레스타인 해방기구(구),2007-01
2007-01-31,576916,4493,572423,보스니아-헤르체고비나,2007-01
2007-01-31,574905,324,574581,수리남,2007-01
2007-01-31,560813,1368976,-808163,아르메니아,2007-01
2007-01-31,557726,18204,539522,몰도바,2007-01
2007-01-31,541973,42655,499318,말라위,2007-01
2007-01-31,532375,0,532375,에리트리아,2007-01
2007-01-31,520847,0,520847,불령 가이아나,2007-01
2007-01-31,502801,497,502304,영령 캐이맨 군도,2007-01
2007-01-31,441051,332012,109039,리히텐슈타인,2007-01
2007-01-31,339121,25189752,-24850631,잠비아,2007-01
2007-01-31,329151,0,329151,가이아나,2007-01
2007-01-31,296028,4544928,-4248900,벨리제,2007-01
2007-01-31,292782,1200,291582,몰디브,2007-01
2007-01-31,271561,0,271561,바누아투,2007-01
2007-01-31,247308,1011342,-764034,솔로몬 군도,2007-01
2007-01-31,241448,175497,65951,모리타니,2007-01
2007-01-31,238386,0,238386,마이크로네시아,2007-01
2007-01-31,227313,0,227313,세인트 루시아,2007-01
2007-01-31,207554,8763,198791,투르크멘,2007-01
2007-01-31,204196,3687,200509,니제르,2007-01
2007-01-31,195253,83392,111861,보츠와나,2007-01
2007-01-31,181956,22382,159574,도미니카,2007-01
2007-01-31,163799,0,163799,르완다,2007-01
2007-01-31,163686,0,163686,소말리아,2007-01
2007-01-31,152859,0,152859,그레나다,2007-01
2007-01-31,151931,0,151931,말리,2007-01
2007-01-31,139363,15880439,-15741076,나미비아,2007-01
2007-01-31,136205,31309,104896,감비아,2007-01
2007-01-31,135314,29330,105984,사모아,2007-01
2007-01-31,112005,0,112005,부르키나 파소,2007-01
2007-01-31,109055,46657,62398,팔라우,2007-01
2007-01-31,104615,24654,79961,안도라,2007-01
2007-01-31,101744,0,101744,부탄,2007-01
2007-01-31,99708,203,99505,카보 베르데,2007-01
2007-01-31,92283,3048431,-2956148,영령 버진군도,2007-01
2007-01-31,89816,497040,-407224,챠드,2007-01
2007-01-31,84769,122588,-37819,시에라 리온,2007-01
2007-01-31,70860,0,70860,세인트 키츠 네비스,2007-01
2007-01-31,64592,0,64592,아메리칸 사모아,2007-01
2007-01-31,58228,0,58228,적도 기니,2007-01
2007-01-31,46506,0,46506,쿡 아일랜드,2007-01
2007-01-31,46018,1269709,-1223691,모나코,2007-01
2007-01-31,43607,0,43607,지브랄타,2007-01
2007-01-31,42646,0,42646,산마리노,2007-01
2007-01-31,24336,0,24336,기네비소,2007-01
2007-01-31,19820,0,19820,투르크 & 카이코스 군도,2007-01
2007-01-31,17651,0,17651,메요트,2007-01
2007-01-31,7356,1427,5929,키리바티,2007-01
2007-01-31,4787,6631,-1844,티모르,2007-01
2007-01-31,3300,0,3300,포클랜드 군도,2007-01
2007-01-31,3265,101,3164,중앙아프리카공화국,2007-01
2007-01-31,2745,0,2745,몬트세라트,2007-01
2007-01-31,1656,0,1656,상토메 프린스페,2007-01
2007-01-31,1600,2814,-1214,부룬디,2007-01
2007-01-31,991,0,991,세인트 빈센트 그레나딘,2007-01
2007-01-31,400,7363,-6963,세인트 헬레나,2007-01
2007-01-31,152,0,152,영령 인도양,2007-01
2007-01-31,0,22180,-22180,토켈라우,2007-01
2007-01-31,0,3635,-3635,코스 군도,2007-01
2007-01-31,0,209573,-209573,통가,2007-01
2007-01-31,0,8987,-8987,파로에 군도,2007-01
2007-01-31,0,137295,-137295,그린랜드,2007-01
2007-01-31,0,1271,-1271,크리스마스 아일랜드,2007-01
2007-01-31,0,385964,-385964,피트카이른,2007-01
2007-01-31,0,7423,-7423,나우루,2007-01
2007-02-28,5482360139,4388189092,1094171047,중국,2007-02
2007-02-28,3704007923,2706305803,997702120,미국,2007-02
2007-02-28,2028249460,4292282030,-2264032570,일본,2007-02
2007-02-28,1289738246,144622168,1145116078,홍콩,2007-02
2007-02-28,868646439,712069537,156576902,대만,2007-02
2007-02-28,851000773,459600527,391400246,싱가포르,2007-02
2007-02-28,746564036,920700876,-174136840,독일,2007-02
2007-02-28,550057194,59671996,490385198,멕시코,2007-02
2007-02-28,533370384,325612651,207757733,인도,2007-02
2007-02-28,493457058,230420135,263036923,영국,2007-02
2007-02-28,474718601,388348098,86370503,러시아 연방,2007-02
2007-02-28,415146876,749236019,-334089143,말레이시아,2007-02
2007-02-28,395865922,94527930,301337992,베트남,2007-02
2007-02-28,373021656,268204592,104817064,태국,2007-02
2007-02-28,368464531,159526838,208937693,필리핀,2007-02
2007-02-28,358523190,21038,358502152,바하마,2007-02
2007-02-28,346647960,680389475,-333741515,인도네시아,2007-02
2007-02-28,326147719,249168337,76979382,이탈리아,2007-02
2007-02-28,324888250,1024463474,-699575224,호주,2007-02
2007-02-28,290639429,10683173,279956256,튀르키예,2007-02
2007-02-28,286356613,64558446,221798167,스페인,2007-02
2007-02-28,283884771,293300923,-9416152,네덜란드,2007-02
2007-02-28,283174585,16255805,266918780,파나마,2007-02
2007-02-28,273518724,1410113471,-1136594747,사우디아라비아,2007-02
2007-02-28,263229238,18792476,244436762,폴란드,2007-02
2007-02-28,248231000,701235558,-453004558,아랍에미리트 연합,2007-02
2007-02-28,244464798,2817652,241647146,그리스,2007-02
2007-02-28,230894199,288008072,-57113873,프랑스,2007-02
2007-02-28,214003372,179890602,34112770,브라질,2007-02
2007-02-28,212596024,258839237,-46243213,캐나다,2007-02
2007-02-28,191673351,303577,191369774,사이프러스,2007-02
2007-02-28,187443889,74965409,112478480,벨기에,2007-02
2007-02-28,183151864,380094491,-196942627,이란,2007-02
2007-02-28,179884180,382666215,-202782035,칠레,2007-02
2007-02-28,168387909,3290145,165097764,슬로바키아,2007-02
2007-02-28,110557822,10599339,99958483,우크라이나,2007-02
2007-02-28,107774784,151158878,-43384094,남아프리카공화국,2007-02
2007-02-28,95950289,14401762,81548527,헝가리,2007-02
2007-02-28,95520785,50389015,45131770,이집트,2007-02
2007-02-28,90407233,7514928,82892305,콜롬비아,2007-02
2007-02-28,76807228,40278371,36528857,핀란드,2007-02
2007-02-28,75192330,1869912,73322418,기타국,2007-02
2007-02-28,74980510,497411739,-422431229,카타르,2007-02
2007-02-28,71034689,21848075,49186614,체코공화국,2007-02
2007-02-28,70390029,564562459,-494172430,쿠웨이트,2007-02
2007-02-28,67130673,634495,66496178,시리아,2007-02
2007-02-28,65645310,76702263,-11056953,뉴질랜드,2007-02
2007-02-28,63752124,9941431,53810693,베네주엘라,2007-02
2007-02-28,59114419,60137052,-1022633,이스라엘,2007-02
2007-02-28,58447062,3570596,54876466,우즈베키스탄,2007-02
2007-02-28,58036727,58702899,-666172,오스트리아,2007-02
2007-02-28,57630584,5586643,52043941,루마니아,2007-02
2007-02-28,56326889,2822813,53504076,몰타,2007-02
2007-02-28,55629874,87104679,-31474805,스웨덴,2007-02
2007-02-28,53202251,1876,53200375,라이베리아,2007-02
2007-02-28,49999375,143535375,-93536000,나이지리아,2007-02
2007-02-28,49979012,42684789,7294223,파키스탄,2007-02
2007-02-28,49196346,62763431,-13567085,아일랜드,2007-02
2007-02-28,48421241,3502174,44919067,방글라데시,2007-02
2007-02-28,39537860,50219,39487641,쿠바,2007-02
2007-02-28,38522648,25082218,13440430,카자흐스탄,2007-02
2007-02-28,36777284,1651456,35125828,에쿠아도르,2007-02
2007-02-28,35471378,2000,35469378,마샬군도,2007-02
2007-02-28,33460739,25431095,8029644,포루투갈,2007-02
2007-02-28,29245167,120203241,-90958074,스위스,2007-02
2007-02-28,28054323,134953146,-106898823,페루,2007-02
2007-02-28,27662209,2521756,25140453,요르단,2007-02
2007-02-28,27576287,6867395,20708892,모로코,2007-02
2007-02-28,27484371,8588196,18896175,과테말라,2007-02
2007-02-28,27029328,2225872,24803456,슬로베니아,2007-02
2007-02-28,26245724,338530697,-312284973,오만,2007-02
2007-02-28,24703530,35861,24667669,알제리,2007-02
2007-02-28,23287237,171274,23115963,리비아,2007-02
2007-02-28,21962152,39019832,-17057680,덴마크,2007-02
2007-02-28,20950598,16915,20933683,니카라과,2007-02
2007-02-28,20024295,95042888,-75018593,노르웨이,2007-02
2007-02-28,19179193,24861659,-5682466,아르헨티나,2007-02
2007-02-28,18779036,6436812,12342224,불가리아,2007-02
2007-02-28,17578706,4228396,13350310,코스타리카,2007-02
2007-02-28,14984155,209988,14774167,예맨,2007-02
2007-02-28,13949269,1163763,12785506,캄보디아,2007-02
2007-02-28,13599314,35116,13564198,팔레스타인 해방기구(구),2007-02
2007-02-28,12770078,10891227,1878851,수단,2007-02
2007-02-28,12457335,3562112,8895223,스리랑카,2007-02
2007-02-28,12146676,4253407,7893269,도미니카 공화국,2007-02
2007-02-28,10785676,4010393,6775283,미얀마,2007-02
2007-02-28,10314151,13517480,-3203329,푸에르토리코,2007-02
2007-02-28,9939257,654695,9284562,크로아티아,2007-02
2007-02-28,9555140,123256956,-113701816,이라크,2007-02
2007-02-28,9379156,15067126,-5687970,온두라스,2007-02
2007-02-28,9250740,1099606,8151134,가나,2007-02
2007-02-28,9208342,3042249,6166093,케냐,2007-02
2007-02-28,8932654,23868991,-14936337,바레인,2007-02
2007-02-28,8255985,1666298,6589687,레바논,2007-02
2007-02-28,7365611,73048668,-65683057,아제르바이잔,2007-02
2007-02-28,7186751,652255,6534496,몽골,2007-02
2007-02-28,7049706,45539470,-38489764,에스토니아,2007-02
2007-02-28,6866123,1950083,4916040,튀니지,2007-02
2007-02-28,6434145,1042108,5392037,에티오피아,2007-02
2007-02-28,6382785,2397,6380388,키르기스스탄,2007-02
2007-02-28,6047371,54980381,-48933010,앙골라,2007-02
2007-02-28,5892073,42815037,-36922964,라트비아,2007-02
2007-02-28,5649769,3835588,1814181,우루과이,2007-02
2007-02-28,5353267,0,5353267,레소토,2007-02
2007-02-28,4765146,504618,4260528,엘살바도르,2007-02
2007-02-28,4585110,335688,4249422,탄자니아,2007-02
2007-02-28,4580816,120753,4460063,트리니다드 토바고,2007-02
2007-02-28,4106361,890156,3216205,리투아니아,2007-02
2007-02-28,3989832,8604,3981228,코트디봐르,2007-02
2007-02-28,3769873,44497,3725376,뉴 칼레도니아,2007-02
2007-02-28,3737552,4422242,-684690,라오스,2007-02
2007-02-28,3699838,17349,3682489,파라과이,2007-02
2007-02-28,3551274,616901,2934373,기니,2007-02
2007-02-28,3467500,4248,3463252,북마리아나 군도,2007-02
2007-02-28,3324891,0,3324891,불령 리유니온 코모도 제도,2007-02
2007-02-28,3284831,467263,2817568,벨라루스,2007-02
2007-02-28,3080320,0,3080320,지부티,2007-02
2007-02-28,2897583,4180,2893403,괌,2007-02
2007-02-28,2588140,0,2588140,아프카니스탄,2007-02
2007-02-28,2552861,0,2552861,과델로프,2007-02
2007-02-28,2468544,49412,2419132,세네갈,2007-02
2007-02-28,2233840,98724,2135116,모리셔스,2007-02
2007-02-28,2217617,198747,2018870,자마이카,2007-02
2007-02-28,2192534,0,2192534,베닝,2007-02
2007-02-28,1951256,599464,1351792,아이슬란드,2007-02
2007-02-28,1862050,66987008,-65124958,브루나이,2007-02
2007-02-28,1826868,18265,1808603,마티니크,2007-02
2007-02-28,1770744,7244,1763500,세르비아 와 몬테네그로,2007-02
2007-02-28,1764007,0,1764007,아루바,2007-02
2007-02-28,1747283,480577,1266706,조지아,2007-02
2007-02-28,1676495,80006,1596489,모잠비크,2007-02
2007-02-28,1602386,91837970,-90235584,카메룬,2007-02
2007-02-28,1593678,17975,1575703,유고,2007-02
2007-02-28,1576596,24651,1551945,불령 폴리네시아,2007-02
2007-02-28,1476102,6454139,-4978037,룩셈부르그,2007-02
2007-02-28,1422005,10939799,-9517794,볼리비아,2007-02
2007-02-28,1346142,2274203,-928061,파푸아 뉴기니,2007-02
2007-02-28,1191762,15872,1175890,피지,2007-02
2007-02-28,1137410,156252,981158,콩고민주공화국,2007-02
2007-02-28,1134012,614190,519822,짐바브웨,2007-02
2007-02-28,1094081,6286866,-5192785,타지크,2007-02
2007-02-28,1073884,777265,296619,마카오,2007-02
2007-02-28,1057254,123495,933759,투르크멘,2007-02
2007-02-28,1030564,95703,934861,마다카스카르,2007-02
2007-02-28,1022331,1581,1020750,아메리칸 사모아,2007-02
2007-02-28,997767,22983,974784,토고,2007-02
2007-02-28,993010,211,992799,네덜란드 열도,2007-02
2007-02-28,922423,54435063,-53512640,콩고,2007-02
2007-02-28,907007,0,907007,바베이도스,2007-02
2007-02-28,865535,2555,862980,알바니아,2007-02
2007-02-28,851339,0,851339,버뮤다,2007-02
2007-02-28,799574,25365,774209,사모아,2007-02
2007-02-28,777084,112,776972,안티가 바부다,2007-02
2007-02-28,729332,42715,686617,네팔,2007-02
2007-02-28,697405,76830,620575,보스니아-헤르체고비나,2007-02
2007-02-28,671613,0,671613,마이크로네시아,2007-02
2007-02-28,622069,7211,614858,몰도바,2007-02
2007-02-28,590656,0,590656,수리남,2007-02
2007-02-28,578954,3130713,-2551759,스와질랜드,2007-02
2007-02-28,575503,43512,531991,아이티,2007-02
2007-02-28,539898,3138,536760,우간다,2007-02
2007-02-28,515424,22981228,-22465804,잠비아,2007-02
2007-02-28,511916,0,511916,도미니카,2007-02
2007-02-28,501883,0,501883,세인트 루시아,2007-02
2007-02-28,499728,0,499728,세이쉘,2007-02
2007-02-28,492162,0,492162,부르키나 파소,2007-02
2007-02-28,441288,91394,349894,벨리제,2007-02
2007-02-28,370693,1045,369648,모리타니,2007-02
2007-02-28,349953,16405,333548,마세도니아,2007-02
2007-02-28,325096,3800,321296,가이아나,2007-02
2007-02-28,311996,428886,-116890,아르메니아,2007-02
2007-02-28,291614,398,291216,그레나다,2007-02
2007-02-28,287989,0,287989,불령 가이아나,2007-02
2007-02-28,270040,0,270040,적도 기니,2007-02
2007-02-28,269950,546590,-276640,리히텐슈타인,2007-02
2007-02-28,257665,0,257665,영령 캐이맨 군도,2007-02
2007-02-28,217156,0,217156,르완다,2007-02
2007-02-28,212024,187498,24526,에리트리아,2007-02
2007-02-28,211190,2539301,-2328111,솔로몬 군도,2007-02
2007-02-28,210531,4580,205951,바누아투,2007-02
2007-02-28,201475,158010,43465,가봉,2007-02
2007-02-28,195984,0,195984,영령 버진군도,2007-02
2007-02-28,192473,0,192473,몰디브,2007-02
2007-02-28,183512,17327,166185,팔라우,2007-02
2007-02-28,140754,939765,-799011,말라위,2007-02
2007-02-28,126495,62703,63792,보츠와나,2007-02
2007-02-28,125464,0,125464,감비아,2007-02
2007-02-28,125414,661305,-535891,모나코,2007-02
2007-02-28,124916,8416,116500,카보 베르데,2007-02
2007-02-28,95000,0,95000,소말리아,2007-02
2007-02-28,84448,16003,68445,부탄,2007-02
2007-02-28,59820,0,59820,세인트 빈센트 그레나딘,2007-02
2007-02-28,57186,0,57186,마이너 아우틀링 합중국 군도,2007-02
2007-02-28,55061,58901,-3840,시에라 리온,2007-02
2007-02-28,54392,0,54392,나미비아,2007-02
2007-02-28,54231,0,54231,부룬디,2007-02
2007-02-28,50977,0,50977,산마리노,2007-02
2007-02-28,47168,0,47168,쿡 아일랜드,2007-02
2007-02-28,38918,0,38918,파로에 군도,2007-02
2007-02-28,35762,0,35762,통가,2007-02
2007-02-28,30786,601476,-570690,말리,2007-02
2007-02-28,30547,42349,-11802,안도라,2007-02
2007-02-28,22288,3342,18946,니제르,2007-02
2007-02-28,19564,0,19564,메요트,2007-02
2007-02-28,15805,443,15362,세인트 키츠 네비스,2007-02
2007-02-28,4254,0,4254,지브랄타,2007-02
2007-02-28,2682,0,2682,세인트 헬레나,2007-02
2007-02-28,2000,0,2000,티모르,2007-02
2007-02-28,1840,0,1840,토켈라우,2007-02
2007-02-28,708,0,708,몬트세라트,2007-02
2007-02-28,548,0,548,미령 버진군도,2007-02
2007-02-28,200,0,200,앙귈라,2007-02
2007-02-28,0,31946,-31946,나우루,2007-02
2007-02-28,0,391,-391,상토메 프린스페,2007-02
2007-02-28,0,82613,-82613,크리스마스 아일랜드,2007-02
2007-02-28,0,116287,-116287,그린랜드,2007-02
2007-02-28,0,331,-331,중앙아프리카공화국,2007-02
2007-02-28,0,196116,-196116,챠드,2007-02
2007-03-31,6382984185,4817522766,1565461419,중국,2007-03
2007-03-31,4059505955,3039549701,1019956254,미국,2007-03
2007-03-31,2205708551,5006938971,-2801230420,일본,2007-03
2007-03-31,1433951408,184466101,1249485307,홍콩,2007-03
2007-03-31,1139721750,826288616,313433134,대만,2007-03
2007-03-31,958128462,1196736923,-238608461,독일,2007-03
2007-03-31,942028145,589746772,352281373,싱가포르,2007-03
2007-03-31,712553483,308687711,403865772,영국,2007-03
2007-03-31,588877227,90922865,497954362,멕시코,2007-03
2007-03-31,536797380,742073631,-205276251,인도네시아,2007-03
2007-03-31,534782411,410012006,124770405,인도,2007-03
2007-03-31,526723740,572379195,-45655455,러시아 연방,2007-03
2007-03-31,435111404,334152218,100959186,태국,2007-03
2007-03-31,409246808,754324112,-345077304,말레이시아,2007-03
2007-03-31,387783740,1518398520,-1130614780,사우디아라비아,2007-03
2007-03-31,380971885,82773355,298198530,베트남,2007-03
2007-03-31,379063835,310370478,68693357,이탈리아,2007-03
2007-03-31,374831758,68582012,306249746,스페인,2007-03
2007-03-31,363996749,977851623,-613854874,호주,2007-03
2007-03-31,338898224,16865307,322032917,튀르키예,2007-03
2007-03-31,333867521,194449484,139418037,필리핀,2007-03
2007-03-31,314606273,278966680,35639593,캐나다,2007-03
2007-03-31,312091502,329804110,-17712608,네덜란드,2007-03
2007-03-31,299533098,1001901140,-702368042,아랍에미리트 연합,2007-03
2007-03-31,292932523,20870254,272062269,폴란드,2007-03
2007-03-31,264633908,317436709,-52802801,프랑스,2007-03
2007-03-31,263360588,5911545,257449043,슬로바키아,2007-03
2007-03-31,262557937,183368371,79189566,브라질,2007-03
2007-03-31,252590339,310068170,-57477831,칠레,2007-03
2007-03-31,241838238,47656,241790582,라이베리아,2007-03
2007-03-31,234131183,94848949,139282234,벨기에,2007-03
2007-03-31,230881268,9490,230871778,바하마,2007-03
2007-03-31,206777382,3001278,203776104,그리스,2007-03
2007-03-31,188592484,393568880,-204976396,이란,2007-03
2007-03-31,172747556,4153,172743403,마샬군도,2007-03
2007-03-31,165026378,123848941,41177437,남아프리카공화국,2007-03
2007-03-31,156995358,0,156995358,버뮤다,2007-03
2007-03-31,149795384,1238976,148556408,파나마,2007-03
2007-03-31,145995051,749080048,-603084997,쿠웨이트,2007-03
2007-03-31,138749362,17257743,121491619,우크라이나,2007-03
2007-03-31,118360352,7314748,111045604,콜롬비아,2007-03
2007-03-31,113459958,23964022,89495936,헝가리,2007-03
2007-03-31,95818579,116257854,-20439275,이집트,2007-03
2007-03-31,93358587,10483926,82874661,베네주엘라,2007-03
2007-03-31,85958896,7909551,78049345,루마니아,2007-03
2007-03-31,85396639,850971462,-765574823,카타르,2007-03
2007-03-31,82678910,4059555,78619355,몰타,2007-03
2007-03-31,81990126,69703883,12286243,핀란드,2007-03
2007-03-31,78352119,76629800,1722319,오스트리아,2007-03
2007-03-31,78151858,83859093,-5707235,이스라엘,2007-03
2007-03-31,77870225,69253531,8616694,아일랜드,2007-03
2007-03-31,77692549,8978495,68714054,기타국,2007-03
2007-03-31,66764418,26417954,40346464,체코공화국,2007-03
2007-03-31,64230623,56026681,8203942,나이지리아,2007-03
2007-03-31,64117788,97096462,-32978674,알제리,2007-03
2007-03-31,63627013,4041491,59585522,우즈베키스탄,2007-03
2007-03-31,60598875,101295319,-40696444,스웨덴,2007-03
2007-03-31,59997276,38497185,21500091,파키스탄,2007-03
2007-03-31,57998983,155101,57843882,시리아,2007-03
2007-03-31,56164638,105223168,-49058530,뉴질랜드,2007-03
2007-03-31,47580799,15491192,32089607,방글라데시,2007-03
2007-03-31,44899320,146953,44752367,사이프러스,2007-03
2007-03-31,42371126,40252152,2118974,페루,2007-03
2007-03-31,42089823,421512323,-379422500,오만,2007-03
2007-03-31,41263797,4189035,37074762,슬로베니아,2007-03
2007-03-31,40532399,30473395,10059004,카자흐스탄,2007-03
2007-03-31,37875962,408075,37467887,리비아,2007-03
2007-03-31,37699715,5298987,32400728,미얀마,2007-03
2007-03-31,37237627,7036115,30201512,모로코,2007-03
2007-03-31,36447485,30259791,6187694,과테말라,2007-03
2007-03-31,35399956,69773787,-34373831,아르헨티나,2007-03
2007-03-31,33987444,98002175,-64014731,노르웨이,2007-03
2007-03-31,32828288,3163754,29664534,요르단,2007-03
2007-03-31,30014087,86202520,-56188433,덴마크,2007-03
2007-03-31,28841414,48519466,-19678052,수단,2007-03
2007-03-31,28721867,158589642,-129867775,스위스,2007-03
2007-03-31,28141733,35237820,-7096087,포루투갈,2007-03
2007-03-31,27330846,916073,26414773,에쿠아도르,2007-03
2007-03-31,24936275,60899,24875376,쿠바,2007-03
2007-03-31,23513974,15265200,8248774,바레인,2007-03
2007-03-31,22144072,640489,21503583,캄보디아,2007-03
2007-03-31,15549366,2978157,12571209,불가리아,2007-03
2007-03-31,14639065,5252212,9386853,스리랑카,2007-03
2007-03-31,14159262,5382690,8776572,코스타리카,2007-03
2007-03-31,14037117,262004,13775113,케냐,2007-03
2007-03-31,13417322,1288392,12128930,몽골,2007-03
2007-03-31,12936687,100313188,-87376501,이라크,2007-03
2007-03-31,12912639,11762,12900877,니카라과,2007-03
2007-03-31,12511172,3853205,8657967,온두라스,2007-03
2007-03-31,11925468,147098,11778370,에티오피아,2007-03
2007-03-31,10748390,2741708,8006682,가나,2007-03
2007-03-31,10283035,1595970,8687065,레바논,2007-03
2007-03-31,10208966,129912,10079054,예맨,2007-03
2007-03-31,9843616,4027678,5815938,크로아티아,2007-03
2007-03-31,9642460,362895,9279565,앙골라,2007-03
2007-03-31,9428406,4984171,4444235,에스토니아,2007-03
2007-03-31,9021460,19661,9001799,키르기스스탄,2007-03
2007-03-31,8852474,10360,8842114,아프카니스탄,2007-03
2007-03-31,8529848,18085913,-9556065,도미니카 공화국,2007-03
2007-03-31,8407718,23774543,-15366825,푸에르토리코,2007-03
2007-03-31,8270491,105613,8164878,엘살바도르,2007-03
2007-03-31,8190104,820771,7369333,리투아니아,2007-03
2007-03-31,7277179,1669,7275510,아제르바이잔,2007-03
2007-03-31,6811524,0,6811524,코트디봐르,2007-03
2007-03-31,6589593,1842386,4747207,라트비아,2007-03
2007-03-31,6339398,86152,6253246,뉴 칼레도니아,2007-03
2007-03-31,6250124,2486569,3763555,튀니지,2007-03
2007-03-31,5828028,3328370,2499658,우루과이,2007-03
2007-03-31,5383647,7006263,-1622616,라오스,2007-03
2007-03-31,4603388,4468,4598920,북마리아나 군도,2007-03
2007-03-31,4419209,389807,4029402,탄자니아,2007-03
2007-03-31,4096849,77562,4019287,세르비아 와 몬테네그로,2007-03
2007-03-31,3726411,33960,3692451,보스니아-헤르체고비나,2007-03
2007-03-31,3574235,19020,3555215,파라과이,2007-03
2007-03-31,3424449,0,3424449,불령 리유니온 코모도 제도,2007-03
2007-03-31,3199900,291444,2908456,트리니다드 토바고,2007-03
2007-03-31,3194813,552011,2642802,아이슬란드,2007-03
2007-03-31,3096699,126700,2969999,모리셔스,2007-03
2007-03-31,3053541,466235,2587306,벨라루스,2007-03
2007-03-31,3033198,61977,2971221,괌,2007-03
2007-03-31,2924496,80445,2844051,유고,2007-03
2007-03-31,2572488,0,2572488,베닝,2007-03
2007-03-31,2534895,66351,2468544,피지,2007-03
2007-03-31,2394772,146632,2248140,조지아,2007-03
2007-03-31,2278589,281616,1996973,세네갈,2007-03
2007-03-31,2076536,459389,1617147,마카오,2007-03
2007-03-31,1992514,88760664,-86768150,카메룬,2007-03
2007-03-31,1875625,214301,1661324,마다카스카르,2007-03
2007-03-31,1790437,0,1790437,토고,2007-03
2007-03-31,1722336,0,1722336,과델로프,2007-03
2007-03-31,1703875,47523643,-45819768,브루나이,2007-03
2007-03-31,1692008,16814,1675194,나우루,2007-03
2007-03-31,1635273,0,1635273,지부티,2007-03
2007-03-31,1628529,7097599,-5469070,룩셈부르그,2007-03
2007-03-31,1495474,107210,1388264,자마이카,2007-03
2007-03-31,1422198,99768,1322430,아루바,2007-03
2007-03-31,1373336,60021261,-58647925,콩고,2007-03
2007-03-31,1347422,0,1347422,마티니크,2007-03
2007-03-31,1267238,83601,1183637,모잠비크,2007-03
2007-03-31,1200429,6505076,-5304647,타지크,2007-03
2007-03-31,1140484,529088,611396,아르메니아,2007-03
2007-03-31,1090657,122038,968619,불령 폴리네시아,2007-03
2007-03-31,1082707,61771,1020936,네팔,2007-03
2007-03-31,1047552,0,1047552,네덜란드 열도,2007-03
2007-03-31,1024211,332,1023879,영령 버진군도,2007-03
2007-03-31,1003049,2811475,-1808426,스와질랜드,2007-03
2007-03-31,903499,9776128,-8872629,파푸아 뉴기니,2007-03
2007-03-31,903117,79597296,-78694179,기니,2007-03
2007-03-31,858769,51705,807064,수리남,2007-03
2007-03-31,827157,94799,732358,우간다,2007-03
2007-03-31,782370,8870,773500,사모아,2007-03
2007-03-31,771924,145291,626633,몰도바,2007-03
2007-03-31,763326,129562,633764,아이티,2007-03
2007-03-31,751085,7344,743741,가이아나,2007-03
2007-03-31,723320,72651,650669,콩고민주공화국,2007-03
2007-03-31,663273,11526679,-10863406,짐바브웨,2007-03
2007-03-31,656812,16434020,-15777208,볼리비아,2007-03
2007-03-31,644487,32921,611566,도미니카,2007-03
2007-03-31,629887,15275,614612,세이쉘,2007-03
2007-03-31,588878,637857,-48979,모리타니,2007-03
2007-03-31,563113,13026,550087,알바니아,2007-03
2007-03-31,531386,199649,331737,리히텐슈타인,2007-03
2007-03-31,515528,1390,514138,벨리제,2007-03
2007-03-31,464698,4289313,-3824615,말라위,2007-03
2007-03-31,452641,0,452641,세인트 루시아,2007-03
2007-03-31,440058,0,440058,영령 캐이맨 군도,2007-03
2007-03-31,425483,1749709,-1324226,마세도니아,2007-03
2007-03-31,405270,0,405270,바베이도스,2007-03
2007-03-31,316821,0,316821,불령 가이아나,2007-03
2007-03-31,297234,0,297234,말리,2007-03
2007-03-31,289067,696,288371,안티가 바부다,2007-03
2007-03-31,287373,12000,275373,마이크로네시아,2007-03
2007-03-31,277767,312,277455,몰디브,2007-03
2007-03-31,268049,197812,70237,가봉,2007-03
2007-03-31,255786,206404,49382,보츠와나,2007-03
2007-03-31,233681,796,232885,바누아투,2007-03
2007-03-31,225218,41638274,-41413056,잠비아,2007-03
2007-03-31,216011,0,216011,부탄,2007-03
2007-03-31,190612,135552,55060,시에라 리온,2007-03
2007-03-31,188915,0,188915,그레나다,2007-03
2007-03-31,168200,31772,136428,니제르,2007-03
2007-03-31,158576,0,158576,레소토,2007-03
2007-03-31,138799,10521062,-10382263,나미비아,2007-03
2007-03-31,114864,82209,32655,팔라우,2007-03
2007-03-31,113861,0,113861,부르키나 파소,2007-03
2007-03-31,112192,392383,-280191,팔레스타인 해방기구(구),2007-03
2007-03-31,108011,36502,71509,카보 베르데,2007-03
2007-03-31,102544,90177,12367,아메리칸 사모아,2007-03
2007-03-31,93485,3140881,-3047396,솔로몬 군도,2007-03
2007-03-31,89825,0,89825,세인트 빈센트 그레나딘,2007-03
2007-03-31,85913,0,85913,투르크멘,2007-03
2007-03-31,83981,5650,78331,안도라,2007-03
2007-03-31,67160,0,67160,투르크 & 카이코스 군도,2007-03
2007-03-31,63450,96845,-33395,르완다,2007-03
2007-03-31,56064,0,56064,세인트 키츠 네비스,2007-03
2007-03-31,52744,0,52744,산마리노,2007-03
2007-03-31,50278,0,50278,적도 기니,2007-03
2007-03-31,48686,0,48686,에리트리아,2007-03
2007-03-31,42253,0,42253,지브랄타,2007-03
2007-03-31,39335,0,39335,쿡 아일랜드,2007-03
2007-03-31,38438,0,38438,키리바티,2007-03
2007-03-31,36490,0,36490,앙귈라,2007-03
2007-03-31,33742,0,33742,챠드,2007-03
2007-03-31,28187,47000,-18813,감비아,2007-03
2007-03-31,18385,0,18385,메요트,2007-03
2007-03-31,14391,0,14391,포클랜드 군도,2007-03
2007-03-31,13485,129772,-116287,상토메 프린스페,2007-03
2007-03-31,1010,14240,-13230,세인트 헬레나,2007-03
2007-03-31,924,1598716,-1597792,모나코,2007-03
2007-03-31,748,0,748,파로에 군도,2007-03
2007-03-31,152,0,152,통가,2007-03
2007-03-31,0,56532,-56532,토켈라우,2007-03
2007-03-31,0,94,-94,몬트세라트,2007-03
2007-03-31,0,187840,-187840,그린랜드,2007-03
2007-03-31,0,52793,-52793,중앙아프리카공화국,2007-03
2007-03-31,0,130248,-130248,교황청,2007-03
2007-03-31,0,7149,-7149,니우에,2007-03
2007-03-31,0,1489,-1489,미령 버진군도,2007-03
2007-03-31,0,44956,-44956,기네비소,2007-03
2007-04-30,6518525742,5447491296,1071034446,중국,2007-04
2007-04-30,3844901714,3416958519,427943195,미국,2007-04
2007-04-30,2109682607,4972020792,-2862338185,일본,2007-04
2007-04-30,1391633614,159545438,1232088176,홍콩,2007-04
2007-04-30,1240043327,579894877,660148450,싱가포르,2007-04
2007-04-30,1100275212,793227555,307047657,대만,2007-04
2007-04-30,936841173,1128688904,-191847731,독일,2007-04
2007-04-30,567755648,614645271,-46889623,러시아 연방,2007-04
2007-04-30,545137349,757102414,-211965065,인도네시아,2007-04
2007-04-30,525791892,70609961,455181931,멕시코,2007-04
2007-04-30,521204843,101357,521103486,라이베리아,2007-04
2007-04-30,483607186,293537826,190069360,영국,2007-04
2007-04-30,476485028,329920430,146564598,인도,2007-04
2007-04-30,448486348,102874390,345611958,베트남,2007-04
2007-04-30,406742892,801300920,-394558028,말레이시아,2007-04
2007-04-30,389868774,342208284,47660490,태국,2007-04
2007-04-30,372147865,1100884276,-728736411,호주,2007-04
2007-04-30,349384469,47946594,301437875,파나마,2007-04
2007-04-30,345768649,66740636,279028013,스페인,2007-04
2007-04-30,328015233,304244956,23770277,이탈리아,2007-04
2007-04-30,322802092,339561471,-16759379,네덜란드,2007-04
2007-04-30,321742202,1629708172,-1307965970,사우디아라비아,2007-04
2007-04-30,319690144,46255274,273434870,튀르키예,2007-04
2007-04-30,312841122,205123162,107717960,필리핀,2007-04
2007-04-30,308326786,230103599,78223187,캐나다,2007-04
2007-04-30,302954161,0,302954161,마샬군도,2007-04
2007-04-30,296177888,688359976,-392182088,아랍에미리트 연합,2007-04
2007-04-30,273207538,22664054,250543484,폴란드,2007-04
2007-04-30,259525084,343659496,-84134412,프랑스,2007-04
2007-04-30,258979464,336152239,-77172775,칠레,2007-04
2007-04-30,256182927,163882689,92300238,브라질,2007-04
2007-04-30,243819762,465776927,-221957165,이란,2007-04
2007-04-30,238218488,4742186,233476302,슬로바키아,2007-04
2007-04-30,234839426,103278882,131560544,벨기에,2007-04
2007-04-30,187209409,115748692,71460717,남아프리카공화국,2007-04
2007-04-30,140923291,17757517,123165774,헝가리,2007-04
2007-04-30,117663598,44657,117618941,베네주엘라,2007-04
2007-04-30,109182278,40766991,68415287,이집트,2007-04
2007-04-30,109058714,11973885,97084829,우크라이나,2007-04
2007-04-30,99102096,7738386,91363710,콜롬비아,2007-04
2007-04-30,98156353,827049562,-728893209,카타르,2007-04
2007-04-30,90576167,34542,90541625,알제리,2007-04
2007-04-30,87792708,4869393,82923315,그리스,2007-04
2007-04-30,86733516,90174477,-3440961,핀란드,2007-04
2007-04-30,85293988,71935073,13358915,이스라엘,2007-04
2007-04-30,77472271,85030370,-7558099,뉴질랜드,2007-04
2007-04-30,76785725,73876777,2908948,오스트리아,2007-04
2007-04-30,76433864,3746155,72687709,루마니아,2007-04
2007-04-30,71303207,63250752,8052455,나이지리아,2007-04
2007-04-30,69114416,83857726,-14743310,스웨덴,2007-04
2007-04-30,66208922,41680008,24528914,몰타,2007-04
2007-04-30,63806208,23005,63783203,바하마,2007-04
2007-04-30,62099040,4460435,57638605,우즈베키스탄,2007-04
2007-04-30,59752412,28454118,31298294,체코공화국,2007-04
2007-04-30,57214876,40660709,16554167,파키스탄,2007-04
2007-04-30,57149250,329805,56819445,시리아,2007-04
2007-04-30,55654595,66218342,-10563747,아일랜드,2007-04
2007-04-30,55027555,7640006,47387549,방글라데시,2007-04
2007-04-30,53910186,561406198,-507496012,쿠웨이트,2007-04
2007-04-30,49356018,30645365,18710653,카자흐스탄,2007-04
2007-04-30,47007888,3763894,43243994,슬로베니아,2007-04
2007-04-30,44998024,43714936,1283088,덴마크,2007-04
2007-04-30,44326471,82821943,-38495472,페루,2007-04
2007-04-30,42339182,26356396,15982786,포루투갈,2007-04
2007-04-30,36587586,70248807,-33661221,아르헨티나,2007-04
2007-04-30,35197803,4454201,30743602,모로코,2007-04
2007-04-30,34148736,9520788,24627948,과테말라,2007-04
2007-04-30,33614970,8607628,25007342,요르단,2007-04
2007-04-30,30284273,913008,29371265,에쿠아도르,2007-04
2007-04-30,28393114,105100,28288014,리비아,2007-04
2007-04-30,28113877,231261621,-203147744,오만,2007-04
2007-04-30,25051573,163989917,-138938344,스위스,2007-04
2007-04-30,23534745,37076074,-13541329,수단,2007-04
2007-04-30,22602705,503208,22099497,캄보디아,2007-04
2007-04-30,19572950,116639187,-97066237,노르웨이,2007-04
2007-04-30,17029347,2745294,14284053,불가리아,2007-04
2007-04-30,16080023,2274909,13805114,몽골,2007-04
2007-04-30,15930384,200141174,-184210790,이라크,2007-04
2007-04-30,15144873,7713225,7431648,기타국,2007-04
2007-04-30,14627263,4470813,10156450,스리랑카,2007-04
2007-04-30,13432950,173968,13258982,케냐,2007-04
2007-04-30,13193449,5398849,7794600,코스타리카,2007-04
2007-04-30,12748004,230549,12517455,앙골라,2007-04
2007-04-30,12170425,23996833,-11826408,온두라스,2007-04
2007-04-30,11422746,5095837,6326909,미얀마,2007-04
2007-04-30,10721310,867202,9854108,도미니카 공화국,2007-04
2007-04-30,10387283,2196,10385087,키르기스스탄,2007-04
2007-04-30,9885255,5024,9880231,니카라과,2007-04
2007-04-30,9666738,175,9666563,아프카니스탄,2007-04
2007-04-30,9624797,44881668,-35256871,예맨,2007-04
2007-04-30,9306494,4145852,5160642,크로아티아,2007-04
2007-04-30,9184959,48572552,-39387593,바레인,2007-04
2007-04-30,9168553,1522656,7645897,레바논,2007-04
2007-04-30,9139952,0,9139952,아제르바이잔,2007-04
2007-04-30,9113839,14289177,-5175338,푸에르토리코,2007-04
2007-04-30,8489177,1401114,7088063,에스토니아,2007-04
2007-04-30,8141529,280192,7861337,쿠바,2007-04
2007-04-30,7879352,115480,7763872,에티오피아,2007-04
2007-04-30,7654985,3272735,4382250,튀니지,2007-04
2007-04-30,7594587,1405134,6189453,가나,2007-04
2007-04-30,7521517,701300,6820217,리투아니아,2007-04
2007-04-30,7305499,1443807,5861692,라트비아,2007-04
2007-04-30,7249099,3787871,3461228,우루과이,2007-04
2007-04-30,7092258,223895,6868363,사이프러스,2007-04
2007-04-30,6944491,260407,6684084,엘살바도르,2007-04
2007-04-30,5349019,18517,5330502,괌,2007-04
2007-04-30,5162789,1425382,3737407,아이슬란드,2007-04
2007-04-30,4877425,77177,4800248,뉴 칼레도니아,2007-04
2007-04-30,4482754,0,4482754,불령 리유니온 코모도 제도,2007-04
2007-04-30,4122031,84762,4037269,파라과이,2007-04
2007-04-30,3901031,509056,3391975,트리니다드 토바고,2007-04
2007-04-30,3687265,9932570,-6245305,라오스,2007-04
2007-04-30,3410440,0,3410440,베닝,2007-04
2007-04-30,3222095,18325,3203770,북마리아나 군도,2007-04
2007-04-30,3167065,157018,3010047,탄자니아,2007-04
2007-04-30,2828882,263477,2565405,세네갈,2007-04
2007-04-30,2729459,9195955,-6466496,룩셈부르그,2007-04
2007-04-30,2647312,244455,2402857,자마이카,2007-04
2007-04-30,2602445,485119,2117326,마카오,2007-04
2007-04-30,2458928,17856,2441072,과델로프,2007-04
2007-04-30,2393217,2595994,-202777,벨라루스,2007-04
2007-04-30,2319734,143526,2176208,모리셔스,2007-04
2007-04-30,2301325,4137,2297188,불령 폴리네시아,2007-04
2007-04-30,2300065,0,2300065,레소토,2007-04
2007-04-30,2179182,76595714,-74416532,브루나이,2007-04
2007-04-30,2178738,113797,2064941,모잠비크,2007-04
2007-04-30,2125502,182088,1943414,조지아,2007-04
2007-04-30,1977166,0,1977166,콩고,2007-04
2007-04-30,1884390,0,1884390,부르키나 파소,2007-04
2007-04-30,1779359,0,1779359,코트디봐르,2007-04
2007-04-30,1745507,29706,1715801,네팔,2007-04
2007-04-30,1741873,130799,1611074,토고,2007-04
2007-04-30,1727414,895699,831715,파푸아 뉴기니,2007-04
2007-04-30,1592700,0,1592700,네덜란드 열도,2007-04
2007-04-30,1568250,48069111,-46500861,카메룬,2007-04
2007-04-30,1510477,616726,893751,콩고민주공화국,2007-04
2007-04-30,1500722,24317,1476405,유고,2007-04
2007-04-30,1466101,55749,1410352,세르비아 와 몬테네그로,2007-04
2007-04-30,1427180,0,1427180,마티니크,2007-04
2007-04-30,1277429,47793239,-46515810,잠비아,2007-04
2007-04-30,1276982,126473,1150509,마다카스카르,2007-04
2007-04-30,1267535,0,1267535,지부티,2007-04
2007-04-30,1239927,145031,1094896,우간다,2007-04
2007-04-30,1199828,4450,1195378,마세도니아,2007-04
2007-04-30,1172614,505498,667116,말라위,2007-04
2007-04-30,1166986,248496,918490,피지,2007-04
2007-04-30,1113449,9029,1104420,아이티,2007-04
2007-04-30,1112772,0,1112772,아루바,2007-04
2007-04-30,1091630,3000,1088630,니제르,2007-04
2007-04-30,1007807,31564,976243,보스니아-헤르체고비나,2007-04
2007-04-30,1003275,0,1003275,바베이도스,2007-04
2007-04-30,936222,43,936179,아르메니아,2007-04
2007-04-30,876389,3208280,-2331891,스와질랜드,2007-04
2007-04-30,858043,11627,846416,수리남,2007-04
2007-04-30,785892,2365292,-1579400,가봉,2007-04
2007-04-30,784997,150973,634024,기니,2007-04
2007-04-30,683051,3126988,-2443937,타지크,2007-04
2007-04-30,650025,585359,64666,볼리비아,2007-04
2007-04-30,612981,59731,553250,세이쉘,2007-04
2007-04-30,575900,0,575900,가이아나,2007-04
2007-04-30,561265,219860,341405,리히텐슈타인,2007-04
2007-04-30,530360,18559,511801,알바니아,2007-04
2007-04-30,484981,92,484889,벨리제,2007-04
2007-04-30,456619,0,456619,부탄,2007-04
2007-04-30,454746,0,454746,안티가 바부다,2007-04
2007-04-30,450339,0,450339,몰디브,2007-04
2007-04-30,441419,5539914,-5098495,짐바브웨,2007-04
2007-04-30,412483,268655,143828,에리트리아,2007-04
2007-04-30,351438,120464,230974,도미니카,2007-04
2007-04-30,328419,0,328419,버뮤다,2007-04
2007-04-30,313659,0,313659,르완다,2007-04
2007-04-30,304661,0,304661,세인트 루시아,2007-04
2007-04-30,288914,84,288830,모리타니,2007-04
2007-04-30,273816,0,273816,영령 캐이맨 군도,2007-04
2007-04-30,262761,0,262761,투르크멘,2007-04
2007-04-30,261414,68296,193118,보츠와나,2007-04
2007-04-30,242032,364195,-122163,몰도바,2007-04
2007-04-30,211298,0,211298,바누아투,2007-04
2007-04-30,199912,0,199912,그레나다,2007-04
2007-04-30,197248,0,197248,불령 가이아나,2007-04
2007-04-30,186794,23280,163514,사모아,2007-04
2007-04-30,154307,0,154307,앙귈라,2007-04
2007-04-30,154289,16800,137489,마이크로네시아,2007-04
2007-04-30,143623,0,143623,적도 기니,2007-04
2007-04-30,132299,919,131380,미령 버진군도,2007-04
2007-04-30,119571,2503,117068,말리,2007-04
2007-04-30,118390,0,118390,아메리칸 사모아,2007-04
2007-04-30,100337,2606903,-2506566,솔로몬 군도,2007-04
2007-04-30,98432,64744,33688,팔레스타인 해방기구(구),2007-04
2007-04-30,89454,7431518,-7342064,나미비아,2007-04
2007-04-30,82076,0,82076,지브랄타,2007-04
2007-04-30,76792,58904,17888,안도라,2007-04
2007-04-30,73626,0,73626,통가,2007-04
2007-04-30,73243,737,72506,세인트 키츠 네비스,2007-04
2007-04-30,69980,0,69980,감비아,2007-04
2007-04-30,68167,0,68167,티모르,2007-04
2007-04-30,67900,21810,46090,카보 베르데,2007-04
2007-04-30,63518,322,63196,산마리노,2007-04
2007-04-30,59906,87650,-27744,시에라 리온,2007-04
2007-04-30,50995,0,50995,팔라우,2007-04
2007-04-30,47137,1000097,-952960,모나코,2007-04
2007-04-30,46196,117144,-70948,그린랜드,2007-04
2007-04-30,45940,0,45940,쿡 아일랜드,2007-04
2007-04-30,14561,0,14561,세인트 빈센트 그레나딘,2007-04
2007-04-30,11448,0,11448,기네비소,2007-04
2007-04-30,2432,0,2432,중앙아프리카공화국,2007-04
2007-04-30,2283,0,2283,나우루,2007-04
2007-04-30,640,0,640,투르크 & 카이코스 군도,2007-04
2007-04-30,171,0,171,영령 버진군도,2007-04
2007-04-30,0,230,-230,서사하라,2007-04
2007-04-30,0,99675,-99675,피트카이른,2007-04
2007-04-30,0,220,-220,몬트세라트,2007-04
2007-04-30,0,109111,-109111,교황청,2007-04
2007-04-30,0,106970,-106970,마이너 아우틀링 합중국 군도,2007-04
2007-04-30,0,1943,-1943,토켈라우,2007-04
2007-04-30,0,187353,-187353,파로에 군도,2007-04
2007-04-30,0,97089,-97089,상토메 프린스페,2007-04
2007-04-30,0,1462,-1462,영령 인도양,2007-04
2007-05-31,6587388640,5285957571,1301431069,중국,2007-05
2007-05-31,3992972872,3159697639,833275233,미국,2007-05
2007-05-31,2145311544,4733950641,-2588639097,일본,2007-05
2007-05-31,1463176305,176994459,1286181846,홍콩,2007-05
2007-05-31,1073633125,681021442,392611683,러시아 연방,2007-05
2007-05-31,1060356683,747596845,312759838,대만,2007-05
2007-05-31,1025259604,527178752,498080852,싱가포르,2007-05
2007-05-31,985209778,1098916621,-113706843,독일,2007-05
2007-05-31,546139323,306935658,239203665,영국,2007-05
2007-05-31,518841459,83996658,434844801,멕시코,2007-05
2007-05-31,499200453,680978689,-181778236,인도네시아,2007-05
2007-05-31,484766393,441549658,43216735,인도,2007-05
2007-05-31,480612282,183663358,296948924,베트남,2007-05
2007-05-31,428904746,712611648,-283706902,말레이시아,2007-05
2007-05-31,410574500,275839469,134735031,이탈리아,2007-05
2007-05-31,404549224,36478238,368070986,튀르키예,2007-05
2007-05-31,378790567,315432400,63358167,태국,2007-05
2007-05-31,360283148,292114108,68169040,네덜란드,2007-05
2007-05-31,352343140,62544489,289798651,스페인,2007-05
2007-05-31,345822588,1054412095,-708589507,호주,2007-05
2007-05-31,327188891,201178127,126010764,필리핀,2007-05
2007-05-31,313928074,50852648,263075426,파나마,2007-05
2007-05-31,312842712,0,312842712,버뮤다,2007-05
2007-05-31,311596708,1718570225,-1406973517,사우디아라비아,2007-05
2007-05-31,299233713,322692782,-23459069,캐나다,2007-05
2007-05-31,297066174,995880536,-698814362,아랍에미리트 연합,2007-05
2007-05-31,284934696,336866591,-51931895,프랑스,2007-05
2007-05-31,282970664,235385324,47585340,브라질,2007-05
2007-05-31,258801526,4140,258797386,마샬군도,2007-05
2007-05-31,258475741,18673237,239802504,폴란드,2007-05
2007-05-31,243545370,482404466,-238859096,이란,2007-05
2007-05-31,238119007,108563,238010444,라이베리아,2007-05
2007-05-31,233843848,6867399,226976449,슬로바키아,2007-05
2007-05-31,209266110,118405495,90860615,벨기에,2007-05
2007-05-31,199361079,331094881,-131733802,칠레,2007-05
2007-05-31,163574625,3390301,160184324,그리스,2007-05
2007-05-31,151641426,104339468,47301958,남아프리카공화국,2007-05
2007-05-31,139114264,101363389,37750875,스웨덴,2007-05
2007-05-31,135103269,4416408,130686861,기타국,2007-05
2007-05-31,129390707,17834489,111556218,우크라이나,2007-05
2007-05-31,114451394,54830,114396564,사이프러스,2007-05
2007-05-31,112506164,741902023,-629395859,카타르,2007-05
2007-05-31,106159850,13282714,92877136,베네주엘라,2007-05
2007-05-31,105831644,53062511,52769133,이집트,2007-05
2007-05-31,102277870,4652863,97625007,루마니아,2007-05
2007-05-31,102074544,26227799,75846745,헝가리,2007-05
2007-05-31,92016835,52422026,39594809,이스라엘,2007-05
2007-05-31,91374353,67531437,23842916,핀란드,2007-05
2007-05-31,85078046,9142500,75935546,콜롬비아,2007-05
2007-05-31,83217707,33225573,49992134,체코공화국,2007-05
2007-05-31,79594278,64827878,14766400,나이지리아,2007-05
2007-05-31,65480301,681803,64798498,시리아,2007-05
2007-05-31,65456233,75325735,-9869502,오스트리아,2007-05
2007-05-31,63168064,105680115,-42512051,뉴질랜드,2007-05
2007-05-31,62461591,28914014,33547577,알제리,2007-05
2007-05-31,62191723,41970193,20221530,파키스탄,2007-05
2007-05-31,61786468,68433944,-6647476,아일랜드,2007-05
2007-05-31,58468309,4018445,54449864,우즈베키스탄,2007-05
2007-05-31,55892371,864014688,-808122317,쿠웨이트,2007-05
2007-05-31,55648553,165389582,-109741029,스위스,2007-05
2007-05-31,48015556,6837456,41178100,모로코,2007-05
2007-05-31,47722369,18490142,29232227,방글라데시,2007-05
2007-05-31,45476215,88082138,-42605923,아르헨티나,2007-05
2007-05-31,44461627,24559811,19901816,카자흐스탄,2007-05
2007-05-31,43158872,87565028,-44406156,페루,2007-05
2007-05-31,39796153,2868403,36927750,슬로베니아,2007-05
2007-05-31,35716490,21644659,14071831,포루투갈,2007-05
2007-05-31,35544793,0,35544793,영령 캐이맨 군도,2007-05
2007-05-31,35054490,1703027,33351463,요르단,2007-05
2007-05-31,34963564,262695,34700869,리비아,2007-05
2007-05-31,34096035,34,34096001,바하마,2007-05
2007-05-31,32851426,14152201,18699225,과테말라,2007-05
2007-05-31,32593108,1677497,30915611,에쿠아도르,2007-05
2007-05-31,31812702,157438942,-125626240,오만,2007-05
2007-05-31,31552717,62224551,-30671834,덴마크,2007-05
2007-05-31,28542104,24117508,4424596,몰타,2007-05
2007-05-31,22603099,121546677,-98943578,노르웨이,2007-05
2007-05-31,21385308,707897,20677411,캄보디아,2007-05
2007-05-31,20677489,5474418,15203071,코스타리카,2007-05
2007-05-31,17584316,52479049,-34894733,수단,2007-05
2007-05-31,17579599,397661665,-380082066,이라크,2007-05
2007-05-31,15147521,548261,14599260,몽골,2007-05
2007-05-31,13408168,1891744,11516424,불가리아,2007-05
2007-05-31,13278077,2353220,10924857,스리랑카,2007-05
2007-05-31,12955168,216132,12739036,키르기스스탄,2007-05
2007-05-31,12379449,2836713,9542736,레바논,2007-05
2007-05-31,12174818,433200,11741618,앙골라,2007-05
2007-05-31,11735661,44001,11691660,니카라과,2007-05
2007-05-31,11612809,478979,11133830,케냐,2007-05
2007-05-31,11064975,2303087,8761888,가나,2007-05
2007-05-31,10271169,444580,9826589,크로아티아,2007-05
2007-05-31,10154176,0,10154176,아제르바이잔,2007-05
2007-05-31,10064868,23337112,-13272244,예맨,2007-05
2007-05-31,10040091,28604919,-18564828,미얀마,2007-05
2007-05-31,9946556,3842256,6104300,온두라스,2007-05
2007-05-31,9737463,15501478,-5764015,바레인,2007-05
2007-05-31,9374709,1590363,7784346,에스토니아,2007-05
2007-05-31,8666818,12548748,-3881930,푸에르토리코,2007-05
2007-05-31,8302198,2007179,6295019,라트비아,2007-05
2007-05-31,8136061,1253575,6882486,도미니카 공화국,2007-05
2007-05-31,7435522,1292644,6142878,튀니지,2007-05
2007-05-31,6921752,3363222,3558530,우루과이,2007-05
2007-05-31,6414229,340344,6073885,엘살바도르,2007-05
2007-05-31,6380181,37303,6342878,뉴 칼레도니아,2007-05
2007-05-31,5970804,943020,5027784,리투아니아,2007-05
2007-05-31,5476682,0,5476682,레소토,2007-05
2007-05-31,5287385,245744,5041641,트리니다드 토바고,2007-05
2007-05-31,4893183,37286,4855897,네팔,2007-05
2007-05-31,4802454,708223,4094231,탄자니아,2007-05
2007-05-31,4389405,10066,4379339,보스니아-헤르체고비나,2007-05
2007-05-31,4167665,96536,4071129,파라과이,2007-05
2007-05-31,3955663,1594517,2361146,세네갈,2007-05
2007-05-31,3817072,16107,3800965,유고,2007-05
2007-05-31,3713563,3269,3710294,코트디봐르,2007-05
2007-05-31,3621369,228242,3393127,쿠바,2007-05
2007-05-31,3540714,272365,3268349,조지아,2007-05
2007-05-31,3370209,2475653,894556,벨라루스,2007-05
2007-05-31,3325689,0,3325689,불령 리유니온 코모도 제도,2007-05
2007-05-31,3225034,178172,3046862,모리셔스,2007-05
2007-05-31,3218893,19732,3199161,북마리아나 군도,2007-05
2007-05-31,3142400,5825084,-2682684,라오스,2007-05
2007-05-31,2970491,14857,2955634,괌,2007-05
2007-05-31,2966936,127007,2839929,마다카스카르,2007-05
2007-05-31,2942478,483862,2458616,베닝,2007-05
2007-05-31,2901290,542991,2358299,마카오,2007-05
2007-05-31,2887081,1759201,1127880,아이슬란드,2007-05
2007-05-31,2844781,78578561,-75733780,잠비아,2007-05
2007-05-31,2681487,54095,2627392,세르비아 와 몬테네그로,2007-05
2007-05-31,2531025,2001490,529535,나우루,2007-05
2007-05-31,2316548,57385097,-55068549,브루나이,2007-05
2007-05-31,2222804,4878,2217926,아프카니스탄,2007-05
2007-05-31,2059917,68657,1991260,피지,2007-05
2007-05-31,2036673,133975,1902698,콩고,2007-05
2007-05-31,2036137,19698818,-17662681,파푸아 뉴기니,2007-05
2007-05-31,1941561,5764295,-3822734,룩셈부르그,2007-05
2007-05-31,1846304,257852,1588452,콩고민주공화국,2007-05
2007-05-31,1799138,38375,1760763,불령 폴리네시아,2007-05
2007-05-31,1696912,57509,1639403,우간다,2007-05
2007-05-31,1565943,121582315,-120016372,카메룬,2007-05
2007-05-31,1527061,364093,1162968,에티오피아,2007-05
2007-05-31,1377989,0,1377989,마티니크,2007-05
2007-05-31,1371812,6267411,-4895599,짐바브웨,2007-05
2007-05-31,1356765,147532,1209233,토고,2007-05
2007-05-31,1347632,170895,1176737,몰도바,2007-05
2007-05-31,1236423,612124,624299,자마이카,2007-05
2007-05-31,1226219,3091233,-1865014,스와질랜드,2007-05
2007-05-31,1211335,31386,1179949,시에라 리온,2007-05
2007-05-31,1177391,0,1177391,아르메니아,2007-05
2007-05-31,1147058,1984,1145074,아이티,2007-05
2007-05-31,1060304,108642,951662,네덜란드 열도,2007-05
2007-05-31,1031740,1591474,-559734,타지크,2007-05
2007-05-31,999282,0,999282,과델로프,2007-05
2007-05-31,941329,18899,922430,아메리칸 사모아,2007-05
2007-05-31,828838,0,828838,지부티,2007-05
2007-05-31,801418,0,801418,아루바,2007-05
2007-05-31,799899,0,799899,바베이도스,2007-05
2007-05-31,730970,13038,717932,알바니아,2007-05
2007-05-31,653150,1878147,-1224997,기니,2007-05
2007-05-31,640593,51424,589169,수리남,2007-05
2007-05-31,630135,379,629756,몰디브,2007-05
2007-05-31,608148,103114,505034,도미니카,2007-05
2007-05-31,596655,3496412,-2899757,말라위,2007-05
2007-05-31,554319,42981,511338,보츠와나,2007-05
2007-05-31,542938,105507,437431,모잠비크,2007-05
2007-05-31,504114,0,504114,안티가 바부다,2007-05
2007-05-31,434595,9963,424632,마세도니아,2007-05
2007-05-31,434308,2649099,-2214791,볼리비아,2007-05
2007-05-31,423936,56481,367455,사모아,2007-05
2007-05-31,389011,0,389011,불령 가이아나,2007-05
2007-05-31,386815,0,386815,세인트 루시아,2007-05
2007-05-31,358983,798053,-439070,가봉,2007-05
2007-05-31,357351,4874520,-4517169,니제르,2007-05
2007-05-31,262748,38800,223948,마이크로네시아,2007-05
2007-05-31,260476,0,260476,르완다,2007-05
2007-05-31,234249,2976,231273,바누아투,2007-05
2007-05-31,233267,537,232730,세이쉘,2007-05
2007-05-31,219757,445855,-226098,리히텐슈타인,2007-05
2007-05-31,211604,53546,158058,팔레스타인 해방기구(구),2007-05
2007-05-31,203702,327723,-124021,그레나다,2007-05
2007-05-31,188560,6036,182524,모리타니,2007-05
2007-05-31,181514,0,181514,부탄,2007-05
2007-05-31,173625,0,173625,투르크 & 카이코스 군도,2007-05
2007-05-31,171209,23911,147298,가이아나,2007-05
2007-05-31,165963,590343,-424380,모나코,2007-05
2007-05-31,163024,68923,94101,영령 버진군도,2007-05
2007-05-31,154820,53750,101070,팔라우,2007-05
2007-05-31,151306,159,151147,벨리제,2007-05
2007-05-31,119707,31203,88504,감비아,2007-05
2007-05-31,85806,0,85806,카보 베르데,2007-05
2007-05-31,78819,106,78713,지브랄타,2007-05
2007-05-31,78168,0,78168,적도 기니,2007-05
2007-05-31,72856,0,72856,부르키나 파소,2007-05
2007-05-31,71310,0,71310,세인트 키츠 네비스,2007-05
2007-05-31,65951,0,65951,세인트 빈센트 그레나딘,2007-05
2007-05-31,58738,70000,-11262,투르크멘,2007-05
2007-05-31,56986,57696,-710,그린랜드,2007-05
2007-05-31,49932,6794,43138,에리트리아,2007-05
2007-05-31,42982,0,42982,노폴크 아일랜드,2007-05
2007-05-31,39350,3254,36096,말리,2007-05
2007-05-31,37084,6726,30358,중앙아프리카공화국,2007-05
2007-05-31,33430,409,33021,마이너 아우틀링 합중국 군도,2007-05
2007-05-31,30893,204179,-173286,나미비아,2007-05
2007-05-31,29257,3112951,-3083694,솔로몬 군도,2007-05
2007-05-31,27971,0,27971,쿡 아일랜드,2007-05
2007-05-31,9415,0,9415,산마리노,2007-05
2007-05-31,8680,0,8680,앙귈라,2007-05
2007-05-31,7437,40418,-32981,안도라,2007-05
2007-05-31,2496,0,2496,투발루,2007-05
2007-05-31,1330,0,1330,티모르,2007-05
2007-05-31,130,0,130,포클랜드 군도,2007-05
2007-05-31,128,0,128,부룬디,2007-05
2007-05-31,0,140540,-140540,챠드,2007-05
2007-05-31,0,63216,-63216,파로에 군도,2007-05
2007-05-31,0,89998,-89998,토켈라우,2007-05
2007-05-31,0,596,-596,몬트세라트,2007-05
2007-05-31,0,47566,-47566,기네비소,2007-05
2007-05-31,0,173,-173,크리스마스 아일랜드,2007-05
2007-05-31,0,33437,-33437,통가,2007-05
2007-06-30,6548213184,5112763270,1435449914,중국,2007-06
2007-06-30,3846283234,3142884442,703398792,미국,2007-06
2007-06-30,2263239284,4498372096,-2235132812,일본,2007-06
2007-06-30,1546368120,194187752,1352180368,홍콩,2007-06
2007-06-30,1422889997,1007482573,415407424,독일,2007-06
2007-06-30,1258043778,375484,1257668294,나이지리아,2007-06
2007-06-30,1093050543,797508010,295542533,대만,2007-06
2007-06-30,1011874652,521867364,490007288,싱가포르,2007-06
2007-06-30,640648502,487793788,152854714,러시아 연방,2007-06
2007-06-30,576389878,626715426,-50325548,인도네시아,2007-06
2007-06-30,574717377,277996506,296720871,영국,2007-06
2007-06-30,524082190,372819596,151262594,인도,2007-06
2007-06-30,446909691,126665599,320244092,멕시코,2007-06
2007-06-30,445643729,567678431,-122034702,말레이시아,2007-06
2007-06-30,441193546,148670653,292522893,베트남,2007-06
2007-06-30,398458251,983084678,-584626427,호주,2007-06
2007-06-30,384010406,1903364439,-1519354033,사우디아라비아,2007-06
2007-06-30,359074065,283338310,75735755,태국,2007-06
2007-06-30,348029744,7863304,340166440,그리스,2007-06
2007-06-30,334160927,298933906,35227021,이탈리아,2007-06
2007-06-30,333075970,24225064,308850906,튀르키예,2007-06
2007-06-30,332048572,235530100,96518472,필리핀,2007-06
2007-06-30,326261728,319235603,7026125,네덜란드,2007-06
2007-06-30,320677395,76499190,244178205,스페인,2007-06
2007-06-30,318697031,1227689752,-908992721,아랍에미리트 연합,2007-06
2007-06-30,296379155,517867794,-221488639,이란,2007-06
2007-06-30,284870708,281668344,3202364,프랑스,2007-06
2007-06-30,283719911,272684772,11035139,브라질,2007-06
2007-06-30,276444006,277644442,-1200436,캐나다,2007-06
2007-06-30,250163484,23020666,227142818,폴란드,2007-06
2007-06-30,240888546,12883118,228005428,파나마,2007-06
2007-06-30,227348153,3067,227345086,라이베리아,2007-06
2007-06-30,203714158,85213816,118500342,벨기에,2007-06
2007-06-30,198682462,421032761,-222350299,칠레,2007-06
2007-06-30,173299565,0,173299565,버뮤다,2007-06
2007-06-30,171445241,619171435,-447726194,쿠웨이트,2007-06
2007-06-30,165668032,21354428,144313604,헝가리,2007-06
2007-06-30,162312520,6043461,156269059,슬로바키아,2007-06
2007-06-30,145005883,152204151,-7198268,남아프리카공화국,2007-06
2007-06-30,141812706,95380211,46432495,스웨덴,2007-06
2007-06-30,133262942,2559883,130703059,사이프러스,2007-06
2007-06-30,127747763,1939609,125808154,우크라이나,2007-06
2007-06-30,110962398,887585,110074813,베네주엘라,2007-06
2007-06-30,108141659,27478353,80663306,이집트,2007-06
2007-06-30,96929538,4693154,92236384,루마니아,2007-06
2007-06-30,95447522,66848585,28598937,핀란드,2007-06
2007-06-30,89053880,31900640,57153240,알제리,2007-06
2007-06-30,87630173,10176114,77454059,콜롬비아,2007-06
2007-06-30,82554144,499331979,-416777835,카타르,2007-06
2007-06-30,75432637,46726198,28706439,이스라엘,2007-06
2007-06-30,70872171,3837,70868334,마샬군도,2007-06
2007-06-30,67799290,34915212,32884078,체코공화국,2007-06
2007-06-30,66655633,3753808,62901825,우즈베키스탄,2007-06
2007-06-30,64338039,71198398,-6860359,오스트리아,2007-06
2007-06-30,62764656,14085143,48679513,파키스탄,2007-06
2007-06-30,60120795,13639646,46481149,카자흐스탄,2007-06
2007-06-30,58595029,56701399,1893630,아일랜드,2007-06
2007-06-30,54240926,107307874,-53066948,뉴질랜드,2007-06
2007-06-30,52233267,7415,52225852,바하마,2007-06
2007-06-30,48779402,104641180,-55861778,아르헨티나,2007-06
2007-06-30,46524048,130356453,-83832405,스위스,2007-06
2007-06-30,44133903,526693,43607210,시리아,2007-06
2007-06-30,42637389,19388798,23248591,방글라데시,2007-06
2007-06-30,41954299,42110696,-156397,페루,2007-06
2007-06-30,40931590,8956551,31975039,기타국,2007-06
2007-06-30,38571591,62441,38509150,리비아,2007-06
2007-06-30,35613775,0,35613775,영령 캐이맨 군도,2007-06
2007-06-30,35143869,10025112,25118757,모로코,2007-06
2007-06-30,32613700,15148994,17464706,포루투갈,2007-06
2007-06-30,32395470,2857481,29537989,슬로베니아,2007-06
2007-06-30,31806019,2141418,29664601,과테말라,2007-06
2007-06-30,31603632,77230558,-45626926,덴마크,2007-06
2007-06-30,25916617,214855421,-188938804,오만,2007-06
2007-06-30,25904555,4308063,21596492,몰타,2007-06
2007-06-30,25900275,6063761,19836514,요르단,2007-06
2007-06-30,24104876,817954,23286922,에쿠아도르,2007-06
2007-06-30,23390079,579302,22810777,캄보디아,2007-06
2007-06-30,23147401,130377631,-107230230,노르웨이,2007-06
2007-06-30,21993154,13638414,8354740,코스타리카,2007-06
2007-06-30,21379788,3038126,18341662,레바논,2007-06
2007-06-30,19721729,212918939,-193197210,이라크,2007-06
2007-06-30,19582375,17523120,2059255,수단,2007-06
2007-06-30,14297065,115296,14181769,니카라과,2007-06
2007-06-30,14251184,3874475,10376709,스리랑카,2007-06
2007-06-30,14096760,2653271,11443489,불가리아,2007-06
2007-06-30,13973985,2388035,11585950,몽골,2007-06
2007-06-30,13441652,2511490,10930162,미얀마,2007-06
2007-06-30,12467208,29638,12437570,가나,2007-06
2007-06-30,11836149,662801,11173348,케냐,2007-06
2007-06-30,11009075,25492,10983583,앙골라,2007-06
2007-06-30,10950746,13294242,-2343496,바레인,2007-06
2007-06-30,10763224,452883,10310341,크로아티아,2007-06
2007-06-30,10260692,3053594,7207098,온두라스,2007-06
2007-06-30,10141144,5,10141139,레소토,2007-06
2007-06-30,10026908,29406057,-19379149,도미니카 공화국,2007-06
2007-06-30,9621296,66020,9555276,아프카니스탄,2007-06
2007-06-30,9511796,260730,9251066,키르기스스탄,2007-06
2007-06-30,9148303,26587442,-17439139,예맨,2007-06
2007-06-30,8341173,1109909,7231264,에스토니아,2007-06
2007-06-30,7591994,2259503,5332491,튀니지,2007-06
2007-06-30,7589761,3330295,4259466,우루과이,2007-06
2007-06-30,7246387,86608,7159779,엘살바도르,2007-06
2007-06-30,6535511,720134,5815377,리투아니아,2007-06
2007-06-30,6472510,1377870,5094640,라트비아,2007-06
2007-06-30,5997309,8912492,-2915183,라오스,2007-06
2007-06-30,5713283,73741824,-68028541,아제르바이잔,2007-06
2007-06-30,5702098,10361462,-4659364,푸에르토리코,2007-06
2007-06-30,5539238,558486,4980752,뉴 칼레도니아,2007-06
2007-06-30,5182768,0,5182768,불령 리유니온 코모도 제도,2007-06
2007-06-30,4768717,319701,4449016,마카오,2007-06
2007-06-30,4723240,3704,4719536,코트디봐르,2007-06
2007-06-30,4667673,383309,4284364,트리니다드 토바고,2007-06
2007-06-30,4435129,369582,4065547,괌,2007-06
2007-06-30,4417905,221684,4196221,탄자니아,2007-06
2007-06-30,4063419,338689,3724730,쿠바,2007-06
2007-06-30,3848034,614732,3233302,에티오피아,2007-06
2007-06-30,3720855,108839,3612016,모리셔스,2007-06
2007-06-30,3702622,186324,3516298,파라과이,2007-06
2007-06-30,3623000,582729,3040271,조지아,2007-06
2007-06-30,3550549,6013,3544536,북마리아나 군도,2007-06
2007-06-30,3518305,136583742,-133065437,브루나이,2007-06
2007-06-30,3398854,241829,3157025,베닝,2007-06
2007-06-30,3115847,135383,2980464,피지,2007-06
2007-06-30,3093514,2495784,597730,아이슬란드,2007-06
2007-06-30,2990082,4622,2985460,아메리칸 사모아,2007-06
2007-06-30,2798708,72199,2726509,세르비아 와 몬테네그로,2007-06
2007-06-30,2708040,11943,2696097,보스니아-헤르체고비나,2007-06
2007-06-30,2580446,119274,2461172,토고,2007-06
2007-06-30,2579154,345591,2233563,세네갈,2007-06
2007-06-30,2498784,0,2498784,마티니크,2007-06
2007-06-30,2481908,262229,2219679,마다카스카르,2007-06
2007-06-30,2197220,668803,1528417,벨라루스,2007-06
2007-06-30,2173257,2127720,45537,스와질랜드,2007-06
2007-06-30,2065167,687,2064480,모리타니,2007-06
2007-06-30,2030885,579,2030306,모잠비크,2007-06
2007-06-30,1968744,9287210,-7318466,짐바브웨,2007-06
2007-06-30,1914535,0,1914535,콩고,2007-06
2007-06-30,1890438,5192,1885246,불령 폴리네시아,2007-06
2007-06-30,1760679,69298,1691381,몰도바,2007-06
2007-06-30,1621820,2595024,-973204,콩고민주공화국,2007-06
2007-06-30,1604712,428981,1175731,카메룬,2007-06
2007-06-30,1539449,18438149,-16898700,파푸아 뉴기니,2007-06
2007-06-30,1450992,121384,1329608,자마이카,2007-06
2007-06-30,1384564,29088,1355476,네팔,2007-06
2007-06-30,1330192,3200,1326992,세이쉘,2007-06
2007-06-30,1284689,520,1284169,유고,2007-06
2007-06-30,1227968,0,1227968,지부티,2007-06
2007-06-30,1227424,147960,1079464,아르메니아,2007-06
2007-06-30,1093684,1990259,-896575,타지크,2007-06
2007-06-30,1071201,20554,1050647,마세도니아,2007-06
2007-06-30,1067532,0,1067532,에리트리아,2007-06
2007-06-30,1040651,0,1040651,아루바,2007-06
2007-06-30,1026086,5500980,-4474894,룩셈부르그,2007-06
2007-06-30,1023490,0,1023490,과델로프,2007-06
2007-06-30,978756,200746,778010,팔레스타인 해방기구(구),2007-06
2007-06-30,946875,2324,944551,아이티,2007-06
2007-06-30,920793,898515,22278,기니,2007-06
2007-06-30,864182,68339311,-67475129,잠비아,2007-06
2007-06-30,807931,679,807252,벨리제,2007-06
2007-06-30,803640,0,803640,바베이도스,2007-06
2007-06-30,758264,30800,727464,수리남,2007-06
2007-06-30,748384,0,748384,마이크로네시아,2007-06
2007-06-30,680842,0,680842,몰디브,2007-06
2007-06-30,679966,498275,181691,말라위,2007-06
2007-06-30,662058,3113,658945,알바니아,2007-06
2007-06-30,553700,0,553700,세인트 루시아,2007-06
2007-06-30,505164,0,505164,부탄,2007-06
2007-06-30,456903,3684,453219,네덜란드 열도,2007-06
2007-06-30,423608,0,423608,감비아,2007-06
2007-06-30,415351,109987,305364,투르크멘,2007-06
2007-06-30,334026,6159513,-5825487,볼리비아,2007-06
2007-06-30,324696,0,324696,니제르,2007-06
2007-06-30,310159,0,310159,불령 가이아나,2007-06
2007-06-30,291282,1510,289772,도미니카,2007-06
2007-06-30,242751,104421,138330,가봉,2007-06
2007-06-30,234614,279722,-45108,리히텐슈타인,2007-06
2007-06-30,222969,6915,216054,사모아,2007-06
2007-06-30,205958,59889,146069,시에라 리온,2007-06
2007-06-30,199806,34990,164816,바누아투,2007-06
2007-06-30,199269,249,199020,안티가 바부다,2007-06
2007-06-30,189690,0,189690,말리,2007-06
2007-06-30,187926,0,187926,챠드,2007-06
2007-06-30,161135,175265,-14130,우간다,2007-06
2007-06-30,131610,0,131610,부룬디,2007-06
2007-06-30,120686,17263,103423,가이아나,2007-06
2007-06-30,118936,576,118360,안도라,2007-06
2007-06-30,109127,862,108265,영령 버진군도,2007-06
2007-06-30,106288,0,106288,적도 기니,2007-06
2007-06-30,104552,0,104552,팔라우,2007-06
2007-06-30,94257,161637,-67380,보츠와나,2007-06
2007-06-30,94191,0,94191,통가,2007-06
2007-06-30,88364,0,88364,세인트 키츠 네비스,2007-06
2007-06-30,79238,0,79238,카보 베르데,2007-06
2007-06-30,62536,471,62065,세인트 빈센트 그레나딘,2007-06
2007-06-30,59426,0,59426,지브랄타,2007-06
2007-06-30,51064,0,51064,그린랜드,2007-06
2007-06-30,46154,14429011,-14382857,나미비아,2007-06
2007-06-30,40632,0,40632,미령 버진군도,2007-06
2007-06-30,34913,453407,-418494,모나코,2007-06
2007-06-30,28590,0,28590,불령 남부지역,2007-06
2007-06-30,28094,1410702,-1382608,솔로몬 군도,2007-06
2007-06-30,24543,0,24543,부르키나 파소,2007-06
2007-06-30,21100,0,21100,키리바티,2007-06
2007-06-30,11430,0,11430,상토메 프린스페,2007-06
2007-06-30,9038,0,9038,르완다,2007-06
2007-06-30,4131,182092,-177961,산마리노,2007-06
2007-06-30,3618,0,3618,코스 군도,2007-06
2007-06-30,2310,0,2310,포클랜드 군도,2007-06
2007-06-30,1988,0,1988,중앙아프리카공화국,2007-06
2007-06-30,1549,93600,-92051,파로에 군도,2007-06
2007-06-30,828,0,828,그레나다,2007-06
2007-06-30,493,0,493,티모르,2007-06
2007-06-30,450,2189,-1739,나우루,2007-06
2007-06-30,223,192599,-192376,기네비소,2007-06
2007-06-30,0,106908,-106908,교황청,2007-06
2007-06-30,0,45,-45,몬트세라트,2007-06
2007-06-30,0,13384,-13384,토켈라우,2007-06
2007-07-31,6889671129,5168092014,1721579115,중국,2007-07
2007-07-31,3794752641,3116667840,678084801,미국,2007-07
2007-07-31,2138700677,4358535594,-2219834917,일본,2007-07
2007-07-31,1605736521,158061420,1447675101,홍콩,2007-07
2007-07-31,1191318431,788100926,403217505,대만,2007-07
2007-07-31,819199124,327209590,491989534,영국,2007-07
2007-07-31,731644375,1102295205,-370650830,독일,2007-07
2007-07-31,714294500,605443897,108850603,싱가포르,2007-07
2007-07-31,608137783,83938394,524199389,멕시코,2007-07
2007-07-31,576257109,301839539,274417570,인도,2007-07
2007-07-31,565340449,724154184,-158813735,러시아 연방,2007-07
2007-07-31,529838189,104544169,425294020,베트남,2007-07
2007-07-31,507957355,699628683,-191671328,인도네시아,2007-07
2007-07-31,483399340,419497818,63901522,네덜란드,2007-07
2007-07-31,464197883,591899275,-127701392,말레이시아,2007-07
2007-07-31,384538951,1066248991,-681710040,호주,2007-07
2007-07-31,378337880,13881283,364456597,튀르키예,2007-07
2007-07-31,376774369,202399280,174375089,필리핀,2007-07
2007-07-31,353291865,1673501395,-1320209530,사우디아라비아,2007-07
2007-07-31,342152432,1239681977,-897529545,아랍에미리트 연합,2007-07
2007-07-31,327283763,313669544,13614219,태국,2007-07
2007-07-31,323590523,277291978,46298545,브라질,2007-07
2007-07-31,304336593,283108085,21228508,캐나다,2007-07
2007-07-31,302472485,73121715,229350770,스페인,2007-07
2007-07-31,299119871,330292766,-31172895,프랑스,2007-07
2007-07-31,292180865,10479473,281701392,파나마,2007-07
2007-07-31,284519008,648463042,-363944034,이란,2007-07
2007-07-31,283092815,25649536,257443279,폴란드,2007-07
2007-07-31,276096184,272694082,3402102,칠레,2007-07
2007-07-31,265428124,332937155,-67509031,이탈리아,2007-07
2007-07-31,243852719,7606458,236246261,슬로바키아,2007-07
2007-07-31,212198789,93515041,118683748,벨기에,2007-07
2007-07-31,191528704,132877791,58650913,남아프리카공화국,2007-07
2007-07-31,178921910,18491618,160430292,헝가리,2007-07
2007-07-31,136214213,16710791,119503422,우크라이나,2007-07
2007-07-31,131230736,2347,131228389,라이베리아,2007-07
2007-07-31,119568002,434800,119133202,베네주엘라,2007-07
2007-07-31,104484730,11233964,93250766,콜롬비아,2007-07
2007-07-31,101223009,3391868,97831141,그리스,2007-07
2007-07-31,99117934,121686509,-22568575,핀란드,2007-07
2007-07-31,95050886,500444,94550442,사이프러스,2007-07
2007-07-31,93240154,11747716,81492438,이집트,2007-07
2007-07-31,88765216,407143096,-318377880,카타르,2007-07
2007-07-31,88264208,126533303,-38269095,알제리,2007-07
2007-07-31,74449226,7261325,67187901,루마니아,2007-07
2007-07-31,71893297,108842964,-36949667,스웨덴,2007-07
2007-07-31,67483806,50253480,17230326,이스라엘,2007-07
2007-07-31,61363470,764857613,-703494143,쿠웨이트,2007-07
2007-07-31,61105163,9958313,51146850,우즈베키스탄,2007-07
2007-07-31,60432700,12450546,47982154,몰타,2007-07
2007-07-31,59504585,26939091,32565494,나이지리아,2007-07
2007-07-31,56225766,79130139,-22904373,아일랜드,2007-07
2007-07-31,54570675,76455158,-21884483,뉴질랜드,2007-07
2007-07-31,54478444,20121894,34356550,카자흐스탄,2007-07
2007-07-31,52863938,49437351,3426587,파키스탄,2007-07
2007-07-31,52226789,29659612,22567177,체코공화국,2007-07
2007-07-31,51536128,723089,50813039,시리아,2007-07
2007-07-31,50242872,64103304,-13860432,덴마크,2007-07
2007-07-31,49930372,54422486,-4492114,아르헨티나,2007-07
2007-07-31,45626912,81035793,-35408881,오스트리아,2007-07
2007-07-31,44445112,14256790,30188322,포루투갈,2007-07
2007-07-31,42036641,152364270,-110327629,페루,2007-07
2007-07-31,40436114,2062949,38373165,에쿠아도르,2007-07
2007-07-31,39331633,7305883,32025750,방글라데시,2007-07
2007-07-31,38933084,29611,38903473,마샬군도,2007-07
2007-07-31,38140568,226656970,-188516402,스위스,2007-07
2007-07-31,35230590,221642,35008948,리비아,2007-07
2007-07-31,34332708,3154940,31177768,슬로베니아,2007-07
2007-07-31,28644727,281648188,-253003461,오만,2007-07
2007-07-31,28359586,9942557,18417029,과테말라,2007-07
2007-07-31,25351350,9103745,16247605,코스타리카,2007-07
2007-07-31,24193749,5122782,19070967,요르단,2007-07
2007-07-31,23166711,27598,23139113,괌,2007-07
2007-07-31,21792193,69003785,-47211592,앙골라,2007-07
2007-07-31,21601371,1061806,20539565,캄보디아,2007-07
2007-07-31,20327689,38572,20289117,쿠바,2007-07
2007-07-31,20212779,14359027,5853752,모로코,2007-07
2007-07-31,19251251,159644335,-140393084,이라크,2007-07
2007-07-31,18677062,7563,18669499,바하마,2007-07
2007-07-31,15817587,112546923,-96729336,노르웨이,2007-07
2007-07-31,15344452,3699212,11645240,기타국,2007-07
2007-07-31,15148421,3252142,11896279,온두라스,2007-07
2007-07-31,15058984,1367286,13691698,몽골,2007-07
2007-07-31,13941479,101521,13839958,예맨,2007-07
2007-07-31,13856785,3890731,9966054,스리랑카,2007-07
2007-07-31,13588421,32414797,-18826376,도미니카 공화국,2007-07
2007-07-31,13324964,1832017,11492947,레바논,2007-07
2007-07-31,13103841,294383,12809458,수단,2007-07
2007-07-31,12187628,14659,12172969,니카라과,2007-07
2007-07-31,12003080,2914517,9088563,불가리아,2007-07
2007-07-31,11370673,3061848,8308825,미얀마,2007-07
2007-07-31,11203280,1635,11201645,아프카니스탄,2007-07
2007-07-31,10749710,615318,10134392,케냐,2007-07
2007-07-31,10645367,3869917,6775450,크로아티아,2007-07
2007-07-31,10555589,792544,9763045,에스토니아,2007-07
2007-07-31,10399953,200606,10199347,키르기스스탄,2007-07
2007-07-31,10237354,81966,10155388,가나,2007-07
2007-07-31,9293561,26006458,-16712897,바레인,2007-07
2007-07-31,9278033,246167,9031866,에티오피아,2007-07
2007-07-31,8417787,1892223,6525564,튀니지,2007-07
2007-07-31,7940752,0,7940752,레소토,2007-07
2007-07-31,7643452,556404,7087048,라트비아,2007-07
2007-07-31,7444040,846855,6597185,리투아니아,2007-07
2007-07-31,7436522,10962808,-3526286,푸에르토리코,2007-07
2007-07-31,6851086,1376865,5474221,엘살바도르,2007-07
2007-07-31,6438790,113361449,-106922659,아제르바이잔,2007-07
2007-07-31,6118237,305087,5813150,조지아,2007-07
2007-07-31,6026493,5815986,210507,라오스,2007-07
2007-07-31,5641004,3915,5637089,코트디봐르,2007-07
2007-07-31,4954773,352365,4602408,탄자니아,2007-07
2007-07-31,4673825,3638122,1035703,우루과이,2007-07
2007-07-31,4486927,34857,4452070,파라과이,2007-07
2007-07-31,4237085,12659,4224426,뉴 칼레도니아,2007-07
2007-07-31,3829206,696,3828510,유고,2007-07
2007-07-31,3072727,73456,2999271,콩고,2007-07
2007-07-31,3011442,0,3011442,불령 리유니온 코모도 제도,2007-07
2007-07-31,2909302,48703,2860599,마다카스카르,2007-07
2007-07-31,2660586,351499,2309087,트리니다드 토바고,2007-07
2007-07-31,2500713,292520,2208193,모리셔스,2007-07
2007-07-31,2437457,30674,2406783,모리타니,2007-07
2007-07-31,2424519,0,2424519,마티니크,2007-07
2007-07-31,2410070,1007,2409063,베닝,2007-07
2007-07-31,2331976,0,2331976,지부티,2007-07
2007-07-31,2331037,747251,1583786,마카오,2007-07
2007-07-31,2245631,1561844,683787,세네갈,2007-07
2007-07-31,2200380,3529,2196851,북마리아나 군도,2007-07
2007-07-31,2187435,4672230,-2484795,타지크,2007-07
2007-07-31,2124125,0,2124125,나우루,2007-07
2007-07-31,2032657,4020620,-1987963,짐바브웨,2007-07
2007-07-31,2025040,246467,1778573,모잠비크,2007-07
2007-07-31,1903410,84468,1818942,세르비아 와 몬테네그로,2007-07
2007-07-31,1900958,1425419,475539,아이슬란드,2007-07
2007-07-31,1879680,44303682,-42424002,잠비아,2007-07
2007-07-31,1805603,157174,1648429,자마이카,2007-07
2007-07-31,1802188,1995425,-193237,스와질랜드,2007-07
2007-07-31,1741445,23122493,-21381048,브루나이,2007-07
2007-07-31,1665421,143448,1521973,토고,2007-07
2007-07-31,1635607,4675366,-3039759,룩셈부르그,2007-07
2007-07-31,1627284,49056,1578228,콩고민주공화국,2007-07
2007-07-31,1506721,2402444,-895723,파푸아 뉴기니,2007-07
2007-07-31,1465827,103103106,-101637279,카메룬,2007-07
2007-07-31,1284188,57522,1226666,피지,2007-07
2007-07-31,1172038,51612,1120426,불령 폴리네시아,2007-07
2007-07-31,1120761,775574,345187,벨라루스,2007-07
2007-07-31,1092562,52625,1039937,아이티,2007-07
2007-07-31,1089662,1645517,-555855,말라위,2007-07
2007-07-31,1064205,0,1064205,아르메니아,2007-07
2007-07-31,1019253,0,1019253,과델로프,2007-07
2007-07-31,990939,138950,851989,우간다,2007-07
2007-07-31,856247,130,856117,도미니카,2007-07
2007-07-31,781637,13625,768012,마세도니아,2007-07
2007-07-31,777268,0,777268,수리남,2007-07
2007-07-31,759536,18098,741438,가이아나,2007-07
2007-07-31,741781,0,741781,네덜란드 열도,2007-07
2007-07-31,696184,2355963,-1659779,가봉,2007-07
2007-07-31,682808,128980,553828,아루바,2007-07
2007-07-31,677691,0,677691,버뮤다,2007-07
2007-07-31,673476,104499,568977,투르크멘,2007-07
2007-07-31,635235,107023,528212,네팔,2007-07
2007-07-31,556838,111246,445592,팔레스타인 해방기구(구),2007-07
2007-07-31,528666,41874,486792,시에라 리온,2007-07
2007-07-31,489902,17475363,-16985461,볼리비아,2007-07
2007-07-31,453749,273913,179836,리히텐슈타인,2007-07
2007-07-31,447740,0,447740,세이쉘,2007-07
2007-07-31,436549,0,436549,바베이도스,2007-07
2007-07-31,394523,993,393530,벨리제,2007-07
2007-07-31,388137,0,388137,사모아,2007-07
2007-07-31,378668,4000,374668,앙귈라,2007-07
2007-07-31,362991,322164,40827,기니,2007-07
2007-07-31,361382,50394,310988,보스니아-헤르체고비나,2007-07
2007-07-31,346140,2871,343269,알바니아,2007-07
2007-07-31,321259,0,321259,바누아투,2007-07
2007-07-31,273495,21000,252495,마이크로네시아,2007-07
2007-07-31,271019,0,271019,영령 캐이맨 군도,2007-07
2007-07-31,237698,0,237698,부탄,2007-07
2007-07-31,216108,6688,209420,안티가 바부다,2007-07
2007-07-31,192079,0,192079,불령 가이아나,2007-07
2007-07-31,188314,0,188314,감비아,2007-07
2007-07-31,168003,60,167943,아메리칸 사모아,2007-07
2007-07-31,161436,76558,84878,몰디브,2007-07
2007-07-31,146664,61750,84914,몰도바,2007-07
2007-07-31,112331,1674,110657,니제르,2007-07
2007-07-31,104120,110201,-6081,보츠와나,2007-07
2007-07-31,101134,0,101134,투르크 & 카이코스 군도,2007-07
2007-07-31,100236,0,100236,팔라우,2007-07
2007-07-31,97436,200,97236,지브랄타,2007-07
2007-07-31,94579,1530,93049,에리트리아,2007-07
2007-07-31,79850,20628,59222,세인트 키츠 네비스,2007-07
2007-07-31,58200,0,58200,영령 버진군도,2007-07
2007-07-31,58159,4151,54008,카보 베르데,2007-07
2007-07-31,55210,0,55210,부룬디,2007-07
2007-07-31,54875,7627947,-7573072,나미비아,2007-07
2007-07-31,48041,0,48041,세인트 루시아,2007-07
2007-07-31,45272,267439,-222167,기네비소,2007-07
2007-07-31,34633,0,34633,말리,2007-07
2007-07-31,32813,0,32813,쿡 아일랜드,2007-07
2007-07-31,29695,0,29695,부르키나 파소,2007-07
2007-07-31,18810,0,18810,르완다,2007-07
2007-07-31,14948,560436,-545488,모나코,2007-07
2007-07-31,12346,53,12293,미령 버진군도,2007-07
2007-07-31,10399,3311470,-3301071,솔로몬 군도,2007-07
2007-07-31,6731,0,6731,노폴크 아일랜드,2007-07
2007-07-31,6370,268203,-261833,안도라,2007-07
2007-07-31,5900,0,5900,메요트,2007-07
2007-07-31,5453,45795,-40342,토켈라우,2007-07
2007-07-31,4282,0,4282,챠드,2007-07
2007-07-31,2448,106999,-104551,중앙아프리카공화국,2007-07
2007-07-31,1132,0,1132,그레나다,2007-07
2007-07-31,720,17872,-17152,산마리노,2007-07
2007-07-31,546,0,546,세인트 빈센트 그레나딘,2007-07
2007-07-31,277,0,277,안타티카,2007-07
2007-07-31,200,0,200,키리바티,2007-07
2007-07-31,0,2186,-2186,파로에 군도,2007-07
2007-07-31,0,36456,-36456,세인트 헬레나,2007-07
2007-07-31,0,1667,-1667,크리스마스 아일랜드,2007-07
2007-07-31,0,104328,-104328,그린랜드,2007-07
2007-07-31,0,7,-7,니우에,2007-07
2007-07-31,0,781,-781,세인트 피레 미켈론,2007-07
2007-07-31,0,665,-665,허드 앤 맥도날드 군도,2007-07
2007-07-31,0,59198,-59198,코스 군도,2007-07
2007-07-31,0,52,-52,마이너 아우틀링 합중국 군도,2007-07
2007-07-31,0,5385,-5385,통가,2007-07
2007-08-31,7158117729,5220312661,1937805068,중국,2007-08
2007-08-31,3515831284,3298765133,217066151,미국,2007-08
2007-08-31,2107231025,4604204011,-2496972986,일본,2007-08
2007-08-31,1485644644,199335293,1286309351,홍콩,2007-08
2007-08-31,1209102638,809572089,399530549,대만,2007-08
2007-08-31,888823655,1182109293,-293285638,독일,2007-08
2007-08-31,776457501,572749228,203708273,싱가포르,2007-08
2007-08-31,740780109,71270627,669509482,멕시코,2007-08
2007-08-31,660980963,563991895,96989068,러시아 연방,2007-08
2007-08-31,599053876,780208388,-181154512,인도네시아,2007-08
2007-08-31,579094857,497240138,81854719,인도,2007-08
2007-08-31,487214603,566862040,-79647437,말레이시아,2007-08
2007-08-31,438152722,312718284,125434438,영국,2007-08
2007-08-31,436151650,267373959,168777691,네덜란드,2007-08
2007-08-31,423620563,444497319,-20876756,칠레,2007-08
2007-08-31,422319500,1028612322,-606292822,호주,2007-08
2007-08-31,409134643,102002894,307131749,베트남,2007-08
2007-08-31,398267714,222408599,175859115,필리핀,2007-08
2007-08-31,396612151,25192229,371419922,폴란드,2007-08
2007-08-31,382737754,857169,381880585,나이지리아,2007-08
2007-08-31,359058013,1930738736,-1571680723,사우디아라비아,2007-08
2007-08-31,356399993,286371692,70028301,태국,2007-08
2007-08-31,326051571,1035753168,-709701597,아랍에미리트 연합,2007-08
2007-08-31,305244222,209559566,95684656,브라질,2007-08
2007-08-31,300058452,63884592,236173860,스페인,2007-08
2007-08-31,298391692,35600352,262791340,튀르키예,2007-08
2007-08-31,277321360,412725575,-135404215,프랑스,2007-08
2007-08-31,276137727,270329649,5808078,캐나다,2007-08
2007-08-31,273301419,532222026,-258920607,이란,2007-08
2007-08-31,263902303,11727920,252174383,슬로바키아,2007-08
2007-08-31,251416827,317485694,-66068867,이탈리아,2007-08
2007-08-31,246203350,118330,246085020,라이베리아,2007-08
2007-08-31,223992168,108680398,115311770,벨기에,2007-08
2007-08-31,201946512,520513,201425999,사이프러스,2007-08
2007-08-31,195596036,19634530,175961506,헝가리,2007-08
2007-08-31,173555940,0,173555940,버뮤다,2007-08
2007-08-31,137250882,400,137250482,마샬군도,2007-08
2007-08-31,122609288,736912,121872376,파나마,2007-08
2007-08-31,120884960,46057856,74827104,우크라이나,2007-08
2007-08-31,119727847,92167806,27560041,남아프리카공화국,2007-08
2007-08-31,109916251,24543617,85372634,베네주엘라,2007-08
2007-08-31,107985901,13455,107972446,바하마,2007-08
2007-08-31,106971230,119200314,-12229084,핀란드,2007-08
2007-08-31,100803256,47439993,53363263,이스라엘,2007-08
2007-08-31,99080845,3344530,95736315,그리스,2007-08
2007-08-31,94148972,28524335,65624637,체코공화국,2007-08
2007-08-31,87611718,3642379,83969339,이집트,2007-08
2007-08-31,83611812,10232148,73379664,콜롬비아,2007-08
2007-08-31,80346631,171163526,-90816895,노르웨이,2007-08
2007-08-31,71353360,586879219,-515525859,카타르,2007-08
2007-08-31,71010591,3885358,67125233,우즈베키스탄,2007-08
2007-08-31,70772450,5863083,64909367,루마니아,2007-08
2007-08-31,62351608,77361230,-15009622,알제리,2007-08
2007-08-31,60520445,97414575,-36894130,스웨덴,2007-08
2007-08-31,58997883,91000370,-32002487,뉴질랜드,2007-08
2007-08-31,58089347,8810574,49278773,몰타,2007-08
2007-08-31,56288270,54915124,1373146,아일랜드,2007-08
2007-08-31,53018271,32351651,20666620,카자흐스탄,2007-08
2007-08-31,52722262,29725340,22996922,파키스탄,2007-08
2007-08-31,51248552,17758338,33490214,방글라데시,2007-08
2007-08-31,50916373,187105403,-136189030,스위스,2007-08
2007-08-31,48866593,71519583,-22652990,오스트리아,2007-08
2007-08-31,41544776,1162066,40382710,크로아티아,2007-08
2007-08-31,40358150,79333113,-38974963,아르헨티나,2007-08
2007-08-31,39116465,252598319,-213481854,오만,2007-08
2007-08-31,37953373,631321838,-593368465,쿠웨이트,2007-08
2007-08-31,37945270,112623922,-74678652,페루,2007-08
2007-08-31,35576157,916567,34659590,시리아,2007-08
2007-08-31,34586623,485986,34100637,쿠바,2007-08
2007-08-31,34336836,20833444,13503392,모로코,2007-08
2007-08-31,32913371,3523114,29390257,에쿠아도르,2007-08
2007-08-31,32877461,7927043,24950418,요르단,2007-08
2007-08-31,31055301,15216141,15839160,포루투갈,2007-08
2007-08-31,30792180,234248,30557932,리비아,2007-08
2007-08-31,28515268,2456084,26059184,슬로베니아,2007-08
2007-08-31,27980681,16881439,11099242,바레인,2007-08
2007-08-31,23902015,6395295,17506720,기타국,2007-08
2007-08-31,23138240,59479084,-36340844,덴마크,2007-08
2007-08-31,21926931,11904902,10022029,코스타리카,2007-08
2007-08-31,21753733,1057172,20696561,과테말라,2007-08
2007-08-31,21419801,1634449,19785352,캄보디아,2007-08
2007-08-31,20297380,199419965,-179122585,이라크,2007-08
2007-08-31,18550597,42374,18508223,아프카니스탄,2007-08
2007-08-31,16751732,0,16751732,아제르바이잔,2007-08
2007-08-31,16197488,2384987,13812501,몽골,2007-08
2007-08-31,15489803,4588574,10901229,스리랑카,2007-08
2007-08-31,14869784,69843972,-54974188,앙골라,2007-08
2007-08-31,13809188,836053,12973135,가나,2007-08
2007-08-31,13085810,61313,13024497,케냐,2007-08
2007-08-31,13058052,137906,12920146,키르기스스탄,2007-08
2007-08-31,12120316,694832,11425484,리투아니아,2007-08
2007-08-31,11967538,4075874,7891664,불가리아,2007-08
2007-08-31,11919790,1878388,10041402,라트비아,2007-08
2007-08-31,10422369,2342583,8079786,온두라스,2007-08
2007-08-31,10082879,40979674,-30896795,수단,2007-08
2007-08-31,10075232,2129286,7945946,튀니지,2007-08
2007-08-31,9851917,9831,9842086,니카라과,2007-08
2007-08-31,9780217,3559533,6220684,레바논,2007-08
2007-08-31,9227016,108950,9118066,예맨,2007-08
2007-08-31,8444101,32974159,-24530058,도미니카 공화국,2007-08
2007-08-31,8262329,4277960,3984369,미얀마,2007-08
2007-08-31,7972634,1377454,6595180,에스토니아,2007-08
2007-08-31,6870576,219158,6651418,파라과이,2007-08
2007-08-31,6766246,622746,6143500,트리니다드 토바고,2007-08
2007-08-31,6506091,14378598,-7872507,푸에르토리코,2007-08
2007-08-31,6418713,10427,6408286,코트디봐르,2007-08
2007-08-31,6353100,3613637,2739463,우루과이,2007-08
2007-08-31,5862906,553019,5309887,엘살바도르,2007-08
2007-08-31,5286770,179364,5107406,탄자니아,2007-08
2007-08-31,4544502,11661963,-7117461,라오스,2007-08
2007-08-31,4080247,192940,3887307,조지아,2007-08
2007-08-31,3679958,144538,3535420,모리셔스,2007-08
2007-08-31,3602356,0,3602356,불령 리유니온 코모도 제도,2007-08
2007-08-31,3517369,95508,3421861,모리타니,2007-08
2007-08-31,3500257,30948,3469309,괌,2007-08
2007-08-31,3409059,85762,3323297,콩고,2007-08
2007-08-31,3076001,45022,3030979,뉴 칼레도니아,2007-08
2007-08-31,3072355,1119879,1952476,아이슬란드,2007-08
2007-08-31,3036010,513808,2522202,세네갈,2007-08
2007-08-31,2859710,195207,2664503,마다카스카르,2007-08
2007-08-31,2664442,568240,2096202,베닝,2007-08
2007-08-31,2400041,432772,1967269,토고,2007-08
2007-08-31,2336042,0,2336042,마티니크,2007-08
2007-08-31,2321441,0,2321441,유고,2007-08
2007-08-31,2145576,222845,1922731,모잠비크,2007-08
2007-08-31,2106184,0,2106184,지부티,2007-08
2007-08-31,2082201,2067708,14493,콩고민주공화국,2007-08
2007-08-31,2032338,3903784,-1871446,스와질랜드,2007-08
2007-08-31,2019655,2893655,-874000,타지크,2007-08
2007-08-31,1992676,0,1992676,부르키나 파소,2007-08
2007-08-31,1978015,269807,1708208,카메룬,2007-08
2007-08-31,1963041,2491570,-528529,벨라루스,2007-08
2007-08-31,1959114,10145,1948969,피지,2007-08
2007-08-31,1919586,6973968,-5054382,아메리칸 사모아,2007-08
2007-08-31,1884280,833959,1050321,세르비아 와 몬테네그로,2007-08
2007-08-31,1813220,40159,1773061,북마리아나 군도,2007-08
2007-08-31,1805155,619368,1185787,마카오,2007-08
2007-08-31,1731456,4529975,-2798519,룩셈부르그,2007-08
2007-08-31,1723929,1803788,-79859,나우루,2007-08
2007-08-31,1677968,87680400,-86002432,브루나이,2007-08
2007-08-31,1593608,937716,655892,파푸아 뉴기니,2007-08
2007-08-31,1520688,29359,1491329,네덜란드 열도,2007-08
2007-08-31,1514695,3261,1511434,불령 폴리네시아,2007-08
2007-08-31,1483550,10597,1472953,보스니아-헤르체고비나,2007-08
2007-08-31,1465410,136685,1328725,자마이카,2007-08
2007-08-31,1364508,0,1364508,과델로프,2007-08
2007-08-31,1361374,58430,1302944,네팔,2007-08
2007-08-31,1353600,0,1353600,레소토,2007-08
2007-08-31,1246039,68735,1177304,팔레스타인 해방기구(구),2007-08
2007-08-31,1231038,993749,237289,에티오피아,2007-08
2007-08-31,1125529,172553,952976,투르크멘,2007-08
2007-08-31,991564,2362,989202,아이티,2007-08
2007-08-31,952991,102,952889,도미니카,2007-08
2007-08-31,921041,362548,558493,마세도니아,2007-08
2007-08-31,845525,39905,805620,아르메니아,2007-08
2007-08-31,844572,0,844572,에리트리아,2007-08
2007-08-31,841019,0,841019,수리남,2007-08
2007-08-31,832744,620177,212567,기니,2007-08
2007-08-31,829779,0,829779,아루바,2007-08
2007-08-31,825686,59042,766644,세이쉘,2007-08
2007-08-31,714533,15465,699068,사모아,2007-08
2007-08-31,714319,4532,709787,바베이도스,2007-08
2007-08-31,669344,0,669344,가이아나,2007-08
2007-08-31,654595,6544,648051,알바니아,2007-08
2007-08-31,642248,51810,590438,몰도바,2007-08
2007-08-31,616036,21000,595036,마이크로네시아,2007-08
2007-08-31,531171,64881087,-64349916,잠비아,2007-08
2007-08-31,462454,149962,312492,말라위,2007-08
2007-08-31,382848,4029499,-3646651,볼리비아,2007-08
2007-08-31,374781,24900,349881,시에라 리온,2007-08
2007-08-31,368191,6161,362030,몰디브,2007-08
2007-08-31,360384,0,360384,바누아투,2007-08
2007-08-31,357226,0,357226,부탄,2007-08
2007-08-31,356133,0,356133,앙귈라,2007-08
2007-08-31,341799,0,341799,감비아,2007-08
2007-08-31,288098,323288,-35190,우간다,2007-08
2007-08-31,278987,163454,115533,가봉,2007-08
2007-08-31,253974,7823,246151,안도라,2007-08
2007-08-31,232678,547445,-314767,리히텐슈타인,2007-08
2007-08-31,226672,30616,196056,팔라우,2007-08
2007-08-31,226108,1241252,-1015144,짐바브웨,2007-08
2007-08-31,218271,107959,110312,보츠와나,2007-08
2007-08-31,216959,129709,87250,벨리제,2007-08
2007-08-31,213239,176,213063,불령 가이아나,2007-08
2007-08-31,205177,0,205177,안티가 바부다,2007-08
2007-08-31,156844,0,156844,그레나다,2007-08
2007-08-31,122740,806671,-683931,나미비아,2007-08
2007-08-31,119581,0,119581,르완다,2007-08
2007-08-31,98050,0,98050,영령 캐이맨 군도,2007-08
2007-08-31,95176,0,95176,적도 기니,2007-08
2007-08-31,90108,1236477,-1146369,솔로몬 군도,2007-08
2007-08-31,75887,429,75458,세인트 루시아,2007-08
2007-08-31,70710,0,70710,니제르,2007-08
2007-08-31,62403,4762,57641,카보 베르데,2007-08
2007-08-31,61125,27808,33317,말리,2007-08
2007-08-31,51456,0,51456,쿡 아일랜드,2007-08
2007-08-31,37387,270483,-233096,모나코,2007-08
2007-08-31,34346,0,34346,메요트,2007-08
2007-08-31,20084,0,20084,키리바티,2007-08
2007-08-31,17960,29868,-11908,토켈라우,2007-08
2007-08-31,7114,0,7114,부룬디,2007-08
2007-08-31,6289,0,6289,티모르,2007-08
2007-08-31,5856,0,5856,미령 버진군도,2007-08
2007-08-31,4677,0,4677,지브랄타,2007-08
2007-08-31,1956,0,1956,통가,2007-08
2007-08-31,1654,0,1654,챠드,2007-08
2007-08-31,1492,0,1492,노폴크 아일랜드,2007-08
2007-08-31,0,229980,-229980,기네비소,2007-08
2007-08-31,0,1557,-1557,산마리노,2007-08
2007-08-31,0,164555,-164555,크리스마스 아일랜드,2007-08
2007-08-31,0,5689,-5689,세인트 키츠 네비스,2007-08
2007-08-31,0,3882,-3882,세인트 헬레나,2007-08
2007-08-31,0,169,-169,코스 군도,2007-08
2007-08-31,0,18570,-18570,중앙아프리카공화국,2007-08
2007-08-31,0,4375,-4375,상토메 프린스페,2007-08
2007-08-31,0,142,-142,세인트 피레 미켈론,2007-08
2007-08-31,0,241,-241,투르크 & 카이코스 군도,2007-08
2007-09-30,7034110548,5010559305,2023551243,중국,2007-09
2007-09-30,3212919142,2546986096,665933046,미국,2007-09
2007-09-30,1972487840,4276815502,-2304327662,일본,2007-09
2007-09-30,1561123206,194429152,1366694054,홍콩,2007-09
2007-09-30,1145550603,537861890,607688713,싱가포르,2007-09
2007-09-30,949502867,753502829,196000038,대만,2007-09
2007-09-30,799194890,990900533,-191705643,독일,2007-09
2007-09-30,787531486,84066255,703465231,멕시코,2007-09
2007-09-30,631604873,501265361,130339512,러시아 연방,2007-09
2007-09-30,597081757,280349515,316732242,영국,2007-09
2007-09-30,568720713,286262135,282458578,인도,2007-09
2007-09-30,505003604,92241240,412762364,베트남,2007-09
2007-09-30,474610899,767522709,-292911810,인도네시아,2007-09
2007-09-30,471176993,588681203,-117504210,말레이시아,2007-09
2007-09-30,405683115,1033833144,-628150029,호주,2007-09
2007-09-30,392911358,13194742,379716616,튀르키예,2007-09
2007-09-30,333440801,274225791,59215010,프랑스,2007-09
2007-09-30,332074754,190655541,141419213,필리핀,2007-09
2007-09-30,328662219,315088085,13574134,태국,2007-09
2007-09-30,318032558,372103331,-54070773,이란,2007-09
2007-09-30,316480292,19778853,296701439,폴란드,2007-09
2007-09-30,308763540,325574865,-16811325,칠레,2007-09
2007-09-30,305306469,172899030,132407439,브라질,2007-09
2007-09-30,300916271,1072656672,-771740401,아랍에미리트 연합,2007-09
2007-09-30,299861782,188651697,111210085,네덜란드,2007-09
2007-09-30,269699900,73911904,195787996,스페인,2007-09
2007-09-30,264149083,1750881568,-1486732485,사우디아라비아,2007-09
2007-09-30,251450132,839,251449293,마샬군도,2007-09
2007-09-30,250151064,218732966,31418098,캐나다,2007-09
2007-09-30,243764691,4052733,239711958,슬로바키아,2007-09
2007-09-30,215648141,250521960,-34873819,이탈리아,2007-09
2007-09-30,178857667,85484039,93373628,벨기에,2007-09
2007-09-30,166439052,21018898,145420154,헝가리,2007-09
2007-09-30,161670049,68696414,92973635,파나마,2007-09
2007-09-30,137260293,67986,137192307,라이베리아,2007-09
2007-09-30,135892473,138331233,-2438760,남아프리카공화국,2007-09
2007-09-30,127382869,82232053,45150816,우크라이나,2007-09
2007-09-30,116566390,881435930,-764869540,쿠웨이트,2007-09
2007-09-30,110595650,673223168,-562627518,카타르,2007-09
2007-09-30,106628351,6424655,100203696,베네주엘라,2007-09
2007-09-30,97146392,72686995,24459397,아일랜드,2007-09
2007-09-30,96313965,9259549,87054416,콜롬비아,2007-09
2007-09-30,96281574,569942,95711632,나이지리아,2007-09
2007-09-30,78457900,92955176,-14497276,핀란드,2007-09
2007-09-30,78067453,54207120,23860333,이집트,2007-09
2007-09-30,74658170,40535035,34123135,이스라엘,2007-09
2007-09-30,69322848,27281345,42041503,체코공화국,2007-09
2007-09-30,64557139,28246471,36310668,우즈베키스탄,2007-09
2007-09-30,62550212,11113012,51437200,루마니아,2007-09
2007-09-30,58411308,93270912,-34859604,스웨덴,2007-09
2007-09-30,55910864,64692043,-8781179,뉴질랜드,2007-09
2007-09-30,55477350,45926083,9551267,덴마크,2007-09
2007-09-30,54711192,304971694,-250260502,오만,2007-09
2007-09-30,53814792,12520563,41294229,사이프러스,2007-09
2007-09-30,52908347,1230666,51677681,알제리,2007-09
2007-09-30,52234833,85405259,-33170426,파키스탄,2007-09
2007-09-30,48922722,523288,48399434,시리아,2007-09
2007-09-30,48518024,5505913,43012111,방글라데시,2007-09
2007-09-30,48003561,10068009,37935552,카자흐스탄,2007-09
2007-09-30,40033504,25102124,14931380,아르헨티나,2007-09
2007-09-30,39261974,2832053,36429921,슬로베니아,2007-09
2007-09-30,38212543,53211295,-14998752,오스트리아,2007-09
2007-09-30,35625131,2186017,33439114,에쿠아도르,2007-09
2007-09-30,35100227,3263972,31836255,그리스,2007-09
2007-09-30,34456958,0,34456958,바하마,2007-09
2007-09-30,32575798,5431578,27144220,포루투갈,2007-09
2007-09-30,30052201,17435408,12616793,페루,2007-09
2007-09-30,29780065,170513616,-140733551,스위스,2007-09
2007-09-30,28864429,6251962,22612467,모로코,2007-09
2007-09-30,28295685,4749411,23546274,요르단,2007-09
2007-09-30,25550485,110715,25439770,리비아,2007-09
2007-09-30,25171003,255150,24915853,과테말라,2007-09
2007-09-30,23446363,22056,23424307,괌,2007-09
2007-09-30,23270269,575247,22695022,캄보디아,2007-09
2007-09-30,18460692,7300613,11160079,코스타리카,2007-09
2007-09-30,18299840,69308616,-51008776,앙골라,2007-09
2007-09-30,18218403,507642,17710761,수단,2007-09
2007-09-30,18211069,11374121,6836948,푸에르토리코,2007-09
2007-09-30,17216156,2504183,14711973,불가리아,2007-09
2007-09-30,17167074,7580416,9586658,몰타,2007-09
2007-09-30,16389308,0,16389308,아제르바이잔,2007-09
2007-09-30,16120248,364282050,-348161802,이라크,2007-09
2007-09-30,15856438,99724,15756714,쿠바,2007-09
2007-09-30,15345691,3554035,11791656,기타국,2007-09
2007-09-30,15123823,4019967,11103856,몽골,2007-09
2007-09-30,14965276,2220015,12745261,가나,2007-09
2007-09-30,14359110,4803064,9556046,스리랑카,2007-09
2007-09-30,13854824,83512923,-69658099,노르웨이,2007-09
2007-09-30,12712914,5507860,7205054,미얀마,2007-09
2007-09-30,11957643,49840598,-37882955,바레인,2007-09
2007-09-30,11274991,2983061,8291930,레바논,2007-09
2007-09-30,10351154,51300,10299854,키르기스스탄,2007-09
2007-09-30,10329221,916,10328305,아프카니스탄,2007-09
2007-09-30,10223173,76140,10147033,니카라과,2007-09
2007-09-30,10219829,90419,10129410,에티오피아,2007-09
2007-09-30,9906380,565415,9340965,도미니카 공화국,2007-09
2007-09-30,9465631,149393,9316238,온두라스,2007-09
2007-09-30,9002782,639829,8362953,크로아티아,2007-09
2007-09-30,8907154,514581,8392573,케냐,2007-09
2007-09-30,8459959,536380,7923579,리투아니아,2007-09
2007-09-30,7187488,487945,6699543,에스토니아,2007-09
2007-09-30,7172219,1703933,5468286,라트비아,2007-09
2007-09-30,6989006,1156570,5832436,튀니지,2007-09
2007-09-30,6957231,336057,6621174,엘살바도르,2007-09
2007-09-30,6908722,205417,6703305,파라과이,2007-09
2007-09-30,5833516,440197,5393319,탄자니아,2007-09
2007-09-30,5602372,386349,5216023,예맨,2007-09
2007-09-30,4950524,1779085,3171439,세네갈,2007-09
2007-09-30,4710677,1946374,2764303,우루과이,2007-09
2007-09-30,4584231,185213,4399018,뉴 칼레도니아,2007-09
2007-09-30,4052779,169172,3883607,조지아,2007-09
2007-09-30,4038508,1361,4037147,레소토,2007-09
2007-09-30,3846695,3045157,801538,트리니다드 토바고,2007-09
2007-09-30,3812140,1579193,2232947,아이슬란드,2007-09
2007-09-30,3791771,0,3791771,과델로프,2007-09
2007-09-30,3448887,3074492,374395,라오스,2007-09
2007-09-30,3297738,51802,3245936,유고,2007-09
2007-09-30,3122454,648648,2473806,모잠비크,2007-09
2007-09-30,3098286,1884,3096402,코트디봐르,2007-09
2007-09-30,2798659,145466,2653193,베닝,2007-09
2007-09-30,2626303,0,2626303,마티니크,2007-09
2007-09-30,2613802,12017,2601785,콩고민주공화국,2007-09
2007-09-30,2542908,0,2542908,토고,2007-09
2007-09-30,2490287,996778,1493509,마카오,2007-09
2007-09-30,2475612,1149285,1326327,벨라루스,2007-09
2007-09-30,2317892,226858,2091034,모리셔스,2007-09
2007-09-30,2278745,181775,2096970,카메룬,2007-09
2007-09-30,2257248,102190,2155058,자마이카,2007-09
2007-09-30,2213021,45625960,-43412939,잠비아,2007-09
2007-09-30,2045376,1073,2044303,북마리아나 군도,2007-09
2007-09-30,2023038,651,2022387,불령 리유니온 코모도 제도,2007-09
2007-09-30,2008683,48974,1959709,불령 폴리네시아,2007-09
2007-09-30,1924757,984320,940437,나우루,2007-09
2007-09-30,1834614,942689,891925,타지크,2007-09
2007-09-30,1797194,93917,1703277,아르메니아,2007-09
2007-09-30,1765009,395854,1369155,마다카스카르,2007-09
2007-09-30,1711700,6444,1705256,네덜란드 열도,2007-09
2007-09-30,1598252,40691821,-39093569,브루나이,2007-09
2007-09-30,1582925,0,1582925,콩고,2007-09
2007-09-30,1558051,3456092,-1898041,룩셈부르그,2007-09
2007-09-30,1511782,103201,1408581,네팔,2007-09
2007-09-30,1461405,100195,1361210,세르비아 와 몬테네그로,2007-09
2007-09-30,1379610,70487,1309123,아이티,2007-09
2007-09-30,1257842,16083,1241759,바베이도스,2007-09
2007-09-30,1157004,8297,1148707,알바니아,2007-09
2007-09-30,1033989,34903248,-33869259,파푸아 뉴기니,2007-09
2007-09-30,1025748,361644,664104,피지,2007-09
2007-09-30,978854,0,978854,몰디브,2007-09
2007-09-30,956883,22764,934119,투르크멘,2007-09
2007-09-30,947015,417272,529743,기니,2007-09
2007-09-30,924301,158738,765563,아루바,2007-09
2007-09-30,903202,108755,794447,보스니아-헤르체고비나,2007-09
2007-09-30,838183,7737,830446,마세도니아,2007-09
2007-09-30,835311,1962457,-1127146,볼리비아,2007-09
2007-09-30,830878,416958,413920,몰도바,2007-09
2007-09-30,824498,1219888,-395390,스와질랜드,2007-09
2007-09-30,641681,7740486,-7098805,가봉,2007-09
2007-09-30,631776,0,631776,지부티,2007-09
2007-09-30,597267,1174501,-577234,우간다,2007-09
2007-09-30,592092,62388,529704,팔레스타인 해방기구(구),2007-09
2007-09-30,554302,0,554302,불령 가이아나,2007-09
2007-09-30,518241,370,517871,세이쉘,2007-09
2007-09-30,485846,77682,408164,도미니카,2007-09
2007-09-30,475286,33096,442190,사모아,2007-09
2007-09-30,445408,500,444908,버뮤다,2007-09
2007-09-30,437778,89270,348508,니제르,2007-09
2007-09-30,416641,67058,349583,모리타니,2007-09
2007-09-30,416473,64996,351477,수리남,2007-09
2007-09-30,389400,0,389400,에리트리아,2007-09
2007-09-30,386499,0,386499,영령 버진군도,2007-09
2007-09-30,378311,328158,50153,리히텐슈타인,2007-09
2007-09-30,324811,33110,291701,마이크로네시아,2007-09
2007-09-30,323953,23746,300207,시에라 리온,2007-09
2007-09-30,278854,0,278854,가이아나,2007-09
2007-09-30,274565,154562,120003,아메리칸 사모아,2007-09
2007-09-30,260407,4567,255840,부탄,2007-09
2007-09-30,245838,265699,-19861,벨리제,2007-09
2007-09-30,234763,23078,211685,바누아투,2007-09
2007-09-30,223406,0,223406,감비아,2007-09
2007-09-30,197469,1998244,-1800775,솔로몬 군도,2007-09
2007-09-30,196219,357471,-161252,모나코,2007-09
2007-09-30,186034,0,186034,부르키나 파소,2007-09
2007-09-30,152849,160105,-7256,보츠와나,2007-09
2007-09-30,149185,0,149185,세인트 루시아,2007-09
2007-09-30,137846,527122,-389276,짐바브웨,2007-09
2007-09-30,104358,182827,-78469,기네비소,2007-09
2007-09-30,91385,0,91385,그레나다,2007-09
2007-09-30,80614,7550270,-7469656,나미비아,2007-09
2007-09-30,78002,866,77136,말리,2007-09
2007-09-30,75246,22966,52280,영령 캐이맨 군도,2007-09
2007-09-30,74186,70315,3871,안티가 바부다,2007-09
2007-09-30,69265,205257,-135992,말라위,2007-09
2007-09-30,67676,0,67676,투르크 & 카이코스 군도,2007-09
2007-09-30,56903,0,56903,쿡 아일랜드,2007-09
2007-09-30,49179,0,49179,팔라우,2007-09
2007-09-30,40631,227,40404,세인트 빈센트 그레나딘,2007-09
2007-09-30,39220,0,39220,앙귈라,2007-09
2007-09-30,35069,117014,-81945,카보 베르데,2007-09
2007-09-30,25204,0,25204,르완다,2007-09
2007-09-30,20982,0,20982,적도 기니,2007-09
2007-09-30,18959,0,18959,안타티카,2007-09
2007-09-30,18424,10292,8132,산마리노,2007-09
2007-09-30,15587,0,15587,메요트,2007-09
2007-09-30,8053,0,8053,지브랄타,2007-09
2007-09-30,2480,0,2480,부룬디,2007-09
2007-09-30,1800,127,1673,챠드,2007-09
2007-09-30,329,0,329,티모르,2007-09
2007-09-30,0,202,-202,파로에 군도,2007-09
2007-09-30,0,2,-2,남조지아 & 남샌드위치 군도,2007-09
2007-09-30,0,5260,-5260,안도라,2007-09
2007-09-30,0,176,-176,코스 군도,2007-09
2007-09-30,0,24720,-24720,그린랜드,2007-09
2007-09-30,0,9416,-9416,피트카이른,2007-09
2007-09-30,0,41,-41,상토메 프린스페,2007-09
2007-09-30,0,2020,-2020,세인트 키츠 네비스,2007-09
2007-09-30,0,310,-310,교황청,2007-09
2007-09-30,0,166,-166,니우에,2007-09
2007-10-31,7740782030,5940532061,1800249969,중국,2007-10
2007-10-31,4224090392,3344996900,879093492,미국,2007-10
2007-10-31,2361917716,5189952837,-2828035121,일본,2007-10
2007-10-31,1866502508,196472034,1670030474,홍콩,2007-10
2007-10-31,1209826059,724617863,485208196,싱가포르,2007-10
2007-10-31,1059831107,1026314019,33517088,대만,2007-10
2007-10-31,883877611,90666074,793211537,멕시코,2007-10
2007-10-31,837509389,1301809762,-464300373,독일,2007-10
2007-10-31,813843436,434804939,379038497,러시아 연방,2007-10
2007-10-31,654057289,753575898,-99518609,말레이시아,2007-10
2007-10-31,620008826,341206937,278801889,영국,2007-10
2007-10-31,568306194,388171190,180135004,인도,2007-10
2007-10-31,567489139,134485476,433003663,베트남,2007-10
2007-10-31,485959882,1163845037,-677885155,호주,2007-10
2007-10-31,471250621,18714232,452536389,파나마,2007-10
2007-10-31,452547761,321085038,131462723,이탈리아,2007-10
2007-10-31,426442058,243007756,183434302,네덜란드,2007-10
2007-10-31,426082686,245745913,180336773,필리핀,2007-10
2007-10-31,418328248,267335886,150992362,캐나다,2007-10
2007-10-31,415537110,1724544923,-1309007813,사우디아라비아,2007-10
2007-10-31,401530685,375878303,25652382,프랑스,2007-10
2007-10-31,383364095,41327904,342036191,튀르키예,2007-10
2007-10-31,377526274,291573840,85952434,브라질,2007-10
2007-10-31,372683168,342711347,29971821,태국,2007-10
2007-10-31,364511643,29878058,334633585,폴란드,2007-10
2007-10-31,353902844,813040722,-459137878,인도네시아,2007-10
2007-10-31,352397922,62991882,289406040,스페인,2007-10
2007-10-31,336697668,692644160,-355946492,이란,2007-10
2007-10-31,323754831,1338039500,-1014284669,아랍에미리트 연합,2007-10
2007-10-31,279232602,346477850,-67245248,칠레,2007-10
2007-10-31,260562706,4780235,255782471,슬로바키아,2007-10
2007-10-31,215526006,24702157,190823849,헝가리,2007-10
2007-10-31,201249755,105807602,95442153,벨기에,2007-10
2007-10-31,174666518,151832591,22833927,노르웨이,2007-10
2007-10-31,163778975,182592542,-18813567,남아프리카공화국,2007-10
2007-10-31,149477542,2844155,146633387,우크라이나,2007-10
2007-10-31,147353756,87374058,59979698,핀란드,2007-10
2007-10-31,129723645,7674851,122048794,베네주엘라,2007-10
2007-10-31,121988217,68825913,53162304,아일랜드,2007-10
2007-10-31,114501732,76349084,38152648,이스라엘,2007-10
2007-10-31,110662303,10916195,99746108,콜롬비아,2007-10
2007-10-31,108569954,46074635,62495319,나이지리아,2007-10
2007-10-31,106022949,734094112,-628071163,카타르,2007-10
2007-10-31,100947886,15035049,85912837,몰타,2007-10
2007-10-31,93706582,33207997,60498585,체코공화국,2007-10
2007-10-31,90950814,83716082,7234732,오스트리아,2007-10
2007-10-31,86143493,3418380,82725113,이집트,2007-10
2007-10-31,80076879,111163958,-31087079,스웨덴,2007-10
2007-10-31,73158285,6209409,66948876,루마니아,2007-10
2007-10-31,72757629,300967398,-228209769,오만,2007-10
2007-10-31,72014925,88646050,-16631125,뉴질랜드,2007-10
2007-10-31,65131149,470714,64660435,과테말라,2007-10
2007-10-31,62769404,2495921,60273483,우즈베키스탄,2007-10
2007-10-31,61000809,32286648,28714161,파키스탄,2007-10
2007-10-31,58936482,173029396,-114092914,알제리,2007-10
2007-10-31,58325706,20280621,38045085,카자흐스탄,2007-10
2007-10-31,56413106,831628263,-775215157,쿠웨이트,2007-10
2007-10-31,53986447,18692724,35293723,방글라데시,2007-10
2007-10-31,53230648,3135238,50095410,에쿠아도르,2007-10
2007-10-31,51848946,19289661,32559285,그리스,2007-10
2007-10-31,49840741,1004939,48835802,시리아,2007-10
2007-10-31,46009401,1035216,44974185,크로아티아,2007-10
2007-10-31,45689336,77844806,-32155470,아르헨티나,2007-10
2007-10-31,45528125,170379094,-124850969,페루,2007-10
2007-10-31,43332023,3337432,39994591,슬로베니아,2007-10
2007-10-31,40981233,59171460,-18190227,덴마크,2007-10
2007-10-31,40929631,182336006,-141406375,스위스,2007-10
2007-10-31,39185031,9497095,29687936,모로코,2007-10
2007-10-31,36239558,100454,36139104,라이베리아,2007-10
2007-10-31,35013123,417997,34595126,캄보디아,2007-10
2007-10-31,34923430,51224372,-16300942,바레인,2007-10
2007-10-31,33736097,2764734,30971363,요르단,2007-10
2007-10-31,32699407,170866,32528541,쿠바,2007-10
2007-10-31,32491593,1322601,31168992,리비아,2007-10
2007-10-31,32356454,6187585,26168869,포루투갈,2007-10
2007-10-31,32060148,10383,32049765,바하마,2007-10
2007-10-31,27314823,9583473,17731350,코스타리카,2007-10
2007-10-31,24266011,361774414,-337508403,이라크,2007-10
2007-10-31,22294924,3891690,18403234,스리랑카,2007-10
2007-10-31,22199042,3103204,19095838,불가리아,2007-10
2007-10-31,22090144,0,22090144,앙골라,2007-10
2007-10-31,20459127,1053343,19405784,몽골,2007-10
2007-10-31,17686039,0,17686039,마샬군도,2007-10
2007-10-31,16154401,3992487,12161914,가나,2007-10
2007-10-31,14528288,53320331,-38792043,예맨,2007-10
2007-10-31,14306981,8041014,6265967,가봉,2007-10
2007-10-31,13869545,273228,13596317,아제르바이잔,2007-10
2007-10-31,12975801,449,12975352,아프카니스탄,2007-10
2007-10-31,12336441,2259635,10076806,튀니지,2007-10
2007-10-31,12193705,3136549,9057156,기타국,2007-10
2007-10-31,12191095,998963,11192132,리투아니아,2007-10
2007-10-31,11906465,19712889,-7806424,푸에르토리코,2007-10
2007-10-31,11618444,1445099,10173345,온두라스,2007-10
2007-10-31,11410765,744215,10666550,수단,2007-10
2007-10-31,11116845,638430,10478415,케냐,2007-10
2007-10-31,11058842,3243587,7815255,레바논,2007-10
2007-10-31,11040565,75249,10965316,키르기스스탄,2007-10
2007-10-31,10797851,584779,10213072,엘살바도르,2007-10
2007-10-31,10724104,139545,10584559,니카라과,2007-10
2007-10-31,9798501,2047348,7751153,라트비아,2007-10
2007-10-31,8905497,10366683,-1461186,미얀마,2007-10
2007-10-31,8824872,879293,7945579,도미니카 공화국,2007-10
2007-10-31,7977643,3398594,4579049,라오스,2007-10
2007-10-31,7235519,303493,6932026,파라과이,2007-10
2007-10-31,7114750,715703,6399047,에티오피아,2007-10
2007-10-31,6966857,3597258,3369599,우루과이,2007-10
2007-10-31,6731926,34274,6697652,탄자니아,2007-10
2007-10-31,6664916,1784190,4880726,에스토니아,2007-10
2007-10-31,5636568,10805408,-5168840,트리니다드 토바고,2007-10
2007-10-31,5536776,0,5536776,코트디봐르,2007-10
2007-10-31,5485405,485411,4999994,사이프러스,2007-10
2007-10-31,5014461,241972,4772489,뉴 칼레도니아,2007-10
2007-10-31,4739729,1733656,3006073,아이슬란드,2007-10
2007-10-31,4677355,0,4677355,마티니크,2007-10
2007-10-31,4416117,26473,4389644,유고,2007-10
2007-10-31,4205860,84396,4121464,괌,2007-10
2007-10-31,4114499,0,4114499,베닝,2007-10
2007-10-31,3941664,70,3941594,콩고민주공화국,2007-10
2007-10-31,3618319,106959203,-103340884,브루나이,2007-10
2007-10-31,3522844,4801613,-1278769,룩셈부르그,2007-10
2007-10-31,3453965,0,3453965,불령 리유니온 코모도 제도,2007-10
2007-10-31,3393750,0,3393750,콩고,2007-10
2007-10-31,3392330,632693,2759637,모리셔스,2007-10
2007-10-31,3348746,0,3348746,모잠비크,2007-10
2007-10-31,3055395,278819,2776576,카메룬,2007-10
2007-10-31,2846703,649413,2197290,벨라루스,2007-10
2007-10-31,2682243,565081,2117162,마카오,2007-10
2007-10-31,2521280,0,2521280,타지크,2007-10
2007-10-31,2474288,0,2474288,토고,2007-10
2007-10-31,2421823,593240,1828583,세네갈,2007-10
2007-10-31,2311837,0,2311837,나우루,2007-10
2007-10-31,2275985,90401,2185584,세르비아 와 몬테네그로,2007-10
2007-10-31,2119946,151584,1968362,마다카스카르,2007-10
2007-10-31,2059243,425240,1634003,자마이카,2007-10
2007-10-31,2035853,5185,2030668,북마리아나 군도,2007-10
2007-10-31,1998876,1085754,913122,파푸아 뉴기니,2007-10
2007-10-31,1983383,530029,1453354,피지,2007-10
2007-10-31,1961925,15751,1946174,마세도니아,2007-10
2007-10-31,1897499,220540,1676959,조지아,2007-10
2007-10-31,1894142,47433060,-45538918,잠비아,2007-10
2007-10-31,1728118,26841,1701277,레소토,2007-10
2007-10-31,1695661,4245073,-2549412,스와질랜드,2007-10
2007-10-31,1519700,0,1519700,과델로프,2007-10
2007-10-31,1418095,101962,1316133,보스니아-헤르체고비나,2007-10
2007-10-31,1345611,55669,1289942,네팔,2007-10
2007-10-31,1343777,32129064,-30785287,볼리비아,2007-10
2007-10-31,1301779,617,1301162,말라위,2007-10
2007-10-31,1298650,129587,1169063,아르메니아,2007-10
2007-10-31,1256454,0,1256454,지부티,2007-10
2007-10-31,1183342,110401,1072941,불령 폴리네시아,2007-10
2007-10-31,1152260,0,1152260,아메리칸 사모아,2007-10
2007-10-31,1151762,0,1151762,세이쉘,2007-10
2007-10-31,1147252,500739,646513,우간다,2007-10
2007-10-31,1143239,2319,1140920,아이티,2007-10
2007-10-31,1140465,158295,982170,몰도바,2007-10
2007-10-31,1043337,122062,921275,벨리제,2007-10
2007-10-31,1039829,138423,901406,아루바,2007-10
2007-10-31,954134,421610,532524,기니,2007-10
2007-10-31,866451,82250,784201,네덜란드 열도,2007-10
2007-10-31,839466,13437,826029,도미니카,2007-10
2007-10-31,793685,0,793685,에리트리아,2007-10
2007-10-31,719445,0,719445,바베이도스,2007-10
2007-10-31,676054,904160,-228106,짐바브웨,2007-10
2007-10-31,664908,0,664908,버뮤다,2007-10
2007-10-31,655739,84351,571388,투르크멘,2007-10
2007-10-31,655179,835788,-180609,팔레스타인 해방기구(구),2007-10
2007-10-31,633878,0,633878,수리남,2007-10
2007-10-31,594447,0,594447,영령 캐이맨 군도,2007-10
2007-10-31,588174,0,588174,불령 가이아나,2007-10
2007-10-31,520487,1192544,-672057,알바니아,2007-10
2007-10-31,447814,55499,392315,바누아투,2007-10
2007-10-31,419875,393021,26854,모리타니,2007-10
2007-10-31,397899,68455,329444,몰디브,2007-10
2007-10-31,396363,442,395921,시에라 리온,2007-10
2007-10-31,393336,693218,-299882,리히텐슈타인,2007-10
2007-10-31,364451,15445,349006,가이아나,2007-10
2007-10-31,315311,5552,309759,팔라우,2007-10
2007-10-31,306618,25325,281293,사모아,2007-10
2007-10-31,297829,3588,294241,감비아,2007-10
2007-10-31,278450,0,278450,부탄,2007-10
2007-10-31,275546,6744,268802,카보 베르데,2007-10
2007-10-31,260572,52624,207948,마이크로네시아,2007-10
2007-10-31,251571,0,251571,세인트 루시아,2007-10
2007-10-31,249607,650,248957,안티가 바부다,2007-10
2007-10-31,242136,0,242136,부르키나 파소,2007-10
2007-10-31,207517,0,207517,그레나다,2007-10
2007-10-31,204721,96,204625,세인트 키츠 네비스,2007-10
2007-10-31,163244,0,163244,지브랄타,2007-10
2007-10-31,148752,0,148752,키리바티,2007-10
2007-10-31,108844,65817,43027,보츠와나,2007-10
2007-10-31,101796,14530525,-14428729,나미비아,2007-10
2007-10-31,98043,0,98043,영령 버진군도,2007-10
2007-10-31,93651,2974931,-2881280,솔로몬 군도,2007-10
2007-10-31,80412,0,80412,르완다,2007-10
2007-10-31,60721,9636,51085,말리,2007-10
2007-10-31,58511,0,58511,투르크 & 카이코스 군도,2007-10
2007-10-31,52433,31529,20904,세인트 빈센트 그레나딘,2007-10
2007-10-31,51040,427613,-376573,모나코,2007-10
2007-10-31,47444,81968,-34524,안도라,2007-10
2007-10-31,34093,0,34093,불령 남부지역,2007-10
2007-10-31,30780,0,30780,투발루,2007-10
2007-10-31,26724,0,26724,코모로스,2007-10
2007-10-31,26060,5921,20139,토켈라우,2007-10
2007-10-31,25728,0,25728,쿡 아일랜드,2007-10
2007-10-31,25192,63424,-38232,미령 버진군도,2007-10
2007-10-31,24315,0,24315,파로에 군도,2007-10
2007-10-31,21183,3944,17239,산마리노,2007-10
2007-10-31,20516,0,20516,니제르,2007-10
2007-10-31,16352,0,16352,메요트,2007-10
2007-10-31,8848,3295,5553,챠드,2007-10
2007-10-31,7460,0,7460,적도 기니,2007-10
2007-10-31,5400,357,5043,코스 군도,2007-10
2007-10-31,2800,0,2800,몬트세라트,2007-10
2007-10-31,1492,0,1492,노폴크 아일랜드,2007-10
2007-10-31,0,132709,-132709,기네비소,2007-10
2007-10-31,0,2900,-2900,소말리아,2007-10
2007-10-31,0,258,-258,상토메 프린스페,2007-10
2007-10-31,0,16001,-16001,남조지아 & 남샌드위치 군도,2007-10
2007-10-31,0,51938,-51938,앙귈라,2007-10
2007-10-31,0,25898,-25898,중앙아프리카공화국,2007-10
2007-10-31,0,297792,-297792,크리스마스 아일랜드,2007-10
2007-10-31,0,180289,-180289,그린랜드,2007-10
2007-11-30,7942034296,6073035394,1868998902,중국,2007-11
2007-11-30,4081464622,3252745687,828718935,미국,2007-11
2007-11-30,2525078306,5122199966,-2597121660,일본,2007-11
2007-11-30,1800519384,178928819,1621590565,홍콩,2007-11
2007-11-30,1188917659,628350666,560566993,싱가포르,2007-11
2007-11-30,1118800759,963605834,155194925,대만,2007-11
2007-11-30,1037597379,1253789629,-216192250,독일,2007-11
2007-11-30,804948928,842138210,-37189282,러시아 연방,2007-11
2007-11-30,759515341,97987950,661527391,멕시코,2007-11
2007-11-30,689630018,494338669,195291349,인도,2007-11
2007-11-30,554694852,126372073,428322779,베트남,2007-11
2007-11-30,542126817,0,542126817,마샬군도,2007-11
2007-11-30,525091215,327811450,197279765,영국,2007-11
2007-11-30,522224852,219635497,302589355,필리핀,2007-11
2007-11-30,513159603,358395526,154764077,네덜란드,2007-11
2007-11-30,498225843,937626897,-439401054,인도네시아,2007-11
2007-11-30,484300172,1241814037,-757513865,호주,2007-11
2007-11-30,471307942,828250888,-356942946,말레이시아,2007-11
2007-11-30,465785553,77828956,387956597,콩고,2007-11
2007-11-30,430145050,316501203,113643847,태국,2007-11
2007-11-30,394804259,302085758,92718501,브라질,2007-11
2007-11-30,365344274,61295101,304049173,스페인,2007-11
2007-11-30,349453826,257140960,92312866,캐나다,2007-11
2007-11-30,348725243,1238986611,-890261368,아랍에미리트 연합,2007-11
2007-11-30,347506043,319387060,28118983,칠레,2007-11
2007-11-30,345842690,804002064,-458159374,이란,2007-11
2007-11-30,343755210,319026683,24728527,이탈리아,2007-11
2007-11-30,342358536,348469814,-6111278,프랑스,2007-11
2007-11-30,339409240,2077732653,-1738323413,사우디아라비아,2007-11
2007-11-30,339322192,15042976,324279216,튀르키예,2007-11
2007-11-30,335081023,26771545,308309478,폴란드,2007-11
2007-11-30,316158277,101410206,214748071,벨기에,2007-11
2007-11-30,243314430,4134348,239180082,파나마,2007-11
2007-11-30,225372953,5829874,219543079,슬로바키아,2007-11
2007-11-30,197604591,44530,197560061,라이베리아,2007-11
2007-11-30,194988584,23372379,171616205,헝가리,2007-11
2007-11-30,178906669,5482881,173423788,그리스,2007-11
2007-11-30,161779222,79143849,82635373,핀란드,2007-11
2007-11-30,161474696,39091878,122382818,우크라이나,2007-11
2007-11-30,156419302,0,156419302,버뮤다,2007-11
2007-11-30,146370965,4111670,142259295,미얀마,2007-11
2007-11-30,144354378,865048931,-720694553,쿠웨이트,2007-11
2007-11-30,142586777,186304338,-43717561,남아프리카공화국,2007-11
2007-11-30,128058558,38546564,89511994,체코공화국,2007-11
2007-11-30,120057881,1675342,118382539,사이프러스,2007-11
2007-11-30,118669323,1910888,116758435,베네주엘라,2007-11
2007-11-30,109093074,22732023,86361051,이집트,2007-11
2007-11-30,105515179,88628816,16886363,오스트리아,2007-11
2007-11-30,95649521,9081254,86568267,콜롬비아,2007-11
2007-11-30,92686860,1034907140,-942220280,카타르,2007-11
2007-11-30,91502784,59164210,32338574,이스라엘,2007-11
2007-11-30,87414745,66663198,20751547,아일랜드,2007-11
2007-11-30,85231896,25227,85206669,나이지리아,2007-11
2007-11-30,82354630,313884917,-231530287,오만,2007-11
2007-11-30,70327582,115215135,-44887553,스웨덴,2007-11
2007-11-30,64456950,10729308,53727642,몰타,2007-11
2007-11-30,64445407,7408420,57036987,루마니아,2007-11
2007-11-30,64019019,635049,63383970,알제리,2007-11
2007-11-30,59030360,1657067,57373293,우즈베키스탄,2007-11
2007-11-30,58063630,620893,57442737,리비아,2007-11
2007-11-30,54790669,48937099,5853570,파키스탄,2007-11
2007-11-30,54010772,17105118,36905654,방글라데시,2007-11
2007-11-30,52959834,41738261,11221573,아르헨티나,2007-11
2007-11-30,52590509,191351452,-138760943,스위스,2007-11
2007-11-30,46742059,620588,46121471,시리아,2007-11
2007-11-30,45535875,146061356,-100525481,뉴질랜드,2007-11
2007-11-30,43877128,16042420,27834708,카자흐스탄,2007-11
2007-11-30,42956308,7814769,35141539,포루투갈,2007-11
2007-11-30,39944410,58263829,-18319419,덴마크,2007-11
2007-11-30,38797960,1294257,37503703,요르단,2007-11
2007-11-30,37491288,2720678,34770610,에쿠아도르,2007-11
2007-11-30,35631038,63900394,-28269356,페루,2007-11
2007-11-30,32645774,9246501,23399273,모로코,2007-11
2007-11-30,31011269,901998,30109271,과테말라,2007-11
2007-11-30,30676751,2192854,28483897,슬로베니아,2007-11
2007-11-30,26632010,466623,26165387,캄보디아,2007-11
2007-11-30,24640956,208594105,-183953149,노르웨이,2007-11
2007-11-30,24333003,36038866,-11705863,수단,2007-11
2007-11-30,21426358,19814641,1611717,코스타리카,2007-11
2007-11-30,19425363,413219868,-393794505,이라크,2007-11
2007-11-30,18978289,12666449,6311840,바레인,2007-11
2007-11-30,17501120,15864,17485256,아이티,2007-11
2007-11-30,17363740,846299,16517441,쿠바,2007-11
2007-11-30,17354232,1179566,16174666,몽골,2007-11
2007-11-30,17043996,582185,16461811,가나,2007-11
2007-11-30,16637030,2127367,14509663,스리랑카,2007-11
2007-11-30,14270063,4293202,9976861,레바논,2007-11
2007-11-30,13978781,154915,13823866,아제르바이잔,2007-11
2007-11-30,13561106,78365123,-64804017,앙골라,2007-11
2007-11-30,13418828,2316001,11102827,불가리아,2007-11
2007-11-30,12824341,4365217,8459124,기타국,2007-11
2007-11-30,12764407,146377,12618030,키르기스스탄,2007-11
2007-11-30,11650165,42813,11607352,탄자니아,2007-11
2007-11-30,11100110,485,11099625,아프카니스탄,2007-11
2007-11-30,10736002,238093,10497909,케냐,2007-11
2007-11-30,10509399,17996695,-7487296,푸에르토리코,2007-11
2007-11-30,10353191,990681,9362510,리투아니아,2007-11
2007-11-30,9966697,57259,9909438,니카라과,2007-11
2007-11-30,9794214,745725,9048489,크로아티아,2007-11
2007-11-30,9729384,8513649,1215735,트리니다드 토바고,2007-11
2007-11-30,9056293,1811125,7245168,도미니카 공화국,2007-11
2007-11-30,8877276,313424,8563852,온두라스,2007-11
2007-11-30,8716147,1058548,7657599,엘살바도르,2007-11
2007-11-30,8651470,171695,8479775,파라과이,2007-11
2007-11-30,8092769,1751906,6340863,튀니지,2007-11
2007-11-30,7632462,0,7632462,코트디봐르,2007-11
2007-11-30,7544061,2487711,5056350,라트비아,2007-11
2007-11-30,7123109,565347,6557762,예맨,2007-11
2007-11-30,6473612,2525493,3948119,우루과이,2007-11
2007-11-30,5250007,3383145,1866862,에스토니아,2007-11
2007-11-30,5249864,95387,5154477,뉴 칼레도니아,2007-11
2007-11-30,5109539,475322,4634217,벨라루스,2007-11
2007-11-30,4698699,353851,4344848,조지아,2007-11
2007-11-30,4482751,75271,4407480,마다카스카르,2007-11
2007-11-30,4309380,3834,4305546,유고,2007-11
2007-11-30,4294804,129291,4165513,피지,2007-11
2007-11-30,4198530,120937,4077593,괌,2007-11
2007-11-30,4015462,1869671,2145791,라오스,2007-11
2007-11-30,3751258,863,3750395,불령 리유니온 코모도 제도,2007-11
2007-11-30,3510078,397034,3113044,모리셔스,2007-11
2007-11-30,3495722,7054,3488668,북마리아나 군도,2007-11
2007-11-30,3486024,2358993,1127031,나우루,2007-11
2007-11-30,3469018,1517539,1951479,타지크,2007-11
2007-11-30,3292502,145492,3147010,베닝,2007-11
2007-11-30,3022440,1176456,1845984,마카오,2007-11
2007-11-30,2757602,2309082,448520,룩셈부르그,2007-11
2007-11-30,2500678,19396,2481282,보스니아-헤르체고비나,2007-11
2007-11-30,2423462,65080549,-62657087,카메룬,2007-11
2007-11-30,2421704,7823460,-5401756,짐바브웨,2007-11
2007-11-30,2352271,3527929,-1175658,아이슬란드,2007-11
2007-11-30,2349402,0,2349402,지부티,2007-11
2007-11-30,2337482,375786,1961696,기니,2007-11
2007-11-30,2224551,87320186,-85095635,브루나이,2007-11
2007-11-30,2188220,609002,1579218,세네갈,2007-11
2007-11-30,2148455,106703,2041752,콩고민주공화국,2007-11
2007-11-30,2085888,46534,2039354,바하마,2007-11
2007-11-30,2083755,0,2083755,부르키나 파소,2007-11
2007-11-30,1900012,382731,1517281,자마이카,2007-11
2007-11-30,1859934,200771,1659163,에티오피아,2007-11
2007-11-30,1831907,26435,1805472,네덜란드 열도,2007-11
2007-11-30,1652066,34062,1618004,마이크로네시아,2007-11
2007-11-30,1602816,433752,1169064,토고,2007-11
2007-11-30,1534211,27079,1507132,모잠비크,2007-11
2007-11-30,1532294,2450,1529844,불령 폴리네시아,2007-11
2007-11-30,1454485,265502,1188983,가봉,2007-11
2007-11-30,1391543,48401,1343142,세르비아 와 몬테네그로,2007-11
2007-11-30,1374159,42559,1331600,네팔,2007-11
2007-11-30,1326418,2419,1323999,과델로프,2007-11
2007-11-30,1301369,123484,1177885,우간다,2007-11
2007-11-30,1268084,392,1267692,아르메니아,2007-11
2007-11-30,1265993,5014,1260979,아루바,2007-11
2007-11-30,1222984,3356,1219628,마세도니아,2007-11
2007-11-30,1220366,3041723,-1821357,스와질랜드,2007-11
2007-11-30,1199695,0,1199695,마티니크,2007-11
2007-11-30,1184424,1894949,-710525,파푸아 뉴기니,2007-11
2007-11-30,1018848,0,1018848,바베이도스,2007-11
2007-11-30,998869,1123613,-124744,팔레스타인 해방기구(구),2007-11
2007-11-30,998784,1210,997574,알바니아,2007-11
2007-11-30,884807,44631,840176,나미비아,2007-11
2007-11-30,836494,0,836494,수리남,2007-11
2007-11-30,768528,146689,621839,몰도바,2007-11
2007-11-30,710350,67784399,-67074049,잠비아,2007-11
2007-11-30,691743,45356,646387,보츠와나,2007-11
2007-11-30,680891,34965,645926,사모아,2007-11
2007-11-30,639215,1809,637406,에리트리아,2007-11
2007-11-30,638726,110386,528340,세이쉘,2007-11
2007-11-30,590763,0,590763,투르크멘,2007-11
2007-11-30,537904,16860,521044,가이아나,2007-11
2007-11-30,514316,8186239,-7671923,말라위,2007-11
2007-11-30,503754,27502234,-26998480,볼리비아,2007-11
2007-11-30,496913,0,496913,불령 가이아나,2007-11
2007-11-30,462847,234231,228616,아메리칸 사모아,2007-11
2007-11-30,406679,6,406673,감비아,2007-11
2007-11-30,362233,51020,311213,모리타니,2007-11
2007-11-30,350025,77412,272613,도미니카,2007-11
2007-11-30,325219,0,325219,영령 캐이맨 군도,2007-11
2007-11-30,312571,1519149,-1206578,솔로몬 군도,2007-11
2007-11-30,309572,14725,294847,바누아투,2007-11
2007-11-30,296013,0,296013,안티가 바부다,2007-11
2007-11-30,253767,604025,-350258,리히텐슈타인,2007-11
2007-11-30,248035,0,248035,세인트 루시아,2007-11
2007-11-30,235522,124544,110978,시에라 리온,2007-11
2007-11-30,233418,0,233418,영령 버진군도,2007-11
2007-11-30,217778,16896,200882,벨리제,2007-11
2007-11-30,192903,28283,164620,몰디브,2007-11
2007-11-30,188018,1226,186792,안도라,2007-11
2007-11-30,185752,0,185752,부탄,2007-11
2007-11-30,160842,0,160842,부룬디,2007-11
2007-11-30,152124,0,152124,말리,2007-11
2007-11-30,140358,14927,125431,세인트 빈센트 그레나딘,2007-11
2007-11-30,129166,0,129166,팔라우,2007-11
2007-11-30,128472,6,128466,그레나다,2007-11
2007-11-30,97650,8262,89388,세인트 키츠 네비스,2007-11
2007-11-30,94261,26313,67948,카보 베르데,2007-11
2007-11-30,85858,0,85858,투르크 & 카이코스 군도,2007-11
2007-11-30,51300,0,51300,적도 기니,2007-11
2007-11-30,48343,79504,-31161,중앙아프리카공화국,2007-11
2007-11-30,48166,9664,38502,니제르,2007-11
2007-11-30,36618,441568,-404950,모나코,2007-11
2007-11-30,31786,1242,30544,산마리노,2007-11
2007-11-30,27184,0,27184,르완다,2007-11
2007-11-30,16692,0,16692,메요트,2007-11
2007-11-30,6321,140977,-134656,세인트 헬레나,2007-11
2007-11-30,4300,7078,-2778,토켈라우,2007-11
2007-11-30,3978,0,3978,지브랄타,2007-11
2007-11-30,2586,40865,-38279,레소토,2007-11
2007-11-30,1335,0,1335,코스 군도,2007-11
2007-11-30,567,0,567,안타티카,2007-11
2007-11-30,196,845,-649,몬트세라트,2007-11
2007-11-30,140,0,140,챠드,2007-11
2007-11-30,29,0,29,앙귈라,2007-11
2007-11-30,0,241616,-241616,통가,2007-11
2007-11-30,0,7,-7,파로에 군도,2007-11
2007-11-30,0,72136,-72136,기네비소,2007-11
2007-11-30,0,1466,-1466,미령 버진군도,2007-11
2007-11-30,0,36,-36,노폴크 아일랜드,2007-11
2007-11-30,0,31365,-31365,티모르,2007-11
2007-11-30,0,55099,-55099,그린랜드,2007-11
2007-11-30,0,3000,-3000,마이너 아우틀링 합중국 군도,2007-11
2007-12-31,7299287142,5672642081,1626645061,중국,2007-12
2007-12-31,3853753887,3176723084,677030803,미국,2007-12
2007-12-31,2501119699,4968459651,-2467339952,일본,2007-12
2007-12-31,1606486428,182225130,1424261298,홍콩,2007-12
2007-12-31,1169551741,1261492336,-91940595,독일,2007-12
2007-12-31,1156454302,916656438,239797864,대만,2007-12
2007-12-31,993265689,560692320,432573369,싱가포르,2007-12
2007-12-31,821900803,643893719,178007084,러시아 연방,2007-12
2007-12-31,653570826,122000150,531570676,베트남,2007-12
2007-12-31,610466516,403854497,206612019,인도,2007-12
2007-12-31,600077820,87984590,512093230,멕시코,2007-12
2007-12-31,557695943,0,557695943,버뮤다,2007-12
2007-12-31,510235498,686614926,-176379428,말레이시아,2007-12
2007-12-31,503451657,310865753,192585904,영국,2007-12
2007-12-31,458383069,348236113,110146956,이탈리아,2007-12
2007-12-31,454871785,375236691,79635094,네덜란드,2007-12
2007-12-31,417924714,912878924,-494954210,인도네시아,2007-12
2007-12-31,408509028,328078245,80430783,태국,2007-12
2007-12-31,377951807,191176221,186775586,필리핀,2007-12
2007-12-31,355878820,89853070,266025750,스페인,2007-12
2007-12-31,344469853,1404999423,-1060529570,호주,2007-12
2007-12-31,343891841,1227719352,-883827511,아랍에미리트 연합,2007-12
2007-12-31,339059759,2304113538,-1965053779,사우디아라비아,2007-12
2007-12-31,332624532,796734296,-464109764,이란,2007-12
2007-12-31,328347842,14106086,314241756,튀르키예,2007-12
2007-12-31,299906012,0,299906012,라이베리아,2007-12
2007-12-31,279199639,31875985,247323654,폴란드,2007-12
2007-12-31,277453819,312708819,-35255000,브라질,2007-12
2007-12-31,264942351,294194814,-29252463,캐나다,2007-12
2007-12-31,240898375,428916812,-188018437,프랑스,2007-12
2007-12-31,240145125,325085726,-84940601,칠레,2007-12
2007-12-31,234739547,5694254,229045293,슬로바키아,2007-12
2007-12-31,222267985,28556402,193711583,헝가리,2007-12
2007-12-31,206795485,101321699,105473786,파나마,2007-12
2007-12-31,187057689,0,187057689,마샬군도,2007-12
2007-12-31,184496988,94252360,90244628,벨기에,2007-12
2007-12-31,174607881,948410191,-773802310,카타르,2007-12
2007-12-31,172032352,934486665,-762454313,쿠웨이트,2007-12
2007-12-31,168689121,35735500,132953621,우크라이나,2007-12
2007-12-31,167386825,76801092,90585733,핀란드,2007-12
2007-12-31,129880885,211347045,-81466160,남아프리카공화국,2007-12
2007-12-31,112025395,42368442,69656953,체코공화국,2007-12
2007-12-31,104298045,135483582,-31185537,이집트,2007-12
2007-12-31,91133727,1833190,89300537,그리스,2007-12
2007-12-31,87756251,140512873,-52756622,노르웨이,2007-12
2007-12-31,87375695,106145099,-18769404,스웨덴,2007-12
2007-12-31,78840067,566416205,-487576138,오만,2007-12
2007-12-31,77019864,106795281,-29775417,아일랜드,2007-12
2007-12-31,72799995,73241945,-441950,이스라엘,2007-12
2007-12-31,71337412,13500978,57836434,베네주엘라,2007-12
2007-12-31,70789085,39090409,31698676,나이지리아,2007-12
2007-12-31,70445007,637016,69807991,사이프러스,2007-12
2007-12-31,66844357,4952051,61892306,방글라데시,2007-12
2007-12-31,66673073,7617430,59055643,콜롬비아,2007-12
2007-12-31,65489688,38993985,26495703,알제리,2007-12
2007-12-31,65045779,34779065,30266714,우즈베키스탄,2007-12
2007-12-31,62411284,45434285,16976999,파키스탄,2007-12
2007-12-31,53324324,84524833,-31200509,오스트리아,2007-12
2007-12-31,52526586,156836754,-104310168,스위스,2007-12
2007-12-31,48442101,64378580,-15936479,아르헨티나,2007-12
2007-12-31,47658276,11447507,36210769,루마니아,2007-12
2007-12-31,47381533,131401830,-84020297,뉴질랜드,2007-12
2007-12-31,47261271,53053038,-5791767,덴마크,2007-12
2007-12-31,47030847,199002,46831845,시리아,2007-12
2007-12-31,45604092,1458084,44146008,요르단,2007-12
2007-12-31,44583443,6464943,38118500,기타국,2007-12
2007-12-31,42570288,62841154,-20270866,페루,2007-12
2007-12-31,41560449,188693,41371756,니카라과,2007-12
2007-12-31,40624859,2933267,37691592,에쿠아도르,2007-12
2007-12-31,36818882,2873646,33945236,슬로베니아,2007-12
2007-12-31,32682401,365755,32316646,캄보디아,2007-12
2007-12-31,28877197,19709482,9167715,카자흐스탄,2007-12
2007-12-31,28510675,408083242,-379572567,이라크,2007-12
2007-12-31,28078160,5978308,22099852,포루투갈,2007-12
2007-12-31,27564010,49488,27514522,괌,2007-12
2007-12-31,27261012,5415751,21845261,모로코,2007-12
2007-12-31,25794147,2655813,23138334,리비아,2007-12
2007-12-31,25640731,17721014,7919717,코스타리카,2007-12
2007-12-31,24996673,510957,24485716,과테말라,2007-12
2007-12-31,23974916,10301,23964615,아이티,2007-12
2007-12-31,20545020,30819,20514201,앙골라,2007-12
2007-12-31,19382706,55066600,-35683894,아제르바이잔,2007-12
2007-12-31,17598332,62241296,-44642964,수단,2007-12
2007-12-31,17234684,4603145,12631539,스리랑카,2007-12
2007-12-31,14913563,1332843,13580720,가나,2007-12
2007-12-31,14429704,3653849,10775855,레바논,2007-12
2007-12-31,13278824,33313398,-20034574,바레인,2007-12
2007-12-31,13187175,1009970,12177205,케냐,2007-12
2007-12-31,12870588,2980077,9890511,튀니지,2007-12
2007-12-31,11486268,13183198,-1696930,푸에르토리코,2007-12
2007-12-31,10987910,2604343,8383567,미얀마,2007-12
2007-12-31,10957236,3444359,7512877,몽골,2007-12
2007-12-31,10926954,1075984,9850970,리투아니아,2007-12
2007-12-31,10698516,1100319,9598197,라트비아,2007-12
2007-12-31,10634376,189926,10444450,키르기스스탄,2007-12
2007-12-31,10170544,333681,9836863,온두라스,2007-12
2007-12-31,10137405,2512950,7624455,불가리아,2007-12
2007-12-31,9961665,1153919,8807746,도미니카 공화국,2007-12
2007-12-31,9233365,421,9232944,아프카니스탄,2007-12
2007-12-31,9171125,2878246,6292879,에스토니아,2007-12
2007-12-31,8843666,145789765,-136946099,트리니다드 토바고,2007-12
2007-12-31,8700116,208592,8491524,에티오피아,2007-12
2007-12-31,8195136,53135381,-44940245,예맨,2007-12
2007-12-31,8075001,483575,7591426,파라과이,2007-12
2007-12-31,7996168,0,7996168,탄자니아,2007-12
2007-12-31,7742344,15534,7726810,뉴 칼레도니아,2007-12
2007-12-31,6922386,10248556,-3326170,몰타,2007-12
2007-12-31,5939076,294150,5644926,코트디봐르,2007-12
2007-12-31,5625312,3538815,2086497,우루과이,2007-12
2007-12-31,5624308,493259,5131049,크로아티아,2007-12
2007-12-31,5521494,691734,4829760,엘살바도르,2007-12
2007-12-31,5357007,28756,5328251,레소토,2007-12
2007-12-31,5132138,177125,4955013,쿠바,2007-12
2007-12-31,4745339,655671,4089668,라오스,2007-12
2007-12-31,4192249,0,4192249,타지크,2007-12
2007-12-31,4179253,1869393,2309860,아이슬란드,2007-12
2007-12-31,3633700,77670,3556030,세르비아 와 몬테네그로,2007-12
2007-12-31,3571672,279321,3292351,자마이카,2007-12
2007-12-31,3405548,0,3405548,아메리칸 사모아,2007-12
2007-12-31,3340235,442931,2897304,조지아,2007-12
2007-12-31,2911009,388979,2522030,벨라루스,2007-12
2007-12-31,2878571,18888,2859683,콩고,2007-12
2007-12-31,2864632,32767,2831865,유고,2007-12
2007-12-31,2717854,0,2717854,베닝,2007-12
2007-12-31,2697537,632922,2064615,짐바브웨,2007-12
2007-12-31,2592215,34227,2557988,바하마,2007-12
2007-12-31,2550749,126991,2423758,마다카스카르,2007-12
2007-12-31,2539623,4240290,-1700667,룩셈부르그,2007-12
2007-12-31,2344400,1871744,472656,마카오,2007-12
2007-12-31,2336285,137080,2199205,몰도바,2007-12
2007-12-31,2256038,0,2256038,불령 리유니온 코모도 제도,2007-12
2007-12-31,2243197,870,2242327,북마리아나 군도,2007-12
2007-12-31,2154382,534841,1619541,세네갈,2007-12
2007-12-31,2116459,241201,1875258,피지,2007-12
2007-12-31,2092688,243974,1848714,카메룬,2007-12
2007-12-31,2076011,62,2075949,콩고민주공화국,2007-12
2007-12-31,2055113,36018263,-33963150,파푸아 뉴기니,2007-12
2007-12-31,1975266,106027361,-104052095,브루나이,2007-12
2007-12-31,1951877,29283237,-27331360,볼리비아,2007-12
2007-12-31,1890620,43487,1847133,토고,2007-12
2007-12-31,1753110,30433,1722677,시에라 리온,2007-12
2007-12-31,1752712,1394,1751318,불령 폴리네시아,2007-12
2007-12-31,1743851,643258,1100593,모리셔스,2007-12
2007-12-31,1742961,290439,1452522,모잠비크,2007-12
2007-12-31,1718398,50188393,-48469995,잠비아,2007-12
2007-12-31,1698477,0,1698477,아루바,2007-12
2007-12-31,1684188,0,1684188,지부티,2007-12
2007-12-31,1640662,0,1640662,바베이도스,2007-12
2007-12-31,1636713,0,1636713,과델로프,2007-12
2007-12-31,1544113,23395,1520718,네팔,2007-12
2007-12-31,1495953,0,1495953,아르메니아,2007-12
2007-12-31,1451465,535811,915654,기니,2007-12
2007-12-31,1278841,515,1278326,보스니아-헤르체고비나,2007-12
2007-12-31,1278171,0,1278171,마티니크,2007-12
2007-12-31,1064973,14072765,-13007792,스와질랜드,2007-12
2007-12-31,932640,27335,905305,네덜란드 열도,2007-12
2007-12-31,926638,149153,777485,말라위,2007-12
2007-12-31,912578,140022,772556,수리남,2007-12
2007-12-31,870384,12753,857631,불령 가이아나,2007-12
2007-12-31,842764,1758,841006,세이쉘,2007-12
2007-12-31,803566,123460,680106,우간다,2007-12
2007-12-31,793676,0,793676,투르크멘,2007-12
2007-12-31,724929,410221,314708,가봉,2007-12
2007-12-31,703299,51683,651616,모리타니,2007-12
2007-12-31,611900,40222,571678,티모르,2007-12
2007-12-31,586717,59313,527404,팔레스타인 해방기구(구),2007-12
2007-12-31,547551,19342,528209,사모아,2007-12
2007-12-31,508904,6194,502710,마세도니아,2007-12
2007-12-31,489529,17685,471844,가이아나,2007-12
2007-12-31,477759,0,477759,세인트 루시아,2007-12
2007-12-31,421352,9894,411458,알바니아,2007-12
2007-12-31,385912,123,385789,지브랄타,2007-12
2007-12-31,377627,22556,355071,바누아투,2007-12
2007-12-31,339120,18957295,-18618175,나미비아,2007-12
2007-12-31,321676,0,321676,영령 버진군도,2007-12
2007-12-31,275183,38601,236582,벨리제,2007-12
2007-12-31,266891,0,266891,부탄,2007-12
2007-12-31,242941,940054,-697113,리히텐슈타인,2007-12
2007-12-31,241009,0,241009,영령 캐이맨 군도,2007-12
2007-12-31,206772,0,206772,마이크로네시아,2007-12
2007-12-31,204359,77793,126566,보츠와나,2007-12
2007-12-31,184331,31971,152360,니제르,2007-12
2007-12-31,183433,0,183433,그레나다,2007-12
2007-12-31,163899,0,163899,말리,2007-12
2007-12-31,163271,0,163271,에리트리아,2007-12
2007-12-31,160130,126283,33847,몰디브,2007-12
2007-12-31,157331,0,157331,부룬디,2007-12
2007-12-31,137123,0,137123,투르크 & 카이코스 군도,2007-12
2007-12-31,124721,7250,117471,팔라우,2007-12
2007-12-31,116889,2998,113891,도미니카,2007-12
2007-12-31,94597,0,94597,세인트 빈센트 그레나딘,2007-12
2007-12-31,75876,0,75876,카보 베르데,2007-12
2007-12-31,73934,59929,14005,안티가 바부다,2007-12
2007-12-31,73931,356704,-282773,솔로몬 군도,2007-12
2007-12-31,71830,0,71830,챠드,2007-12
2007-12-31,64050,31560,32490,안도라,2007-12
2007-12-31,62956,0,62956,르완다,2007-12
2007-12-31,54096,62164,-8068,산마리노,2007-12
2007-12-31,53356,81,53275,중앙아프리카공화국,2007-12
2007-12-31,51900,0,51900,적도 기니,2007-12
2007-12-31,42687,0,42687,부르키나 파소,2007-12
2007-12-31,37914,159,37755,세인트 키츠 네비스,2007-12
2007-12-31,15753,28250,-12497,쿡 아일랜드,2007-12
2007-12-31,10800,514340,-503540,모나코,2007-12
2007-12-31,7878,0,7878,코모로스,2007-12
2007-12-31,7295,0,7295,키리바티,2007-12
2007-12-31,6669,0,6669,안타티카,2007-12
2007-12-31,2045,0,2045,감비아,2007-12
2007-12-31,945,0,945,파로에 군도,2007-12
2007-12-31,626,0,626,소말리아,2007-12
2007-12-31,1,10725,-10724,미령 버진군도,2007-12
2007-12-31,0,3378,-3378,코스 군도,2007-12
2007-12-31,0,4,-4,교황청,2007-12
2007-12-31,0,233186,-233186,그린랜드,2007-12
2007-12-31,0,0,0,앙귈라,2007-12
2007-12-31,0,2675665,-2675665,나우루,2007-12
2007-12-31,0,33012,-33012,몬트세라트,2007-12
2007-12-31,0,2070,-2070,세인트 헬레나,2007-12
2007-12-31,0,28978,-28978,토켈라우,2007-12
2007-12-31,0,58677,-58677,피트카이른,2007-12
2007-12-31,0,211489,-211489,통가,2007-12
2008-01-31,7269037445,6342943100,926094345,중국,2008-01
2008-01-31,3656069479,3156799601,499269878,미국,2008-01
2008-01-31,2334129074,4646728210,-2312599136,일본,2008-01
2008-01-31,1365283609,211678432,1153605177,홍콩,2008-01
2008-01-31,1171426326,727514517,443911809,싱가포르,2008-01
2008-01-31,1158195501,1275467099,-117271598,독일,2008-01
2008-01-31,1056144590,1027745847,28398743,대만,2008-01
2008-01-31,754206857,112660800,641546057,멕시코,2008-01
2008-01-31,678295363,940780554,-262485191,러시아 연방,2008-01
2008-01-31,667876896,140157832,527719064,베트남,2008-01
2008-01-31,553330772,578054934,-24724162,인도,2008-01
2008-01-31,528935220,288543183,240392037,영국,2008-01
2008-01-31,452731086,891027754,-438296668,말레이시아,2008-01
2008-01-31,435322309,357137904,78184405,이탈리아,2008-01
2008-01-31,433003325,207229502,225773823,필리핀,2008-01
2008-01-31,431838055,299791880,132046175,태국,2008-01
2008-01-31,417085743,1050952449,-633866706,인도네시아,2008-01
2008-01-31,398902259,404775991,-5873732,브라질,2008-01
2008-01-31,385290406,1188291571,-803001165,호주,2008-01
2008-01-31,379690396,405442717,-25752321,네덜란드,2008-01
2008-01-31,378403151,2417263249,-2038860098,사우디아라비아,2008-01
2008-01-31,347913258,25213024,322700234,폴란드,2008-01
2008-01-31,341797492,746187266,-404389774,이란,2008-01
2008-01-31,335817689,76645604,259172085,스페인,2008-01
2008-01-31,326191270,1465897553,-1139706283,아랍에미리트 연합,2008-01
2008-01-31,321472638,19989637,301483001,튀르키예,2008-01
2008-01-31,315809954,119283502,196526452,벨기에,2008-01
2008-01-31,311698814,1162588,310536226,파나마,2008-01
2008-01-31,305963432,344408492,-38445060,캐나다,2008-01
2008-01-31,279617290,507832859,-228215569,칠레,2008-01
2008-01-31,278154896,0,278154896,마샬군도,2008-01
2008-01-31,272418142,400718869,-128300727,프랑스,2008-01
2008-01-31,244577355,77813093,166764262,핀란드,2008-01
2008-01-31,238824744,7962603,230862141,슬로바키아,2008-01
2008-01-31,200220864,27496741,172724123,헝가리,2008-01
2008-01-31,154911724,77180275,77731449,그리스,2008-01
2008-01-31,149226015,52795828,96430187,우크라이나,2008-01
2008-01-31,136340759,364,136340395,라이베리아,2008-01
2008-01-31,135524420,107927631,27596789,스웨덴,2008-01
2008-01-31,129905553,188905638,-59000085,남아프리카공화국,2008-01
2008-01-31,110613543,1160308025,-1049694482,카타르,2008-01
2008-01-31,95958122,43940288,52017834,체코공화국,2008-01
2008-01-31,93384362,169308442,-75924080,이집트,2008-01
2008-01-31,92771925,78281041,14490884,아일랜드,2008-01
2008-01-31,92044071,16312906,75731165,콜롬비아,2008-01
2008-01-31,89057860,65655938,23401922,이스라엘,2008-01
2008-01-31,88586395,130172,88456223,나이지리아,2008-01
2008-01-31,87314573,92507805,-5193232,뉴질랜드,2008-01
2008-01-31,78865945,2242976,76622969,우즈베키스탄,2008-01
2008-01-31,76198587,5183793,71014794,루마니아,2008-01
2008-01-31,69395754,511465662,-442069908,오만,2008-01
2008-01-31,64684488,182651982,-117967494,노르웨이,2008-01
2008-01-31,62947297,183305869,-120358572,알제리,2008-01
2008-01-31,59998556,27205585,32792971,방글라데시,2008-01
2008-01-31,57609311,59284199,-1674888,파키스탄,2008-01
2008-01-31,54677551,44108320,10569231,아르헨티나,2008-01
2008-01-31,54496965,72708523,-18211558,오스트리아,2008-01
2008-01-31,54310346,479325,53831021,시리아,2008-01
2008-01-31,51414362,220098,51194264,사이프러스,2008-01
2008-01-31,50955571,6567505,44388066,리비아,2008-01
2008-01-31,50684912,136295180,-85610268,페루,2008-01
2008-01-31,48091366,1028250523,-980159157,쿠웨이트,2008-01
2008-01-31,47924187,2697144,45227043,요르단,2008-01
2008-01-31,38523256,9194447,29328809,모로코,2008-01
2008-01-31,38362513,1071754,37290759,에쿠아도르,2008-01
2008-01-31,34516871,3247539,31269332,슬로베니아,2008-01
2008-01-31,33761996,13408074,20353922,카자흐스탄,2008-01
2008-01-31,32759199,7027896,25731303,포루투갈,2008-01
2008-01-31,31690446,20951584,10738862,코스타리카,2008-01
2008-01-31,29909352,447299713,-417390361,이라크,2008-01
2008-01-31,29713066,55480583,-25767517,덴마크,2008-01
2008-01-31,28699771,167145625,-138445854,스위스,2008-01
2008-01-31,25969139,1790969,24178170,베네주엘라,2008-01
2008-01-31,25407325,3139811,22267514,과테말라,2008-01
2008-01-31,25073562,322341,24751221,쿠바,2008-01
2008-01-31,24851468,431315,24420153,니카라과,2008-01
2008-01-31,23159333,9182674,13976659,몰타,2008-01
2008-01-31,20875235,1251704,19623531,캄보디아,2008-01
2008-01-31,19637672,0,19637672,앙골라,2008-01
2008-01-31,19436025,11275948,8160077,바레인,2008-01
2008-01-31,18317157,0,18317157,안티가 바부다,2008-01
2008-01-31,16497182,1036607,15460575,아제르바이잔,2008-01
2008-01-31,15240372,5855812,9384560,몽골,2008-01
2008-01-31,14332522,1538189,12794333,리투아니아,2008-01
2008-01-31,14138729,6884601,7254128,기타국,2008-01
2008-01-31,13719517,15092640,-1373123,푸에르토리코,2008-01
2008-01-31,13603100,6927523,6675577,스리랑카,2008-01
2008-01-31,13473349,4984048,8489301,불가리아,2008-01
2008-01-31,13433903,3116459,10317444,가나,2008-01
2008-01-31,13012319,4368773,8643546,미얀마,2008-01
2008-01-31,12890066,2592353,10297713,레바논,2008-01
2008-01-31,12816882,429882,12387000,온두라스,2008-01
2008-01-31,11132879,46355002,-35222123,수단,2008-01
2008-01-31,10732563,1312725,9419838,라트비아,2008-01
2008-01-31,9564011,48276461,-38712450,예맨,2008-01
2008-01-31,9448296,164480,9283816,키르기스스탄,2008-01
2008-01-31,9313023,72370,9240653,파라과이,2008-01
2008-01-31,9294153,432126,8862027,크로아티아,2008-01
2008-01-31,9211218,2746337,6464881,튀니지,2008-01
2008-01-31,9021728,1086008,7935720,에스토니아,2008-01
2008-01-31,8811784,0,8811784,코트디봐르,2008-01
2008-01-31,8605697,154009,8451688,케냐,2008-01
2008-01-31,7751470,121765978,-114014508,트리니다드 토바고,2008-01
2008-01-31,7364063,85529,7278534,탄자니아,2008-01
2008-01-31,6972583,76554,6896029,에티오피아,2008-01
2008-01-31,6837198,8032265,-1195067,도미니카 공화국,2008-01
2008-01-31,6562015,3111744,3450271,우루과이,2008-01
2008-01-31,6410419,326263,6084156,엘살바도르,2008-01
2008-01-31,5887314,1327251,4560063,뉴 칼레도니아,2008-01
2008-01-31,5764462,231546,5532916,라오스,2008-01
2008-01-31,4670203,469599,4200604,조지아,2008-01
2008-01-31,4351424,1357435,2993989,아이슬란드,2008-01
2008-01-31,3693754,140067009,-136373255,카메룬,2008-01
2008-01-31,3386368,116783,3269585,괌,2008-01
2008-01-31,3314496,0,3314496,아프카니스탄,2008-01
2008-01-31,3165907,477775,2688132,세네갈,2008-01
2008-01-31,2902715,579684,2323031,베닝,2008-01
2008-01-31,2730253,10028960,-7298707,짐바브웨,2008-01
2008-01-31,2638991,1371868,1267123,룩셈부르그,2008-01
2008-01-31,2623236,912656,1710580,마카오,2008-01
2008-01-31,2592490,491492,2100998,모리셔스,2008-01
2008-01-31,2582219,0,2582219,불령 리유니온 코모도 제도,2008-01
2008-01-31,2570577,0,2570577,부르키나 파소,2008-01
2008-01-31,2535603,298588,2237015,마다카스카르,2008-01
2008-01-31,2333822,8976,2324846,유고,2008-01
2008-01-31,2242311,64,2242247,타지크,2008-01
2008-01-31,2233518,237012,1996506,자마이카,2008-01
2008-01-31,2191032,1032946,1158086,아메리칸 사모아,2008-01
2008-01-31,2185888,106570246,-104384358,브루나이,2008-01
2008-01-31,2141646,1201,2140445,아르메니아,2008-01
2008-01-31,2095027,0,2095027,과델로프,2008-01
2008-01-31,2083968,21264897,-19180929,파푸아 뉴기니,2008-01
2008-01-31,1993261,1118061,875200,기니,2008-01
2008-01-31,1928846,1120,1927726,마티니크,2008-01
2008-01-31,1776156,80307,1695849,아이티,2008-01
2008-01-31,1752691,598781,1153910,모잠비크,2008-01
2008-01-31,1749544,117184,1632360,세르비아 와 몬테네그로,2008-01
2008-01-31,1674582,15000,1659582,가이아나,2008-01
2008-01-31,1541161,167675,1373486,네팔,2008-01
2008-01-31,1485685,832677,653008,벨라루스,2008-01
2008-01-31,1470513,0,1470513,수리남,2008-01
2008-01-31,1458263,135832,1322431,불령 폴리네시아,2008-01
2008-01-31,1450016,41916,1408100,북마리아나 군도,2008-01
2008-01-31,1399023,383089,1015934,볼리비아,2008-01
2008-01-31,1376108,241,1375867,투르크멘,2008-01
2008-01-31,1312887,1591822,-278935,토고,2008-01
2008-01-31,1303907,11341,1292566,콩고민주공화국,2008-01
2008-01-31,1283416,0,1283416,콩고,2008-01
2008-01-31,1156433,1532872,-376439,팔레스타인 해방기구(구),2008-01
2008-01-31,1084630,8627,1076003,몰도바,2008-01
2008-01-31,1040087,181008,859079,우간다,2008-01
2008-01-31,1021786,10655,1011131,보스니아-헤르체고비나,2008-01
2008-01-31,920050,4789068,-3869018,스와질랜드,2008-01
2008-01-31,898440,8354,890086,레소토,2008-01
2008-01-31,894517,0,894517,에리트리아,2008-01
2008-01-31,863578,39275,824303,네덜란드 열도,2008-01
2008-01-31,735286,0,735286,바베이도스,2008-01
2008-01-31,732555,205728,526827,피지,2008-01
2008-01-31,712153,77,712076,벨리제,2008-01
2008-01-31,706059,83927,622132,시에라 리온,2008-01
2008-01-31,693065,4610,688455,아루바,2008-01
2008-01-31,646177,1102844,-456667,말라위,2008-01
2008-01-31,638393,198,638195,버뮤다,2008-01
2008-01-31,636772,0,636772,도미니카,2008-01
2008-01-31,630258,0,630258,지부티,2008-01
2008-01-31,627713,11090136,-10462423,가봉,2008-01
2008-01-31,584065,31483220,-30899155,잠비아,2008-01
2008-01-31,575581,14349,561232,세이쉘,2008-01
2008-01-31,566687,0,566687,마이크로네시아,2008-01
2008-01-31,479491,0,479491,불령 가이아나,2008-01
2008-01-31,463553,5137,458416,알바니아,2008-01
2008-01-31,421897,145374,276523,보츠와나,2008-01
2008-01-31,402444,40571,361873,모리타니,2008-01
2008-01-31,385086,12089,372997,바누아투,2008-01
2008-01-31,367962,923,367039,안도라,2008-01
2008-01-31,363967,0,363967,몰디브,2008-01
2008-01-31,307008,24527,282481,사모아,2008-01
2008-01-31,279711,591372,-311661,모나코,2008-01
2008-01-31,230000,359075,-129075,리히텐슈타인,2008-01
2008-01-31,225694,0,225694,영령 캐이맨 군도,2008-01
2008-01-31,218506,0,218506,팔라우,2008-01
2008-01-31,206309,5234,201075,마세도니아,2008-01
2008-01-31,163936,0,163936,감비아,2008-01
2008-01-31,157301,22399,134902,영령 버진군도,2008-01
2008-01-31,155107,0,155107,부탄,2008-01
2008-01-31,121449,23579698,-23458249,세인트 루시아,2008-01
2008-01-31,118824,0,118824,르완다,2008-01
2008-01-31,116951,34087,82864,바하마,2008-01
2008-01-31,90177,272,89905,지브랄타,2008-01
2008-01-31,70542,0,70542,기네비소,2008-01
2008-01-31,59877,0,59877,나미비아,2008-01
2008-01-31,57311,0,57311,투르크 & 카이코스 군도,2008-01
2008-01-31,54224,93941942,-93887718,적도 기니,2008-01
2008-01-31,53869,145015,-91146,말리,2008-01
2008-01-31,48673,308,48365,산마리노,2008-01
2008-01-31,44967,1828510,-1783543,솔로몬 군도,2008-01
2008-01-31,35327,0,35327,카보 베르데,2008-01
2008-01-31,33724,0,33724,안타티카,2008-01
2008-01-31,31750,0,31750,세인트 빈센트 그레나딘,2008-01
2008-01-31,28989,557014,-528025,니제르,2008-01
2008-01-31,25728,0,25728,쿡 아일랜드,2008-01
2008-01-31,22216,0,22216,메요트,2008-01
2008-01-31,19855,0,19855,세인트 키츠 네비스,2008-01
2008-01-31,16640,2664,13976,미령 버진군도,2008-01
2008-01-31,12408,0,12408,키리바티,2008-01
2008-01-31,9020,251,8769,티모르,2008-01
2008-01-31,6003,0,6003,부룬디,2008-01
2008-01-31,2028,0,2028,파로에 군도,2008-01
2008-01-31,1823,12779,-10956,토켈라우,2008-01
2008-01-31,884,0,884,크리스마스 아일랜드,2008-01
2008-01-31,700,101031,-100331,중앙아프리카공화국,2008-01
2008-01-31,239,6004,-5765,상토메 프린스페,2008-01
2008-01-31,160,0,160,그레나다,2008-01
2008-01-31,0,126,-126,챠드,2008-01
2008-01-31,0,79948,-79948,그린랜드,2008-01
2008-01-31,0,39095,-39095,피트카이른,2008-01
2008-01-31,0,6252,-6252,영령 인도양,2008-01
2008-01-31,0,29598,-29598,노폴크 아일랜드,2008-01
2008-01-31,0,7341632,-7341632,나우루,2008-01
2008-01-31,0,41464,-41464,통가,2008-01
2008-01-31,0,417,-417,몬트세라트,2008-01
2008-01-31,0,12882,-12882,앙귈라,2008-01
2008-02-29,6438014994,5101205008,1336809986,중국,2008-02
2008-02-29,3358817109,2921567618,437249491,미국,2008-02
2008-02-29,2253636083,5183126657,-2929490574,일본,2008-02
2008-02-29,1640103455,656920808,983182647,싱가포르,2008-02
2008-02-29,1324379893,166565113,1157814780,홍콩,2008-02
2008-02-29,1036638744,1027259481,9379263,독일,2008-02
2008-02-29,926231960,849759640,76472320,대만,2008-02
2008-02-29,778497250,444933190,333564060,러시아 연방,2008-02
2008-02-29,727507941,69924405,657583536,멕시코,2008-02
2008-02-29,653179193,185493412,467685781,노르웨이,2008-02
2008-02-29,634229972,425039966,209190006,인도,2008-02
2008-02-29,620235662,1203046761,-582811099,인도네시아,2008-02
2008-02-29,593735770,114028844,479706926,베트남,2008-02
2008-02-29,523774875,545293646,-21518771,이란,2008-02
2008-02-29,513459261,238703086,274756175,영국,2008-02
2008-02-29,467288691,265172333,202116358,브라질,2008-02
2008-02-29,461817776,1539855515,-1078037739,아랍에미리트 연합,2008-02
2008-02-29,446154493,304289998,141864495,태국,2008-02
2008-02-29,434266065,928597488,-494331423,말레이시아,2008-02
2008-02-29,367551291,1205433286,-837881995,호주,2008-02
2008-02-29,352824770,222569746,130255024,필리핀,2008-02
2008-02-29,344162313,25134721,319027592,폴란드,2008-02
2008-02-29,342123676,18481354,323642322,튀르키예,2008-02
2008-02-29,294844707,322655769,-27811062,이탈리아,2008-02
2008-02-29,284471407,2195834303,-1911362896,사우디아라비아,2008-02
2008-02-29,278379592,3549708,274829884,슬로바키아,2008-02
2008-02-29,277588241,314664535,-37076294,캐나다,2008-02
2008-02-29,265029593,344033004,-79003411,네덜란드,2008-02
2008-02-29,263060615,391753172,-128692557,칠레,2008-02
2008-02-29,249501506,67774073,181727433,스페인,2008-02
2008-02-29,248580968,334986535,-86405567,프랑스,2008-02
2008-02-29,189543528,93821748,95721780,벨기에,2008-02
2008-02-29,188973028,7322,188965706,라이베리아,2008-02
2008-02-29,163965110,91294427,72670683,핀란드,2008-02
2008-02-29,158760004,12180570,146579434,파나마,2008-02
2008-02-29,152505062,18172691,134332371,헝가리,2008-02
2008-02-29,152396834,0,152396834,앙골라,2008-02
2008-02-29,146407372,1155061112,-1008653740,카타르,2008-02
2008-02-29,143248968,30239204,113009764,우크라이나,2008-02
2008-02-29,112064107,122146102,-10081995,이집트,2008-02
2008-02-29,104625925,125614401,-20988476,남아프리카공화국,2008-02
2008-02-29,99368163,13875276,85492887,콜롬비아,2008-02
2008-02-29,85304690,332511,84972179,나이지리아,2008-02
2008-02-29,78453423,29436898,49016525,체코공화국,2008-02
2008-02-29,73056936,444201438,-371144502,오만,2008-02
2008-02-29,68606333,1011861,67594472,베네주엘라,2008-02
2008-02-29,68599196,53312344,15286852,이스라엘,2008-02
2008-02-29,68479084,2542843,65936241,루마니아,2008-02
2008-02-29,66787077,51004567,15782510,우즈베키스탄,2008-02
2008-02-29,66588213,8202227,58385986,몰타,2008-02
2008-02-29,59103863,3533907,55569956,방글라데시,2008-02
2008-02-29,58111811,685997107,-627885296,쿠웨이트,2008-02
2008-02-29,58033963,320075,57713888,시리아,2008-02
2008-02-29,56368707,90148643,-33779936,스웨덴,2008-02
2008-02-29,56292959,119407815,-63114856,페루,2008-02
2008-02-29,54345956,75374135,-21028179,파키스탄,2008-02
2008-02-29,53077877,61505370,-8427493,오스트리아,2008-02
2008-02-29,52572267,169815660,-117243393,알제리,2008-02
2008-02-29,50827700,95602841,-44775141,아르헨티나,2008-02
2008-02-29,47773811,96512415,-48738604,뉴질랜드,2008-02
2008-02-29,42198505,171511,42026994,리비아,2008-02
2008-02-29,42121493,7193028,34928465,요르단,2008-02
2008-02-29,40507775,58984516,-18476741,덴마크,2008-02
2008-02-29,40350902,0,40350902,마샬군도,2008-02
2008-02-29,38050716,7268259,30782457,그리스,2008-02
2008-02-29,37138841,4614239,32524602,안티가 바부다,2008-02
2008-02-29,36562418,74149746,-37587328,아일랜드,2008-02
2008-02-29,35757657,4073910,31683747,슬로베니아,2008-02
2008-02-29,35592839,6215014,29377825,포루투갈,2008-02
2008-02-29,30101713,9000,30092713,불령 폴리네시아,2008-02
2008-02-29,29986013,13582866,16403147,모로코,2008-02
2008-02-29,29928270,1877678,28050592,에쿠아도르,2008-02
2008-02-29,29848413,19245795,10602618,카자흐스탄,2008-02
2008-02-29,28347718,582542,27765176,쿠바,2008-02
2008-02-29,28168899,140333129,-112164230,스위스,2008-02
2008-02-29,27595670,17084391,10511279,과테말라,2008-02
2008-02-29,22656532,394837418,-372180886,이라크,2008-02
2008-02-29,22439388,1219498,21219890,캄보디아,2008-02
2008-02-29,18082034,71310,18010724,에티오피아,2008-02
2008-02-29,16838565,12959885,3878680,코스타리카,2008-02
2008-02-29,16738940,9649365,7089575,수단,2008-02
2008-02-29,15126891,3086750,12040141,몽골,2008-02
2008-02-29,15090467,1391629,13698838,레바논,2008-02
2008-02-29,14810001,5040987,9769014,스리랑카,2008-02
2008-02-29,13625953,904616,12721337,아제르바이잔,2008-02
2008-02-29,12914501,1581172,11333329,가나,2008-02
2008-02-29,12255758,2035342,10220416,라트비아,2008-02
2008-02-29,11661142,702851,10958291,리투아니아,2008-02
2008-02-29,11603526,23341994,-11738468,불가리아,2008-02
2008-02-29,11117386,1475700,9641686,온두라스,2008-02
2008-02-29,10777868,6597293,4180575,기타국,2008-02
2008-02-29,10480378,1995639,8484739,키르기스스탄,2008-02
2008-02-29,9676595,11415869,-1739274,예맨,2008-02
2008-02-29,9669368,2039396,7629972,도미니카 공화국,2008-02
2008-02-29,9608648,30876893,-21268245,바레인,2008-02
2008-02-29,9523382,32729173,-23205791,미얀마,2008-02
2008-02-29,9298907,537430,8761477,케냐,2008-02
2008-02-29,8886896,211495,8675401,니카라과,2008-02
2008-02-29,8605194,4099963,4505231,튀니지,2008-02
2008-02-29,8238568,126580,8111988,파라과이,2008-02
2008-02-29,7985557,191,7985366,코트디봐르,2008-02
2008-02-29,7911657,248559,7663098,조지아,2008-02
2008-02-29,7761629,91129,7670500,모리셔스,2008-02
2008-02-29,7199972,170224,7029748,엘살바도르,2008-02
2008-02-29,6947657,333431,6614226,크로아티아,2008-02
2008-02-29,5790337,140362,5649975,탄자니아,2008-02
2008-02-29,5700750,14805384,-9104634,푸에르토리코,2008-02
2008-02-29,5570981,43916438,-38345457,트리니다드 토바고,2008-02
2008-02-29,5530868,505828,5025040,에스토니아,2008-02
2008-02-29,5440212,2104051,3336161,뉴 칼레도니아,2008-02
2008-02-29,4928107,236699,4691408,모잠비크,2008-02
2008-02-29,4717000,507529,4209471,사이프러스,2008-02
2008-02-29,4657355,2341154,2316201,우루과이,2008-02
2008-02-29,4433324,530991,3902333,아이슬란드,2008-02
2008-02-29,4330699,108629,4222070,괌,2008-02
2008-02-29,4126059,2806771,1319288,라오스,2008-02
2008-02-29,4080901,358877,3722024,세네갈,2008-02
2008-02-29,3514421,245829,3268592,카메룬,2008-02
2008-02-29,3502067,817,3501250,콩고,2008-02
2008-02-29,3422582,1552,3421030,불령 리유니온 코모도 제도,2008-02
2008-02-29,3158202,42320,3115882,토고,2008-02
2008-02-29,3064369,439052,2625317,벨라루스,2008-02
2008-02-29,2928993,52399,2876594,마다카스카르,2008-02
2008-02-29,2824366,0,2824366,투르크멘,2008-02
2008-02-29,2457839,708688,1749151,아메리칸 사모아,2008-02
2008-02-29,2450374,0,2450374,콩고민주공화국,2008-02
2008-02-29,2398577,9314,2389263,레소토,2008-02
2008-02-29,2003707,138,2003569,아프카니스탄,2008-02
2008-02-29,1952470,0,1952470,베닝,2008-02
2008-02-29,1921046,0,1921046,타지크,2008-02
2008-02-29,1836377,775,1835602,지부티,2008-02
2008-02-29,1791546,13023,1778523,영령 버진군도,2008-02
2008-02-29,1774245,3374870,-1600625,스와질랜드,2008-02
2008-02-29,1695066,4150982,-2455916,가봉,2008-02
2008-02-29,1689269,100230,1589039,세르비아 와 몬테네그로,2008-02
2008-02-29,1664306,4976,1659330,아이티,2008-02
2008-02-29,1555077,3070,1552007,수리남,2008-02
2008-02-29,1529815,76653,1453162,몰도바,2008-02
2008-02-29,1529302,721361,807941,마카오,2008-02
2008-02-29,1516699,48610,1468089,네팔,2008-02
2008-02-29,1436543,153363965,-151927422,브루나이,2008-02
2008-02-29,1396759,0,1396759,바베이도스,2008-02
2008-02-29,1379586,52247,1327339,팔레스타인 해방기구(구),2008-02
2008-02-29,1366025,26862,1339163,마세도니아,2008-02
2008-02-29,1334722,565475,769247,기니,2008-02
2008-02-29,1229959,2852687,-1622728,룩셈부르그,2008-02
2008-02-29,1229797,15351239,-14121442,볼리비아,2008-02
2008-02-29,1217713,1131,1216582,바하마,2008-02
2008-02-29,1204020,626844,577176,자마이카,2008-02
2008-02-29,1102368,62964,1039404,과델로프,2008-02
2008-02-29,1087564,112664,974900,피지,2008-02
2008-02-29,1084073,0,1084073,마티니크,2008-02
2008-02-29,1052501,3294,1049207,유고,2008-02
2008-02-29,1039436,45968,993468,시에라 리온,2008-02
2008-02-29,1014930,85923,929007,세이쉘,2008-02
2008-02-29,969342,115297,854045,아루바,2008-02
2008-02-29,907243,246,906997,아르메니아,2008-02
2008-02-29,904248,12985,891263,북마리아나 군도,2008-02
2008-02-29,843087,0,843087,가이아나,2008-02
2008-02-29,779257,6918184,-6138927,파푸아 뉴기니,2008-02
2008-02-29,660651,0,660651,네덜란드 열도,2008-02
2008-02-29,622379,19140142,-18517763,잠비아,2008-02
2008-02-29,599130,17104,582026,알바니아,2008-02
2008-02-29,598169,73128,525041,우간다,2008-02
2008-02-29,594356,820057,-225701,버뮤다,2008-02
2008-02-29,552048,23000,529048,마이크로네시아,2008-02
2008-02-29,524273,0,524273,말라위,2008-02
2008-02-29,470894,102,470792,몰디브,2008-02
2008-02-29,430858,30689,400169,보스니아-헤르체고비나,2008-02
2008-02-29,408960,66118,342842,보츠와나,2008-02
2008-02-29,380921,433296,-52375,벨리제,2008-02
2008-02-29,336250,352412,-16162,리히텐슈타인,2008-02
2008-02-29,332926,916270,-583344,솔로몬 군도,2008-02
2008-02-29,303499,349,303150,부르키나 파소,2008-02
2008-02-29,252660,0,252660,부탄,2008-02
2008-02-29,222581,6297,216284,감비아,2008-02
2008-02-29,215304,0,215304,티모르,2008-02
2008-02-29,195178,200,194978,영령 캐이맨 군도,2008-02
2008-02-29,173687,352,173335,바누아투,2008-02
2008-02-29,166436,727,165709,안도라,2008-02
2008-02-29,153369,111,153258,세인트 루시아,2008-02
2008-02-29,147947,500734,-352787,모나코,2008-02
2008-02-29,145331,44643,100688,사모아,2008-02
2008-02-29,139113,5789775,-5650662,짐바브웨,2008-02
2008-02-29,131664,0,131664,팔라우,2008-02
2008-02-29,118382,0,118382,투르크 & 카이코스 군도,2008-02
2008-02-29,112392,0,112392,그레나다,2008-02
2008-02-29,107997,27373,80624,도미니카,2008-02
2008-02-29,97680,149516892,-149419212,적도 기니,2008-02
2008-02-29,94951,39603,55348,모리타니,2008-02
2008-02-29,83496,8886492,-8802996,나미비아,2008-02
2008-02-29,76698,0,76698,통가,2008-02
2008-02-29,76454,0,76454,불령 가이아나,2008-02
2008-02-29,73081,0,73081,파로에 군도,2008-02
2008-02-29,55802,0,55802,르완다,2008-02
2008-02-29,53433,0,53433,산마리노,2008-02
2008-02-29,48756,0,48756,지브랄타,2008-02
2008-02-29,47700,0,47700,챠드,2008-02
2008-02-29,41896,0,41896,노폴크 아일랜드,2008-02
2008-02-29,38850,0,38850,세인트 빈센트 그레나딘,2008-02
2008-02-29,35415,11111,24304,말리,2008-02
2008-02-29,33800,621923,-588123,니제르,2008-02
2008-02-29,21057,0,21057,투발루,2008-02
2008-02-29,16801,0,16801,메요트,2008-02
2008-02-29,4680,0,4680,쿡 아일랜드,2008-02
2008-02-29,2849,292,2557,미령 버진군도,2008-02
2008-02-29,735,0,735,에리트리아,2008-02
2008-02-29,688,81578,-80890,중앙아프리카공화국,2008-02
2008-02-29,176,0,176,기네비소,2008-02
2008-02-29,0,303858,-303858,그린랜드,2008-02
2008-02-29,0,47848,-47848,마이너 아우틀링 합중국 군도,2008-02
2008-02-29,0,18022,-18022,세인트 헬레나,2008-02
2008-02-29,0,4521187,-4521187,나우루,2008-02
2008-02-29,0,747,-747,몬트세라트,2008-02
2008-03-31,8338492479,6539855527,1798636952,중국,2008-03
2008-03-31,4086718207,3289728249,796989958,미국,2008-03
2008-03-31,2417451550,5600609749,-3183158199,일본,2008-03
2008-03-31,1677823064,205784009,1472039055,홍콩,2008-03
2008-03-31,1180756755,760245096,420511659,싱가포르,2008-03
2008-03-31,1026539149,949721361,76817788,대만,2008-03
2008-03-31,975676159,192668097,783008062,베트남,2008-03
2008-03-31,881450873,578388209,303062664,러시아 연방,2008-03
2008-03-31,867672697,1304221073,-436548376,독일,2008-03
2008-03-31,796818464,107563959,689254505,멕시코,2008-03
2008-03-31,757165038,505430274,251734764,인도,2008-03
2008-03-31,650956399,122714689,528241710,벨기에,2008-03
2008-03-31,645736361,285400682,360335679,네덜란드,2008-03
2008-03-31,509616487,294695831,214920656,영국,2008-03
2008-03-31,505839060,1258652618,-752813558,호주,2008-03
2008-03-31,503219575,359121503,144098072,태국,2008-03
2008-03-31,479432110,1164502157,-685070047,인도네시아,2008-03
2008-03-31,476374222,1003015766,-526641544,말레이시아,2008-03
2008-03-31,408553744,19489052,389064692,파나마,2008-03
2008-03-31,407349761,207743447,199606314,브라질,2008-03
2008-03-31,400949040,527884162,-126935122,이란,2008-03
2008-03-31,393201961,250395510,142806451,필리핀,2008-03
2008-03-31,391906740,1613857618,-1221950878,아랍에미리트 연합,2008-03
2008-03-31,386781879,433542091,-46760212,칠레,2008-03
2008-03-31,370344626,27204456,343140170,폴란드,2008-03
2008-03-31,353339811,78632288,274707523,스페인,2008-03
2008-03-31,351244817,382014349,-30769532,이탈리아,2008-03
2008-03-31,349135163,2611585413,-2262450250,사우디아라비아,2008-03
2008-03-31,344753812,375437940,-30684128,캐나다,2008-03
2008-03-31,326837492,24377266,302460226,튀르키예,2008-03
2008-03-31,315190481,449874241,-134683760,프랑스,2008-03
2008-03-31,277848619,8882779,268965840,슬로바키아,2008-03
2008-03-31,220269702,19804,220249898,라이베리아,2008-03
2008-03-31,186695752,1118962830,-932267078,카타르,2008-03
2008-03-31,180337105,86699344,93637761,핀란드,2008-03
2008-03-31,171220991,31254236,139966755,우크라이나,2008-03
2008-03-31,160351835,20688,160331147,바하마,2008-03
2008-03-31,158744281,34965535,123778746,헝가리,2008-03
2008-03-31,140231285,222055389,-81824104,남아프리카공화국,2008-03
2008-03-31,125054678,268175458,-143120780,이집트,2008-03
2008-03-31,124039601,1333360,122706241,그리스,2008-03
2008-03-31,109947254,8890470,101056784,몰타,2008-03
2008-03-31,105433572,20922727,84510845,콜롬비아,2008-03
2008-03-31,103244421,78785473,24458948,이스라엘,2008-03
2008-03-31,101090848,216512,100874336,나이지리아,2008-03
2008-03-31,83071378,45802446,37268932,체코공화국,2008-03
2008-03-31,80288237,1680151,78608086,우즈베키스탄,2008-03
2008-03-31,78782374,138783737,-60001363,알제리,2008-03
2008-03-31,72225353,83645922,-11420569,루마니아,2008-03
2008-03-31,70884603,528274,70356329,시리아,2008-03
2008-03-31,67765075,5140987,62624088,방글라데시,2008-03
2008-03-31,66079358,74380065,-8300707,오스트리아,2008-03
2008-03-31,63172797,75687416,-12514619,아일랜드,2008-03
2008-03-31,63082903,78280646,-15197743,파키스탄,2008-03
2008-03-31,62321458,2855884,59465574,슬로베니아,2008-03
2008-03-31,61959785,9287787,52671998,베네주엘라,2008-03
2008-03-31,60840767,492226236,-431385469,오만,2008-03
2008-03-31,58463691,114974108,-56510417,스웨덴,2008-03
2008-03-31,56231287,51218690,5012597,페루,2008-03
2008-03-31,55389674,4385650,51004024,모로코,2008-03
2008-03-31,54969474,265218,54704256,리비아,2008-03
2008-03-31,54854745,98030100,-43175355,뉴질랜드,2008-03
2008-03-31,54555749,183190526,-128634777,스위스,2008-03
2008-03-31,48501173,3276223,45224950,요르단,2008-03
2008-03-31,47589271,7072439,40516832,사이프러스,2008-03
2008-03-31,46339807,952980,45386827,에쿠아도르,2008-03
2008-03-31,44758499,18675290,26083209,아르헨티나,2008-03
2008-03-31,44476900,18079,44458821,니카라과,2008-03
2008-03-31,43192079,1234508763,-1191316684,쿠웨이트,2008-03
2008-03-31,39126852,164756541,-125629689,노르웨이,2008-03
2008-03-31,35254807,64015321,-28760514,덴마크,2008-03
2008-03-31,33613233,36891098,-3277865,카자흐스탄,2008-03
2008-03-31,33584394,6172132,27412262,포루투갈,2008-03
2008-03-31,31412682,14132215,17280467,과테말라,2008-03
2008-03-31,27482488,1308219,26174269,캄보디아,2008-03
2008-03-31,26563684,140719155,-114155471,이라크,2008-03
2008-03-31,23812004,1946605,21865399,몽골,2008-03
2008-03-31,22406181,14964054,7442127,불가리아,2008-03
2008-03-31,20604938,17345,20587593,앙골라,2008-03
2008-03-31,20510395,15937161,4573234,코스타리카,2008-03
2008-03-31,19409706,11827812,7581894,수단,2008-03
2008-03-31,19208504,71319,19137185,쿠바,2008-03
2008-03-31,17452067,40845179,-23393112,트리니다드 토바고,2008-03
2008-03-31,17394723,16554368,840355,바레인,2008-03
2008-03-31,17273620,6120179,11153441,스리랑카,2008-03
2008-03-31,16114665,4328887,11785778,크로아티아,2008-03
2008-03-31,16114599,1978016,14136583,아제르바이잔,2008-03
2008-03-31,14608325,91570,14516755,키르기스스탄,2008-03
2008-03-31,13884131,3748649,10135482,미얀마,2008-03
2008-03-31,13078936,1154588,11924348,레바논,2008-03
2008-03-31,13060767,4980154,8080613,기타국,2008-03
2008-03-31,12552214,1299698,11252516,라트비아,2008-03
2008-03-31,11423752,535366,10888386,케냐,2008-03
2008-03-31,11194103,4182939,7011164,온두라스,2008-03
2008-03-31,11002897,2575986,8426911,튀니지,2008-03
2008-03-31,10724585,1679954,9044631,가나,2008-03
2008-03-31,10608207,2941969,7666238,리투아니아,2008-03
2008-03-31,9905822,139358,9766464,세르비아 와 몬테네그로,2008-03
2008-03-31,9437633,17262621,-7824988,도미니카 공화국,2008-03
2008-03-31,8611661,2806155,5805506,에스토니아,2008-03
2008-03-31,8597523,3598162,4999361,우루과이,2008-03
2008-03-31,8487257,421171,8066086,예맨,2008-03
2008-03-31,8350578,89593,8260985,파라과이,2008-03
2008-03-31,8339599,0,8339599,마샬군도,2008-03
2008-03-31,7940666,387840,7552826,에티오피아,2008-03
2008-03-31,7510404,73154,7437250,조지아,2008-03
2008-03-31,7297329,4291086,3006243,나우루,2008-03
2008-03-31,6440427,273115,6167312,엘살바도르,2008-03
2008-03-31,6054362,3909,6050453,아프카니스탄,2008-03
2008-03-31,6044845,4643,6040202,불령 리유니온 코모도 제도,2008-03
2008-03-31,5435990,767159,4668831,벨라루스,2008-03
2008-03-31,5262247,231577,5030670,탄자니아,2008-03
2008-03-31,5200655,53504,5147151,뉴 칼레도니아,2008-03
2008-03-31,5197762,544737,4653025,자마이카,2008-03
2008-03-31,5124997,954021,4170976,팔레스타인 해방기구(구),2008-03
2008-03-31,5101404,137,5101267,코트디봐르,2008-03
2008-03-31,4896955,14865853,-9968898,푸에르토리코,2008-03
2008-03-31,4828855,126775150,-121946295,브루나이,2008-03
2008-03-31,4659621,10128427,-5468806,라오스,2008-03
2008-03-31,4358134,138592,4219542,콩고,2008-03
2008-03-31,4262115,0,4262115,지부티,2008-03
2008-03-31,4211506,1485486,2726020,세네갈,2008-03
2008-03-31,4176303,141574,4034729,피지,2008-03
2008-03-31,4148511,112978,4035533,괌,2008-03
2008-03-31,3506927,2067890,1439037,아이슬란드,2008-03
2008-03-31,3244759,37886,3206873,베닝,2008-03
2008-03-31,3228218,248589,2979629,모잠비크,2008-03
2008-03-31,3069960,495629,2574331,마카오,2008-03
2008-03-31,3006197,190134,2816063,아르메니아,2008-03
2008-03-31,2965141,90763,2874378,모리셔스,2008-03
2008-03-31,2957185,11968,2945217,타지크,2008-03
2008-03-31,2952977,0,2952977,마티니크,2008-03
2008-03-31,2549762,169936,2379826,마다카스카르,2008-03
2008-03-31,2518849,39647,2479202,레소토,2008-03
2008-03-31,2350568,224848,2125720,보스니아-헤르체고비나,2008-03
2008-03-31,2161084,391430,1769654,카메룬,2008-03
2008-03-31,2153909,31955,2121954,불령 폴리네시아,2008-03
2008-03-31,1969999,418403,1551596,아메리칸 사모아,2008-03
2008-03-31,1818945,186217,1632728,토고,2008-03
2008-03-31,1797110,46585921,-44788811,파푸아 뉴기니,2008-03
2008-03-31,1508743,10174572,-8665829,볼리비아,2008-03
2008-03-31,1494276,38337,1455939,네팔,2008-03
2008-03-31,1308042,5884498,-4576456,말라위,2008-03
2008-03-31,1305908,130990,1174918,콩고민주공화국,2008-03
2008-03-31,1284462,718764,565698,기니,2008-03
2008-03-31,1232716,5463,1227253,알바니아,2008-03
2008-03-31,1222191,553,1221638,네덜란드 열도,2008-03
2008-03-31,1219470,8717,1210753,수리남,2008-03
2008-03-31,1214590,6090665,-4876075,스와질랜드,2008-03
2008-03-31,1087787,0,1087787,과델로프,2008-03
2008-03-31,1062593,0,1062593,바베이도스,2008-03
2008-03-31,1051364,66417,984947,시에라 리온,2008-03
2008-03-31,1047328,11071,1036257,아이티,2008-03
2008-03-31,1033672,322554,711118,우간다,2008-03
2008-03-31,1004228,115,1004113,아루바,2008-03
2008-03-31,978093,2406120,-1428027,짐바브웨,2008-03
2008-03-31,902223,62697,839526,북마리아나 군도,2008-03
2008-03-31,856157,0,856157,마이크로네시아,2008-03
2008-03-31,853189,0,853189,투르크멘,2008-03
2008-03-31,832049,168484,663565,마세도니아,2008-03
2008-03-31,811027,1104624,-293597,버뮤다,2008-03
2008-03-31,810980,67890,743090,세이쉘,2008-03
2008-03-31,791964,307535,484429,몰도바,2008-03
2008-03-31,751600,6338980,-5587380,룩셈부르그,2008-03
2008-03-31,736533,236717,499816,가봉,2008-03
2008-03-31,720624,2472263,-1751639,안티가 바부다,2008-03
2008-03-31,695807,0,695807,모리타니,2008-03
2008-03-31,694610,132735,561875,보츠와나,2008-03
2008-03-31,670588,289102,381486,니제르,2008-03
2008-03-31,670284,450,669834,가이아나,2008-03
2008-03-31,640504,948,639556,도미니카,2008-03
2008-03-31,616298,0,616298,르완다,2008-03
2008-03-31,609998,70558,539440,말리,2008-03
2008-03-31,492367,24360,468007,사모아,2008-03
2008-03-31,453221,22803,430418,바누아투,2008-03
2008-03-31,398296,91349,306947,영령 버진군도,2008-03
2008-03-31,390864,0,390864,부르키나 파소,2008-03
2008-03-31,381858,5019,376839,에리트리아,2008-03
2008-03-31,380067,0,380067,부탄,2008-03
2008-03-31,373648,0,373648,영령 캐이맨 군도,2008-03
2008-03-31,352942,25254,327688,안도라,2008-03
2008-03-31,342830,608,342222,그레나다,2008-03
2008-03-31,295168,0,295168,불령 가이아나,2008-03
2008-03-31,289392,0,289392,세인트 루시아,2008-03
2008-03-31,240776,1426,239350,몰디브,2008-03
2008-03-31,226698,27146540,-26919842,잠비아,2008-03
2008-03-31,221869,1147207,-925338,벨리제,2008-03
2008-03-31,203419,0,203419,세인트 키츠 네비스,2008-03
2008-03-31,189674,508526,-318852,리히텐슈타인,2008-03
2008-03-31,174420,0,174420,앙귈라,2008-03
2008-03-31,153056,0,153056,코스 군도,2008-03
2008-03-31,148005,9932165,-9784160,나미비아,2008-03
2008-03-31,146379,11336,135043,팔라우,2008-03
2008-03-31,145160,0,145160,감비아,2008-03
2008-03-31,133728,0,133728,세인트 빈센트 그레나딘,2008-03
2008-03-31,124371,0,124371,투르크 & 카이코스 군도,2008-03
2008-03-31,86655,0,86655,부룬디,2008-03
2008-03-31,81778,0,81778,카보 베르데,2008-03
2008-03-31,62500,98026487,-97963987,적도 기니,2008-03
2008-03-31,56678,2403038,-2346360,솔로몬 군도,2008-03
2008-03-31,49868,0,49868,쿡 아일랜드,2008-03
2008-03-31,49795,95,49700,지브랄타,2008-03
2008-03-31,45303,0,45303,불령 남부지역,2008-03
2008-03-31,39033,0,39033,메요트,2008-03
2008-03-31,38810,785689,-746879,모나코,2008-03
2008-03-31,25146,0,25146,상토메 프린스페,2008-03
2008-03-31,15280,155,15125,미령 버진군도,2008-03
2008-03-31,200,44460,-44260,통가,2008-03
2008-03-31,0,76050,-76050,남조지아 & 남샌드위치 군도,2008-03
2008-03-31,0,135,-135,피트카이른,2008-03
2008-03-31,0,5450,-5450,챠드,2008-03
2008-03-31,0,1980,-1980,토켈라우,2008-03
2008-03-31,0,261718,-261718,그린랜드,2008-03
2008-03-31,0,539,-539,세인트 헬레나,2008-03
2008-03-31,0,276,-276,마이너 아우틀링 합중국 군도,2008-03
2008-04-30,8647030701,7140264219,1506766482,중국,2008-04
2008-04-30,4235371095,3602862392,632508703,미국,2008-04
2008-04-30,2493949572,5815769378,-3321819806,일본,2008-04
2008-04-30,1829490539,217257067,1612233472,홍콩,2008-04
2008-04-30,1361931658,763933374,597998284,싱가포르,2008-04
2008-04-30,1079278911,953369506,125909405,대만,2008-04
2008-04-30,1043070266,1406535105,-363464839,독일,2008-04
2008-04-30,913029366,803461716,109567650,러시아 연방,2008-04
2008-04-30,863718463,196211272,667507191,베트남,2008-04
2008-04-30,808684161,533182541,275501620,인도,2008-04
2008-04-30,763481442,94642369,668839073,멕시코,2008-04
2008-04-30,661415483,983085936,-321670453,인도네시아,2008-04
2008-04-30,574818899,1570535485,-995716586,아랍에미리트 연합,2008-04
2008-04-30,537290091,811643397,-274353306,말레이시아,2008-04
2008-04-30,514735332,317208703,197526629,태국,2008-04
2008-04-30,510824458,649328942,-138504484,이란,2008-04
2008-04-30,493652914,299889238,193763676,영국,2008-04
2008-04-30,485631255,256071167,229560088,브라질,2008-04
2008-04-30,482588030,292541640,190046390,필리핀,2008-04
2008-04-30,437722965,1387048223,-949325258,호주,2008-04
2008-04-30,420233729,85906886,334326843,파나마,2008-04
2008-04-30,413056513,2564869431,-2151812918,사우디아라비아,2008-04
2008-04-30,404319857,35476459,368843398,튀르키예,2008-04
2008-04-30,393592443,458957579,-65365136,프랑스,2008-04
2008-04-30,381433137,28271994,353161143,폴란드,2008-04
2008-04-30,375765509,337585684,38179825,캐나다,2008-04
2008-04-30,372172419,365420563,6751856,이탈리아,2008-04
2008-04-30,339421777,347580179,-8158402,네덜란드,2008-04
2008-04-30,338948878,32351,338916527,바하마,2008-04
2008-04-30,314829104,5362233,309466871,슬로바키아,2008-04
2008-04-30,289455950,127588597,161867353,스페인,2008-04
2008-04-30,273355890,12414558,260941332,몰타,2008-04
2008-04-30,243997873,112467910,131529963,벨기에,2008-04
2008-04-30,236469621,0,236469621,마샬군도,2008-04
2008-04-30,234739645,804572,233935073,사이프러스,2008-04
2008-04-30,208207355,76756300,131451055,핀란드,2008-04
2008-04-30,204660972,54244110,150416862,우크라이나,2008-04
2008-04-30,178209696,203538,178006158,라이베리아,2008-04
2008-04-30,173473416,327547052,-154073636,칠레,2008-04
2008-04-30,160744202,22784186,137960016,헝가리,2008-04
2008-04-30,148048103,87385233,60662870,이집트,2008-04
2008-04-30,124134754,208120803,-83986049,남아프리카공화국,2008-04
2008-04-30,103446529,180367,103266162,나이지리아,2008-04
2008-04-30,99833421,48468721,51364700,파키스탄,2008-04
2008-04-30,91324761,13638501,77686260,콜롬비아,2008-04
2008-04-30,90997618,26143261,64854357,우즈베키스탄,2008-04
2008-04-30,90371234,110890863,-20519629,이스라엘,2008-04
2008-04-30,87763276,1180867555,-1093104279,카타르,2008-04
2008-04-30,86787112,451737957,-364950845,오만,2008-04
2008-04-30,86025300,127269626,-41244326,노르웨이,2008-04
2008-04-30,85589653,100903506,-15313853,뉴질랜드,2008-04
2008-04-30,85092393,157055530,-71963137,알제리,2008-04
2008-04-30,76467405,3776063,72691342,슬로베니아,2008-04
2008-04-30,76193588,69781887,6411701,아일랜드,2008-04
2008-04-30,74518139,6025196,68492943,방글라데시,2008-04
2008-04-30,72078895,944733,71134162,베네주엘라,2008-04
2008-04-30,71513222,5171518,66341704,스리랑카,2008-04
2008-04-30,70224917,143458624,-73233707,스웨덴,2008-04
2008-04-30,68394149,43288922,25105227,체코공화국,2008-04
2008-04-30,67417512,24002030,43415482,루마니아,2008-04
2008-04-30,65957171,61214,65895957,리비아,2008-04
2008-04-30,59494475,863916,58630559,시리아,2008-04
2008-04-30,59134008,6809071,52324937,그리스,2008-04
2008-04-30,58378114,70570387,-12192273,페루,2008-04
2008-04-30,51218646,7661648,43556998,포루투갈,2008-04
2008-04-30,49461820,27211033,22250787,아르헨티나,2008-04
2008-04-30,49321911,2730317,46591594,요르단,2008-04
2008-04-30,47611289,80548300,-32937011,오스트리아,2008-04
2008-04-30,47236709,1116701895,-1069465186,쿠웨이트,2008-04
2008-04-30,41228783,2325329,38903454,에쿠아도르,2008-04
2008-04-30,37986593,64887,37921706,쿠바,2008-04
2008-04-30,35397403,56827654,-21430251,덴마크,2008-04
2008-04-30,34529597,144774,34384823,괌,2008-04
2008-04-30,34003767,174343024,-140339257,스위스,2008-04
2008-04-30,33593372,10550569,23042803,코스타리카,2008-04
2008-04-30,32753662,15213836,17539826,모로코,2008-04
2008-04-30,29459841,1095015,28364826,캄보디아,2008-04
2008-04-30,26899640,97222,26802418,몽골,2008-04
2008-04-30,26430191,3886927,22543264,과테말라,2008-04
2008-04-30,23449496,30481078,-7031582,카자흐스탄,2008-04
2008-04-30,22160934,237886949,-215726015,이라크,2008-04
2008-04-30,21480151,2787534,18692617,아제르바이잔,2008-04
2008-04-30,20926283,595267,20331016,가나,2008-04
2008-04-30,20144370,33748915,-13604545,바레인,2008-04
2008-04-30,20118686,9088567,11030119,스와질랜드,2008-04
2008-04-30,18365891,90914,18274977,앙골라,2008-04
2008-04-30,16236080,1878652,14357428,불가리아,2008-04
2008-04-30,16190768,320470,15870298,니카라과,2008-04
2008-04-30,15689239,1148382,14540857,라트비아,2008-04
2008-04-30,15434218,2964640,12469578,레바논,2008-04
2008-04-30,14959332,50766738,-35807406,수단,2008-04
2008-04-30,14502376,3153537,11348839,도미니카 공화국,2008-04
2008-04-30,13878952,18492,13860460,키르기스스탄,2008-04
2008-04-30,13273013,2374477,10898536,에스토니아,2008-04
2008-04-30,12973091,626613,12346478,케냐,2008-04
2008-04-30,12131300,4905470,7225830,온두라스,2008-04
2008-04-30,11781406,37233,11744173,아프카니스탄,2008-04
2008-04-30,11773182,181251,11591931,크로아티아,2008-04
2008-04-30,11744744,5765131,5979613,기타국,2008-04
2008-04-30,11489111,5005435,6483676,미얀마,2008-04
2008-04-30,10672846,693024,9979822,리투아니아,2008-04
2008-04-30,10609593,14146050,-3536457,푸에르토리코,2008-04
2008-04-30,10155670,2418077,7737593,튀니지,2008-04
2008-04-30,10030413,6169159,3861254,우루과이,2008-04
2008-04-30,9129681,952226,8177455,예맨,2008-04
2008-04-30,7884743,64433,7820310,에티오피아,2008-04
2008-04-30,7021377,287494,6733883,라오스,2008-04
2008-04-30,7007977,474865,6533112,조지아,2008-04
2008-04-30,6863725,45254,6818471,코트디봐르,2008-04
2008-04-30,6649195,94530,6554665,마다카스카르,2008-04
2008-04-30,6273213,36313406,-30040193,트리니다드 토바고,2008-04
2008-04-30,6047305,193379,5853926,파라과이,2008-04
2008-04-30,5750092,124365,5625727,탄자니아,2008-04
2008-04-30,5708514,69485,5639029,뉴 칼레도니아,2008-04
2008-04-30,5477424,450949,5026475,베닝,2008-04
2008-04-30,5106314,0,5106314,부르키나 파소,2008-04
2008-04-30,4776940,206964,4569976,엘살바도르,2008-04
2008-04-30,4667235,35938,4631297,세르비아 와 몬테네그로,2008-04
2008-04-30,4357827,2535328,1822499,벨라루스,2008-04
2008-04-30,4286084,266284,4019800,카메룬,2008-04
2008-04-30,4235661,126500105,-122264444,브루나이,2008-04
2008-04-30,4014127,0,4014127,불령 리유니온 코모도 제도,2008-04
2008-04-30,3669305,1246068,2423237,아이슬란드,2008-04
2008-04-30,3606148,81928,3524220,피지,2008-04
2008-04-30,3553817,4089,3549728,레소토,2008-04
2008-04-30,3444921,492839,2952082,몰도바,2008-04
2008-04-30,3330462,442994,2887468,모리셔스,2008-04
2008-04-30,3302364,3826402,-524038,나우루,2008-04
2008-04-30,3288275,513138,2775137,세네갈,2008-04
2008-04-30,3268233,0,3268233,지부티,2008-04
2008-04-30,3080155,49565702,-46485547,볼리비아,2008-04
2008-04-30,3055527,0,3055527,콩고,2008-04
2008-04-30,2901092,256803,2644289,모잠비크,2008-04
2008-04-30,2830988,15995,2814993,타지크,2008-04
2008-04-30,2802751,426318,2376433,마카오,2008-04
2008-04-30,2584027,31740,2552287,네팔,2008-04
2008-04-30,2549209,54005,2495204,불령 폴리네시아,2008-04
2008-04-30,2476530,137089,2339441,보스니아-헤르체고비나,2008-04
2008-04-30,2124878,1096563,1028315,파푸아 뉴기니,2008-04
2008-04-30,1893303,2100,1891203,아르메니아,2008-04
2008-04-30,1842324,670273,1172051,콩고민주공화국,2008-04
2008-04-30,1812726,619098,1193628,자마이카,2008-04
2008-04-30,1741993,20788587,-19046594,가봉,2008-04
2008-04-30,1677535,0,1677535,아메리칸 사모아,2008-04
2008-04-30,1671754,357453,1314301,토고,2008-04
2008-04-30,1642301,138895,1503406,수리남,2008-04
2008-04-30,1541724,707374,834350,팔레스타인 해방기구(구),2008-04
2008-04-30,1535595,2972,1532623,도미니카,2008-04
2008-04-30,1442202,1746,1440456,아이티,2008-04
2008-04-30,1265686,34896,1230790,네덜란드 열도,2008-04
2008-04-30,1241371,854581,386790,기니,2008-04
2008-04-30,1184548,0,1184548,과델로프,2008-04
2008-04-30,1134424,557876,576548,짐바브웨,2008-04
2008-04-30,1074535,5138211,-4063676,룩셈부르그,2008-04
2008-04-30,1058719,59703,999016,알바니아,2008-04
2008-04-30,1017585,35527135,-34509550,잠비아,2008-04
2008-04-30,895697,0,895697,마티니크,2008-04
2008-04-30,853184,380,852804,가이아나,2008-04
2008-04-30,838847,18993,819854,투르크멘,2008-04
2008-04-30,832204,35638,796566,북마리아나 군도,2008-04
2008-04-30,810685,58279,752406,사모아,2008-04
2008-04-30,753826,4314152,-3560326,말라위,2008-04
2008-04-30,723381,50,723331,모리타니,2008-04
2008-04-30,684219,261456,422763,마세도니아,2008-04
2008-04-30,680305,0,680305,바베이도스,2008-04
2008-04-30,670096,0,670096,아루바,2008-04
2008-04-30,642732,161128,481604,보츠와나,2008-04
2008-04-30,641695,0,641695,마이크로네시아,2008-04
2008-04-30,637679,44224,593455,세이쉘,2008-04
2008-04-30,598146,0,598146,버뮤다,2008-04
2008-04-30,553266,466960,86306,우간다,2008-04
2008-04-30,529312,2056,527256,벨리제,2008-04
2008-04-30,443445,0,443445,미령 버진군도,2008-04
2008-04-30,436610,82,436528,말리,2008-04
2008-04-30,365859,0,365859,부탄,2008-04
2008-04-30,358891,4597238,-4238347,안티가 바부다,2008-04
2008-04-30,352680,46191,306489,몰디브,2008-04
2008-04-30,328265,43774,284491,시에라 리온,2008-04
2008-04-30,305036,16956,288080,세인트 루시아,2008-04
2008-04-30,298757,628786,-330029,바누아투,2008-04
2008-04-30,275696,0,275696,영령 캐이맨 군도,2008-04
2008-04-30,271392,754466,-483074,솔로몬 군도,2008-04
2008-04-30,237630,0,237630,에리트리아,2008-04
2008-04-30,212395,396708,-184313,리히텐슈타인,2008-04
2008-04-30,196930,0,196930,감비아,2008-04
2008-04-30,187840,28794,159046,니제르,2008-04
2008-04-30,173131,0,173131,불령 가이아나,2008-04
2008-04-30,170176,0,170176,팔라우,2008-04
2008-04-30,141282,0,141282,그레나다,2008-04
2008-04-30,135322,0,135322,몬트세라트,2008-04
2008-04-30,124000,227,123773,세인트 키츠 네비스,2008-04
2008-04-30,111750,0,111750,영령 버진군도,2008-04
2008-04-30,90850,90014088,-89923238,적도 기니,2008-04
2008-04-30,84162,128,84034,투르크 & 카이코스 군도,2008-04
2008-04-30,72864,33401,39463,중앙아프리카공화국,2008-04
2008-04-30,56911,638956,-582045,모나코,2008-04
2008-04-30,56646,0,56646,기네비소,2008-04
2008-04-30,41964,599,41365,르완다,2008-04
2008-04-30,35126,0,35126,산마리노,2008-04
2008-04-30,30083,0,30083,카보 베르데,2008-04
2008-04-30,28248,0,28248,키리바티,2008-04
2008-04-30,24334,0,24334,지브랄타,2008-04
2008-04-30,21144,50,21094,세인트 빈센트 그레나딘,2008-04
2008-04-30,17161,0,17161,투발루,2008-04
2008-04-30,14441,1796251,-1781810,나미비아,2008-04
2008-04-30,1214,0,1214,소말리아,2008-04
2008-04-30,770,131,639,포클랜드 군도,2008-04
2008-04-30,395,214112,-213717,안도라,2008-04
2008-04-30,200,0,200,통가,2008-04
2008-04-30,90,24,66,앙귈라,2008-04
2008-04-30,0,9990,-9990,티모르,2008-04
2008-04-30,0,428,-428,영령 인도양,2008-04
2008-04-30,0,279893,-279893,그린랜드,2008-04
2008-04-30,0,76050,-76050,남조지아 & 남샌드위치 군도,2008-04
2008-04-30,0,3798,-3798,토켈라우,2008-04
2008-04-30,0,1450,-1450,코스 군도,2008-04
2008-04-30,0,1745,-1745,마이너 아우틀링 합중국 군도,2008-04
2008-04-30,0,188,-188,상토메 프린스페,2008-04
2008-05-31,8914537354,6937567264,1976970090,중국,2008-05
2008-05-31,3870187590,3529138634,341048956,미국,2008-05
2008-05-31,2520171535,5335648451,-2815476916,일본,2008-05
2008-05-31,1740411049,191231949,1549179100,홍콩,2008-05
2008-05-31,1603934298,711905471,892028827,싱가포르,2008-05
2008-05-31,1412828911,400962,1412427949,나이지리아,2008-05
2008-05-31,1135278877,785541438,349737439,러시아 연방,2008-05
2008-05-31,1125555561,999359295,126196266,대만,2008-05
2008-05-31,824006994,1279202525,-455195531,독일,2008-05
2008-05-31,806142883,319876700,486266183,영국,2008-05
2008-05-31,793969358,74183096,719786262,멕시코,2008-05
2008-05-31,773305344,683545253,89760091,인도,2008-05
2008-05-31,713098584,1085628775,-372530191,인도네시아,2008-05
2008-05-31,622252498,220469492,401783006,베트남,2008-05
2008-05-31,615779242,323296240,292483002,브라질,2008-05
2008-05-31,579799989,151963,579648026,바하마,2008-05
2008-05-31,541959513,178307821,363651692,네덜란드,2008-05
2008-05-31,523140517,935259685,-412119168,말레이시아,2008-05
2008-05-31,476179141,352956039,123223102,태국,2008-05
2008-05-31,474612529,90,474612439,마샬군도,2008-05
2008-05-31,455162679,1329625357,-874462678,호주,2008-05
2008-05-31,449901416,1691173597,-1241272181,아랍에미리트 연합,2008-05
2008-05-31,440479089,286887790,153591299,필리핀,2008-05
2008-05-31,415609113,3255330211,-2839721098,사우디아라비아,2008-05
2008-05-31,410062502,407794758,2267744,이란,2008-05
2008-05-31,365519924,295247744,70272180,이탈리아,2008-05
2008-05-31,357086022,28687526,328398496,폴란드,2008-05
2008-05-31,340373220,131349760,209023460,벨기에,2008-05
2008-05-31,336824995,408526110,-71701115,캐나다,2008-05
2008-05-31,331870102,434696633,-102826531,프랑스,2008-05
2008-05-31,301990903,69334117,232656786,스페인,2008-05
2008-05-31,292324403,45191939,247132464,튀르키예,2008-05
2008-05-31,275209025,5651965,269557060,슬로바키아,2008-05
2008-05-31,254820069,393562324,-138742255,칠레,2008-05
2008-05-31,245687900,112303346,133384554,핀란드,2008-05
2008-05-31,219791041,52978,219738063,라이베리아,2008-05
2008-05-31,177886624,187321130,-9434506,파나마,2008-05
2008-05-31,175473761,23737511,151736250,우크라이나,2008-05
2008-05-31,160952789,35854498,125098291,헝가리,2008-05
2008-05-31,154499630,5768469,148731161,사이프러스,2008-05
2008-05-31,147673253,3089287,144583966,그리스,2008-05
2008-05-31,143259732,164561155,-21301423,남아프리카공화국,2008-05
2008-05-31,136790150,17793810,118996340,방글라데시,2008-05
2008-05-31,127486576,136832208,-9345632,이집트,2008-05
2008-05-31,126911099,31911096,95000003,바레인,2008-05
2008-05-31,110301119,10522382,99778737,몰타,2008-05
2008-05-31,99886011,219510150,-119624139,노르웨이,2008-05
2008-05-31,98325447,27333201,70992246,우즈베키스탄,2008-05
2008-05-31,96670993,75518764,21152229,이스라엘,2008-05
2008-05-31,82955970,6033833,76922137,슬로베니아,2008-05
2008-05-31,81258069,1305237965,-1223979896,카타르,2008-05
2008-05-31,79046156,9992492,69053664,콜롬비아,2008-05
2008-05-31,78824413,4498547,74325866,스리랑카,2008-05
2008-05-31,75380352,32908373,42471979,파키스탄,2008-05
2008-05-31,74889697,4727688,70162009,루마니아,2008-05
2008-05-31,62807746,82413038,-19605292,페루,2008-05
2008-05-31,60791284,34784753,26006531,체코공화국,2008-05
2008-05-31,60582265,1008320158,-947737893,쿠웨이트,2008-05
2008-05-31,60551093,590884795,-530333702,오만,2008-05
2008-05-31,59666680,128179597,-68512917,스웨덴,2008-05
2008-05-31,58081127,56530590,1550537,알제리,2008-05
2008-05-31,57625756,839355,56786401,시리아,2008-05
2008-05-31,56011332,1376891,54634441,에쿠아도르,2008-05
2008-05-31,53344881,785967,52558914,리비아,2008-05
2008-05-31,51523392,27528944,23994448,아르헨티나,2008-05
2008-05-31,50398928,1642406,48756522,베네주엘라,2008-05
2008-05-31,47755696,1668426,46087270,요르단,2008-05
2008-05-31,43006060,83005415,-39999355,아일랜드,2008-05
2008-05-31,42074737,108890483,-66815746,뉴질랜드,2008-05
2008-05-31,40416769,64266,40352503,쿠바,2008-05
2008-05-31,39961608,439143519,-399181911,이라크,2008-05
2008-05-31,38463282,6467104,31996178,포루투갈,2008-05
2008-05-31,32534899,70687466,-38152567,오스트리아,2008-05
2008-05-31,30895297,452194,30443103,캄보디아,2008-05
2008-05-31,30806332,157248301,-126441969,스위스,2008-05
2008-05-31,30088993,42128275,-12039282,모로코,2008-05
2008-05-31,29197070,40047265,-10850195,카자흐스탄,2008-05
2008-05-31,26798064,6186724,20611340,코스타리카,2008-05
2008-05-31,23906857,705553,23201304,과테말라,2008-05
2008-05-31,22840011,898652,21941359,아제르바이잔,2008-05
2008-05-31,21837836,69916368,-48078532,덴마크,2008-05
2008-05-31,21811558,2909109,18902449,몽골,2008-05
2008-05-31,19101990,1402964,17699026,라트비아,2008-05
2008-05-31,18594064,1754707,16839357,안티가 바부다,2008-05
2008-05-31,16991199,2473262,14517937,불가리아,2008-05
2008-05-31,16287533,90376,16197157,앙골라,2008-05
2008-05-31,16076458,4932401,11144057,에스토니아,2008-05
2008-05-31,15894164,588901,15305263,가나,2008-05
2008-05-31,13799585,3314695,10484890,레바논,2008-05
2008-05-31,13596373,2904846,10691527,도미니카 공화국,2008-05
2008-05-31,13400470,4289769,9110701,기타국,2008-05
2008-05-31,13265542,2424,13263118,키르기스스탄,2008-05
2008-05-31,13091066,2095521,10995545,튀니지,2008-05
2008-05-31,12308418,105766,12202652,니카라과,2008-05
2008-05-31,11206468,1390542,9815926,수단,2008-05
2008-05-31,10668553,1634794,9033759,크로아티아,2008-05
2008-05-31,10455026,4540570,5914456,온두라스,2008-05
2008-05-31,9467895,767172,8700723,케냐,2008-05
2008-05-31,8562085,27948,8534137,세르비아 와 몬테네그로,2008-05
2008-05-31,8403974,40157035,-31753061,미얀마,2008-05
2008-05-31,8311109,605251,7705858,예맨,2008-05
2008-05-31,7215857,42225,7173632,아프카니스탄,2008-05
2008-05-31,7025727,517329,6508398,조지아,2008-05
2008-05-31,6954493,242226,6712267,코트디봐르,2008-05
2008-05-31,6829454,143740,6685714,에티오피아,2008-05
2008-05-31,6443781,1404537,5039244,리투아니아,2008-05
2008-05-31,6191926,44692,6147234,파라과이,2008-05
2008-05-31,6124408,0,6124408,레소토,2008-05
2008-05-31,5962255,14129876,-8167621,트리니다드 토바고,2008-05
2008-05-31,5954934,14524524,-8569590,푸에르토리코,2008-05
2008-05-31,5909609,576017,5333592,엘살바도르,2008-05
2008-05-31,5861005,5992953,-131948,우루과이,2008-05
2008-05-31,5834337,123170,5711167,탄자니아,2008-05
2008-05-31,5806723,2677,5804046,뉴 칼레도니아,2008-05
2008-05-31,5549752,2430549,3119203,벨라루스,2008-05
2008-05-31,5033545,0,5033545,베닝,2008-05
2008-05-31,4819132,98883,4720249,마다카스카르,2008-05
2008-05-31,4170545,85338039,-81167494,카메룬,2008-05
2008-05-31,4112878,171148,3941730,라오스,2008-05
2008-05-31,3849764,2161,3847603,니제르,2008-05
2008-05-31,3498751,118762,3379989,팔레스타인 해방기구(구),2008-05
2008-05-31,3455697,183600,3272097,모리셔스,2008-05
2008-05-31,3207954,0,3207954,불령 리유니온 코모도 제도,2008-05
2008-05-31,3099905,50653,3049252,토고,2008-05
2008-05-31,2983660,128988737,-126005077,브루나이,2008-05
2008-05-31,2599742,21209,2578533,보스니아-헤르체고비나,2008-05
2008-05-31,2584360,137465,2446895,피지,2008-05
2008-05-31,2490623,101534806,-99044183,콩고,2008-05
2008-05-31,2423438,34951,2388487,알바니아,2008-05
2008-05-31,2319148,949983,1369165,타지크,2008-05
2008-05-31,2315849,289089,2026760,세네갈,2008-05
2008-05-31,2274981,0,2274981,마티니크,2008-05
2008-05-31,2116753,0,2116753,지부티,2008-05
2008-05-31,2102670,31441,2071229,투르크멘,2008-05
2008-05-31,2072351,55167103,-53094752,잠비아,2008-05
2008-05-31,2053335,23971,2029364,괌,2008-05
2008-05-31,1939536,0,1939536,미령 버진군도,2008-05
2008-05-31,1882597,45038303,-43155706,파푸아 뉴기니,2008-05
2008-05-31,1627420,3870,1623550,수리남,2008-05
2008-05-31,1611889,830538,781351,자마이카,2008-05
2008-05-31,1576009,6892115,-5316106,스와질랜드,2008-05
2008-05-31,1483434,652276,831158,마카오,2008-05
2008-05-31,1448722,121604,1327118,가봉,2008-05
2008-05-31,1436352,164771,1271581,네팔,2008-05
2008-05-31,1328383,936911,391472,아이슬란드,2008-05
2008-05-31,1252557,55999,1196558,몰도바,2008-05
2008-05-31,1187768,1066,1186702,네덜란드 열도,2008-05
2008-05-31,1163457,48077,1115380,모리타니,2008-05
2008-05-31,1152974,947120,205854,콩고민주공화국,2008-05
2008-05-31,1135654,226547,909107,아메리칸 사모아,2008-05
2008-05-31,1091078,293851,797227,모잠비크,2008-05
2008-05-31,1023637,14757,1008880,불령 폴리네시아,2008-05
2008-05-31,975265,1690108,-714843,말라위,2008-05
2008-05-31,971306,0,971306,가이아나,2008-05
2008-05-31,912704,200400,712304,북마리아나 군도,2008-05
2008-05-31,885826,9212,876614,도미니카,2008-05
2008-05-31,864572,360,864212,아르메니아,2008-05
2008-05-31,793271,31200442,-30407171,볼리비아,2008-05
2008-05-31,738708,0,738708,아이티,2008-05
2008-05-31,706971,55659,651312,마이크로네시아,2008-05
2008-05-31,700874,775195,-74321,기니,2008-05
2008-05-31,665674,429043,236631,세이쉘,2008-05
2008-05-31,642970,15357,627613,마세도니아,2008-05
2008-05-31,542520,4296027,-3753507,룩셈부르그,2008-05
2008-05-31,531088,773,530315,안도라,2008-05
2008-05-31,521245,14028,507217,영령 버진군도,2008-05
2008-05-31,510921,53486,457435,바누아투,2008-05
2008-05-31,496040,24120,471920,사모아,2008-05
2008-05-31,491194,1535191,-1043997,벨리제,2008-05
2008-05-31,440703,67857,372846,보츠와나,2008-05
2008-05-31,435078,0,435078,과델로프,2008-05
2008-05-31,378985,6925,372060,몰디브,2008-05
2008-05-31,371277,0,371277,세인트 루시아,2008-05
2008-05-31,349124,5223,343901,에리트리아,2008-05
2008-05-31,332772,0,332772,불령 가이아나,2008-05
2008-05-31,322696,2530843,-2208147,솔로몬 군도,2008-05
2008-05-31,319896,1277295,-957399,버뮤다,2008-05
2008-05-31,304776,160,304616,아루바,2008-05
2008-05-31,302567,526800,-224233,리히텐슈타인,2008-05
2008-05-31,234087,0,234087,부탄,2008-05
2008-05-31,213075,413424,-200349,우간다,2008-05
2008-05-31,212094,0,212094,바베이도스,2008-05
2008-05-31,198380,0,198380,르완다,2008-05
2008-05-31,196680,0,196680,적도 기니,2008-05
2008-05-31,177436,0,177436,감비아,2008-05
2008-05-31,166114,53657,112457,시에라 리온,2008-05
2008-05-31,161225,0,161225,팔라우,2008-05
2008-05-31,147971,0,147971,그레나다,2008-05
2008-05-31,84202,0,84202,세인트 빈센트 그레나딘,2008-05
2008-05-31,83675,1745,81930,산마리노,2008-05
2008-05-31,81010,0,81010,말리,2008-05
2008-05-31,71412,0,71412,영령 캐이맨 군도,2008-05
2008-05-31,54824,0,54824,카보 베르데,2008-05
2008-05-31,53688,884559,-830871,모나코,2008-05
2008-05-31,52742,0,52742,지브랄타,2008-05
2008-05-31,50016,1338268,-1288252,나미비아,2008-05
2008-05-31,49006,1487967,-1438961,짐바브웨,2008-05
2008-05-31,43786,0,43786,불령 남부지역,2008-05
2008-05-31,33285,148,33137,몬트세라트,2008-05
2008-05-31,32322,0,32322,부르키나 파소,2008-05
2008-05-31,15522,0,15522,부룬디,2008-05
2008-05-31,12776,0,12776,파로에 군도,2008-05
2008-05-31,7792,6868510,-6860718,나우루,2008-05
2008-05-31,6915,7704,-789,토켈라우,2008-05
2008-05-31,6600,0,6600,키리바티,2008-05
2008-05-31,6440,0,6440,코스 군도,2008-05
2008-05-31,3290,0,3290,포클랜드 군도,2008-05
2008-05-31,2544,69400,-66856,그린랜드,2008-05
2008-05-31,1279,0,1279,투르크 & 카이코스 군도,2008-05
2008-05-31,284,0,284,기네비소,2008-05
2008-05-31,204,0,204,챠드,2008-05
2008-05-31,0,15368,-15368,세인트 키츠 네비스,2008-05
2008-05-31,0,42824,-42824,중앙아프리카공화국,2008-05
2008-05-31,0,1102,-1102,세인트 헬레나,2008-05
2008-06-30,8713123386,6843920537,1869202849,중국,2008-06
2008-06-30,4215345208,3230839636,984505572,미국,2008-06
2008-06-30,2597267421,5167967919,-2570700498,일본,2008-06
2008-06-30,1780621678,189784621,1590837057,홍콩,2008-06
2008-06-30,1719712917,713514618,1006198299,싱가포르,2008-06
2008-06-30,1091674735,961508340,130166395,대만,2008-06
2008-06-30,868562250,554432336,314129914,러시아 연방,2008-06
2008-06-30,808240673,101747196,706493477,멕시코,2008-06
2008-06-30,791833046,164581006,627252040,베트남,2008-06
2008-06-30,759886385,5281,759881104,마샬군도,2008-06
2008-06-30,751953923,1254520691,-502566768,독일,2008-06
2008-06-30,679102388,581370827,97731561,인도,2008-06
2008-06-30,638660547,14896166,623764381,파나마,2008-06
2008-06-30,607682215,984323431,-376641216,인도네시아,2008-06
2008-06-30,533821814,2095068964,-1561247150,아랍에미리트 연합,2008-06
2008-06-30,516078243,309318826,206759417,태국,2008-06
2008-06-30,511469386,753730673,-242261287,말레이시아,2008-06
2008-06-30,507572712,305370092,202202620,브라질,2008-06
2008-06-30,446209022,3319559374,-2873350352,사우디아라비아,2008-06
2008-06-30,436785371,254862296,181923075,필리핀,2008-06
2008-06-30,424472969,1545798144,-1121325175,호주,2008-06
2008-06-30,412122821,330454534,81668287,영국,2008-06
2008-06-30,340800298,409208187,-68407889,캐나다,2008-06
2008-06-30,313969028,376746904,-62777876,이탈리아,2008-06
2008-06-30,306742298,441633518,-134891220,프랑스,2008-06
2008-06-30,298748404,864255984,-565507580,이란,2008-06
2008-06-30,296973232,6259929,290713303,슬로바키아,2008-06
2008-06-30,293166566,391657659,-98491093,네덜란드,2008-06
2008-06-30,289507921,26366618,263141303,튀르키예,2008-06
2008-06-30,283100972,304475031,-21374059,칠레,2008-06
2008-06-30,278190161,28185349,250004812,폴란드,2008-06
2008-06-30,245995443,132267546,113727897,핀란드,2008-06
2008-06-30,240241413,78195085,162046328,스페인,2008-06
2008-06-30,186606821,109133808,77473013,벨기에,2008-06
2008-06-30,169940813,969055,168971758,버뮤다,2008-06
2008-06-30,162667557,26069035,136598522,우크라이나,2008-06
2008-06-30,153106031,8810129,144295902,그리스,2008-06
2008-06-30,146014576,168003285,-21988709,남아프리카공화국,2008-06
2008-06-30,143759041,10013376,133745665,바레인,2008-06
2008-06-30,134933257,13119484,121813773,몰타,2008-06
2008-06-30,133641266,2314387,131326879,사이프러스,2008-06
2008-06-30,128156405,36718677,91437728,헝가리,2008-06
2008-06-30,122052261,119155257,2897004,이집트,2008-06
2008-06-30,115947512,881163263,-765215751,카타르,2008-06
2008-06-30,113121553,3534070,109587483,슬로베니아,2008-06
2008-06-30,112595778,184143043,-71547265,노르웨이,2008-06
2008-06-30,112071375,78496,111992879,라이베리아,2008-06
2008-06-30,111394890,4922048,106472842,방글라데시,2008-06
2008-06-30,106672072,111141874,-4469802,뉴질랜드,2008-06
2008-06-30,87353206,289056710,-201703504,오만,2008-06
2008-06-30,86892530,140206,86752324,나이지리아,2008-06
2008-06-30,84578056,3827053,80751003,스리랑카,2008-06
2008-06-30,81412477,84894719,-3482242,이스라엘,2008-06
2008-06-30,76476452,30728901,45747551,우즈베키스탄,2008-06
2008-06-30,75651867,9689441,65962426,콜롬비아,2008-06
2008-06-30,74586336,10317019,64269317,루마니아,2008-06
2008-06-30,65695494,15429275,50266219,알제리,2008-06
2008-06-30,63230642,89007773,-25777131,페루,2008-06
2008-06-30,62684561,708141,61976420,리비아,2008-06
2008-06-30,62079181,89248615,-27169434,오스트리아,2008-06
2008-06-30,61896263,2707462,59188801,베네주엘라,2008-06
2008-06-30,61605503,52227506,9377997,파키스탄,2008-06
2008-06-30,60100183,1186638679,-1126538496,쿠웨이트,2008-06
2008-06-30,59323742,592386,58731356,시리아,2008-06
2008-06-30,57566145,12681379,44884766,요르단,2008-06
2008-06-30,53101680,118508864,-65407184,스웨덴,2008-06
2008-06-30,49012707,32275800,16736907,체코공화국,2008-06
2008-06-30,47965067,5294257,42670810,포루투갈,2008-06
2008-06-30,44509010,2814171,41694839,에쿠아도르,2008-06
2008-06-30,43995333,3040801,40954532,쿠바,2008-06
2008-06-30,37310649,89535246,-52224597,아르헨티나,2008-06
2008-06-30,37050523,59647199,-22596676,덴마크,2008-06
2008-06-30,29966613,75233763,-45267150,아일랜드,2008-06
2008-06-30,28236072,495059668,-466823596,이라크,2008-06
2008-06-30,27418001,5379892,22038109,모로코,2008-06
2008-06-30,25991070,180701519,-154710449,스위스,2008-06
2008-06-30,25529373,24567470,961903,카자흐스탄,2008-06
2008-06-30,24637496,4536124,20101372,몽골,2008-06
2008-06-30,24433986,1985157,22448829,과테말라,2008-06
2008-06-30,24053991,11997586,12056405,코스타리카,2008-06
2008-06-30,23236478,1013020,22223458,캄보디아,2008-06
2008-06-30,20725820,1685265,19040555,미얀마,2008-06
2008-06-30,20142526,129800,20012726,앙골라,2008-06
2008-06-30,17495609,462813,17032796,아제르바이잔,2008-06
2008-06-30,15997886,2335950,13661936,레바논,2008-06
2008-06-30,15880282,92294,15787988,키르기스스탄,2008-06
2008-06-30,14615573,1185146,13430427,가나,2008-06
2008-06-30,12828407,2627446,10200961,에스토니아,2008-06
2008-06-30,12768536,3214496,9554040,기타국,2008-06
2008-06-30,12042098,21051571,-9009473,도미니카 공화국,2008-06
2008-06-30,11997468,2632704,9364764,불가리아,2008-06
2008-06-30,11574654,448226,11126428,케냐,2008-06
2008-06-30,11279720,239453,11040267,에티오피아,2008-06
2008-06-30,11105214,3930068,7175146,온두라스,2008-06
2008-06-30,10711398,834356,9877042,리투아니아,2008-06
2008-06-30,10503085,1225967,9277118,라트비아,2008-06
2008-06-30,10489531,10511,10479020,니카라과,2008-06
2008-06-30,9398139,568744,8829395,예맨,2008-06
2008-06-30,9059875,32991079,-23931204,튀니지,2008-06
2008-06-30,8348156,66556,8281600,파라과이,2008-06
2008-06-30,7412150,62461,7349689,마다카스카르,2008-06
2008-06-30,7020078,43753,6976325,레소토,2008-06
2008-06-30,6993130,390259,6602871,코트디봐르,2008-06
2008-06-30,6875799,2253992,4621807,수단,2008-06
2008-06-30,6844015,2959249,3884766,우루과이,2008-06
2008-06-30,6443612,43280,6400332,아프카니스탄,2008-06
2008-06-30,6431441,17279238,-10847797,푸에르토리코,2008-06
2008-06-30,5901953,555207,5346746,조지아,2008-06
2008-06-30,5833872,731047,5102825,엘살바도르,2008-06
2008-06-30,5788030,168553970,-162765940,브루나이,2008-06
2008-06-30,5347214,6075865,-728651,트리니다드 토바고,2008-06
2008-06-30,5204570,215649,4988921,탄자니아,2008-06
2008-06-30,5161742,20052,5141690,세르비아 와 몬테네그로,2008-06
2008-06-30,5045730,1060341,3985389,뉴 칼레도니아,2008-06
2008-06-30,4977404,614524,4362880,크로아티아,2008-06
2008-06-30,4565135,3289123,1276012,벨라루스,2008-06
2008-06-30,4079805,94586,3985219,괌,2008-06
2008-06-30,3807565,282257,3525308,카메룬,2008-06
2008-06-30,3576905,0,3576905,르완다,2008-06
2008-06-30,3499722,482690,3017032,세네갈,2008-06
2008-06-30,3397913,278765,3119148,라오스,2008-06
2008-06-30,3392237,534549,2857688,모리셔스,2008-06
2008-06-30,3203859,34163,3169696,콩고,2008-06
2008-06-30,3141811,29,3141782,불령 리유니온 코모도 제도,2008-06
2008-06-30,2954461,359170,2595291,베닝,2008-06
2008-06-30,2823414,206,2823208,모잠비크,2008-06
2008-06-30,2770482,1825,2768657,지부티,2008-06
2008-06-30,2742148,44838,2697310,토고,2008-06
2008-06-30,2670160,739416,1930744,타지크,2008-06
2008-06-30,2634281,18929,2615352,부르키나 파소,2008-06
2008-06-30,2567150,2036,2565114,벨리제,2008-06
2008-06-30,2446552,8613,2437939,알바니아,2008-06
2008-06-30,1983306,189140,1794166,콩고민주공화국,2008-06
2008-06-30,1959785,3468158,-1508373,스와질랜드,2008-06
2008-06-30,1886861,542315,1344546,기니,2008-06
2008-06-30,1631926,4901,1627025,아메리칸 사모아,2008-06
2008-06-30,1614311,51241,1563070,네팔,2008-06
2008-06-30,1536657,634,1536023,아르메니아,2008-06
2008-06-30,1479071,24418,1454653,바하마,2008-06
2008-06-30,1469571,34713,1434858,보스니아-헤르체고비나,2008-06
2008-06-30,1454505,8561,1445944,시에라 리온,2008-06
2008-06-30,1394276,205566,1188710,마카오,2008-06
2008-06-30,1314022,82742,1231280,팔레스타인 해방기구(구),2008-06
2008-06-30,1298445,1291706,6739,자마이카,2008-06
2008-06-30,1292314,350856,941458,피지,2008-06
2008-06-30,1265143,85177,1179966,가봉,2008-06
2008-06-30,1196024,807848,388176,아이티,2008-06
2008-06-30,1183178,103383,1079795,짐바브웨,2008-06
2008-06-30,1142013,35261,1106752,투르크멘,2008-06
2008-06-30,1106818,0,1106818,챠드,2008-06
2008-06-30,1065016,89845,975171,불령 폴리네시아,2008-06
2008-06-30,990334,15247544,-14257210,파푸아 뉴기니,2008-06
2008-06-30,953909,0,953909,수리남,2008-06
2008-06-30,948123,157481,790642,마티니크,2008-06
2008-06-30,921407,153794,767613,아루바,2008-06
2008-06-30,897683,30951,866732,마세도니아,2008-06
2008-06-30,892960,0,892960,니제르,2008-06
2008-06-30,855318,0,855318,가이아나,2008-06
2008-06-30,826946,9351,817595,네덜란드 열도,2008-06
2008-06-30,817562,20256,797306,몰도바,2008-06
2008-06-30,740119,6395505,-5655386,아이슬란드,2008-06
2008-06-30,737829,5253857,-4516028,룩셈부르그,2008-06
2008-06-30,597748,84455,513293,바누아투,2008-06
2008-06-30,596889,214887,382002,리히텐슈타인,2008-06
2008-06-30,505999,10855,495144,북마리아나 군도,2008-06
2008-06-30,481215,0,481215,과델로프,2008-06
2008-06-30,475929,112675,363254,말라위,2008-06
2008-06-30,458369,0,458369,마이크로네시아,2008-06
2008-06-30,445476,2004,443472,모리타니,2008-06
2008-06-30,439551,24229605,-23790054,잠비아,2008-06
2008-06-30,439340,12077,427263,세이쉘,2008-06
2008-06-30,386048,2866,383182,몰디브,2008-06
2008-06-30,373681,61646,312035,우간다,2008-06
2008-06-30,352376,21323158,-20970782,볼리비아,2008-06
2008-06-30,342564,0,342564,팔라우,2008-06
2008-06-30,335957,22654,313303,바베이도스,2008-06
2008-06-30,303939,2,303937,안티가 바부다,2008-06
2008-06-30,298869,0,298869,영령 캐이맨 군도,2008-06
2008-06-30,296059,0,296059,카보 베르데,2008-06
2008-06-30,263011,0,263011,부탄,2008-06
2008-06-30,226340,31927,194413,도미니카,2008-06
2008-06-30,216205,0,216205,사모아,2008-06
2008-06-30,174954,1942574,-1767620,솔로몬 군도,2008-06
2008-06-30,172067,65524,106543,보츠와나,2008-06
2008-06-30,170587,0,170587,감비아,2008-06
2008-06-30,115968,0,115968,세인트 키츠 네비스,2008-06
2008-06-30,106192,0,106192,앙귈라,2008-06
2008-06-30,102105,48919022,-48816917,적도 기니,2008-06
2008-06-30,97433,0,97433,말리,2008-06
2008-06-30,77789,1158638,-1080849,나미비아,2008-06
2008-06-30,75820,0,75820,세인트 루시아,2008-06
2008-06-30,70618,489666,-419048,모나코,2008-06
2008-06-30,60169,0,60169,그레나다,2008-06
2008-06-30,57478,0,57478,불령 가이아나,2008-06
2008-06-30,37700,339,37361,쿡 아일랜드,2008-06
2008-06-30,31060,3744,27316,에리트리아,2008-06
2008-06-30,28474,0,28474,세인트 빈센트 그레나딘,2008-06
2008-06-30,20426,2359,18067,토켈라우,2008-06
2008-06-30,19000,1320,17680,코스 군도,2008-06
2008-06-30,17133,2196,14937,산마리노,2008-06
2008-06-30,15686,0,15686,키리바티,2008-06
2008-06-30,14042,5860606,-5846564,나우루,2008-06
2008-06-30,12240,0,12240,지브랄타,2008-06
2008-06-30,8612,349,8263,미령 버진군도,2008-06
2008-06-30,6128,11376,-5248,티모르,2008-06
2008-06-30,5339,193207,-187868,그린랜드,2008-06
2008-06-30,2440,366,2074,안도라,2008-06
2008-06-30,2336,0,2336,부룬디,2008-06
2008-06-30,0,994,-994,상토메 프린스페,2008-06
2008-06-30,0,92,-92,마이너 아우틀링 합중국 군도,2008-06
2008-06-30,0,19849,-19849,몬트세라트,2008-06
2008-06-30,0,52272,-52272,영령 버진군도,2008-06
2008-06-30,0,62757,-62757,기네비소,2008-06
2008-06-30,0,13,-13,통가,2008-06
2008-06-30,0,24803,-24803,중앙아프리카공화국,2008-06
2008-07-31,8961206799,7446861203,1514345596,중국,2008-07
2008-07-31,4146698566,3736777023,409921543,미국,2008-07
2008-07-31,2617734782,5674307944,-3056573162,일본,2008-07
2008-07-31,2201585803,192201255,2009384548,홍콩,2008-07
2008-07-31,1700359633,745874275,954485358,싱가포르,2008-07
2008-07-31,1174434230,1029644069,144790161,대만,2008-07
2008-07-31,1087938694,1089428855,-1490161,인도네시아,2008-07
2008-07-31,1015644554,800434413,215210141,러시아 연방,2008-07
2008-07-31,940381975,784333613,156048362,인도,2008-07
2008-07-31,932107486,1314341313,-382233827,독일,2008-07
2008-07-31,928073834,95616341,832457493,멕시코,2008-07
2008-07-31,852483905,182903565,669580340,베트남,2008-07
2008-07-31,646093995,2443854809,-1797760814,아랍에미리트 연합,2008-07
2008-07-31,601035588,352717416,248318172,태국,2008-07
2008-07-31,600927268,3863495634,-3262568366,사우디아라비아,2008-07
2008-07-31,592156257,735978262,-143822005,말레이시아,2008-07
2008-07-31,572467304,1891024176,-1318556872,호주,2008-07
2008-07-31,556192433,46432311,509760122,파나마,2008-07
2008-07-31,546457422,447567973,98889449,브라질,2008-07
2008-07-31,495994778,336625315,159369463,필리핀,2008-07
2008-07-31,429684902,354360640,75324262,영국,2008-07
2008-07-31,429675837,28169,429647668,라이베리아,2008-07
2008-07-31,424245153,5207843,419037310,슬로바키아,2008-07
2008-07-31,411127093,29166555,381960538,폴란드,2008-07
2008-07-31,398957954,61327895,337630059,튀르키예,2008-07
2008-07-31,380230124,377588188,2641936,네덜란드,2008-07
2008-07-31,364283467,760656552,-396373085,이란,2008-07
2008-07-31,335777711,161635,335616076,바하마,2008-07
2008-07-31,333018716,355773871,-22755155,캐나다,2008-07
2008-07-31,322528438,460601260,-138072822,칠레,2008-07
2008-07-31,322261200,141704831,180556369,벨기에,2008-07
2008-07-31,307430074,522455660,-215025586,프랑스,2008-07
2008-07-31,287761077,75233851,212527226,스페인,2008-07
2008-07-31,257509799,421128691,-163618892,이탈리아,2008-07
2008-07-31,241570188,240,241569948,마샬군도,2008-07
2008-07-31,211488680,311500,211177180,사이프러스,2008-07
2008-07-31,207451507,136659632,70791875,핀란드,2008-07
2008-07-31,205647158,34178209,171468949,우크라이나,2008-07
2008-07-31,200215606,1278093265,-1077877659,카타르,2008-07
2008-07-31,161051370,111812761,49238609,스웨덴,2008-07
2008-07-31,131879814,55853983,76025831,이집트,2008-07
2008-07-31,130503415,5638919,124864496,그리스,2008-07
2008-07-31,128461639,192961,128268678,나이지리아,2008-07
2008-07-31,123977548,240968283,-116990735,남아프리카공화국,2008-07
2008-07-31,121684103,97406957,24277146,파키스탄,2008-07
2008-07-31,120721554,21447416,99274138,방글라데시,2008-07
2008-07-31,118608988,4590574,114018414,슬로베니아,2008-07
2008-07-31,111890406,235571207,-123680801,노르웨이,2008-07
2008-07-31,107792209,11817127,95975082,몰타,2008-07
2008-07-31,103327555,81651498,21676057,아일랜드,2008-07
2008-07-31,99470767,35649968,63820799,헝가리,2008-07
2008-07-31,94900858,71165341,23735517,우즈베키스탄,2008-07
2008-07-31,92569136,4694498,87874638,스리랑카,2008-07
2008-07-31,92046580,13688065,78358515,콜롬비아,2008-07
2008-07-31,87271696,76216231,11055465,이스라엘,2008-07
2008-07-31,81475172,94704206,-13229034,오스트리아,2008-07
2008-07-31,80291764,186105603,-105813839,스위스,2008-07
2008-07-31,76179674,396513529,-320333855,오만,2008-07
2008-07-31,74111506,33419687,40691819,체코공화국,2008-07
2008-07-31,73207758,1194687,72013071,베네주엘라,2008-07
2008-07-31,68799733,74192810,-5393077,페루,2008-07
2008-07-31,68072044,3673580,64398464,에쿠아도르,2008-07
2008-07-31,67777490,93963125,-26185635,뉴질랜드,2008-07
2008-07-31,65642218,1230624,64411594,알제리,2008-07
2008-07-31,63345236,1312687,62032549,리비아,2008-07
2008-07-31,63141616,19347047,43794569,루마니아,2008-07
2008-07-31,59412587,606326,58806261,시리아,2008-07
2008-07-31,57500263,64722706,-7222443,아르헨티나,2008-07
2008-07-31,55307306,71977,55235329,괌,2008-07
2008-07-31,52345770,1378775,50966995,요르단,2008-07
2008-07-31,48046670,164,48046506,쿠바,2008-07
2008-07-31,46865485,1269355289,-1222489804,쿠웨이트,2008-07
2008-07-31,37104682,178553,36926129,니카라과,2008-07
2008-07-31,33239979,84202283,-50962304,덴마크,2008-07
2008-07-31,31922865,8189219,23733646,포루투갈,2008-07
2008-07-31,31884736,35088535,-3203799,모로코,2008-07
2008-07-31,30369520,1055640,29313880,캄보디아,2008-07
2008-07-31,30027902,37896558,-7868656,카자흐스탄,2008-07
2008-07-31,28055719,3103366,24952353,과테말라,2008-07
2008-07-31,25528568,59591,25468977,아제르바이잔,2008-07
2008-07-31,23904822,10757493,13147329,레바논,2008-07
2008-07-31,22547747,10571402,11976345,코스타리카,2008-07
2008-07-31,21847934,411480,21436454,가나,2008-07
2008-07-31,20050085,137691,19912394,앙골라,2008-07
2008-07-31,19784981,6239635,13545346,몽골,2008-07
2008-07-31,17856431,13347464,4508967,바레인,2008-07
2008-07-31,17770304,3743553,14026751,튀니지,2008-07
2008-07-31,17200058,2327981,14872077,미얀마,2008-07
2008-07-31,17083930,3364,17080566,키르기스스탄,2008-07
2008-07-31,16592191,828948122,-812355931,이라크,2008-07
2008-07-31,14352249,851702,13500547,케냐,2008-07
2008-07-31,14139717,171629508,-157489791,브루나이,2008-07
2008-07-31,13598677,892891,12705786,수단,2008-07
2008-07-31,13337908,2644520,10693388,라트비아,2008-07
2008-07-31,13057902,1800866,11257036,에스토니아,2008-07
2008-07-31,12376290,10200658,2175632,온두라스,2008-07
2008-07-31,11826050,9681379,2144671,도미니카 공화국,2008-07
2008-07-31,11699392,16052992,-4353600,푸에르토리코,2008-07
2008-07-31,11128613,2484627,8643986,우루과이,2008-07
2008-07-31,11066610,1233896,9832714,리투아니아,2008-07
2008-07-31,9779647,763011,9016636,파라과이,2008-07
2008-07-31,8992625,28440,8964185,마다카스카르,2008-07
2008-07-31,8878991,3272549,5606442,불가리아,2008-07
2008-07-31,8731008,796438,7934570,예맨,2008-07
2008-07-31,8531603,4849716,3681887,기타국,2008-07
2008-07-31,6468374,703,6467671,타지크,2008-07
2008-07-31,6389130,271167,6117963,세르비아 와 몬테네그로,2008-07
2008-07-31,6352716,974512,5378204,조지아,2008-07
2008-07-31,6117377,574722,5542655,크로아티아,2008-07
2008-07-31,6034386,239046,5795340,자마이카,2008-07
2008-07-31,5891410,143076,5748334,탄자니아,2008-07
2008-07-31,5854632,509625,5345007,에티오피아,2008-07
2008-07-31,5797704,31131,5766573,레소토,2008-07
2008-07-31,5562900,454810,5108090,피지,2008-07
2008-07-31,5385680,1181891,4203789,베닝,2008-07
2008-07-31,5235918,14799138,-9563220,뉴 칼레도니아,2008-07
2008-07-31,5138137,9373163,-4235026,나우루,2008-07
2008-07-31,4726890,1000204,3726686,트리니다드 토바고,2008-07
2008-07-31,4616173,605450,4010723,엘살바도르,2008-07
2008-07-31,4460346,0,4460346,코트디봐르,2008-07
2008-07-31,4447051,86003,4361048,모잠비크,2008-07
2008-07-31,4414618,288934,4125684,라오스,2008-07
2008-07-31,4127146,2666889,1460257,벨라루스,2008-07
2008-07-31,3967103,584005,3383098,카메룬,2008-07
2008-07-31,3470657,99435,3371222,네팔,2008-07
2008-07-31,3344821,1729321,1615500,모리셔스,2008-07
2008-07-31,3184827,58263,3126564,아프카니스탄,2008-07
2008-07-31,3100141,674638,2425503,세네갈,2008-07
2008-07-31,3042877,0,3042877,부르키나 파소,2008-07
2008-07-31,2909512,5314202,-2404690,파푸아 뉴기니,2008-07
2008-07-31,2868001,251932,2616069,아메리칸 사모아,2008-07
2008-07-31,2761336,0,2761336,불령 리유니온 코모도 제도,2008-07
2008-07-31,2457756,1126691,1331065,아이티,2008-07
2008-07-31,2150170,261400,1888770,아르메니아,2008-07
2008-07-31,2001305,590719,1410586,마카오,2008-07
2008-07-31,1988661,56776,1931885,불령 폴리네시아,2008-07
2008-07-31,1969743,31567,1938176,콩고,2008-07
2008-07-31,1948726,4629960,-2681234,볼리비아,2008-07
2008-07-31,1940896,62010,1878886,몰디브,2008-07
2008-07-31,1907632,247315,1660317,기니,2008-07
2008-07-31,1753063,0,1753063,지부티,2008-07
2008-07-31,1723296,2608988,-885692,스와질랜드,2008-07
2008-07-31,1711004,35450,1675554,보스니아-헤르체고비나,2008-07
2008-07-31,1540066,2229,1537837,수리남,2008-07
2008-07-31,1526133,1221230,304903,토고,2008-07
2008-07-31,1510848,166957,1343891,팔레스타인 해방기구(구),2008-07
2008-07-31,1427483,26520,1400963,북마리아나 군도,2008-07
2008-07-31,1376188,0,1376188,콩고민주공화국,2008-07
2008-07-31,1322325,13283,1309042,투르크멘,2008-07
2008-07-31,1226826,5313268,-4086442,룩셈부르그,2008-07
2008-07-31,1186100,100645,1085455,말라위,2008-07
2008-07-31,1105716,23680,1082036,마이크로네시아,2008-07
2008-07-31,997298,2130354,-1133056,아이슬란드,2008-07
2008-07-31,937175,1028309,-91134,우간다,2008-07
2008-07-31,910945,47480,863465,벨리제,2008-07
2008-07-31,840870,660885,179985,마세도니아,2008-07
2008-07-31,763549,333167,430382,도미니카,2008-07
2008-07-31,758009,274870,483139,세이쉘,2008-07
2008-07-31,742931,0,742931,마티니크,2008-07
2008-07-31,645026,212638,432388,가이아나,2008-07
2008-07-31,632466,3988,628478,네덜란드 열도,2008-07
2008-07-31,627580,0,627580,아루바,2008-07
2008-07-31,622451,950755,-328304,알바니아,2008-07
2008-07-31,616396,0,616396,모리타니,2008-07
2008-07-31,579562,5194,574368,안도라,2008-07
2008-07-31,571082,1071,570011,버뮤다,2008-07
2008-07-31,543801,0,543801,과델로프,2008-07
2008-07-31,473676,0,473676,바베이도스,2008-07
2008-07-31,466888,610699,-143811,나미비아,2008-07
2008-07-31,464562,92999,371563,보츠와나,2008-07
2008-07-31,463923,6932,456991,바누아투,2008-07
2008-07-31,455380,0,455380,부탄,2008-07
2008-07-31,447588,431123,16465,가봉,2008-07
2008-07-31,438784,126744,312040,안티가 바부다,2008-07
2008-07-31,417066,459,416607,영령 버진군도,2008-07
2008-07-31,398865,0,398865,영령 캐이맨 군도,2008-07
2008-07-31,376639,62909,313730,기네비소,2008-07
2008-07-31,363483,0,363483,르완다,2008-07
2008-07-31,360403,12020,348383,사모아,2008-07
2008-07-31,315035,500575,-185540,리히텐슈타인,2008-07
2008-07-31,290284,66464,223820,몰도바,2008-07
2008-07-31,256004,37583,218421,팔라우,2008-07
2008-07-31,228278,0,228278,앙귈라,2008-07
2008-07-31,227841,12929955,-12702114,잠비아,2008-07
2008-07-31,191979,7219601,-7027622,짐바브웨,2008-07
2008-07-31,180476,0,180476,세인트 루시아,2008-07
2008-07-31,156365,0,156365,미령 버진군도,2008-07
2008-07-31,151209,857,150352,감비아,2008-07
2008-07-31,145361,31686,113675,시에라 리온,2008-07
2008-07-31,140000,2933265,-2793265,솔로몬 군도,2008-07
2008-07-31,99600,53489899,-53390299,적도 기니,2008-07
2008-07-31,87154,0,87154,메요트,2008-07
2008-07-31,84865,44531,40334,그레나다,2008-07
2008-07-31,76493,536,75957,카보 베르데,2008-07
2008-07-31,61189,0,61189,불령 가이아나,2008-07
2008-07-31,59185,0,59185,티모르,2008-07
2008-07-31,52107,42738,9369,말리,2008-07
2008-07-31,47449,0,47449,에리트리아,2008-07
2008-07-31,44066,0,44066,불령 남부지역,2008-07
2008-07-31,29081,0,29081,쿡 아일랜드,2008-07
2008-07-31,26239,0,26239,그린랜드,2008-07
2008-07-31,25638,0,25638,부룬디,2008-07
2008-07-31,19146,874518,-855372,모나코,2008-07
2008-07-31,18600,15,18585,니제르,2008-07
2008-07-31,17301,5754,11547,산마리노,2008-07
2008-07-31,14775,218,14557,지브랄타,2008-07
2008-07-31,9640,0,9640,투르크 & 카이코스 군도,2008-07
2008-07-31,6885,0,6885,상토메 프린스페,2008-07
2008-07-31,4724,0,4724,소말리아,2008-07
2008-07-31,3078,19963,-16885,세인트 키츠 네비스,2008-07
2008-07-31,2000,52668,-50668,토켈라우,2008-07
2008-07-31,1480,34686,-33206,통가,2008-07
2008-07-31,0,5150,-5150,세인트 헬레나,2008-07
2008-07-31,0,80,-80,세인트 빈센트 그레나딘,2008-07
2008-07-31,0,44654,-44654,중앙아프리카공화국,2008-07
2008-07-31,0,1743,-1743,마이너 아우틀링 합중국 군도,2008-07
2008-07-31,0,9,-9,안타티카,2008-07
2008-07-31,0,106,-106,영령 인도양,2008-07
2008-07-31,0,61310,-61310,피트카이른,2008-07
2008-07-31,0,6531,-6531,코스 군도,2008-07
2008-07-31,0,26,-26,몬트세라트,2008-07
2008-08-31,8538672337,7165923055,1372749282,중국,2008-08
2008-08-31,3549423015,3326058614,223364401,미국,2008-08
2008-08-31,2202681431,5215987006,-3013305575,일본,2008-08
2008-08-31,1730462378,180088441,1550373937,홍콩,2008-08
2008-08-31,1436372466,734218876,702153590,싱가포르,2008-08
2008-08-31,1028093790,970540098,57553692,대만,2008-08
2008-08-31,845214146,87935298,757278848,멕시코,2008-08
2008-08-31,813593489,891009872,-77416383,러시아 연방,2008-08
2008-08-31,787913915,842130937,-54217022,인도,2008-08
2008-08-31,768269062,864680789,-96411727,인도네시아,2008-08
2008-08-31,741970450,465822683,276147767,브라질,2008-08
2008-08-31,723032763,348059694,374973069,영국,2008-08
2008-08-31,684890626,1471048379,-786157753,독일,2008-08
2008-08-31,648645846,301924180,346721666,네덜란드,2008-08
2008-08-31,613797184,336,613796848,버뮤다,2008-08
2008-08-31,580041460,4421928018,-3841886558,사우디아라비아,2008-08
2008-08-31,542314877,466403664,75911213,태국,2008-08
2008-08-31,539782142,900173386,-360391244,말레이시아,2008-08
2008-08-31,538971841,174477757,364494084,베트남,2008-08
2008-08-31,510260898,294861438,215399460,필리핀,2008-08
2008-08-31,466262597,1662036413,-1195773816,아랍에미리트 연합,2008-08
2008-08-31,442174713,304,442174409,마샬군도,2008-08
2008-08-31,424639883,1488491006,-1063851123,호주,2008-08
2008-08-31,374620313,330,374619983,라이베리아,2008-08
2008-08-31,359423391,19777627,339645764,폴란드,2008-08
2008-08-31,348187433,6270784,341916649,슬로바키아,2008-08
2008-08-31,328869329,415862154,-86992825,캐나다,2008-08
2008-08-31,325115464,12391622,312723842,파나마,2008-08
2008-08-31,284259073,1016775534,-732516461,이란,2008-08
2008-08-31,281514932,439313399,-157798467,프랑스,2008-08
2008-08-31,248102250,30430966,217671284,튀르키예,2008-08
2008-08-31,227700352,179920893,47779459,스페인,2008-08
2008-08-31,224052653,391677472,-167624819,칠레,2008-08
2008-08-31,222546748,110619287,111927461,벨기에,2008-08
2008-08-31,208289132,326380598,-118091466,이탈리아,2008-08
2008-08-31,201149647,240636,200909011,바하마,2008-08
2008-08-31,191702936,331440,191371496,사이프러스,2008-08
2008-08-31,182171210,94233095,87938115,우크라이나,2008-08
2008-08-31,180117771,83295574,96822197,핀란드,2008-08
2008-08-31,137677115,4219706,133457409,그리스,2008-08
2008-08-31,136558441,12930833,123627608,몰타,2008-08
2008-08-31,129417250,146045669,-16628419,이집트,2008-08
2008-08-31,113956380,9243,113947137,나이지리아,2008-08
2008-08-31,106910038,170609034,-63698996,남아프리카공화국,2008-08
2008-08-31,101431902,342715172,-241283270,오만,2008-08
2008-08-31,99741865,21317342,78424523,헝가리,2008-08
2008-08-31,93505596,1974358,91531238,우즈베키스탄,2008-08
2008-08-31,91235056,1119691568,-1028456512,카타르,2008-08
2008-08-31,89391292,55395,89335897,중앙아프리카공화국,2008-08
2008-08-31,85825088,3053042,82772046,슬로베니아,2008-08
2008-08-31,76808941,23425420,53383521,파키스탄,2008-08
2008-08-31,76611363,2155045,74456318,요르단,2008-08
2008-08-31,71772114,4533264,67238850,스리랑카,2008-08
2008-08-31,71137502,67435919,3701583,이스라엘,2008-08
2008-08-31,69227493,36522089,32705404,방글라데시,2008-08
2008-08-31,67866383,1178112652,-1110246269,쿠웨이트,2008-08
2008-08-31,67199071,1107173,66091898,베네주엘라,2008-08
2008-08-31,65070922,36873544,28197378,페루,2008-08
2008-08-31,58001054,105476358,-47475304,스웨덴,2008-08
2008-08-31,57513472,110260511,-52747039,뉴질랜드,2008-08
2008-08-31,57262735,10282808,46979927,콜롬비아,2008-08
2008-08-31,56108135,425016,55683119,모나코,2008-08
2008-08-31,52268433,28113463,24154970,체코공화국,2008-08
2008-08-31,49156452,1152437,48004015,알제리,2008-08
2008-08-31,49021555,48455398,566157,바레인,2008-08
2008-08-31,48898186,40607436,8290750,시리아,2008-08
2008-08-31,48885768,11897190,36988578,루마니아,2008-08
2008-08-31,47655514,772940,46882574,리비아,2008-08
2008-08-31,47445691,51813899,-4368208,덴마크,2008-08
2008-08-31,45328759,37461,45291298,쿠바,2008-08
2008-08-31,44535617,3529361,41006256,에쿠아도르,2008-08
2008-08-31,43402425,142286060,-98883635,아르헨티나,2008-08
2008-08-31,43117078,86172831,-43055753,오스트리아,2008-08
2008-08-31,34317085,366675,33950410,괌,2008-08
2008-08-31,31790684,1208,31789476,아제르바이잔,2008-08
2008-08-31,30674522,34110979,-3436457,카자흐스탄,2008-08
2008-08-31,25957133,6601381,19355752,포루투갈,2008-08
2008-08-31,23162476,359143497,-335981021,이라크,2008-08
2008-08-31,22652632,10682388,11970244,코스타리카,2008-08
2008-08-31,22360562,1653876,20706686,레바논,2008-08
2008-08-31,21983357,2619761,19363596,과테말라,2008-08
2008-08-31,21673841,60294362,-38620521,아일랜드,2008-08
2008-08-31,21538466,193828,21344638,수단,2008-08
2008-08-31,20665156,210255319,-189590163,노르웨이,2008-08
2008-08-31,20637328,1619,20635709,앙골라,2008-08
2008-08-31,20513549,147156302,-126642753,스위스,2008-08
2008-08-31,20198327,2172389,18025938,캄보디아,2008-08
2008-08-31,20129585,4356061,15773524,모로코,2008-08
2008-08-31,18006456,2788195,15218261,가나,2008-08
2008-08-31,17950888,0,17950888,키르기스스탄,2008-08
2008-08-31,17844351,3771937,14072414,몽골,2008-08
2008-08-31,16582832,720955,15861877,케냐,2008-08
2008-08-31,15744501,4963537,10780964,기타국,2008-08
2008-08-31,14881142,4376162,10504980,미얀마,2008-08
2008-08-31,13963347,1914597,12048750,불가리아,2008-08
2008-08-31,13825830,10549697,3276133,나우루,2008-08
2008-08-31,13534946,2682483,10852463,튀니지,2008-08
2008-08-31,13059845,207526,12852319,니카라과,2008-08
2008-08-31,12823093,2751225,10071868,온두라스,2008-08
2008-08-31,11981284,832279,11149005,리투아니아,2008-08
2008-08-31,9772224,20271203,-10498979,푸에르토리코,2008-08
2008-08-31,9634358,351181,9283177,마다카스카르,2008-08
2008-08-31,9615257,2742639,6872618,우루과이,2008-08
2008-08-31,9357885,2307870,7050015,라트비아,2008-08
2008-08-31,9045800,11525741,-2479941,도미니카 공화국,2008-08
2008-08-31,8665090,286948,8378142,예맨,2008-08
2008-08-31,8386171,1255402,7130769,에스토니아,2008-08
2008-08-31,8092758,1180376,6912382,탄자니아,2008-08
2008-08-31,7112900,364565,6748335,파라과이,2008-08
2008-08-31,7077518,316517,6761001,크로아티아,2008-08
2008-08-31,6720307,122188,6598119,모리셔스,2008-08
2008-08-31,6275050,0,6275050,지부티,2008-08
2008-08-31,6256724,1434672,4822052,벨라루스,2008-08
2008-08-31,6212512,690880,5521632,엘살바도르,2008-08
2008-08-31,6027022,5971129,55893,뉴 칼레도니아,2008-08
2008-08-31,5568339,560128,5008211,에티오피아,2008-08
2008-08-31,4249386,133327337,-129077951,브루나이,2008-08
2008-08-31,3912630,40481,3872149,세르비아 와 몬테네그로,2008-08
2008-08-31,3848686,835497,3013189,타지크,2008-08
2008-08-31,3834650,1094735,2739915,트리니다드 토바고,2008-08
2008-08-31,3678803,327407,3351396,카메룬,2008-08
2008-08-31,3539278,39259,3500019,아프카니스탄,2008-08
2008-08-31,3479305,9867,3469438,코트디봐르,2008-08
2008-08-31,3455878,964746,2491132,베닝,2008-08
2008-08-31,3291818,263039,3028779,모잠비크,2008-08
2008-08-31,3134912,7497,3127415,불령 리유니온 코모도 제도,2008-08
2008-08-31,3119726,6615827,-3496101,라오스,2008-08
2008-08-31,3069171,5043,3064128,투르크멘,2008-08
2008-08-31,2777570,337582,2439988,콩고,2008-08
2008-08-31,2754653,58595,2696058,네팔,2008-08
2008-08-31,2744282,37599141,-34854859,잠비아,2008-08
2008-08-31,2662676,1922805,739871,기니,2008-08
2008-08-31,2584655,16845,2567810,레소토,2008-08
2008-08-31,2575913,365543,2210370,조지아,2008-08
2008-08-31,2479684,1541090,938594,토고,2008-08
2008-08-31,2453436,557267,1896169,세네갈,2008-08
2008-08-31,2222193,142662,2079531,아르메니아,2008-08
2008-08-31,1958911,809253,1149658,마카오,2008-08
2008-08-31,1852534,5832,1846702,아메리칸 사모아,2008-08
2008-08-31,1744514,13,1744501,콩고민주공화국,2008-08
2008-08-31,1712626,6398449,-4685823,스와질랜드,2008-08
2008-08-31,1704121,169626,1534495,팔레스타인 해방기구(구),2008-08
2008-08-31,1632844,0,1632844,마티니크,2008-08
2008-08-31,1413047,910604,502443,자마이카,2008-08
2008-08-31,1304141,85083,1219058,과델로프,2008-08
2008-08-31,1179759,2092212,-912453,짐바브웨,2008-08
2008-08-31,1082989,77267,1005722,불령 폴리네시아,2008-08
2008-08-31,1079369,1909924,-830555,파푸아 뉴기니,2008-08
2008-08-31,1043026,0,1043026,아루바,2008-08
2008-08-31,985417,8286392,-7300975,룩셈부르그,2008-08
2008-08-31,930546,235,930311,네덜란드 열도,2008-08
2008-08-31,891796,3595,888201,바누아투,2008-08
2008-08-31,880366,110746,769620,보스니아-헤르체고비나,2008-08
2008-08-31,861036,21783,839253,알바니아,2008-08
2008-08-31,813255,58988,754267,모리타니,2008-08
2008-08-31,764665,2020218,-1255553,아이티,2008-08
2008-08-31,757613,215496,542117,말라위,2008-08
2008-08-31,734636,45033,689603,안도라,2008-08
2008-08-31,714313,0,714313,수리남,2008-08
2008-08-31,664700,1379,663321,니제르,2008-08
2008-08-31,656071,354043,302028,피지,2008-08
2008-08-31,651171,52597,598574,세이쉘,2008-08
2008-08-31,603544,194941,408603,도미니카,2008-08
2008-08-31,589213,2255,586958,북마리아나 군도,2008-08
2008-08-31,583776,0,583776,벨리제,2008-08
2008-08-31,512820,16684531,-16171711,볼리비아,2008-08
2008-08-31,497063,1255701,-758638,아이슬란드,2008-08
2008-08-31,495288,328932,166356,우간다,2008-08
2008-08-31,477810,115070,362740,바베이도스,2008-08
2008-08-31,405225,11387,393838,에리트리아,2008-08
2008-08-31,398827,23821,375006,부탄,2008-08
2008-08-31,369613,5845,363768,마이크로네시아,2008-08
2008-08-31,360534,1131024,-770490,리히텐슈타인,2008-08
2008-08-31,349780,41900,307880,마세도니아,2008-08
2008-08-31,332959,0,332959,영령 캐이맨 군도,2008-08
2008-08-31,324234,648026,-323792,가이아나,2008-08
2008-08-31,312776,116124,196652,보츠와나,2008-08
2008-08-31,270708,740495,-469787,나미비아,2008-08
2008-08-31,270424,59108,211316,사모아,2008-08
2008-08-31,217812,0,217812,감비아,2008-08
2008-08-31,202376,0,202376,카보 베르데,2008-08
2008-08-31,188113,69418,118695,몰디브,2008-08
2008-08-31,169024,76459,92565,안티가 바부다,2008-08
2008-08-31,150492,36918,113574,몰도바,2008-08
2008-08-31,131657,401484,-269827,가봉,2008-08
2008-08-31,120184,0,120184,부르키나 파소,2008-08
2008-08-31,113320,46536934,-46423614,적도 기니,2008-08
2008-08-31,97899,71894,26005,시에라 리온,2008-08
2008-08-31,86173,0,86173,세인트 루시아,2008-08
2008-08-31,85118,12082,73036,팔라우,2008-08
2008-08-31,62295,0,62295,그레나다,2008-08
2008-08-31,57670,84,57586,세인트 키츠 네비스,2008-08
2008-08-31,55257,31500,23757,영령 버진군도,2008-08
2008-08-31,51345,0,51345,노폴크 아일랜드,2008-08
2008-08-31,47997,0,47997,르완다,2008-08
2008-08-31,47363,0,47363,세인트 빈센트 그레나딘,2008-08
2008-08-31,43450,1731,41719,몬트세라트,2008-08
2008-08-31,36741,0,36741,불령 가이아나,2008-08
2008-08-31,29097,0,29097,상토메 프린스페,2008-08
2008-08-31,13751,0,13751,코모로스,2008-08
2008-08-31,11606,0,11606,지브랄타,2008-08
2008-08-31,8240,0,8240,말리,2008-08
2008-08-31,6850,0,6850,왈라스 & 퓨투나 군도,2008-08
2008-08-31,6760,6034,726,티모르,2008-08
2008-08-31,1890,0,1890,앙귈라,2008-08
2008-08-31,1157,3626,-2469,미령 버진군도,2008-08
2008-08-31,0,1620614,-1620614,솔로몬 군도,2008-08
2008-08-31,0,330914,-330914,그린랜드,2008-08
2008-08-31,0,97354,-97354,남조지아 & 남샌드위치 군도,2008-08
2008-08-31,0,7385,-7385,산마리노,2008-08
2008-08-31,0,12091,-12091,토켈라우,2008-08
2008-08-31,0,335,-335,크리스마스 아일랜드,2008-08
2008-08-31,0,780,-780,맨섬,2008-08
2008-08-31,0,128675,-128675,기네비소,2008-08
2008-09-30,8090175934,7374982546,715193388,중국,2008-09
2008-09-30,3833835532,3275930463,557905069,미국,2008-09
2008-09-30,2297715474,5442939160,-3145223686,일본,2008-09
2008-09-30,1814198843,170794980,1643403863,홍콩,2008-09
2008-09-30,1330481770,751977072,578504698,싱가포르,2008-09
2008-09-30,1002907911,196542314,806365597,네덜란드,2008-09
2008-09-30,1002241847,86980306,915261541,멕시코,2008-09
2008-09-30,979328181,1364001007,-384672826,독일,2008-09
2008-09-30,961894567,940973984,20920583,대만,2008-09
2008-09-30,858802008,230394,858571614,앙골라,2008-09
2008-09-30,838410754,908473340,-70062586,러시아 연방,2008-09
2008-09-30,828588564,629778234,198810330,인도,2008-09
2008-09-30,726696057,276,726695781,마샬군도,2008-09
2008-09-30,693563489,362102866,331460623,브라질,2008-09
2008-09-30,547367530,505767032,41600498,태국,2008-09
2008-09-30,540604386,175422608,365181778,베트남,2008-09
2008-09-30,509978265,902311198,-392332933,말레이시아,2008-09
2008-09-30,492272380,1827384942,-1335112562,아랍에미리트 연합,2008-09
2008-09-30,485163009,332485620,152677389,필리핀,2008-09
2008-09-30,482842501,858411190,-375568689,인도네시아,2008-09
2008-09-30,479492892,3235959319,-2756466427,사우디아라비아,2008-09
2008-09-30,470294830,1588716472,-1118421642,호주,2008-09
2008-09-30,458864581,362511954,96352627,영국,2008-09
2008-09-30,458587104,71616850,386970254,파나마,2008-09
2008-09-30,382626708,44524577,338102131,튀르키예,2008-09
2008-09-30,377319317,27582510,349736807,폴란드,2008-09
2008-09-30,350182774,4945249,345237525,슬로바키아,2008-09
2008-09-30,343546138,315027699,28518439,칠레,2008-09
2008-09-30,313681902,373982130,-60300228,프랑스,2008-09
2008-09-30,300577150,393496411,-92919261,캐나다,2008-09
2008-09-30,290865108,1205194472,-914329364,카타르,2008-09
2008-09-30,245267699,14551220,230716479,몰타,2008-09
2008-09-30,244103292,38595,244064697,라이베리아,2008-09
2008-09-30,244066753,131184202,112882551,스페인,2008-09
2008-09-30,215649441,73543051,142106390,핀란드,2008-09
2008-09-30,214272585,355746008,-141473423,이탈리아,2008-09
2008-09-30,213746050,1013048269,-799302219,이란,2008-09
2008-09-30,179962164,95686696,84275468,벨기에,2008-09
2008-09-30,150774096,26241523,124532573,방글라데시,2008-09
2008-09-30,134827992,96016228,38811764,우크라이나,2008-09
2008-09-30,125524771,32914765,92610006,헝가리,2008-09
2008-09-30,124367668,180514,124187154,나이지리아,2008-09
2008-09-30,116270556,177578588,-61308032,남아프리카공화국,2008-09
2008-09-30,113768771,42528594,71240177,이집트,2008-09
2008-09-30,111621461,2519666,109101795,우즈베키스탄,2008-09
2008-09-30,108876983,12497668,96379315,콜롬비아,2008-09
2008-09-30,104730815,249392035,-144661220,노르웨이,2008-09
2008-09-30,96388860,84063294,12325566,뉴질랜드,2008-09
2008-09-30,89188486,28033966,61154520,파키스탄,2008-09
2008-09-30,84314430,66494971,17819459,이스라엘,2008-09
2008-09-30,80936537,2552111,78384426,슬로베니아,2008-09
2008-09-30,77095717,1168357448,-1091261731,쿠웨이트,2008-09
2008-09-30,73415387,2901228,70514159,에쿠아도르,2008-09
2008-09-30,69190311,7573611,61616700,스리랑카,2008-09
2008-09-30,68026264,736163,67290101,리비아,2008-09
2008-09-30,67941931,89220303,-21278372,오스트리아,2008-09
2008-09-30,64183822,9319380,54864442,그리스,2008-09
2008-09-30,63862517,580379447,-516516930,오만,2008-09
2008-09-30,63164564,4510472,58654092,요르단,2008-09
2008-09-30,62164955,1037678,61127277,베네주엘라,2008-09
2008-09-30,61274235,28426504,32847731,체코공화국,2008-09
2008-09-30,59118682,65361296,-6242614,알제리,2008-09
2008-09-30,56740009,17652412,39087597,페루,2008-09
2008-09-30,55675227,50854101,4821126,아르헨티나,2008-09
2008-09-30,53244734,37006070,16238664,시리아,2008-09
2008-09-30,49648572,11619845,38028727,루마니아,2008-09
2008-09-30,48356786,92693096,-44336310,스웨덴,2008-09
2008-09-30,40136679,312425783,-272289104,이라크,2008-09
2008-09-30,37118317,645092,36473225,니카라과,2008-09
2008-09-30,36122238,42979714,-6857476,카자흐스탄,2008-09
2008-09-30,28009029,70153444,-42144415,아일랜드,2008-09
2008-09-30,27474422,1261738,26212684,아제르바이잔,2008-09
2008-09-30,27339325,33847132,-6507807,모로코,2008-09
2008-09-30,27064069,49973207,-22909138,덴마크,2008-09
2008-09-30,26426509,7014675,19411834,포루투갈,2008-09
2008-09-30,26219882,483597,25736285,예맨,2008-09
2008-09-30,25923182,6270024,19653158,미얀마,2008-09
2008-09-30,24307438,874652,23432786,몽골,2008-09
2008-09-30,22552302,142779509,-120227207,스위스,2008-09
2008-09-30,22173138,1628861,20544277,과테말라,2008-09
2008-09-30,22059668,7823200,14236468,바레인,2008-09
2008-09-30,21728813,1153010,20575803,레바논,2008-09
2008-09-30,21142831,1185866,19956965,캄보디아,2008-09
2008-09-30,20064589,184667419,-164602830,브루나이,2008-09
2008-09-30,19875275,8272932,11602343,도미니카 공화국,2008-09
2008-09-30,19156641,9869511,9287130,코스타리카,2008-09
2008-09-30,18671257,188217,18483040,안티가 바부다,2008-09
2008-09-30,18247426,26851,18220575,키르기스스탄,2008-09
2008-09-30,15860443,1246658,14613785,가나,2008-09
2008-09-30,13884203,2770189,11114014,튀니지,2008-09
2008-09-30,12963909,5020504,7943405,우루과이,2008-09
2008-09-30,12841350,470400,12370950,케냐,2008-09
2008-09-30,12705974,482338,12223636,아프카니스탄,2008-09
2008-09-30,12332948,844193,11488755,온두라스,2008-09
2008-09-30,10612884,4257137,6355747,기타국,2008-09
2008-09-30,10324648,3018590,7306058,불가리아,2008-09
2008-09-30,9657131,379190,9277941,수단,2008-09
2008-09-30,9442779,6892,9435887,나우루,2008-09
2008-09-30,8903829,2651932,6251897,라트비아,2008-09
2008-09-30,8802149,34673,8767476,쿠바,2008-09
2008-09-30,8685795,173145,8512650,탄자니아,2008-09
2008-09-30,8161160,22186454,-14025294,푸에르토리코,2008-09
2008-09-30,8101189,439657,7661532,리투아니아,2008-09
2008-09-30,7706487,985287,6721200,나미비아,2008-09
2008-09-30,7419817,137434,7282383,마다카스카르,2008-09
2008-09-30,7419792,549006,6870786,에스토니아,2008-09
2008-09-30,7366450,180113,7186337,파라과이,2008-09
2008-09-30,6763680,1174205,5589475,조지아,2008-09
2008-09-30,6425623,291382,6134241,크로아티아,2008-09
2008-09-30,6419461,56997,6362464,뉴 칼레도니아,2008-09
2008-09-30,6323734,19821,6303913,레소토,2008-09
2008-09-30,6185002,387924,5797078,에티오피아,2008-09
2008-09-30,6053236,1333993,4719243,엘살바도르,2008-09
2008-09-30,5572596,377373,5195223,코트디봐르,2008-09
2008-09-30,5219064,97334,5121730,사이프러스,2008-09
2008-09-30,4620205,116594,4503611,토고,2008-09
2008-09-30,4534821,599672,3935149,세네갈,2008-09
2008-09-30,4473245,730284,3742961,콩고,2008-09
2008-09-30,4301134,664055,3637079,카메룬,2008-09
2008-09-30,4284976,488889,3796087,괌,2008-09
2008-09-30,4006948,30152,3976796,세르비아 와 몬테네그로,2008-09
2008-09-30,3948758,543357,3405401,벨라루스,2008-09
2008-09-30,3915165,27452810,-23537645,파푸아 뉴기니,2008-09
2008-09-30,3889742,3576795,312947,라오스,2008-09
2008-09-30,3820500,883624,2936876,기니,2008-09
2008-09-30,3546007,52360,3493647,베닝,2008-09
2008-09-30,3481710,128353,3353357,모잠비크,2008-09
2008-09-30,3337172,16327851,-12990679,트리니다드 토바고,2008-09
2008-09-30,3198541,444863,2753678,타지크,2008-09
2008-09-30,3097871,0,3097871,지부티,2008-09
2008-09-30,2620033,14022950,-11402917,룩셈부르그,2008-09
2008-09-30,2615916,221279,2394637,자마이카,2008-09
2008-09-30,2584318,6446,2577872,투르크멘,2008-09
2008-09-30,2553140,0,2553140,불령 리유니온 코모도 제도,2008-09
2008-09-30,2325031,0,2325031,콩고민주공화국,2008-09
2008-09-30,2305486,404157,1901329,모리셔스,2008-09
2008-09-30,2215755,0,2215755,아메리칸 사모아,2008-09
2008-09-30,2089729,0,2089729,티모르,2008-09
2008-09-30,2088659,391139,1697520,아르메니아,2008-09
2008-09-30,2080452,368850,1711602,피지,2008-09
2008-09-30,1694349,97387,1596962,네팔,2008-09
2008-09-30,1610581,1012894,597687,마카오,2008-09
2008-09-30,1570142,271,1569871,말라위,2008-09
2008-09-30,1424941,51255559,-49830618,적도 기니,2008-09
2008-09-30,1410051,60021,1350030,네덜란드 열도,2008-09
2008-09-30,1306030,143186,1162844,아루바,2008-09
2008-09-30,1298338,2771,1295567,마티니크,2008-09
2008-09-30,1266632,0,1266632,과델로프,2008-09
2008-09-30,1146318,30192075,-29045757,볼리비아,2008-09
2008-09-30,1124153,0,1124153,모리타니,2008-09
2008-09-30,1109488,200964,908524,우간다,2008-09
2008-09-30,1100010,6770424,-5670414,짐바브웨,2008-09
2008-09-30,1063703,3681,1060022,도미니카,2008-09
2008-09-30,1060151,244453,815698,챠드,2008-09
2008-09-30,1026946,21261801,-20234855,잠비아,2008-09
2008-09-30,957174,2799879,-1842705,스와질랜드,2008-09
2008-09-30,953171,118570,834601,세이쉘,2008-09
2008-09-30,926864,49692,877172,팔레스타인 해방기구(구),2008-09
2008-09-30,885358,128700,756658,불령 폴리네시아,2008-09
2008-09-30,867958,2047841,-1179883,아이슬란드,2008-09
2008-09-30,781347,31826,749521,보스니아-헤르체고비나,2008-09
2008-09-30,721384,25613,695771,마세도니아,2008-09
2008-09-30,717153,52951,664202,보츠와나,2008-09
2008-09-30,704075,167691,536384,가봉,2008-09
2008-09-30,676481,692234,-15753,몰도바,2008-09
2008-09-30,633471,0,633471,버뮤다,2008-09
2008-09-30,631532,17021,614511,북마리아나 군도,2008-09
2008-09-30,593959,48151,545808,수리남,2008-09
2008-09-30,592174,1150562,-558388,아이티,2008-09
2008-09-30,582423,15820,566603,부탄,2008-09
2008-09-30,499413,0,499413,벨리제,2008-09
2008-09-30,467496,27730,439766,알바니아,2008-09
2008-09-30,465373,0,465373,바누아투,2008-09
2008-09-30,441007,472342,-31335,가이아나,2008-09
2008-09-30,440490,31158,409332,사모아,2008-09
2008-09-30,383157,37655,345502,바베이도스,2008-09
2008-09-30,371466,2400,369066,마이크로네시아,2008-09
2008-09-30,342853,483665,-140812,리히텐슈타인,2008-09
2008-09-30,299993,32152,267841,바하마,2008-09
2008-09-30,299403,1673,297730,몰디브,2008-09
2008-09-30,255763,800,254963,르완다,2008-09
2008-09-30,247252,148540,98712,니제르,2008-09
2008-09-30,214385,0,214385,부르키나 파소,2008-09
2008-09-30,196122,0,196122,불령 가이아나,2008-09
2008-09-30,181037,3057577,-2876540,솔로몬 군도,2008-09
2008-09-30,170850,24451,146399,영령 캐이맨 군도,2008-09
2008-09-30,169100,19851,149249,팔라우,2008-09
2008-09-30,166276,0,166276,그레나다,2008-09
2008-09-30,138969,117516,21453,시에라 리온,2008-09
2008-09-30,125471,0,125471,세인트 키츠 네비스,2008-09
2008-09-30,118481,0,118481,파로에 군도,2008-09
2008-09-30,113486,0,113486,산마리노,2008-09
2008-09-30,113271,0,113271,감비아,2008-09
2008-09-30,113263,0,113263,코모로스,2008-09
2008-09-30,111474,0,111474,카보 베르데,2008-09
2008-09-30,96672,406689,-310017,모나코,2008-09
2008-09-30,84762,0,84762,투르크 & 카이코스 군도,2008-09
2008-09-30,72904,0,72904,세인트 루시아,2008-09
2008-09-30,61203,116,61087,중앙아프리카공화국,2008-09
2008-09-30,59723,0,59723,몬트세라트,2008-09
2008-09-30,47559,0,47559,노폴크 아일랜드,2008-09
2008-09-30,46279,0,46279,불령 남부지역,2008-09
2008-09-30,43782,31500,12282,영령 버진군도,2008-09
2008-09-30,34188,0,34188,교황청,2008-09
2008-09-30,33176,124,33052,말리,2008-09
2008-09-30,19060,189,18871,지브랄타,2008-09
2008-09-30,17450,0,17450,미령 버진군도,2008-09
2008-09-30,13781,0,13781,부룬디,2008-09
2008-09-30,10312,7639,2673,코스 군도,2008-09
2008-09-30,5101,996,4105,쿡 아일랜드,2008-09
2008-09-30,180,0,180,통가,2008-09
2008-09-30,150,0,150,키리바티,2008-09
2008-09-30,0,407355,-407355,안도라,2008-09
2008-09-30,0,1426,-1426,앙귈라,2008-09
2008-09-30,0,25,-25,크리스마스 아일랜드,2008-09
2008-09-30,0,4810,-4810,영령 인도양,2008-09
2008-09-30,0,100144,-100144,토켈라우,2008-09
2008-09-30,0,48,-48,투발루,2008-09
2008-09-30,0,222,-222,안타티카,2008-09
2008-09-30,0,1824,-1824,상토메 프린스페,2008-09
2008-10-31,7467633082,6436912121,1030720961,중국,2008-10
2008-10-31,4434726510,3307294966,1127431544,미국,2008-10
2008-10-31,2443017832,5117799329,-2674781497,일본,2008-10
2008-10-31,1700072050,145807770,1554264280,홍콩,2008-10
2008-10-31,1310731162,793656984,517074178,싱가포르,2008-10
2008-10-31,1155079697,462385433,692694264,인도,2008-10
2008-10-31,1007552254,1188479549,-180927295,독일,2008-10
2008-10-31,895450778,693378399,202072379,러시아 연방,2008-10
2008-10-31,879874192,881241131,-1366939,대만,2008-10
2008-10-31,857319520,154300439,703019081,네덜란드,2008-10
2008-10-31,837606738,81314870,756291868,멕시코,2008-10
2008-10-31,834664863,412931256,421733607,파나마,2008-10
2008-10-31,689080757,755235531,-66154774,인도네시아,2008-10
2008-10-31,588166128,450873008,137293120,브라질,2008-10
2008-10-31,555845250,371199497,184645753,캐나다,2008-10
2008-10-31,520403384,409308703,111094681,태국,2008-10
2008-10-31,499257988,212135042,287122946,베트남,2008-10
2008-10-31,492111537,704806461,-212694924,말레이시아,2008-10
2008-10-31,479968171,1430422308,-950454137,아랍에미리트 연합,2008-10
2008-10-31,465779059,1879134521,-1413355462,호주,2008-10
2008-10-31,461845869,2653683544,-2191837675,사우디아라비아,2008-10
2008-10-31,425874001,315217375,110656626,영국,2008-10
2008-10-31,383856567,290290566,93566001,필리핀,2008-10
2008-10-31,381174316,23588141,357586175,폴란드,2008-10
2008-10-31,326893197,16818893,310074304,튀르키예,2008-10
2008-10-31,303308438,30658,303277780,라이베리아,2008-10
2008-10-31,299750275,18218344,281531931,슬로바키아,2008-10
2008-10-31,288893583,81569753,207323830,스페인,2008-10
2008-10-31,288740432,348494022,-59753590,이탈리아,2008-10
2008-10-31,279265828,371939485,-92673657,프랑스,2008-10
2008-10-31,266512727,641669997,-375157270,이란,2008-10
2008-10-31,259691563,85151307,174540256,핀란드,2008-10
2008-10-31,250925400,115775,250809625,바하마,2008-10
2008-10-31,232074578,979617295,-747542717,카타르,2008-10
2008-10-31,189580293,2889319,186690974,기타국,2008-10
2008-10-31,173295716,237061964,-63766248,칠레,2008-10
2008-10-31,172457538,96222951,76234587,벨기에,2008-10
2008-10-31,148622547,99638719,48983828,스웨덴,2008-10
2008-10-31,143569624,102437067,41132557,이집트,2008-10
2008-10-31,131546043,14340584,117205459,몰타,2008-10
2008-10-31,130327088,148096762,-17769674,노르웨이,2008-10
2008-10-31,126057671,1671032,124386639,우즈베키스탄,2008-10
2008-10-31,118945085,1580,118943505,마샬군도,2008-10
2008-10-31,117409341,116073819,1335522,우크라이나,2008-10
2008-10-31,116217774,217884682,-101666908,남아프리카공화국,2008-10
2008-10-31,111912049,32484275,79427774,헝가리,2008-10
2008-10-31,106453161,10388000,96065161,콜롬비아,2008-10
2008-10-31,105925594,11207,105914387,사이프러스,2008-10
2008-10-31,104052485,68620058,35432427,아일랜드,2008-10
2008-10-31,94863331,70712406,24150925,이스라엘,2008-10
2008-10-31,90390313,95018,90295295,리비아,2008-10
2008-10-31,87846569,63970107,23876462,나이지리아,2008-10
2008-10-31,86226521,1594350,84632171,베네주엘라,2008-10
2008-10-31,84797950,1848995,82948955,요르단,2008-10
2008-10-31,83305611,405762,82899849,시리아,2008-10
2008-10-31,78462990,6458291,72004699,방글라데시,2008-10
2008-10-31,78249228,7588857,70660371,슬로베니아,2008-10
2008-10-31,74048609,31500331,42548278,체코공화국,2008-10
2008-10-31,73255416,1994894,71260522,에쿠아도르,2008-10
2008-10-31,73051301,533656138,-460604837,오만,2008-10
2008-10-31,72074106,3188855,68885251,그리스,2008-10
2008-10-31,69120689,977836203,-908715514,쿠웨이트,2008-10
2008-10-31,66667964,33413,66634551,앙골라,2008-10
2008-10-31,65641939,222929,65419010,예맨,2008-10
2008-10-31,63810561,81216098,-17405537,뉴질랜드,2008-10
2008-10-31,63595244,81298168,-17702924,오스트리아,2008-10
2008-10-31,58516337,113292458,-54776121,아르헨티나,2008-10
2008-10-31,58245755,94907628,-36661873,페루,2008-10
2008-10-31,58009148,515740,57493408,알제리,2008-10
2008-10-31,57570717,583715,56987002,모나코,2008-10
2008-10-31,56839540,6573193,50266347,루마니아,2008-10
2008-10-31,48924168,298816589,-249892421,이라크,2008-10
2008-10-31,48168991,4432846,43736145,스리랑카,2008-10
2008-10-31,46906163,69406077,-22499914,파키스탄,2008-10
2008-10-31,46109945,58348889,-12238944,덴마크,2008-10
2008-10-31,40871372,4111852,36759520,모로코,2008-10
2008-10-31,33072309,37617755,-4545446,카자흐스탄,2008-10
2008-10-31,32434534,1815287,30619247,아제르바이잔,2008-10
2008-10-31,30002519,7237458,22765061,포루투갈,2008-10
2008-10-31,27291787,885315,26406472,과테말라,2008-10
2008-10-31,26402223,8579983,17822240,미얀마,2008-10
2008-10-31,25299990,1187648,24112342,캄보디아,2008-10
2008-10-31,22116303,379112,21737191,괌,2008-10
2008-10-31,21899199,166258687,-144359488,스위스,2008-10
2008-10-31,20589683,64983402,-44393719,바레인,2008-10
2008-10-31,19710371,926279,18784092,몽골,2008-10
2008-10-31,19486847,7151823,12335024,코스타리카,2008-10
2008-10-31,19421746,464685,18957061,레바논,2008-10
2008-10-31,19188668,21513461,-2324793,푸에르토리코,2008-10
2008-10-31,18055969,1408956,16647013,아이슬란드,2008-10
2008-10-31,17690717,1786262,15904455,가나,2008-10
2008-10-31,16936768,336961,16599807,케냐,2008-10
2008-10-31,16930307,49694,16880613,키르기스스탄,2008-10
2008-10-31,13768461,330067,13438394,크로아티아,2008-10
2008-10-31,12996481,5392,12991089,쿠바,2008-10
2008-10-31,12733065,1221677,11511388,튀니지,2008-10
2008-10-31,12036021,1552034,10483987,라트비아,2008-10
2008-10-31,11893528,2172370,9721158,불가리아,2008-10
2008-10-31,11678932,2458002,9220930,우루과이,2008-10
2008-10-31,11241929,1317879,9924050,온두라스,2008-10
2008-10-31,10785905,502974,10282931,파라과이,2008-10
2008-10-31,9352191,759784,8592407,수단,2008-10
2008-10-31,9204074,189143,9014931,니카라과,2008-10
2008-10-31,8609383,93888,8515495,마다카스카르,2008-10
2008-10-31,8199927,1184756,7015171,리투아니아,2008-10
2008-10-31,8073756,210134,7863622,코트디봐르,2008-10
2008-10-31,7760664,2009350,5751314,도미니카 공화국,2008-10
2008-10-31,6970196,883244,6086952,에스토니아,2008-10
2008-10-31,6723684,4834603,1889081,탄자니아,2008-10
2008-10-31,6695059,592756,6102303,에티오피아,2008-10
2008-10-31,6499882,1511431,4988451,엘살바도르,2008-10
2008-10-31,6325601,40741,6284860,뉴 칼레도니아,2008-10
2008-10-31,6244633,488856,5755777,피지,2008-10
2008-10-31,6132863,28226144,-22093281,라오스,2008-10
2008-10-31,6095333,142913,5952420,모잠비크,2008-10
2008-10-31,5507271,32327005,-26819734,파푸아 뉴기니,2008-10
2008-10-31,5370155,666662,4703493,벨라루스,2008-10
2008-10-31,5274579,36184,5238395,아메리칸 사모아,2008-10
2008-10-31,5151651,1824601,3327050,조지아,2008-10
2008-10-31,4880553,197766,4682787,베닝,2008-10
2008-10-31,4831826,46829767,-41997941,트리니다드 토바고,2008-10
2008-10-31,4625825,822404,3803421,세네갈,2008-10
2008-10-31,4363199,456052,3907147,카메룬,2008-10
2008-10-31,4350527,128406,4222121,세르비아 와 몬테네그로,2008-10
2008-10-31,3824731,11746496,-7921765,나우루,2008-10
2008-10-31,3719326,43845,3675481,타지크,2008-10
2008-10-31,3531635,3196,3528439,말라위,2008-10
2008-10-31,3390746,194424,3196322,모리셔스,2008-10
2008-10-31,3240650,136552,3104098,아르메니아,2008-10
2008-10-31,3153066,3306,3149760,레소토,2008-10
2008-10-31,2835135,956,2834179,부르키나 파소,2008-10
2008-10-31,2800187,7975,2792212,불령 리유니온 코모도 제도,2008-10
2008-10-31,2706074,190139,2515935,아프카니스탄,2008-10
2008-10-31,2681047,414178,2266869,토고,2008-10
2008-10-31,2673732,50175,2623557,불령 폴리네시아,2008-10
2008-10-31,2671666,3557298,-885632,룩셈부르그,2008-10
2008-10-31,2656119,89193,2566926,콩고,2008-10
2008-10-31,2568753,184754744,-182185991,브루나이,2008-10
2008-10-31,2560920,244976,2315944,팔레스타인 해방기구(구),2008-10
2008-10-31,2529547,173908,2355639,기니,2008-10
2008-10-31,2508027,0,2508027,과델로프,2008-10
2008-10-31,2430192,0,2430192,지부티,2008-10
2008-10-31,2360080,253030,2107050,자마이카,2008-10
2008-10-31,2280701,0,2280701,마티니크,2008-10
2008-10-31,2174518,30596,2143922,보스니아-헤르체고비나,2008-10
2008-10-31,2014267,19346091,-17331824,잠비아,2008-10
2008-10-31,2012562,0,2012562,아루바,2008-10
2008-10-31,1694084,0,1694084,수리남,2008-10
2008-10-31,1647093,89756,1557337,도미니카,2008-10
2008-10-31,1642403,676649,965754,콩고민주공화국,2008-10
2008-10-31,1631698,355579,1276119,마카오,2008-10
2008-10-31,1613534,143276,1470258,네팔,2008-10
2008-10-31,1462412,282128,1180284,몰도바,2008-10
2008-10-31,1325064,88951,1236113,바베이도스,2008-10
2008-10-31,1303972,645890,658082,아이티,2008-10
2008-10-31,1222506,0,1222506,적도 기니,2008-10
2008-10-31,1220211,1476475,-256264,스와질랜드,2008-10
2008-10-31,1153991,33718648,-32564657,가봉,2008-10
2008-10-31,1062723,29641,1033082,세이쉘,2008-10
2008-10-31,948354,209634,738720,볼리비아,2008-10
2008-10-31,919789,575093,344696,우간다,2008-10
2008-10-31,710770,0,710770,부탄,2008-10
2008-10-31,710642,10612,700030,벨리제,2008-10
2008-10-31,679047,46,679001,바누아투,2008-10
2008-10-31,675496,1414,674082,마세도니아,2008-10
2008-10-31,672710,76632,596078,안티가 바부다,2008-10
2008-10-31,648190,8074,640116,알바니아,2008-10
2008-10-31,647200,1910,645290,니제르,2008-10
2008-10-31,566081,937,565144,북마리아나 군도,2008-10
2008-10-31,544321,77750,466571,모리타니,2008-10
2008-10-31,482246,112014,370232,시에라 리온,2008-10
2008-10-31,450874,0,450874,버뮤다,2008-10
2008-10-31,432351,44013,388338,투르크멘,2008-10
2008-10-31,417254,2129248,-1711994,솔로몬 군도,2008-10
2008-10-31,415172,27267,387905,보츠와나,2008-10
2008-10-31,393649,5698,387951,안도라,2008-10
2008-10-31,392408,348214,44194,가이아나,2008-10
2008-10-31,374336,33613,340723,몰디브,2008-10
2008-10-31,347850,30000,317850,마이크로네시아,2008-10
2008-10-31,343137,89662,253475,사모아,2008-10
2008-10-31,339353,83177,256176,영령 캐이맨 군도,2008-10
2008-10-31,327877,0,327877,불령 가이아나,2008-10
2008-10-31,266436,389,266047,감비아,2008-10
2008-10-31,219009,255100,-36091,리히텐슈타인,2008-10
2008-10-31,210399,845880,-635481,짐바브웨,2008-10
2008-10-31,207300,0,207300,투르크 & 카이코스 군도,2008-10
2008-10-31,153955,0,153955,세인트 루시아,2008-10
2008-10-31,144971,0,144971,그레나다,2008-10
2008-10-31,143741,0,143741,네덜란드 열도,2008-10
2008-10-31,123001,2420,120581,미령 버진군도,2008-10
2008-10-31,113963,0,113963,키리바티,2008-10
2008-10-31,104004,5991,98013,팔라우,2008-10
2008-10-31,103882,170469,-66587,나미비아,2008-10
2008-10-31,99268,0,99268,에리트리아,2008-10
2008-10-31,97057,20452,76605,르완다,2008-10
2008-10-31,68453,66198,2255,기네비소,2008-10
2008-10-31,62966,2385,60581,산마리노,2008-10
2008-10-31,46545,0,46545,세인트 키츠 네비스,2008-10
2008-10-31,44706,0,44706,티모르,2008-10
2008-10-31,43261,0,43261,투발루,2008-10
2008-10-31,40374,0,40374,앙귈라,2008-10
2008-10-31,34894,0,34894,카보 베르데,2008-10
2008-10-31,24408,2370,22038,쿡 아일랜드,2008-10
2008-10-31,14620,0,14620,챠드,2008-10
2008-10-31,13570,0,13570,지브랄타,2008-10
2008-10-31,13049,551794,-538745,그린랜드,2008-10
2008-10-31,4441,0,4441,말리,2008-10
2008-10-31,1110,0,1110,교황청,2008-10
2008-10-31,733,0,733,소말리아,2008-10
2008-10-31,0,48149,-48149,영령 버진군도,2008-10
2008-10-31,0,66989,-66989,세인트 헬레나,2008-10
2008-10-31,0,300,-300,세인트 빈센트 그레나딘,2008-10
2008-10-31,0,21998,-21998,토켈라우,2008-10
2008-10-31,0,390,-390,마이너 아우틀링 합중국 군도,2008-10
2008-10-31,0,7,-7,안타티카,2008-10
2008-10-31,0,46074,-46074,니우에,2008-10
2008-11-30,5296229435,5207918420,88311015,중국,2008-11
2008-11-30,3498158080,2477569359,1020588721,미국,2008-11
2008-11-30,2077232377,3958069697,-1880837320,일본,2008-11
2008-11-30,1534419092,131816220,1402602872,홍콩,2008-11
2008-11-30,1024844349,544216329,480628020,싱가포르,2008-11
2008-11-30,1012166365,447451,1011718914,파나마,2008-11
2008-11-30,722914114,450,722913664,마샬군도,2008-11
2008-11-30,704235364,871213801,-166978437,독일,2008-11
2008-11-30,629271892,100296045,528975847,네덜란드,2008-11
2008-11-30,613465459,588349877,25115582,대만,2008-11
2008-11-30,529426388,306833849,222592539,인도,2008-11
2008-11-30,489397495,541188725,-51791230,러시아 연방,2008-11
2008-11-30,486709942,703675159,-216965217,인도네시아,2008-11
2008-11-30,462095907,1050237487,-588141580,아랍에미리트 연합,2008-11
2008-11-30,436107391,1806987929,-1370880538,사우디아라비아,2008-11
2008-11-30,425628031,77657664,347970367,멕시코,2008-11
2008-11-30,370396735,754161320,-383764585,말레이시아,2008-11
2008-11-30,365445281,125070935,240374346,베트남,2008-11
2008-11-30,364766074,251000009,113766065,태국,2008-11
2008-11-30,347765990,623158858,-275392868,이란,2008-11
2008-11-30,342318593,1584144506,-1241825913,호주,2008-11
2008-11-30,337378251,224654392,112723859,영국,2008-11
2008-11-30,303100637,182774636,120326001,필리핀,2008-11
2008-11-30,296807039,298531886,-1724847,프랑스,2008-11
2008-11-30,295950127,468634396,-172684269,브라질,2008-11
2008-11-30,281873658,308784864,-26911206,캐나다,2008-11
2008-11-30,275835351,18826518,257008833,튀르키예,2008-11
2008-11-30,261136241,93461282,167674959,벨기에,2008-11
2008-11-30,258709150,19844669,238864481,폴란드,2008-11
2008-11-30,244024625,299105267,-55080642,이탈리아,2008-11
2008-11-30,234506987,75963535,158543452,스페인,2008-11
2008-11-30,225158384,5827343,219331041,몰타,2008-11
2008-11-30,202964174,4128343,198835831,슬로바키아,2008-11
2008-11-30,186963584,134616517,52347067,노르웨이,2008-11
2008-11-30,181919228,21084648,160834580,라이베리아,2008-11
2008-11-30,179608885,236028893,-56420008,칠레,2008-11
2008-11-30,162417701,63297,162354404,사이프러스,2008-11
2008-11-30,143962179,68459077,75503102,이집트,2008-11
2008-11-30,137949903,101248,137848655,리비아,2008-11
2008-11-30,128076889,1521597974,-1393521085,카타르,2008-11
2008-11-30,124446795,270844,124175951,나이지리아,2008-11
2008-11-30,120309750,54781211,65528539,알제리,2008-11
2008-11-30,110182636,49323854,60858782,핀란드,2008-11
2008-11-30,105926333,625373,105300960,시리아,2008-11
2008-11-30,105025110,1875362,103149748,그리스,2008-11
2008-11-30,103820493,579961,103240532,요르단,2008-11
2008-11-30,99899682,44426565,55473117,우즈베키스탄,2008-11
2008-11-30,94520082,7515163,87004919,방글라데시,2008-11
2008-11-30,85928968,5205563,80723405,콜롬비아,2008-11
2008-11-30,77039500,633535314,-556495814,쿠웨이트,2008-11
2008-11-30,75814685,1454837,74359848,에쿠아도르,2008-11
2008-11-30,75604194,66437602,9166592,이스라엘,2008-11
2008-11-30,72572387,24918558,47653829,헝가리,2008-11
2008-11-30,72526804,60489303,12037501,페루,2008-11
2008-11-30,72057613,149078576,-77020963,우크라이나,2008-11
2008-11-30,70945231,140208988,-69263757,남아프리카공화국,2008-11
2008-11-30,67985809,21656738,46329071,체코공화국,2008-11
2008-11-30,60515885,596328286,-535812401,오만,2008-11
2008-11-30,53648098,861097,52787001,베네주엘라,2008-11
2008-11-30,52794819,72293561,-19498742,뉴질랜드,2008-11
2008-11-30,48509447,80521862,-32012415,스웨덴,2008-11
2008-11-30,47308287,3209738,44098549,슬로베니아,2008-11
2008-11-30,46630549,88613671,-41983122,오스트리아,2008-11
2008-11-30,42676057,3020589,39655468,스리랑카,2008-11
2008-11-30,42523374,48030623,-5507249,아일랜드,2008-11
2008-11-30,42395440,135644329,-93248889,아르헨티나,2008-11
2008-11-30,38302947,35972056,2330891,파키스탄,2008-11
2008-11-30,37372415,132430470,-95058055,이라크,2008-11
2008-11-30,33823639,6231429,27592210,포루투갈,2008-11
2008-11-30,32847000,23675954,9171046,루마니아,2008-11
2008-11-30,30692195,863723,29828472,레바논,2008-11
2008-11-30,30432362,4228335,26204027,미얀마,2008-11
2008-11-30,28435097,119485474,-91050377,스위스,2008-11
2008-11-30,26635412,4119228,22516184,모로코,2008-11
2008-11-30,25058176,11890,25046286,앙골라,2008-11
2008-11-30,24719399,12856382,11863017,바레인,2008-11
2008-11-30,24300231,42370356,-18070125,덴마크,2008-11
2008-11-30,21661587,21187542,474045,카자흐스탄,2008-11
2008-11-30,21463416,602211,20861205,과테말라,2008-11
2008-11-30,20442899,220739,20222160,케냐,2008-11
2008-11-30,19001763,711738,18290025,캄보디아,2008-11
2008-11-30,17338814,431843,16906971,몽골,2008-11
2008-11-30,17308006,1197174,16110832,아제르바이잔,2008-11
2008-11-30,16111835,255469,15856366,가나,2008-11
2008-11-30,13834764,5809,13828955,수단,2008-11
2008-11-30,13756536,11705847,2050689,푸에르토리코,2008-11
2008-11-30,10931606,7337468,3594138,코스타리카,2008-11
2008-11-30,10091770,164000,9927770,키르기스스탄,2008-11
2008-11-30,9836012,149756,9686256,파라과이,2008-11
2008-11-30,9591201,657704,8933497,라트비아,2008-11
2008-11-30,9536925,957660,8579265,온두라스,2008-11
2008-11-30,9496740,50952,9445788,마다카스카르,2008-11
2008-11-30,9278584,505647,8772937,튀니지,2008-11
2008-11-30,8934417,79356,8855061,니카라과,2008-11
2008-11-30,8847503,5445,8842058,아프카니스탄,2008-11
2008-11-30,8807650,437400,8370250,크로아티아,2008-11
2008-11-30,8595550,1246,8594304,예맨,2008-11
2008-11-30,8040002,3253673,4786329,우루과이,2008-11
2008-11-30,6917474,159391,6758083,쿠바,2008-11
2008-11-30,6837466,62173785,-55336319,트리니다드 토바고,2008-11
2008-11-30,6831758,845772,5985986,탄자니아,2008-11
2008-11-30,6673071,23079269,-16406198,파푸아 뉴기니,2008-11
2008-11-30,6095958,1756,6094202,코트디봐르,2008-11
2008-11-30,6065153,1809538,4255615,불가리아,2008-11
2008-11-30,5819840,46333876,-40514036,적도 기니,2008-11
2008-11-30,5647035,2120476,3526559,도미니카 공화국,2008-11
2008-11-30,5428045,413793,5014252,벨라루스,2008-11
2008-11-30,4741092,43921,4697171,아메리칸 사모아,2008-11
2008-11-30,4709728,14403092,-9693364,룩셈부르그,2008-11
2008-11-30,4620738,199090475,-194469737,브루나이,2008-11
2008-11-30,4478285,290087,4188198,기니,2008-11
2008-11-30,4442723,356435,4086288,리투아니아,2008-11
2008-11-30,4287069,3545,4283524,타지크,2008-11
2008-11-30,4242635,284814,3957821,엘살바도르,2008-11
2008-11-30,4235398,0,4235398,투르크멘,2008-11
2008-11-30,4209477,9292269,-5082792,뉴 칼레도니아,2008-11
2008-11-30,4198246,5308190,-1109944,에스토니아,2008-11
2008-11-30,4033510,605606,3427904,베닝,2008-11
2008-11-30,3929887,3043113,886774,기타국,2008-11
2008-11-30,3905043,875076,3029967,조지아,2008-11
2008-11-30,3421284,11482,3409802,지부티,2008-11
2008-11-30,3398087,219186,3178901,모리셔스,2008-11
2008-11-30,3336945,755936,2581009,카메룬,2008-11
2008-11-30,3325188,651312,2673876,세네갈,2008-11
2008-11-30,3310616,168103,3142513,라오스,2008-11
2008-11-30,3064202,64402,2999800,괌,2008-11
2008-11-30,2987326,14477,2972849,세르비아 와 몬테네그로,2008-11
2008-11-30,2510617,2307,2508310,아르메니아,2008-11
2008-11-30,2475475,1117,2474358,네덜란드 열도,2008-11
2008-11-30,2459618,0,2459618,불령 리유니온 코모도 제도,2008-11
2008-11-30,2367211,21639,2345572,콩고,2008-11
2008-11-30,2343832,504906,1838926,마카오,2008-11
2008-11-30,2278004,83493,2194511,아이티,2008-11
2008-11-30,2196602,508056,1688546,에티오피아,2008-11
2008-11-30,2153252,22322,2130930,네팔,2008-11
2008-11-30,1942063,0,1942063,마티니크,2008-11
2008-11-30,1830324,22725781,-20895457,나우루,2008-11
2008-11-30,1798923,11324818,-9525895,잠비아,2008-11
2008-11-30,1665907,307,1665600,모잠비크,2008-11
2008-11-30,1412100,1027,1411073,레소토,2008-11
2008-11-30,1297565,21906180,-20608615,볼리비아,2008-11
2008-11-30,1267061,20699,1246362,바하마,2008-11
2008-11-30,1224576,129213,1095363,자마이카,2008-11
2008-11-30,1122740,0,1122740,콩고민주공화국,2008-11
2008-11-30,1089427,342573,746854,몰도바,2008-11
2008-11-30,1072677,5767045,-4694368,말라위,2008-11
2008-11-30,1039423,108564,930859,피지,2008-11
2008-11-30,1039380,4848,1034532,알바니아,2008-11
2008-11-30,1027599,115223,912376,불령 폴리네시아,2008-11
2008-11-30,962551,0,962551,아루바,2008-11
2008-11-30,949074,940,948134,모리타니,2008-11
2008-11-30,883116,0,883116,토고,2008-11
2008-11-30,869590,287681,581909,가봉,2008-11
2008-11-30,851329,1185296,-333967,스와질랜드,2008-11
2008-11-30,835856,1108953,-273097,세이쉘,2008-11
2008-11-30,814214,10309,803905,바베이도스,2008-11
2008-11-30,797959,0,797959,과델로프,2008-11
2008-11-30,730559,472022,258537,가이아나,2008-11
2008-11-30,725191,22960,702231,사모아,2008-11
2008-11-30,715301,100,715201,바누아투,2008-11
2008-11-30,661941,0,661941,영령 캐이맨 군도,2008-11
2008-11-30,631108,325278,305830,팔레스타인 해방기구(구),2008-11
2008-11-30,603230,12154,591076,마세도니아,2008-11
2008-11-30,596161,46464,549697,보스니아-헤르체고비나,2008-11
2008-11-30,548718,4631,544087,니제르,2008-11
2008-11-30,543884,336,543548,안티가 바부다,2008-11
2008-11-30,513050,0,513050,부탄,2008-11
2008-11-30,473587,79002,394585,도미니카,2008-11
2008-11-30,460516,0,460516,수리남,2008-11
2008-11-30,459937,0,459937,버뮤다,2008-11
2008-11-30,393960,1609,392351,북마리아나 군도,2008-11
2008-11-30,359986,18,359968,르완다,2008-11
2008-11-30,356320,172,356148,안도라,2008-11
2008-11-30,355118,14358,340760,보츠와나,2008-11
2008-11-30,340770,50973,289797,벨리제,2008-11
2008-11-30,299880,862377,-562497,솔로몬 군도,2008-11
2008-11-30,272441,0,272441,불령 가이아나,2008-11
2008-11-30,259741,426,259315,에리트리아,2008-11
2008-11-30,259154,0,259154,마이크로네시아,2008-11
2008-11-30,253640,271848,-18208,우간다,2008-11
2008-11-30,249809,0,249809,미령 버진군도,2008-11
2008-11-30,249780,48642,201138,시에라 리온,2008-11
2008-11-30,243103,356603,-113500,리히텐슈타인,2008-11
2008-11-30,230618,0,230618,그레나다,2008-11
2008-11-30,215083,0,215083,부르키나 파소,2008-11
2008-11-30,173480,0,173480,세인트 루시아,2008-11
2008-11-30,154615,193001,-38386,나미비아,2008-11
2008-11-30,128770,5577,123193,팔라우,2008-11
2008-11-30,122658,20,122638,감비아,2008-11
2008-11-30,114201,15,114186,몰디브,2008-11
2008-11-30,97202,0,97202,영령 버진군도,2008-11
2008-11-30,75776,0,75776,카보 베르데,2008-11
2008-11-30,72523,445253,-372730,짐바브웨,2008-11
2008-11-30,63210,0,63210,투르크 & 카이코스 군도,2008-11
2008-11-30,58954,787916,-728962,아이슬란드,2008-11
2008-11-30,57277,0,57277,지브랄타,2008-11
2008-11-30,41870,0,41870,노폴크 아일랜드,2008-11
2008-11-30,37654,0,37654,세인트 키츠 네비스,2008-11
2008-11-30,29996,472598,-442602,모나코,2008-11
2008-11-30,25613,0,25613,티모르,2008-11
2008-11-30,24592,460447,-435855,통가,2008-11
2008-11-30,24408,0,24408,쿡 아일랜드,2008-11
2008-11-30,22770,0,22770,상토메 프린스페,2008-11
2008-11-30,21100,5255,15845,말리,2008-11
2008-11-30,21087,0,21087,세인트 빈센트 그레나딘,2008-11
2008-11-30,3650,0,3650,앙귈라,2008-11
2008-11-30,21,485493,-485472,그린랜드,2008-11
2008-11-30,0,375,-375,세인트 헬레나,2008-11
2008-11-30,0,1600,-1600,코스 군도,2008-11
2008-11-30,0,2756,-2756,마이너 아우틀링 합중국 군도,2008-11
2008-11-30,0,7693,-7693,토켈라우,2008-11
2008-11-30,0,31471,-31471,중앙아프리카공화국,2008-11
2008-11-30,0,95,-95,교황청,2008-11
2008-12-31,4714746071,4391918672,322827399,중국,2008-12
2008-12-31,3491259813,2510216424,981043389,미국,2008-12
2008-12-31,1997483412,3797437717,-1799954305,일본,2008-12
2008-12-31,1161183111,8005026,1153178085,파나마,2008-12
2008-12-31,1073123674,219710590,853413084,홍콩,2008-12
2008-12-31,919826309,577319886,342506423,인도네시아,2008-12
2008-12-31,812316447,457791394,354525053,싱가포르,2008-12
2008-12-31,709142246,800,709141446,마샬군도,2008-12
2008-12-31,533058694,1012828325,-479769631,독일,2008-12
2008-12-31,529855152,249155324,280699828,인도,2008-12
2008-12-31,498784769,490654673,8130096,대만,2008-12
2008-12-31,492960852,138948936,354011916,베트남,2008-12
2008-12-31,469741797,160714785,309027012,노르웨이,2008-12
2008-12-31,463389211,858170668,-394781457,아랍에미리트 연합,2008-12
2008-12-31,440345761,398037894,42307867,러시아 연방,2008-12
2008-12-31,422206046,156534624,265671422,네덜란드,2008-12
2008-12-31,408127183,1434998748,-1026871565,사우디아라비아,2008-12
2008-12-31,406959458,59057343,347902115,멕시코,2008-12
2008-12-31,379831024,427003098,-47172074,이란,2008-12
2008-12-31,354794448,588399894,-233605446,말레이시아,2008-12
2008-12-31,319800212,1653949813,-1334149601,호주,2008-12
2008-12-31,315011405,353771034,-38759629,태국,2008-12
2008-12-31,298996538,147964237,151032301,필리핀,2008-12
2008-12-31,297389800,260166386,37223414,영국,2008-12
2008-12-31,275353164,368574178,-93221014,캐나다,2008-12
2008-12-31,249881702,24445500,225436202,폴란드,2008-12
2008-12-31,230386933,1468772852,-1238385919,카타르,2008-12
2008-12-31,226840488,1757434,225083054,그리스,2008-12
2008-12-31,212231863,45097,212186766,라이베리아,2008-12
2008-12-31,199670467,301297145,-101626678,이탈리아,2008-12
2008-12-31,197796007,18786,197777221,바하마,2008-12
2008-12-31,183393647,6872308,176521339,몰타,2008-12
2008-12-31,177234143,423029400,-245795257,브라질,2008-12
2008-12-31,163568972,20100481,143468491,튀르키예,2008-12
2008-12-31,157635959,12598206,145037753,이집트,2008-12
2008-12-31,155000576,4283641,150716935,슬로바키아,2008-12
2008-12-31,148426911,350271556,-201844645,프랑스,2008-12
2008-12-31,148257026,87900338,60356688,벨기에,2008-12
2008-12-31,147956567,128244062,19712505,칠레,2008-12
2008-12-31,139209540,87832967,51376573,스페인,2008-12
2008-12-31,116901341,2161827,114739514,슬로베니아,2008-12
2008-12-31,107655727,760780,106894947,알제리,2008-12
2008-12-31,104866355,2044474,102821881,우즈베키스탄,2008-12
2008-12-31,97321536,6935512,90386024,콜롬비아,2008-12
2008-12-31,88942971,641187143,-552244172,쿠웨이트,2008-12
2008-12-31,83595782,72994,83522788,리비아,2008-12
2008-12-31,78759598,43403775,35355823,나이지리아,2008-12
2008-12-31,76660232,232268,76427964,시리아,2008-12
2008-12-31,75563654,465526241,-389962587,오만,2008-12
2008-12-31,74664747,134730241,-60065494,남아프리카공화국,2008-12
2008-12-31,71739546,6228353,65511193,방글라데시,2008-12
2008-12-31,68160563,41611045,26549518,핀란드,2008-12
2008-12-31,67991183,78637683,-10646500,이스라엘,2008-12
2008-12-31,63589215,21900569,41688646,체코공화국,2008-12
2008-12-31,62219834,71886177,-9666343,뉴질랜드,2008-12
2008-12-31,60155841,13798061,46357780,요르단,2008-12
2008-12-31,57231539,293587,56937952,사이프러스,2008-12
2008-12-31,54819819,30224605,24595214,파키스탄,2008-12
2008-12-31,54682140,116508909,-61826769,우크라이나,2008-12
2008-12-31,51937243,2776778,49160465,미얀마,2008-12
2008-12-31,50995218,70865091,-19869873,페루,2008-12
2008-12-31,45982322,0,45982322,지브랄타,2008-12
2008-12-31,45031423,725638,44305785,베네주엘라,2008-12
2008-12-31,42859426,89954719,-47095293,오스트리아,2008-12
2008-12-31,42193822,38152104,4041718,헝가리,2008-12
2008-12-31,37146993,105996152,-68849159,스웨덴,2008-12
2008-12-31,35427882,3558088,31869794,루마니아,2008-12
2008-12-31,34953311,1984075,32969236,에쿠아도르,2008-12
2008-12-31,33787852,18636,33769216,니카라과,2008-12
2008-12-31,32633849,140848253,-108214404,이라크,2008-12
2008-12-31,32158142,105310565,-73152423,아르헨티나,2008-12
2008-12-31,30407793,57507128,-27099335,덴마크,2008-12
2008-12-31,29741194,1874787,27866407,모로코,2008-12
2008-12-31,27672338,39913,27632425,쿠바,2008-12
2008-12-31,27635864,0,27635864,앙골라,2008-12
2008-12-31,26618268,10799033,15819235,바레인,2008-12
2008-12-31,23982269,1725400,22256869,캄보디아,2008-12
2008-12-31,23301907,245625,23056282,레바논,2008-12
2008-12-31,23175893,4140500,19035393,포루투갈,2008-12
2008-12-31,23140818,143472884,-120332066,스위스,2008-12
2008-12-31,21580576,3581547,17999029,스리랑카,2008-12
2008-12-31,21555638,95292897,-73737259,아일랜드,2008-12
2008-12-31,20777483,12023441,8754042,카자흐스탄,2008-12
2008-12-31,20097299,7350,20089949,수단,2008-12
2008-12-31,20038581,942265,19096316,과테말라,2008-12
2008-12-31,16909127,645776,16263351,가나,2008-12
2008-12-31,12157282,18830,12138452,아제르바이잔,2008-12
2008-12-31,11863667,69338,11794329,케냐,2008-12
2008-12-31,11717474,473685,11243789,몽골,2008-12
2008-12-31,11328233,8844870,2483363,푸에르토리코,2008-12
2008-12-31,10542380,113749,10428631,예맨,2008-12
2008-12-31,8627226,641549,7985677,튀니지,2008-12
2008-12-31,8486410,316846,8169564,에티오피아,2008-12
2008-12-31,8473244,1434836,7038408,불가리아,2008-12
2008-12-31,8403860,31252,8372608,키르기스스탄,2008-12
2008-12-31,8149359,7655792,493567,코스타리카,2008-12
2008-12-31,7510169,632,7509537,아르메니아,2008-12
2008-12-31,6960386,485633,6474753,에스토니아,2008-12
2008-12-31,6083895,6683,6077212,아프카니스탄,2008-12
2008-12-31,6063300,1571453,4491847,탄자니아,2008-12
2008-12-31,5903007,118918,5784089,마다카스카르,2008-12
2008-12-31,5888290,288951,5599339,크로아티아,2008-12
2008-12-31,5598735,10326863,-4728128,뉴 칼레도니아,2008-12
2008-12-31,5309811,2115171,3194640,도미니카 공화국,2008-12
2008-12-31,4997725,1367493,3630232,라트비아,2008-12
2008-12-31,4945058,0,4945058,콩고,2008-12
2008-12-31,4703459,611850,4091609,리투아니아,2008-12
2008-12-31,4567123,3646,4563477,코트디봐르,2008-12
2008-12-31,4353027,60914472,-56561445,트리니다드 토바고,2008-12
2008-12-31,4200003,3242407,957596,기타국,2008-12
2008-12-31,3972384,13592,3958792,세르비아 와 몬테네그로,2008-12
2008-12-31,3842428,3337,3839091,괌,2008-12
2008-12-31,3747503,341342,3406161,벨라루스,2008-12
2008-12-31,3597573,986068,2611505,온두라스,2008-12
2008-12-31,3512613,156661405,-153148792,적도 기니,2008-12
2008-12-31,3250528,56650,3193878,르완다,2008-12
2008-12-31,3236979,184909,3052070,라오스,2008-12
2008-12-31,3107124,40265256,-37158132,브루나이,2008-12
2008-12-31,3020916,2780988,239928,우루과이,2008-12
2008-12-31,3011651,924601,2087050,베닝,2008-12
2008-12-31,2923481,0,2923481,토고,2008-12
2008-12-31,2888391,1791031,1097360,카메룬,2008-12
2008-12-31,2784023,131167,2652856,모잠비크,2008-12
2008-12-31,2702005,708,2701297,아메리칸 사모아,2008-12
2008-12-31,2584811,290960,2293851,파라과이,2008-12
2008-12-31,2566631,332622,2234009,세네갈,2008-12
2008-12-31,2469586,0,2469586,타지크,2008-12
2008-12-31,2407873,202976,2204897,엘살바도르,2008-12
2008-12-31,2355471,52513,2302958,모리셔스,2008-12
2008-12-31,2170943,3035550,-864607,룩셈부르그,2008-12
2008-12-31,2080098,34011700,-31931602,아루바,2008-12
2008-12-31,2057633,127949,1929684,가봉,2008-12
2008-12-31,2023945,1402,2022543,알바니아,2008-12
2008-12-31,2015882,90303,1925579,팔레스타인 해방기구(구),2008-12
2008-12-31,1849386,44611,1804775,네팔,2008-12
2008-12-31,1816029,310070,1505959,피지,2008-12
2008-12-31,1774426,127399,1647027,콩고민주공화국,2008-12
2008-12-31,1671350,189,1671161,지부티,2008-12
2008-12-31,1615980,2502185,-886205,파푸아 뉴기니,2008-12
2008-12-31,1587266,42244,1545022,보츠와나,2008-12
2008-12-31,1582787,22749,1560038,투르크멘,2008-12
2008-12-31,1515996,1123365,392631,조지아,2008-12
2008-12-31,1488552,357344,1131208,마카오,2008-12
2008-12-31,1469010,0,1469010,나우루,2008-12
2008-12-31,1433278,42009,1391269,세이쉘,2008-12
2008-12-31,1308861,7118,1301743,아이티,2008-12
2008-12-31,1270245,98246,1171999,자마이카,2008-12
2008-12-31,1262462,8391,1254071,보스니아-헤르체고비나,2008-12
2008-12-31,1184176,0,1184176,버뮤다,2008-12
2008-12-31,1139630,47321,1092309,네덜란드 열도,2008-12
2008-12-31,1106987,0,1106987,마티니크,2008-12
2008-12-31,1093391,650206,443185,기니,2008-12
2008-12-31,982681,4020,978661,레소토,2008-12
2008-12-31,975732,488,975244,과델로프,2008-12
2008-12-31,972606,11143,961463,불령 폴리네시아,2008-12
2008-12-31,894856,919282,-24426,볼리비아,2008-12
2008-12-31,868250,0,868250,불령 리유니온 코모도 제도,2008-12
2008-12-31,844413,12632,831781,마세도니아,2008-12
2008-12-31,827668,1462488,-634820,말라위,2008-12
2008-12-31,795737,437830,357907,몰도바,2008-12
2008-12-31,579414,1100042,-520628,스와질랜드,2008-12
2008-12-31,514998,0,514998,불령 가이아나,2008-12
2008-12-31,509084,268816,240268,바누아투,2008-12
2008-12-31,485450,0,485450,영령 캐이맨 군도,2008-12
2008-12-31,462171,75768,386403,감비아,2008-12
2008-12-31,433992,0,433992,수리남,2008-12
2008-12-31,432337,0,432337,마이크로네시아,2008-12
2008-12-31,402168,84710,317458,우간다,2008-12
2008-12-31,367777,0,367777,가이아나,2008-12
2008-12-31,318653,288,318365,몰디브,2008-12
2008-12-31,308343,3861,304482,니제르,2008-12
2008-12-31,299967,5011234,-4711267,잠비아,2008-12
2008-12-31,287587,48462,239125,북마리아나 군도,2008-12
2008-12-31,255280,0,255280,세인트 키츠 네비스,2008-12
2008-12-31,245658,0,245658,바베이도스,2008-12
2008-12-31,241149,293208,-52059,리히텐슈타인,2008-12
2008-12-31,239605,391748,-152143,짐바브웨,2008-12
2008-12-31,211856,2219616,-2007760,솔로몬 군도,2008-12
2008-12-31,198124,1506316,-1308192,아이슬란드,2008-12
2008-12-31,184319,90021,94298,사모아,2008-12
2008-12-31,181242,0,181242,부탄,2008-12
2008-12-31,173254,0,173254,세인트 루시아,2008-12
2008-12-31,159008,0,159008,카보 베르데,2008-12
2008-12-31,156348,25520,130828,팔라우,2008-12
2008-12-31,149821,0,149821,부르키나 파소,2008-12
2008-12-31,139290,25982,113308,시에라 리온,2008-12
2008-12-31,130022,0,130022,안티가 바부다,2008-12
2008-12-31,122604,0,122604,미령 버진군도,2008-12
2008-12-31,102281,58224,44057,모리타니,2008-12
2008-12-31,96216,4020,92196,나미비아,2008-12
2008-12-31,88173,0,88173,세인트 빈센트 그레나딘,2008-12
2008-12-31,79195,2466,76729,벨리제,2008-12
2008-12-31,70626,69835,791,기네비소,2008-12
2008-12-31,63141,25495,37646,그레나다,2008-12
2008-12-31,60463,0,60463,말리,2008-12
2008-12-31,46832,18308,28524,영령 버진군도,2008-12
2008-12-31,43339,0,43339,챠드,2008-12
2008-12-31,38278,0,38278,불령 남부지역,2008-12
2008-12-31,18804,159044,-140240,도미니카,2008-12
2008-12-31,18252,3803,14449,산마리노,2008-12
2008-12-31,14784,773965,-759181,모나코,2008-12
2008-12-31,6849,0,6849,쿡 아일랜드,2008-12
2008-12-31,4730,257221,-252491,통가,2008-12
2008-12-31,4517,1578,2939,안도라,2008-12
2008-12-31,3850,31196,-27346,중앙아프리카공화국,2008-12
2008-12-31,2033,2588,-555,몬트세라트,2008-12
2008-12-31,0,121,-121,교황청,2008-12
2008-12-31,0,765,-765,코스 군도,2008-12
2008-12-31,0,11305,-11305,토켈라우,2008-12
2008-12-31,0,9,-9,앙귈라,2008-12
2008-12-31,0,69467,-69467,에리트리아,2008-12
2008-12-31,0,264521,-264521,키리바티,2008-12
2008-12-31,0,1694826,-1694826,파로에 군도,2008-12
2008-12-31,0,374960,-374960,그린랜드,2008-12
2008-12-31,0,854,-854,투발루,2008-12
2008-12-31,0,2256,-2256,마이너 아우틀링 합중국 군도,2008-12
2008-12-31,0,906,-906,메요트,2008-12
2009-01-31,4465852319,4123664317,342188002,중국,2009-01
2009-01-31,2627953178,1753805541,874147637,미국,2009-01
2009-01-31,1530821063,2994648952,-1463827889,일본,2009-01
2009-01-31,1110963049,131139947,979823102,홍콩,2009-01
2009-01-31,700094797,679283225,20811572,싱가포르,2009-01
2009-01-31,612334288,846381198,-234046910,독일,2009-01
2009-01-31,518451736,51981954,466469782,멕시코,2009-01
2009-01-31,417003242,166878606,250124636,인도,2009-01
2009-01-31,406007174,575511526,-169504352,대만,2009-01
2009-01-31,377360420,100427062,276933358,네덜란드,2009-01
2009-01-31,344636627,598467921,-253831294,인도네시아,2009-01
2009-01-31,342559337,900,342558437,마샬군도,2009-01
2009-01-31,340038623,138545570,201493053,베트남,2009-01
2009-01-31,333369573,388153423,-54783850,러시아 연방,2009-01
2009-01-31,321878302,163680413,158197889,필리핀,2009-01
2009-01-31,309977829,329579179,-19601350,프랑스,2009-01
2009-01-31,306665571,1417372274,-1110706703,호주,2009-01
2009-01-31,293766699,27407,293739292,라이베리아,2009-01
2009-01-31,285071630,83612229,201459401,벨기에,2009-01
2009-01-31,282446608,701356557,-418909949,아랍에미리트 연합,2009-01
2009-01-31,270456022,250617412,19838610,태국,2009-01
2009-01-31,268317557,66333926,201983631,파나마,2009-01
2009-01-31,259479027,434604967,-175125940,이란,2009-01
2009-01-31,254578263,1657204793,-1402626530,사우디아라비아,2009-01
2009-01-31,253307855,394154759,-140846904,브라질,2009-01
2009-01-31,245560629,743021198,-497460569,말레이시아,2009-01
2009-01-31,226695072,24923356,201771716,폴란드,2009-01
2009-01-31,209658913,254177529,-44518616,캐나다,2009-01
2009-01-31,202060160,195429145,6631015,영국,2009-01
2009-01-31,197807609,5377961,192429648,몰타,2009-01
2009-01-31,171322539,1135923269,-964600730,카타르,2009-01
2009-01-31,171248235,285790132,-114541897,이탈리아,2009-01
2009-01-31,155617880,46987351,108630529,튀르키예,2009-01
2009-01-31,150664130,4471769,146192361,슬로바키아,2009-01
2009-01-31,138626560,187731044,-49104484,칠레,2009-01
2009-01-31,107656974,59919646,47737328,스페인,2009-01
2009-01-31,87268944,23039609,64229335,알제리,2009-01
2009-01-31,79403808,220303688,-140899880,이집트,2009-01
2009-01-31,73906406,651643310,-577736904,쿠웨이트,2009-01
2009-01-31,73827100,3676663,70150437,방글라데시,2009-01
2009-01-31,70033735,41203882,28829853,덴마크,2009-01
2009-01-31,66859179,80167095,-13307916,나이지리아,2009-01
2009-01-31,64678164,0,64678164,리비아,2009-01
2009-01-31,63114017,722194,62391823,우즈베키스탄,2009-01
2009-01-31,62969145,22498203,40470942,파키스탄,2009-01
2009-01-31,60813413,24473198,36340215,헝가리,2009-01
2009-01-31,59182578,97069558,-37886980,남아프리카공화국,2009-01
2009-01-31,58131144,227550,57903594,요르단,2009-01
2009-01-31,56345709,455133,55890576,시리아,2009-01
2009-01-31,47292134,22609750,24682384,체코공화국,2009-01
2009-01-31,45925112,65445692,-19520580,이스라엘,2009-01
2009-01-31,44879825,443718,44436107,베네주엘라,2009-01
2009-01-31,44169020,59520226,-15351206,뉴질랜드,2009-01
2009-01-31,42899067,17849129,25049938,루마니아,2009-01
2009-01-31,42630259,6556421,36073838,콜롬비아,2009-01
2009-01-31,39855654,256224787,-216369133,이라크,2009-01
2009-01-31,34470010,90336522,-55866512,핀란드,2009-01
2009-01-31,33095816,4448,33091368,앙골라,2009-01
2009-01-31,32532644,896472022,-863939378,오만,2009-01
2009-01-31,31892189,58679291,-26787102,오스트리아,2009-01
2009-01-31,31688617,112689083,-81000466,스위스,2009-01
2009-01-31,29768813,4518431,25250382,슬로베니아,2009-01
2009-01-31,29179900,85455094,-56275194,스웨덴,2009-01
2009-01-31,24611985,82565440,-57953455,페루,2009-01
2009-01-31,21600322,68720931,-47120609,아르헨티나,2009-01
2009-01-31,19857753,414958,19442795,에쿠아도르,2009-01
2009-01-31,17719491,3668738,14050753,포루투갈,2009-01
2009-01-31,17667997,1492406,16175591,모로코,2009-01
2009-01-31,17322172,662084,16660088,과테말라,2009-01
2009-01-31,16287557,2784911,13502646,그리스,2009-01
2009-01-31,15167053,98384202,-83217149,우크라이나,2009-01
2009-01-31,14777847,881347,13896500,캄보디아,2009-01
2009-01-31,13179648,9258899,3920749,카자흐스탄,2009-01
2009-01-31,11988084,3476094,8511990,가나,2009-01
2009-01-31,11845966,3832920,8013046,바레인,2009-01
2009-01-31,11571741,2886728,8685013,미얀마,2009-01
2009-01-31,11050774,150612,10900162,레바논,2009-01
2009-01-31,10961387,3454094,7507293,스리랑카,2009-01
2009-01-31,10879944,28067,10851877,쿠바,2009-01
2009-01-31,10868259,137754307,-126886048,노르웨이,2009-01
2009-01-31,10845833,48167684,-37321851,아일랜드,2009-01
2009-01-31,9503493,82552,9420941,마다카스카르,2009-01
2009-01-31,9337945,9291743,46202,푸에르토리코,2009-01
2009-01-31,8700334,1529421,7170913,튀니지,2009-01
2009-01-31,7999454,207989,7791465,예맨,2009-01
2009-01-31,7837443,1011641,6825802,수단,2009-01
2009-01-31,7703360,235632,7467728,아제르바이잔,2009-01
2009-01-31,7551972,105261,7446711,키르기스스탄,2009-01
2009-01-31,7454585,4287,7450298,니카라과,2009-01
2009-01-31,7385837,323460,7062377,케냐,2009-01
2009-01-31,7383808,610216,6773592,라트비아,2009-01
2009-01-31,7106216,1335471,5770745,몽골,2009-01
2009-01-31,7095765,372412,6723353,세네갈,2009-01
2009-01-31,6700467,164014431,-157313964,트리니다드 토바고,2009-01
2009-01-31,6584415,4667935,1916480,불가리아,2009-01
2009-01-31,5727010,19513,5707497,아프카니스탄,2009-01
2009-01-31,5258995,0,5258995,코트디봐르,2009-01
2009-01-31,5251163,445990,4805173,크로아티아,2009-01
2009-01-31,5079402,2106646,2972756,우루과이,2009-01
2009-01-31,4715196,2679362,2035834,에티오피아,2009-01
2009-01-31,4312837,16405,4296432,탄자니아,2009-01
2009-01-31,4084709,3610189,474520,도미니카 공화국,2009-01
2009-01-31,4009896,50,4009846,아메리칸 사모아,2009-01
2009-01-31,3620063,5706753,-2086690,룩셈부르그,2009-01
2009-01-31,3493194,0,3493194,지부티,2009-01
2009-01-31,3126436,178708,2947728,토고,2009-01
2009-01-31,3120011,8187974,-5067963,코스타리카,2009-01
2009-01-31,3076205,1099118,1977087,파라과이,2009-01
2009-01-31,3059745,175901,2883844,에스토니아,2009-01
2009-01-31,2992059,194334,2797725,엘살바도르,2009-01
2009-01-31,2982307,1731152,1251155,뉴 칼레도니아,2009-01
2009-01-31,2849476,114642,2734834,온두라스,2009-01
2009-01-31,2801714,549191,2252523,기니,2009-01
2009-01-31,2518936,64573,2454363,사이프러스,2009-01
2009-01-31,2502992,194484068,-191981076,브루나이,2009-01
2009-01-31,2460251,89621,2370630,아르메니아,2009-01
2009-01-31,2410272,165922,2244350,베닝,2009-01
2009-01-31,2406481,10198,2396283,레소토,2009-01
2009-01-31,2401594,323413,2078181,파푸아 뉴기니,2009-01
2009-01-31,2390962,56565,2334397,괌,2009-01
2009-01-31,2258928,445141,1813787,리투아니아,2009-01
2009-01-31,2215393,60258,2155135,모리셔스,2009-01
2009-01-31,2211915,0,2211915,투르크멘,2009-01
2009-01-31,2193348,804023,1389325,카메룬,2009-01
2009-01-31,2088029,91445,1996584,라오스,2009-01
2009-01-31,1856553,22502,1834051,모잠비크,2009-01
2009-01-31,1841764,65885,1775879,네팔,2009-01
2009-01-31,1832045,34641,1797404,세르비아 와 몬테네그로,2009-01
2009-01-31,1653824,3717367,-2063543,기타국,2009-01
2009-01-31,1574831,10418,1564413,콩고민주공화국,2009-01
2009-01-31,1574574,323542,1251032,벨라루스,2009-01
2009-01-31,1467350,602726,864624,조지아,2009-01
2009-01-31,1460981,3314936,-1853955,볼리비아,2009-01
2009-01-31,1450449,0,1450449,르완다,2009-01
2009-01-31,1424843,38886,1385957,자마이카,2009-01
2009-01-31,1339997,335,1339662,콩고,2009-01
2009-01-31,1318730,590631,728099,마카오,2009-01
2009-01-31,1199378,3146,1196232,네덜란드 열도,2009-01
2009-01-31,1047560,3331239,-2283679,스와질랜드,2009-01
2009-01-31,1040568,24186,1016382,아이티,2009-01
2009-01-31,989004,19,988985,불령 리유니온 코모도 제도,2009-01
2009-01-31,882033,36713,845320,보츠와나,2009-01
2009-01-31,859086,212172,646914,세이쉘,2009-01
2009-01-31,832111,88781,743330,불령 폴리네시아,2009-01
2009-01-31,773578,165,773413,타지크,2009-01
2009-01-31,693269,0,693269,니제르,2009-01
2009-01-31,656021,0,656021,바베이도스,2009-01
2009-01-31,648126,83,648043,부르키나 파소,2009-01
2009-01-31,640233,0,640233,알바니아,2009-01
2009-01-31,637484,73115,564369,아루바,2009-01
2009-01-31,629887,660216,-30329,피지,2009-01
2009-01-31,628203,0,628203,수리남,2009-01
2009-01-31,611348,3235,608113,마세도니아,2009-01
2009-01-31,601270,1112,600158,나미비아,2009-01
2009-01-31,593922,14412,579510,도미니카,2009-01
2009-01-31,580297,145152,435145,우간다,2009-01
2009-01-31,562567,0,562567,모리타니,2009-01
2009-01-31,531588,0,531588,영령 버진군도,2009-01
2009-01-31,513677,0,513677,마티니크,2009-01
2009-01-31,447857,46961,400896,말라위,2009-01
2009-01-31,441787,79220,362567,팔레스타인 해방기구(구),2009-01
2009-01-31,432082,0,432082,버뮤다,2009-01
2009-01-31,373759,158376,215383,가봉,2009-01
2009-01-31,333727,0,333727,부룬디,2009-01
2009-01-31,332863,38494,294369,바누아투,2009-01
2009-01-31,321637,24052,297585,몰도바,2009-01
2009-01-31,317396,0,317396,과델로프,2009-01
2009-01-31,283974,78960,205014,시에라 리온,2009-01
2009-01-31,280573,370,280203,몰디브,2009-01
2009-01-31,272192,1678213,-1406021,아이슬란드,2009-01
2009-01-31,254932,98468,156464,사모아,2009-01
2009-01-31,238956,0,238956,벨리제,2009-01
2009-01-31,238939,0,238939,감비아,2009-01
2009-01-31,238280,0,238280,그레나다,2009-01
2009-01-31,221984,70549,151435,리히텐슈타인,2009-01
2009-01-31,177928,2241254,-2063326,솔로몬 군도,2009-01
2009-01-31,176088,5702123,-5526035,잠비아,2009-01
2009-01-31,162586,0,162586,마이크로네시아,2009-01
2009-01-31,140819,9324,131495,북마리아나 군도,2009-01
2009-01-31,134414,0,134414,세인트 루시아,2009-01
2009-01-31,109060,37085,71975,보스니아-헤르체고비나,2009-01
2009-01-31,98807,0,98807,불령 가이아나,2009-01
2009-01-31,93990,95683,-1693,안티가 바부다,2009-01
2009-01-31,91102,0,91102,에리트리아,2009-01
2009-01-31,85623,0,85623,부탄,2009-01
2009-01-31,82298,10618,71680,팔라우,2009-01
2009-01-31,81502,11362,70140,바하마,2009-01
2009-01-31,75324,32,75292,통가,2009-01
2009-01-31,74352,0,74352,카보 베르데,2009-01
2009-01-31,68794,0,68794,산마리노,2009-01
2009-01-31,63755,1306,62449,상토메 프린스페,2009-01
2009-01-31,60730,0,60730,기네비소,2009-01
2009-01-31,59598,0,59598,지브랄타,2009-01
2009-01-31,54045,0,54045,세인트 빈센트 그레나딘,2009-01
2009-01-31,51384,217978,-166594,짐바브웨,2009-01
2009-01-31,46415,0,46415,노폴크 아일랜드,2009-01
2009-01-31,45797,10006385,-9960588,말리,2009-01
2009-01-31,44639,0,44639,영령 캐이맨 군도,2009-01
2009-01-31,22521,0,22521,가이아나,2009-01
2009-01-31,9666,21244,-11578,안도라,2009-01
2009-01-31,8413,95630,-87217,티모르,2009-01
2009-01-31,6112,0,6112,미령 버진군도,2009-01
2009-01-31,4042,25,4017,앙귈라,2009-01
2009-01-31,2654,0,2654,파로에 군도,2009-01
2009-01-31,2378,628561,-626183,모나코,2009-01
2009-01-31,1935,0,1935,포클랜드 군도,2009-01
2009-01-31,36,135040,-135004,중앙아프리카공화국,2009-01
2009-01-31,0,11285,-11285,세인트 헬레나,2009-01
2009-01-31,0,12205,-12205,토켈라우,2009-01
2009-01-31,0,400,-400,세인트 피레 미켈론,2009-01
2009-01-31,0,2089,-2089,크리스마스 아일랜드,2009-01
2009-01-31,0,76,-76,세인트 키츠 네비스,2009-01
2009-01-31,0,154389210,-154389210,적도 기니,2009-01
2009-01-31,0,1562,-1562,교황청,2009-01
2009-01-31,0,334710,-334710,그린랜드,2009-01
2009-01-31,0,6348,-6348,몬트세라트,2009-01
2009-01-31,0,339,-339,쿡 아일랜드,2009-01
2009-01-31,0,591,-591,마이너 아우틀링 합중국 군도,2009-01
2009-02-28,5560922535,3528983685,2031938850,중국,2009-02
2009-02-28,2743835195,1976573293,767261902,미국,2009-02
2009-02-28,1533752785,3733905110,-2200152325,일본,2009-02
2009-02-28,1523657025,91920233,1431736792,홍콩,2009-02
2009-02-28,1078991190,563980521,515010669,싱가포르,2009-02
2009-02-28,994179130,500,994178630,마샬군도,2009-02
2009-02-28,866452673,125079924,741372749,파나마,2009-02
2009-02-28,585329706,760567734,-175238028,독일,2009-02
2009-02-28,540676208,192788946,347887262,인도,2009-02
2009-02-28,512128888,536614925,-24486037,대만,2009-02
2009-02-28,476304646,38296107,438008539,멕시코,2009-02
2009-02-28,422913890,119043795,303870095,베트남,2009-02
2009-02-28,401641869,277876386,123765483,러시아 연방,2009-02
2009-02-28,398514300,1626451,396887849,그리스,2009-02
2009-02-28,353006521,245248383,107758138,태국,2009-02
2009-02-28,337418351,22661,337395690,라이베리아,2009-02
2009-02-28,330850685,139766055,191084630,네덜란드,2009-02
2009-02-28,322054858,650015499,-327960641,인도네시아,2009-02
2009-02-28,304614057,1373511008,-1068896951,사우디아라비아,2009-02
2009-02-28,303229363,171885570,131343793,영국,2009-02
2009-02-28,287084588,1316459094,-1029374506,호주,2009-02
2009-02-28,283848549,166080760,117767789,필리핀,2009-02
2009-02-28,265827257,18040045,247787212,폴란드,2009-02
2009-02-28,264553536,362881067,-98327531,이란,2009-02
2009-02-28,257145052,391325632,-134180580,아랍에미리트 연합,2009-02
2009-02-28,248696055,709957203,-461261148,말레이시아,2009-02
2009-02-28,220673603,232094351,-11420748,캐나다,2009-02
2009-02-28,210593739,6905036,203688703,슬로바키아,2009-02
2009-02-28,192141538,382520749,-190379211,브라질,2009-02
2009-02-28,172688418,874177102,-701488684,카타르,2009-02
2009-02-28,156672619,256102121,-99429502,이탈리아,2009-02
2009-02-28,156329825,41111726,115218099,이집트,2009-02
2009-02-28,146741844,273850185,-127108341,프랑스,2009-02
2009-02-28,146339074,274843592,-128504518,이라크,2009-02
2009-02-28,135882901,11604093,124278808,튀르키예,2009-02
2009-02-28,130409668,46774052,83635616,벨기에,2009-02
2009-02-28,123921874,59450770,64471104,스페인,2009-02
2009-02-28,123808512,160030903,-36222391,칠레,2009-02
2009-02-28,118652887,15544,118637343,바하마,2009-02
2009-02-28,110323009,71723,110251286,리비아,2009-02
2009-02-28,97374514,8668761,88705753,방글라데시,2009-02
2009-02-28,92485723,55516846,36968877,뉴질랜드,2009-02
2009-02-28,83935245,22608516,61326729,헝가리,2009-02
2009-02-28,83556425,396610,83159815,요르단,2009-02
2009-02-28,81354745,48964769,32389976,남아프리카공화국,2009-02
2009-02-28,80013200,103789,79909411,나이지리아,2009-02
2009-02-28,79616660,1760773,77855887,우즈베키스탄,2009-02
2009-02-28,75293906,7088790,68205116,콜롬비아,2009-02
2009-02-28,75080827,441830,74638997,시리아,2009-02
2009-02-28,62096602,2875198,59221404,알제리,2009-02
2009-02-28,57993249,14282772,43710477,파키스탄,2009-02
2009-02-28,56133465,40882333,15251132,핀란드,2009-02
2009-02-28,52752477,18404958,34347519,체코공화국,2009-02
2009-02-28,51675945,568518408,-516842463,쿠웨이트,2009-02
2009-02-28,47509198,4546374,42962824,사이프러스,2009-02
2009-02-28,46986861,55508716,-8521855,오스트리아,2009-02
2009-02-28,45158768,50232933,-5074165,이스라엘,2009-02
2009-02-28,41317564,112164516,-70846952,스위스,2009-02
2009-02-28,39594837,39525413,69424,아일랜드,2009-02
2009-02-28,36283442,68224481,-31941039,스웨덴,2009-02
2009-02-28,36131045,12770530,23360515,몰타,2009-02
2009-02-28,33594484,379319349,-345724865,오만,2009-02
2009-02-28,33072364,50246126,-17173762,덴마크,2009-02
2009-02-28,32506477,252306,32254171,에쿠아도르,2009-02
2009-02-28,29129285,14857386,14271899,페루,2009-02
2009-02-28,28808192,1868908,26939284,베네주엘라,2009-02
2009-02-28,25908393,17720619,8187774,앙골라,2009-02
2009-02-28,24303136,3115021,21188115,슬로베니아,2009-02
2009-02-28,21080462,3788692,17291770,미얀마,2009-02
2009-02-28,20748296,64962585,-44214289,아르헨티나,2009-02
2009-02-28,20566983,2746102,17820881,모로코,2009-02
2009-02-28,20093366,3689910,16403456,루마니아,2009-02
2009-02-28,19910235,4730300,15179935,카자흐스탄,2009-02
2009-02-28,19656523,571265,19085258,캄보디아,2009-02
2009-02-28,19128705,20002516,-873811,과테말라,2009-02
2009-02-28,16528284,5566583,10961701,포루투갈,2009-02
2009-02-28,15273461,504287,14769174,아제르바이잔,2009-02
2009-02-28,14177225,192422910,-178245685,노르웨이,2009-02
2009-02-28,13218394,2900,13215494,불령 폴리네시아,2009-02
2009-02-28,13056827,987592,12069235,수단,2009-02
2009-02-28,11833710,4610108,7223602,스리랑카,2009-02
2009-02-28,11643095,1004187,10638908,가나,2009-02
2009-02-28,11465337,523259,10942078,레바논,2009-02
2009-02-28,11362309,23152283,-11789974,바레인,2009-02
2009-02-28,11241547,72317781,-61076234,우크라이나,2009-02
2009-02-28,10381560,7192,10374368,니카라과,2009-02
2009-02-28,10164584,907595,9256989,몽골,2009-02
2009-02-28,9870398,340010,9530388,예맨,2009-02
2009-02-28,9548749,76594,9472155,케냐,2009-02
2009-02-28,9208005,75043,9132962,키르기스스탄,2009-02
2009-02-28,9124181,0,9124181,아프카니스탄,2009-02
2009-02-28,8693110,97424,8595686,쿠바,2009-02
2009-02-28,8177818,833,8176985,르완다,2009-02
2009-02-28,7785045,156053303,-148268258,브루나이,2009-02
2009-02-28,7216407,761496,6454911,라트비아,2009-02
2009-02-28,7170679,22629,7148050,콩고,2009-02
2009-02-28,7071781,11704603,-4632822,푸에르토리코,2009-02
2009-02-28,6484254,826234,5658020,도미니카 공화국,2009-02
2009-02-28,6375315,2784459,3590856,우루과이,2009-02
2009-02-28,6239333,2949368,3289965,에티오피아,2009-02
2009-02-28,5826993,1828556,3998437,튀니지,2009-02
2009-02-28,5619580,1300573,4319007,온두라스,2009-02
2009-02-28,5514436,11209790,-5695354,코스타리카,2009-02
2009-02-28,4379121,93,4379028,코트디봐르,2009-02
2009-02-28,4285657,2946219,1339438,불가리아,2009-02
2009-02-28,4107318,4639258,-531940,리투아니아,2009-02
2009-02-28,3601833,322998,3278835,파라과이,2009-02
2009-02-28,3531976,233607,3298369,크로아티아,2009-02
2009-02-28,3288387,64529,3223858,라오스,2009-02
2009-02-28,3051774,241328,2810446,마다카스카르,2009-02
2009-02-28,2989863,0,2989863,아메리칸 사모아,2009-02
2009-02-28,2961675,6588,2955087,아르메니아,2009-02
2009-02-28,2864634,644879,2219755,괌,2009-02
2009-02-28,2826044,193145,2632899,모잠비크,2009-02
2009-02-28,2816502,90452307,-87635805,적도 기니,2009-02
2009-02-28,2802310,24668172,-21865862,파푸아 뉴기니,2009-02
2009-02-28,2740479,223351,2517128,모리셔스,2009-02
2009-02-28,2606561,53659,2552902,베닝,2009-02
2009-02-28,2582830,990534,1592296,카메룬,2009-02
2009-02-28,2485346,32,2485314,지부티,2009-02
2009-02-28,2481589,0,2481589,부르키나 파소,2009-02
2009-02-28,2414349,1750,2412599,레소토,2009-02
2009-02-28,2398000,0,2398000,타지크,2009-02
2009-02-28,2139750,1232040,907710,조지아,2009-02
2009-02-28,2082212,2906331,-824119,기타국,2009-02
2009-02-28,2079316,1860858,218458,에스토니아,2009-02
2009-02-28,2078377,114984,1963393,엘살바도르,2009-02
2009-02-28,2010782,50433,1960349,네팔,2009-02
2009-02-28,1898872,395623,1503249,세네갈,2009-02
2009-02-28,1836179,79633,1756546,도미니카,2009-02
2009-02-28,1823529,2332015,-508486,뉴 칼레도니아,2009-02
2009-02-28,1704296,85597,1618699,탄자니아,2009-02
2009-02-28,1592960,127308856,-125715896,트리니다드 토바고,2009-02
2009-02-28,1415069,179581,1235488,투르크멘,2009-02
2009-02-28,1394997,63149,1331848,가봉,2009-02
2009-02-28,1374843,3190266,-1815423,볼리비아,2009-02
2009-02-28,1323019,7424643,-6101624,룩셈부르그,2009-02
2009-02-28,1252853,19,1252834,불령 리유니온 코모도 제도,2009-02
2009-02-28,1247322,612502,634820,기니,2009-02
2009-02-28,1208276,741959,466317,토고,2009-02
2009-02-28,1171686,167619,1004067,피지,2009-02
2009-02-28,1125706,0,1125706,알바니아,2009-02
2009-02-28,1107060,89882,1017178,말라위,2009-02
2009-02-28,1057660,133,1057527,버뮤다,2009-02
2009-02-28,981970,323038,658932,자마이카,2009-02
2009-02-28,950097,4059,946038,아이티,2009-02
2009-02-28,943945,1451108,-507163,네덜란드 열도,2009-02
2009-02-28,862693,2570687,-1707994,벨라루스,2009-02
2009-02-28,857145,40796,816349,우간다,2009-02
2009-02-28,842356,105215,737141,팔레스타인 해방기구(구),2009-02
2009-02-28,815557,63218,752339,세르비아 와 몬테네그로,2009-02
2009-02-28,808368,0,808368,수리남,2009-02
2009-02-28,716898,341705,375193,마카오,2009-02
2009-02-28,715056,133520,581536,콩고민주공화국,2009-02
2009-02-28,667814,0,667814,영령 버진군도,2009-02
2009-02-28,616301,0,616301,마티니크,2009-02
2009-02-28,591597,0,591597,마이크로네시아,2009-02
2009-02-28,581616,123820,457796,세이쉘,2009-02
2009-02-28,475779,260038,215741,솔로몬 군도,2009-02
2009-02-28,407460,0,407460,니제르,2009-02
2009-02-28,389039,60450,328589,모리타니,2009-02
2009-02-28,374836,2183186,-1808350,스와질랜드,2009-02
2009-02-28,374329,285477,88852,몰도바,2009-02
2009-02-28,357014,574,356440,몰디브,2009-02
2009-02-28,339250,4117,335133,에리트리아,2009-02
2009-02-28,338648,6382,332266,벨리제,2009-02
2009-02-28,336229,0,336229,바누아투,2009-02
2009-02-28,331376,3198,328178,바베이도스,2009-02
2009-02-28,273958,655685,-381727,아이슬란드,2009-02
2009-02-28,272965,0,272965,세인트 루시아,2009-02
2009-02-28,264691,0,264691,아루바,2009-02
2009-02-28,259533,34247,225286,북마리아나 군도,2009-02
2009-02-28,252786,7605940,-7353154,잠비아,2009-02
2009-02-28,220294,96203,124091,가이아나,2009-02
2009-02-28,203562,72087,131475,시에라 리온,2009-02
2009-02-28,202733,0,202733,티모르,2009-02
2009-02-28,199564,1755,197809,세인트 키츠 네비스,2009-02
2009-02-28,192046,26663,165383,보츠와나,2009-02
2009-02-28,184516,0,184516,기네비소,2009-02
2009-02-28,174634,51264,123370,마세도니아,2009-02
2009-02-28,161018,11248,149770,나미비아,2009-02
2009-02-28,137556,0,137556,과델로프,2009-02
2009-02-28,135474,0,135474,팔라우,2009-02
2009-02-28,121032,0,121032,영령 캐이맨 군도,2009-02
2009-02-28,118511,232342,-113831,리히텐슈타인,2009-02
2009-02-28,115656,0,115656,그레나다,2009-02
2009-02-28,113093,43238,69855,사모아,2009-02
2009-02-28,105718,0,105718,안티가 바부다,2009-02
2009-02-28,105700,42,105658,감비아,2009-02
2009-02-28,105100,19400,85700,보스니아-헤르체고비나,2009-02
2009-02-28,88085,0,88085,부룬디,2009-02
2009-02-28,74502,22641,51861,안도라,2009-02
2009-02-28,64188,0,64188,소말리아,2009-02
2009-02-28,47063,204,46859,통가,2009-02
2009-02-28,39107,149398,-110291,짐바브웨,2009-02
2009-02-28,36959,0,36959,지브랄타,2009-02
2009-02-28,28364,0,28364,카보 베르데,2009-02
2009-02-28,24715,0,24715,말리,2009-02
2009-02-28,21626,0,21626,키리바티,2009-02
2009-02-28,15438,0,15438,부탄,2009-02
2009-02-28,15414,44709,-29295,중앙아프리카공화국,2009-02
2009-02-28,5701,0,5701,불령 가이아나,2009-02
2009-02-28,5336,0,5336,포클랜드 군도,2009-02
2009-02-28,2685,0,2685,쿡 아일랜드,2009-02
2009-02-28,2656,198,2458,세인트 헬레나,2009-02
2009-02-28,2619,0,2619,산마리노,2009-02
2009-02-28,1772,0,1772,코스 군도,2009-02
2009-02-28,1766,674,1092,미령 버진군도,2009-02
2009-02-28,1684,838517,-836833,모나코,2009-02
2009-02-28,796,1103,-307,나우루,2009-02
2009-02-28,88,0,88,크리스마스 아일랜드,2009-02
2009-02-28,0,708,-708,마이너 아우틀링 합중국 군도,2009-02
2009-02-28,0,51426,-51426,몬트세라트,2009-02
2009-02-28,0,1652,-1652,상토메 프린스페,2009-02
2009-02-28,0,253399,-253399,그린랜드,2009-02
2009-02-28,0,1238,-1238,토켈라우,2009-02
2009-02-28,0,324,-324,코모로스,2009-02
2009-03-31,6474498039,4593492909,1881005130,중국,2009-03
2009-03-31,2935611890,1978422115,957189775,미국,2009-03
2009-03-31,1564472502,3886154941,-2321682439,일본,2009-03
2009-03-31,1401225965,101754552,1299471413,홍콩,2009-03
2009-03-31,967205305,567501129,399704176,싱가포르,2009-03
2009-03-31,728996109,492,728995617,마샬군도,2009-03
2009-03-31,646120181,725656623,-79536442,대만,2009-03
2009-03-31,629192704,278069521,351123183,인도,2009-03
2009-03-31,556139535,65639046,490500489,멕시코,2009-03
2009-03-31,556012955,165393913,390619042,베트남,2009-03
2009-03-31,526127197,2313213,523813984,그리스,2009-03
2009-03-31,518569195,1615,518567580,라이베리아,2009-03
2009-03-31,513278772,896295867,-383017095,독일,2009-03
2009-03-31,388476901,145875261,242601640,네덜란드,2009-03
2009-03-31,363652756,79838,363572918,파나마,2009-03
2009-03-31,358062089,671779807,-313717718,인도네시아,2009-03
2009-03-31,357978997,13635,357965362,바하마,2009-03
2009-03-31,357212432,14653538,342558894,폴란드,2009-03
2009-03-31,344592226,948943448,-604351222,사우디아라비아,2009-03
2009-03-31,343260218,265917263,77342955,태국,2009-03
2009-03-31,330886027,1116001222,-785115195,호주,2009-03
2009-03-31,324379879,220503785,103876094,필리핀,2009-03
2009-03-31,316941809,668108400,-351166591,아랍에미리트 연합,2009-03
2009-03-31,309048052,739542870,-430494818,말레이시아,2009-03
2009-03-31,296956016,182477859,114478157,영국,2009-03
2009-03-31,285268231,15295788,269972443,튀르키예,2009-03
2009-03-31,280971578,313798828,-32827250,캐나다,2009-03
2009-03-31,280710203,3677599,277032604,슬로바키아,2009-03
2009-03-31,270106067,340886807,-70780740,이란,2009-03
2009-03-31,270067547,262690485,7377062,브라질,2009-03
2009-03-31,266426254,415104500,-148678246,러시아 연방,2009-03
2009-03-31,230306553,7039645,223266908,사이프러스,2009-03
2009-03-31,197287960,271452966,-74165006,프랑스,2009-03
2009-03-31,176826928,70293979,106532949,벨기에,2009-03
2009-03-31,172319936,282102157,-109782221,이탈리아,2009-03
2009-03-31,154020795,243664091,-89643296,노르웨이,2009-03
2009-03-31,152097634,233727531,-81629897,칠레,2009-03
2009-03-31,141166600,87314060,53852540,스페인,2009-03
2009-03-31,134522460,8211128,126311332,몰타,2009-03
2009-03-31,132422485,791815623,-659393138,카타르,2009-03
2009-03-31,123940153,13300712,110639441,우즈베키스탄,2009-03
2009-03-31,115637323,4754175,110883148,포루투갈,2009-03
2009-03-31,105887626,11317432,94570194,방글라데시,2009-03
2009-03-31,103338483,677744,102660739,리비아,2009-03
2009-03-31,98847162,9729108,89118054,요르단,2009-03
2009-03-31,97905806,11260356,86645450,나이지리아,2009-03
2009-03-31,97318900,36681318,60637582,헝가리,2009-03
2009-03-31,92617326,31762966,60854360,이집트,2009-03
2009-03-31,84092979,20325346,63767633,체코공화국,2009-03
2009-03-31,76381170,5349837,71031333,앙골라,2009-03
2009-03-31,74770604,112254493,-37483889,스위스,2009-03
2009-03-31,74122601,24195261,49927340,알제리,2009-03
2009-03-31,72983530,6856986,66126544,콜롬비아,2009-03
2009-03-31,69668067,557327,69110740,시리아,2009-03
2009-03-31,64041457,59386229,4655228,뉴질랜드,2009-03
2009-03-31,63891273,14693292,49197981,파키스탄,2009-03
2009-03-31,61650721,61566700,84021,남아프리카공화국,2009-03
2009-03-31,58102308,67199279,-9096971,핀란드,2009-03
2009-03-31,56623704,0,56623704,영령 버진군도,2009-03
2009-03-31,53437573,56029783,-2592210,이스라엘,2009-03
2009-03-31,51999019,377562138,-325563119,쿠웨이트,2009-03
2009-03-31,50121747,69535417,-19413670,오스트리아,2009-03
2009-03-31,41476192,4548860,36927332,미얀마,2009-03
2009-03-31,37460584,307980036,-270519452,오만,2009-03
2009-03-31,35119560,55626705,-20507145,페루,2009-03
2009-03-31,33053003,66929729,-33876726,스웨덴,2009-03
2009-03-31,31047573,52107666,-21060093,모로코,2009-03
2009-03-31,30537631,4071644,26465987,슬로베니아,2009-03
2009-03-31,27823662,273838,27549824,에쿠아도르,2009-03
2009-03-31,27766124,224074867,-196308743,이라크,2009-03
2009-03-31,27394052,21078818,6315234,아르헨티나,2009-03
2009-03-31,26240012,244090,25995922,괌,2009-03
2009-03-31,25101991,542952,24559039,베네주엘라,2009-03
2009-03-31,23177738,32559345,-9381607,카자흐스탄,2009-03
2009-03-31,23031662,12921361,10110301,과테말라,2009-03
2009-03-31,22926063,224182,22701881,아제르바이잔,2009-03
2009-03-31,22567740,1643560,20924180,캄보디아,2009-03
2009-03-31,22274174,11232123,11042051,루마니아,2009-03
2009-03-31,21730739,38767546,-17036807,우크라이나,2009-03
2009-03-31,15839787,43105266,-27265479,덴마크,2009-03
2009-03-31,14566511,468860,14097651,케냐,2009-03
2009-03-31,14203091,32000,14171091,불령 폴리네시아,2009-03
2009-03-31,13533635,9873816,3659819,푸에르토리코,2009-03
2009-03-31,13530952,2526,13528426,레바논,2009-03
2009-03-31,13451951,16237470,-2785519,바레인,2009-03
2009-03-31,13092701,4564226,8528475,스리랑카,2009-03
2009-03-31,13088146,3088943,9999203,에티오피아,2009-03
2009-03-31,12400119,132914,12267205,가나,2009-03
2009-03-31,12367203,72998,12294205,예맨,2009-03
2009-03-31,12027821,154588,11873233,니카라과,2009-03
2009-03-31,11366895,51409839,-40042944,아일랜드,2009-03
2009-03-31,10648120,0,10648120,코트디봐르,2009-03
2009-03-31,10646798,0,10646798,키르기스스탄,2009-03
2009-03-31,10417198,4172,10413026,수단,2009-03
2009-03-31,9928647,539260,9389387,몽골,2009-03
2009-03-31,9309043,21314,9287729,아르메니아,2009-03
2009-03-31,7715072,557397,7157675,라트비아,2009-03
2009-03-31,7509569,83716478,-76206909,브루나이,2009-03
2009-03-31,7208542,275008,6933534,우간다,2009-03
2009-03-31,6763315,2104014,4659301,도미니카 공화국,2009-03
2009-03-31,6734587,13137583,-6402996,코스타리카,2009-03
2009-03-31,6616422,27193005,-20576583,트리니다드 토바고,2009-03
2009-03-31,6237802,1596034,4641768,튀니지,2009-03
2009-03-31,6092855,7243230,-1150375,쿠바,2009-03
2009-03-31,6090391,0,6090391,아프카니스탄,2009-03
2009-03-31,6072613,6226,6066387,레소토,2009-03
2009-03-31,5680619,2355006,3325613,불가리아,2009-03
2009-03-31,5635987,3944820,1691167,온두라스,2009-03
2009-03-31,5415357,94546,5320811,라오스,2009-03
2009-03-31,5322638,93424,5229214,타지크,2009-03
2009-03-31,5290231,3847935,1442296,크로아티아,2009-03
2009-03-31,4896835,88181,4808654,탄자니아,2009-03
2009-03-31,4340167,3059559,1280608,우루과이,2009-03
2009-03-31,4292810,157,4292653,부르키나 파소,2009-03
2009-03-31,4225898,0,4225898,르완다,2009-03
2009-03-31,3662593,758863,2903730,리투아니아,2009-03
2009-03-31,3631651,1382014,2249637,룩셈부르그,2009-03
2009-03-31,3308572,0,3308572,지부티,2009-03
2009-03-31,3301869,440213,2861656,세네갈,2009-03
2009-03-31,3251904,158264,3093640,파라과이,2009-03
2009-03-31,3152192,100980,3051212,마다카스카르,2009-03
2009-03-31,3048522,285260,2763262,엘살바도르,2009-03
2009-03-31,3030191,9140740,-6110549,뉴 칼레도니아,2009-03
2009-03-31,2988182,257792,2730390,모잠비크,2009-03
2009-03-31,2522130,307828,2214302,카메룬,2009-03
2009-03-31,2487125,0,2487125,베닝,2009-03
2009-03-31,2326790,1276968,1049822,파푸아 뉴기니,2009-03
2009-03-31,2136630,64564,2072066,세르비아 와 몬테네그로,2009-03
2009-03-31,2095003,152401,1942602,피지,2009-03
2009-03-31,2065130,41401,2023729,네팔,2009-03
2009-03-31,1965378,30909330,-28943952,기니,2009-03
2009-03-31,1942075,106482,1835593,콩고,2009-03
2009-03-31,1941932,293453,1648479,에스토니아,2009-03
2009-03-31,1915377,0,1915377,아메리칸 사모아,2009-03
2009-03-31,1874940,441952,1432988,벨라루스,2009-03
2009-03-31,1727561,141871,1585690,투르크멘,2009-03
2009-03-31,1577512,318697,1258815,조지아,2009-03
2009-03-31,1558441,1744983,-186542,기타국,2009-03
2009-03-31,1543741,97217,1446524,가봉,2009-03
2009-03-31,1534629,379188,1155441,토고,2009-03
2009-03-31,1511447,4563133,-3051686,볼리비아,2009-03
2009-03-31,1494566,200248,1294318,모리셔스,2009-03
2009-03-31,1458447,64,1458383,불령 리유니온 코모도 제도,2009-03
2009-03-31,1447703,70973,1376730,자마이카,2009-03
2009-03-31,1447515,0,1447515,챠드,2009-03
2009-03-31,1336896,31460,1305436,시에라 리온,2009-03
2009-03-31,1218785,10254,1208531,도미니카,2009-03
2009-03-31,1181985,627898,554087,마카오,2009-03
2009-03-31,1114348,0,1114348,마이크로네시아,2009-03
2009-03-31,1016924,0,1016924,에리트리아,2009-03
2009-03-31,892916,25336,867580,알바니아,2009-03
2009-03-31,853016,0,853016,버뮤다,2009-03
2009-03-31,849557,28632,820925,아이티,2009-03
2009-03-31,818659,19330978,-18512319,말라위,2009-03
2009-03-31,789943,2142,787801,네덜란드 열도,2009-03
2009-03-31,714147,548089,166058,가이아나,2009-03
2009-03-31,692110,674369,17741,세이쉘,2009-03
2009-03-31,634003,137119,496884,보스니아-헤르체고비나,2009-03
2009-03-31,630370,19714896,-19084526,잠비아,2009-03
2009-03-31,457706,27343,430363,마세도니아,2009-03
2009-03-31,450565,1253,449312,수리남,2009-03
2009-03-31,415879,4011,411868,니제르,2009-03
2009-03-31,408890,0,408890,바베이도스,2009-03
2009-03-31,405949,0,405949,몰디브,2009-03
2009-03-31,398650,1748746,-1350096,스와질랜드,2009-03
2009-03-31,393578,0,393578,영령 캐이맨 군도,2009-03
2009-03-31,337070,30,337040,마티니크,2009-03
2009-03-31,333453,253091,80362,모리타니,2009-03
2009-03-31,309303,4367471,-4058168,팔레스타인 해방기구(구),2009-03
2009-03-31,307934,383991,-76057,짐바브웨,2009-03
2009-03-31,266304,226,266078,북마리아나 군도,2009-03
2009-03-31,257570,43750,213820,사모아,2009-03
2009-03-31,222194,592790,-370596,몰도바,2009-03
2009-03-31,218336,183326,35010,콩고민주공화국,2009-03
2009-03-31,212953,0,212953,바누아투,2009-03
2009-03-31,189131,0,189131,그레나다,2009-03
2009-03-31,188011,0,188011,아루바,2009-03
2009-03-31,187652,2190,185462,말리,2009-03
2009-03-31,185520,0,185520,불령 가이아나,2009-03
2009-03-31,165209,400,164809,벨리제,2009-03
2009-03-31,160873,306030,-145157,솔로몬 군도,2009-03
2009-03-31,142227,939372,-797145,아이슬란드,2009-03
2009-03-31,133985,38269,95716,보츠와나,2009-03
2009-03-31,113108,61,113047,감비아,2009-03
2009-03-31,107606,433,107173,부탄,2009-03
2009-03-31,99899,600,99299,티모르,2009-03
2009-03-31,90464,0,90464,안티가 바부다,2009-03
2009-03-31,85297,0,85297,과델로프,2009-03
2009-03-31,80804,0,80804,노폴크 아일랜드,2009-03
2009-03-31,72145,0,72145,파로에 군도,2009-03
2009-03-31,68536,0,68536,팔라우,2009-03
2009-03-31,65344,325,65019,나미비아,2009-03
2009-03-31,64512,63,64449,투르크 & 카이코스 군도,2009-03
2009-03-31,60191,0,60191,불령 남부지역,2009-03
2009-03-31,59309,0,59309,세인트 빈센트 그레나딘,2009-03
2009-03-31,52136,265,51871,세인트 루시아,2009-03
2009-03-31,48926,5502,43424,산마리노,2009-03
2009-03-31,46080,67,46013,쿡 아일랜드,2009-03
2009-03-31,40356,87423,-47067,리히텐슈타인,2009-03
2009-03-31,39753,0,39753,앙귈라,2009-03
2009-03-31,38899,0,38899,지브랄타,2009-03
2009-03-31,31563,0,31563,카보 베르데,2009-03
2009-03-31,18085,0,18085,그린랜드,2009-03
2009-03-31,4472,0,4472,통가,2009-03
2009-03-31,3534,549439,-545905,모나코,2009-03
2009-03-31,2668,25343,-22675,안도라,2009-03
2009-03-31,2652,0,2652,상토메 프린스페,2009-03
2009-03-31,2528,125731383,-125728855,적도 기니,2009-03
2009-03-31,900,40138,-39238,중앙아프리카공화국,2009-03
2009-03-31,814,0,814,부룬디,2009-03
2009-03-31,334,0,334,세인트 키츠 네비스,2009-03
2009-03-31,0,204,-204,피트카이른,2009-03
2009-03-31,0,6211,-6211,토켈라우,2009-03
2009-03-31,0,1665,-1665,마이너 아우틀링 합중국 군도,2009-03
2009-03-31,0,449,-449,교황청,2009-03
2009-03-31,0,1050,-1050,세인트 헬레나,2009-03
2009-03-31,0,641,-641,코스 군도,2009-03
2009-04-30,6986960111,4341983790,2644976321,중국,2009-04
2009-04-30,3270305537,2275283829,995021708,미국,2009-04
2009-04-30,1669377446,4174378156,-2505000710,일본,2009-04
2009-04-30,1536612169,36957,1536575212,마샬군도,2009-04
2009-04-30,1282408374,114609177,1167799197,홍콩,2009-04
2009-04-30,1159840821,705895554,453945267,싱가포르,2009-04
2009-04-30,711176764,776173389,-64996625,대만,2009-04
2009-04-30,661354429,924731461,-263377032,독일,2009-04
2009-04-30,657380281,568819689,88560592,아랍에미리트 연합,2009-04
2009-04-30,593977468,71864142,522113326,멕시코,2009-04
2009-04-30,592470402,360539610,231930792,인도,2009-04
2009-04-30,590312857,216941255,373371602,베트남,2009-04
2009-04-30,462455116,710151452,-247696336,인도네시아,2009-04
2009-04-30,431663618,1123034076,-691370458,호주,2009-04
2009-04-30,425930223,13149122,412781101,그리스,2009-04
2009-04-30,413919946,198995035,214924911,필리핀,2009-04
2009-04-30,404281676,107407239,296874437,네덜란드,2009-04
2009-04-30,402538798,4772,402534026,라이베리아,2009-04
2009-04-30,392451522,217540705,174910817,영국,2009-04
2009-04-30,357081837,13139007,343942830,폴란드,2009-04
2009-04-30,352557375,63760889,288796486,벨기에,2009-04
2009-04-30,339687260,337837364,1849896,러시아 연방,2009-04
2009-04-30,335766242,260717311,75048931,브라질,2009-04
2009-04-30,328634490,584698793,-256064303,말레이시아,2009-04
2009-04-30,324776438,264895373,59881065,태국,2009-04
2009-04-30,304243793,345307781,-41063988,캐나다,2009-04
2009-04-30,299176778,1154776389,-855599611,사우디아라비아,2009-04
2009-04-30,284421193,4509853,279911340,슬로바키아,2009-04
2009-04-30,267763708,511171307,-243407599,이란,2009-04
2009-04-30,266448141,266647170,-199029,이탈리아,2009-04
2009-04-30,237617819,77426341,160191478,파나마,2009-04
2009-04-30,223285493,74489585,148795908,덴마크,2009-04
2009-04-30,204099935,18294064,185805871,튀르키예,2009-04
2009-04-30,203009016,345978138,-142969122,프랑스,2009-04
2009-04-30,180334238,450318,179883920,사이프러스,2009-04
2009-04-30,159956834,676712019,-516755185,카타르,2009-04
2009-04-30,145435645,304714407,-159278762,칠레,2009-04
2009-04-30,136185336,280807432,-144622096,이라크,2009-04
2009-04-30,135126393,8,135126385,말리,2009-04
2009-04-30,129670117,107557296,22112821,스페인,2009-04
2009-04-30,120966139,19854,120946285,바하마,2009-04
2009-04-30,119090467,371290,118719177,리비아,2009-04
2009-04-30,103620002,4181820,99438182,방글라데시,2009-04
2009-04-30,102762521,15356156,87406365,헝가리,2009-04
2009-04-30,102755845,17617127,85138718,이집트,2009-04
2009-04-30,99679208,983442,98695766,우즈베키스탄,2009-04
2009-04-30,89667591,588852,89078739,시리아,2009-04
2009-04-30,86754709,1410827,85343882,요르단,2009-04
2009-04-30,80847313,51312556,29534757,알제리,2009-04
2009-04-30,77807700,240599203,-162791503,노르웨이,2009-04
2009-04-30,74347782,6313066,68034716,콜롬비아,2009-04
2009-04-30,73712259,50245323,23466936,남아프리카공화국,2009-04
2009-04-30,71811682,29517773,42293909,체코공화국,2009-04
2009-04-30,64752024,129508,64622516,나이지리아,2009-04
2009-04-30,63328883,27589343,35739540,파키스탄,2009-04
2009-04-30,55839689,89914817,-34075128,핀란드,2009-04
2009-04-30,50723753,69755064,-19031311,뉴질랜드,2009-04
2009-04-30,49530351,48743289,787062,이스라엘,2009-04
2009-04-30,49431765,536914898,-487483133,쿠웨이트,2009-04
2009-04-30,48130554,77395306,-29264752,오스트리아,2009-04
2009-04-30,43053679,65755144,-22701465,페루,2009-04
2009-04-30,40176854,123532063,-83355209,스위스,2009-04
2009-04-30,39860554,83388565,-43528011,스웨덴,2009-04
2009-04-30,38508135,54002346,-15494211,아르헨티나,2009-04
2009-04-30,35217721,4521726,30695995,포루투갈,2009-04
2009-04-30,34909748,7003731,27906017,미얀마,2009-04
2009-04-30,32619651,276993764,-244374113,오만,2009-04
2009-04-30,32212241,58203947,-25991706,아일랜드,2009-04
2009-04-30,27888067,3194743,24693324,모로코,2009-04
2009-04-30,26624320,627628,25996692,베네주엘라,2009-04
2009-04-30,25000798,34896925,-9896127,우크라이나,2009-04
2009-04-30,23900289,3804689,20095600,슬로베니아,2009-04
2009-04-30,23435559,700925,22734634,캄보디아,2009-04
2009-04-30,23163878,15918492,7245386,카자흐스탄,2009-04
2009-04-30,22548819,246145,22302674,에쿠아도르,2009-04
2009-04-30,22087601,16299658,5787943,루마니아,2009-04
2009-04-30,21066418,17529899,3536519,과테말라,2009-04
2009-04-30,18910926,68386,18842540,수단,2009-04
2009-04-30,18622291,22023484,-3401193,앙골라,2009-04
2009-04-30,15337925,17094,15320831,가나,2009-04
2009-04-30,14727184,458543,14268641,몽골,2009-04
2009-04-30,13335285,13303202,32083,푸에르토리코,2009-04
2009-04-30,12647896,334669,12313227,레바논,2009-04
2009-04-30,12439139,4909718,7529421,스리랑카,2009-04
2009-04-30,9750572,667106,9083466,케냐,2009-04
2009-04-30,9503206,137029,9366177,예맨,2009-04
2009-04-30,9404681,166228,9238453,니카라과,2009-04
2009-04-30,9160312,1135468,8024844,튀니지,2009-04
2009-04-30,8058327,1764,8056563,아프카니스탄,2009-04
2009-04-30,7977825,9285678,-1307853,바레인,2009-04
2009-04-30,7931198,5456792,2474406,온두라스,2009-04
2009-04-30,7432389,66929,7365460,키르기스스탄,2009-04
2009-04-30,7426429,12301723,-4875294,코스타리카,2009-04
2009-04-30,7104946,71394,7033552,아르메니아,2009-04
2009-04-30,6936803,1072280,5864523,도미니카 공화국,2009-04
2009-04-30,5923322,1039,5922283,레소토,2009-04
2009-04-30,5918510,519483,5399027,기니,2009-04
2009-04-30,5743645,215929,5527716,투르크멘,2009-04
2009-04-30,5715939,1974587,3741352,기타국,2009-04
2009-04-30,5441298,2831226,2610072,아제르바이잔,2009-04
2009-04-30,5160372,1478069,3682303,라트비아,2009-04
2009-04-30,5065625,79022,4986603,라오스,2009-04
2009-04-30,4984014,1910391,3073623,불가리아,2009-04
2009-04-30,4902284,28361926,-23459642,브루나이,2009-04
2009-04-30,4830092,529150,4300942,벨라루스,2009-04
2009-04-30,4552092,541034,4011058,크로아티아,2009-04
2009-04-30,4538547,0,4538547,적도 기니,2009-04
2009-04-30,4491451,129476,4361975,코트디봐르,2009-04
2009-04-30,4232111,2120165,2111946,탄자니아,2009-04
2009-04-30,3987634,21579045,-17591411,몰타,2009-04
2009-04-30,3736461,7445493,-3709032,우루과이,2009-04
2009-04-30,3482826,294354,3188472,파라과이,2009-04
2009-04-30,3240256,6841233,-3600977,뉴 칼레도니아,2009-04
2009-04-30,3097923,78739,3019184,쿠바,2009-04
2009-04-30,3004232,96910,2907322,괌,2009-04
2009-04-30,2969414,64,2969350,아메리칸 사모아,2009-04
2009-04-30,2877538,100610,2776928,마다카스카르,2009-04
2009-04-30,2844364,0,2844364,지부티,2009-04
2009-04-30,2676829,732826,1944003,리투아니아,2009-04
2009-04-30,2511419,1303,2510116,세르비아 와 몬테네그로,2009-04
2009-04-30,2496821,450535,2046286,카메룬,2009-04
2009-04-30,2394821,208558,2186263,세네갈,2009-04
2009-04-30,2364176,134112,2230064,네팔,2009-04
2009-04-30,2265113,1210079,1055034,에티오피아,2009-04
2009-04-30,2245816,1747526,498290,룩셈부르그,2009-04
2009-04-30,2170438,104717,2065721,모잠비크,2009-04
2009-04-30,2065426,228830,1836596,엘살바도르,2009-04
2009-04-30,2012305,9465942,-7453637,토고,2009-04
2009-04-30,1868488,386,1868102,아이티,2009-04
2009-04-30,1762617,1974113,-211496,타지크,2009-04
2009-04-30,1680482,39,1680443,불령 리유니온 코모도 제도,2009-04
2009-04-30,1631392,178220,1453172,베닝,2009-04
2009-04-30,1611767,415409,1196358,조지아,2009-04
2009-04-30,1536554,19,1536535,에리트리아,2009-04
2009-04-30,1506918,40725869,-39218951,파푸아 뉴기니,2009-04
2009-04-30,1504907,80302,1424605,모리셔스,2009-04
2009-04-30,1443313,539208,904105,에스토니아,2009-04
2009-04-30,1418350,824995,593355,짐바브웨,2009-04
2009-04-30,1384059,2189010,-804951,가봉,2009-04
2009-04-30,1305989,568078,737911,우간다,2009-04
2009-04-30,1294395,814513,479882,트리니다드 토바고,2009-04
2009-04-30,1273720,0,1273720,영령 버진군도,2009-04
2009-04-30,1194553,167,1194386,버뮤다,2009-04
2009-04-30,1169131,2168844,-999713,네덜란드 열도,2009-04
2009-04-30,1108985,118329,990656,피지,2009-04
2009-04-30,1100878,9691,1091187,콩고민주공화국,2009-04
2009-04-30,1057072,7393,1049679,자마이카,2009-04
2009-04-30,973226,180104,793122,팔레스타인 해방기구(구),2009-04
2009-04-30,969029,1070373,-101344,아이슬란드,2009-04
2009-04-30,964953,2556117,-1591164,스와질랜드,2009-04
2009-04-30,958132,3910988,-2952856,말라위,2009-04
2009-04-30,933636,304553,629083,마카오,2009-04
2009-04-30,932191,0,932191,마이크로네시아,2009-04
2009-04-30,877084,0,877084,부르키나 파소,2009-04
2009-04-30,876571,193154,683417,콩고,2009-04
2009-04-30,770941,4588,766353,알바니아,2009-04
2009-04-30,746847,125,746722,니제르,2009-04
2009-04-30,665514,846,664668,바누아투,2009-04
2009-04-30,619443,25856,593587,모리타니,2009-04
2009-04-30,601753,33382,568371,불령 폴리네시아,2009-04
2009-04-30,596967,0,596967,르완다,2009-04
2009-04-30,583622,2522,581100,마세도니아,2009-04
2009-04-30,551965,0,551965,아루바,2009-04
2009-04-30,530130,18331,511799,도미니카,2009-04
2009-04-30,519471,0,519471,수리남,2009-04
2009-04-30,494777,76081,418696,세이쉘,2009-04
2009-04-30,477754,11538,466216,벨리제,2009-04
2009-04-30,434446,1598704,-1164258,볼리비아,2009-04
2009-04-30,409168,74359,334809,가이아나,2009-04
2009-04-30,381455,0,381455,몰디브,2009-04
2009-04-30,319861,5124,314737,북마리아나 군도,2009-04
2009-04-30,306611,64774,241837,시에라 리온,2009-04
2009-04-30,294845,201878,92967,사모아,2009-04
2009-04-30,277940,0,277940,마티니크,2009-04
2009-04-30,276105,0,276105,영령 캐이맨 군도,2009-04
2009-04-30,270000,0,270000,세인트 키츠 네비스,2009-04
2009-04-30,260618,711,259907,바베이도스,2009-04
2009-04-30,254599,0,254599,과델로프,2009-04
2009-04-30,206610,42478,164132,보츠와나,2009-04
2009-04-30,203109,921,202188,토켈라우,2009-04
2009-04-30,174321,225507,-51186,보스니아-헤르체고비나,2009-04
2009-04-30,165660,0,165660,팔라우,2009-04
2009-04-30,161743,291385,-129642,리히텐슈타인,2009-04
2009-04-30,155914,0,155914,소말리아,2009-04
2009-04-30,150637,971367,-820730,솔로몬 군도,2009-04
2009-04-30,142736,107,142629,나미비아,2009-04
2009-04-30,113400,0,113400,투르크 & 카이코스 군도,2009-04
2009-04-30,110814,0,110814,기네비소,2009-04
2009-04-30,107242,546586,-439344,몰도바,2009-04
2009-04-30,77841,13455839,-13377998,잠비아,2009-04
2009-04-30,73039,0,73039,챠드,2009-04
2009-04-30,71925,0,71925,세인트 빈센트 그레나딘,2009-04
2009-04-30,71462,0,71462,부탄,2009-04
2009-04-30,69283,0,69283,파로에 군도,2009-04
2009-04-30,39113,0,39113,불령 가이아나,2009-04
2009-04-30,38992,1124,37868,안티가 바부다,2009-04
2009-04-30,38814,0,38814,코모로스,2009-04
2009-04-30,32242,0,32242,중앙아프리카공화국,2009-04
2009-04-30,27686,0,27686,지브랄타,2009-04
2009-04-30,19269,0,19269,보빗군도,2009-04
2009-04-30,18281,190812,-172531,그린랜드,2009-04
2009-04-30,17748,227,17521,상토메 프린스페,2009-04
2009-04-30,15910,678267,-662357,모나코,2009-04
2009-04-30,9434,58,9376,감비아,2009-04
2009-04-30,6655,0,6655,티모르,2009-04
2009-04-30,6183,111,6072,몬트세라트,2009-04
2009-04-30,5036,0,5036,노폴크 아일랜드,2009-04
2009-04-30,4510,34,4476,통가,2009-04
2009-04-30,2756,14661,-11905,안도라,2009-04
2009-04-30,2381,0,2381,카보 베르데,2009-04
2009-04-30,1577,20557,-18980,세인트 루시아,2009-04
2009-04-30,1269,0,1269,부룬디,2009-04
2009-04-30,1222,106,1116,미령 버진군도,2009-04
2009-04-30,0,2552607,-2552607,나우루,2009-04
2009-04-30,0,2960,-2960,크리스마스 아일랜드,2009-04
2009-04-30,0,79,-79,산마리노,2009-04
2009-04-30,0,700,-700,코스 군도,2009-04
2009-04-30,0,6,-6,앙귈라,2009-04
2009-05-31,6635667319,4016415511,2619251808,중국,2009-05
2009-05-31,2942502761,2375287712,567215049,미국,2009-05
2009-05-31,1633145037,3414060082,-1780915045,일본,2009-05
2009-05-31,1550775449,111232343,1439543106,홍콩,2009-05
2009-05-31,973657656,706541837,267115819,싱가포르,2009-05
2009-05-31,805981991,257064883,548917108,인도,2009-05
2009-05-31,802736399,778406393,24330006,대만,2009-05
2009-05-31,789145243,1000,789144243,마샬군도,2009-05
2009-05-31,671338166,849906426,-178568260,독일,2009-05
2009-05-31,578877383,176145307,402732076,베트남,2009-05
2009-05-31,533865411,90603464,443261947,멕시코,2009-05
2009-05-31,481643090,318966956,162676134,프랑스,2009-05
2009-05-31,474805224,568748739,-93943515,인도네시아,2009-05
2009-05-31,446126845,169837750,276289095,영국,2009-05
2009-05-31,421761145,132980962,288780183,파나마,2009-05
2009-05-31,408351956,1054724855,-646372899,호주,2009-05
2009-05-31,353716872,320856211,32860661,브라질,2009-05
2009-05-31,342310732,242156358,100154374,캐나다,2009-05
2009-05-31,331818927,524266272,-192447345,말레이시아,2009-05
2009-05-31,329471372,24058067,305413305,폴란드,2009-05
2009-05-31,320095131,268651364,51443767,태국,2009-05
2009-05-31,309896939,583209589,-273312650,아랍에미리트 연합,2009-05
2009-05-31,300728153,228105026,72623127,필리핀,2009-05
2009-05-31,293155442,323596358,-30440916,이란,2009-05
2009-05-31,287174588,227253946,59920642,네덜란드,2009-05
2009-05-31,276538436,1621932111,-1345393675,사우디아라비아,2009-05
2009-05-31,261429499,384,261429115,라이베리아,2009-05
2009-05-31,255495182,5276297,250218885,슬로바키아,2009-05
2009-05-31,254372597,406053632,-151681035,러시아 연방,2009-05
2009-05-31,206447450,21115436,185332014,튀르키예,2009-05
2009-05-31,191139062,3043585,188095477,그리스,2009-05
2009-05-31,169910541,71786058,98124483,벨기에,2009-05
2009-05-31,162643797,322912999,-160269202,이탈리아,2009-05
2009-05-31,142152719,47968131,94184588,아일랜드,2009-05
2009-05-31,132471042,28625735,103845307,헝가리,2009-05
2009-05-31,130885932,21260,130864672,바하마,2009-05
2009-05-31,130496569,213448791,-82952222,칠레,2009-05
2009-05-31,117986672,58647987,59338685,이라크,2009-05
2009-05-31,103341955,14665172,88676783,나이지리아,2009-05
2009-05-31,99416784,67071283,32345501,스페인,2009-05
2009-05-31,98953496,252885530,-153932034,노르웨이,2009-05
2009-05-31,98282519,1978184,96304335,우즈베키스탄,2009-05
2009-05-31,97511016,68181522,29329494,뉴질랜드,2009-05
2009-05-31,90326647,353391,89973256,시리아,2009-05
2009-05-31,89174096,71757478,17416618,남아프리카공화국,2009-05
2009-05-31,85921505,39361989,46559516,이집트,2009-05
2009-05-31,85124444,508428788,-423304344,카타르,2009-05
2009-05-31,76248031,43397512,32850519,이스라엘,2009-05
2009-05-31,73738325,2963581,70774744,방글라데시,2009-05
2009-05-31,70206914,70019065,187849,알제리,2009-05
2009-05-31,68713174,2432745,66280429,요르단,2009-05
2009-05-31,65416208,123047,65293161,리비아,2009-05
2009-05-31,57824329,36712558,21111771,파키스탄,2009-05
2009-05-31,54910371,90331079,-35420708,핀란드,2009-05
2009-05-31,53367066,44274880,9092186,우크라이나,2009-05
2009-05-31,48130417,5763682,42366735,콜롬비아,2009-05
2009-05-31,45364982,59034373,-13669391,오스트리아,2009-05
2009-05-31,39553481,560737958,-521184477,쿠웨이트,2009-05
2009-05-31,39090083,22670860,16419223,체코공화국,2009-05
2009-05-31,38519959,3914812,34605147,미얀마,2009-05
2009-05-31,36213981,33635864,2578117,아르헨티나,2009-05
2009-05-31,35101809,11029624,24072185,몰타,2009-05
2009-05-31,34801667,76464622,-41662955,페루,2009-05
2009-05-31,31911490,188353371,-156441881,오만,2009-05
2009-05-31,31149703,3018811,28130892,슬로베니아,2009-05
2009-05-31,29995395,88056404,-58061009,스웨덴,2009-05
2009-05-31,27163623,706337,26457286,에쿠아도르,2009-05
2009-05-31,23422106,4437397,18984709,포루투갈,2009-05
2009-05-31,22219000,1526170,20692830,모로코,2009-05
2009-05-31,21928134,10851291,11076843,카자흐스탄,2009-05
2009-05-31,21109398,895509,20213889,과테말라,2009-05
2009-05-31,20444316,87702,20356614,불령 폴리네시아,2009-05
2009-05-31,19962211,710076,19252135,캄보디아,2009-05
2009-05-31,19435441,0,19435441,앙골라,2009-05
2009-05-31,19132302,3340684,15791618,루마니아,2009-05
2009-05-31,16969981,38891413,-21921432,덴마크,2009-05
2009-05-31,16832836,582292,16250544,베네주엘라,2009-05
2009-05-31,16795266,2079886,14715380,몽골,2009-05
2009-05-31,14981927,105663816,-90681889,스위스,2009-05
2009-05-31,14419907,114,14419793,아프카니스탄,2009-05
2009-05-31,14399148,492681,13906467,레바논,2009-05
2009-05-31,13498476,2495,13495981,괌,2009-05
2009-05-31,12744417,12030443,713974,푸에르토리코,2009-05
2009-05-31,12459301,383657,12075644,케냐,2009-05
2009-05-31,12394681,59158,12335523,수단,2009-05
2009-05-31,11866957,12144951,-277994,코스타리카,2009-05
2009-05-31,11569613,17381003,-5811390,바레인,2009-05
2009-05-31,10957132,880278,10076854,튀니지,2009-05
2009-05-31,10755584,22107,10733477,가나,2009-05
2009-05-31,10562544,51313,10511231,니카라과,2009-05
2009-05-31,10201207,3363061,6838146,스리랑카,2009-05
2009-05-31,9787776,4376151,5411625,아제르바이잔,2009-05
2009-05-31,9587654,6813,9580841,투르크멘,2009-05
2009-05-31,7544854,1547740,5997114,도미니카 공화국,2009-05
2009-05-31,7483614,1135414,6348200,라트비아,2009-05
2009-05-31,7337977,303005,7034972,예맨,2009-05
2009-05-31,7151589,121524,7030065,키르기스스탄,2009-05
2009-05-31,6971419,365064,6606355,리투아니아,2009-05
2009-05-31,5082457,3550341,1532116,온두라스,2009-05
2009-05-31,5019176,441613,4577563,크로아티아,2009-05
2009-05-31,4817544,3168811,1648733,기타국,2009-05
2009-05-31,4685017,0,4685017,르완다,2009-05
2009-05-31,4125581,60872,4064709,라오스,2009-05
2009-05-31,4099647,3129774,969873,불가리아,2009-05
2009-05-31,3812722,877,3811845,레소토,2009-05
2009-05-31,3462506,0,3462506,지부티,2009-05
2009-05-31,3207218,9520579,-6313361,우루과이,2009-05
2009-05-31,3098580,0,3098580,코트디봐르,2009-05
2009-05-31,3018024,2127,3015897,탄자니아,2009-05
2009-05-31,3002559,76,3002483,부르키나 파소,2009-05
2009-05-31,2917504,0,2917504,베닝,2009-05
2009-05-31,2840670,68020,2772650,아르메니아,2009-05
2009-05-31,2834947,72087,2762860,모리셔스,2009-05
2009-05-31,2824480,98828,2725652,세이쉘,2009-05
2009-05-31,2773998,60370,2713628,마다카스카르,2009-05
2009-05-31,2681009,34618377,-31937368,파푸아 뉴기니,2009-05
2009-05-31,2532117,17540665,-15008548,브루나이,2009-05
2009-05-31,2525328,8038247,-5512919,에스토니아,2009-05
2009-05-31,2515768,254288,2261480,피지,2009-05
2009-05-31,2445311,242807,2202504,엘살바도르,2009-05
2009-05-31,2289129,390903,1898226,세네갈,2009-05
2009-05-31,2261752,3718172,-1456420,룩셈부르그,2009-05
2009-05-31,2213543,1322625,890918,에티오피아,2009-05
2009-05-31,2149872,2912361,-762489,트리니다드 토바고,2009-05
2009-05-31,2142256,15494342,-13352086,뉴 칼레도니아,2009-05
2009-05-31,2095637,35110,2060527,세르비아 와 몬테네그로,2009-05
2009-05-31,1978700,316770,1661930,파라과이,2009-05
2009-05-31,1949126,181455,1767671,조지아,2009-05
2009-05-31,1919575,40684710,-38765135,잠비아,2009-05
2009-05-31,1918883,104717,1814166,모잠비크,2009-05
2009-05-31,1822707,72689,1750018,네팔,2009-05
2009-05-31,1758883,0,1758883,아메리칸 사모아,2009-05
2009-05-31,1718089,385787,1332302,카메룬,2009-05
2009-05-31,1581640,15350589,-13768949,사이프러스,2009-05
2009-05-31,1559395,676729,882666,콩고민주공화국,2009-05
2009-05-31,1424445,19,1424426,불령 리유니온 코모도 제도,2009-05
2009-05-31,1365465,1620331,-254866,콩고,2009-05
2009-05-31,1310757,616133,694624,기니,2009-05
2009-05-31,1300608,4756633,-3456025,스와질랜드,2009-05
2009-05-31,1223866,81112,1142754,팔레스타인 해방기구(구),2009-05
2009-05-31,1217398,8174010,-6956612,볼리비아,2009-05
2009-05-31,1199531,59382,1140149,쿠바,2009-05
2009-05-31,1133007,319506,813501,자마이카,2009-05
2009-05-31,1112519,243366,869153,벨라루스,2009-05
2009-05-31,1095523,0,1095523,가이아나,2009-05
2009-05-31,971109,379525,591584,마카오,2009-05
2009-05-31,953585,21868,931717,토고,2009-05
2009-05-31,724255,0,724255,아루바,2009-05
2009-05-31,723799,0,723799,버뮤다,2009-05
2009-05-31,714629,39279,675350,알바니아,2009-05
2009-05-31,714516,0,714516,마티니크,2009-05
2009-05-31,704638,594646,109992,우간다,2009-05
2009-05-31,693881,909217,-215336,타지크,2009-05
2009-05-31,665875,14212,651663,아이티,2009-05
2009-05-31,661155,41467,619688,네덜란드 열도,2009-05
2009-05-31,595314,932,594382,도미니카,2009-05
2009-05-31,521744,4357,517387,니제르,2009-05
2009-05-31,480995,0,480995,에리트리아,2009-05
2009-05-31,437894,0,437894,수리남,2009-05
2009-05-31,415146,0,415146,마이크로네시아,2009-05
2009-05-31,397872,34131,363741,마세도니아,2009-05
2009-05-31,356621,472,356149,북마리아나 군도,2009-05
2009-05-31,332537,378151,-45614,짐바브웨,2009-05
2009-05-31,330046,100,329946,영령 캐이맨 군도,2009-05
2009-05-31,291116,393578,-102462,리히텐슈타인,2009-05
2009-05-31,280110,0,280110,부탄,2009-05
2009-05-31,276330,7179810,-6903480,말라위,2009-05
2009-05-31,236198,58664467,-58428269,가봉,2009-05
2009-05-31,235487,0,235487,바베이도스,2009-05
2009-05-31,227991,0,227991,말리,2009-05
2009-05-31,220449,366347,-145898,솔로몬 군도,2009-05
2009-05-31,216079,11187,204892,벨리제,2009-05
2009-05-31,205165,27097,178068,보츠와나,2009-05
2009-05-31,200077,0,200077,몰디브,2009-05
2009-05-31,195923,148269,47654,사모아,2009-05
2009-05-31,184515,0,184515,기네비소,2009-05
2009-05-31,173345,0,173345,팔라우,2009-05
2009-05-31,163931,916028,-752097,모리타니,2009-05
2009-05-31,161883,0,161883,그레나다,2009-05
2009-05-31,147498,8,147490,나미비아,2009-05
2009-05-31,142513,91,142422,카보 베르데,2009-05
2009-05-31,127920,718320,-590400,아이슬란드,2009-05
2009-05-31,125449,25067,100382,시에라 리온,2009-05
2009-05-31,115015,3215,111800,안도라,2009-05
2009-05-31,109967,2540,107427,영령 버진군도,2009-05
2009-05-31,107309,46592,60717,몰도바,2009-05
2009-05-31,102294,647919,-545625,바누아투,2009-05
2009-05-31,95064,0,95064,소말리아,2009-05
2009-05-31,89668,0,89668,투르크 & 카이코스 군도,2009-05
2009-05-31,88358,0,88358,부룬디,2009-05
2009-05-31,88232,0,88232,과델로프,2009-05
2009-05-31,85759,646040,-560281,모나코,2009-05
2009-05-31,65501,0,65501,안티가 바부다,2009-05
2009-05-31,62101,26,62075,감비아,2009-05
2009-05-31,55802,37,55765,세인트 빈센트 그레나딘,2009-05
2009-05-31,54492,0,54492,쿡 아일랜드,2009-05
2009-05-31,48192,0,48192,세인트 루시아,2009-05
2009-05-31,47514,0,47514,산마리노,2009-05
2009-05-31,47086,388216,-341130,보스니아-헤르체고비나,2009-05
2009-05-31,42911,0,42911,불령 가이아나,2009-05
2009-05-31,37949,1484,36465,챠드,2009-05
2009-05-31,33887,0,33887,통가,2009-05
2009-05-31,30509,0,30509,지브랄타,2009-05
2009-05-31,18369,0,18369,메요트,2009-05
2009-05-31,7743,4358,3385,적도 기니,2009-05
2009-05-31,5901,0,5901,세인트 헬레나,2009-05
2009-05-31,5755,46100,-40345,중앙아프리카공화국,2009-05
2009-05-31,1900,633,1267,키리바티,2009-05
2009-05-31,553,0,553,몬트세라트,2009-05
2009-05-31,18,0,18,피트카이른,2009-05
2009-05-31,0,0,0,앙귈라,2009-05
2009-05-31,0,43,-43,코모로스,2009-05
2009-05-31,0,4813,-4813,세인트 키츠 네비스,2009-05
2009-05-31,0,1359,-1359,마이너 아우틀링 합중국 군도,2009-05
2009-05-31,0,1965,-1965,토켈라우,2009-05
2009-05-31,0,291,-291,보빗군도,2009-05
2009-05-31,0,14791,-14791,나우루,2009-05
2009-06-30,7310083501,4410146286,2899937215,중국,2009-06
2009-06-30,3278597215,2398052212,880545003,미국,2009-06
2009-06-30,1819762234,3990235642,-2170473408,일본,2009-06
2009-06-30,1719638295,115663673,1603974622,홍콩,2009-06
2009-06-30,1361445215,327,1361444888,마샬군도,2009-06
2009-06-30,1190205140,632072755,558132385,싱가포르,2009-06
2009-06-30,1049253792,829789422,219464370,아랍에미리트 연합,2009-06
2009-06-30,756680283,852786767,-96106484,대만,2009-06
2009-06-30,756200110,1105058673,-348858563,독일,2009-06
2009-06-30,660851024,335478924,325372100,인도,2009-06
2009-06-30,624862566,10511710,614350856,파나마,2009-06
2009-06-30,622134532,201002101,421132431,베트남,2009-06
2009-06-30,612915098,42283,612872815,라이베리아,2009-06
2009-06-30,580559069,76130535,504428534,멕시코,2009-06
2009-06-30,553417706,704565364,-151147658,인도네시아,2009-06
2009-06-30,448338812,972866957,-524528145,호주,2009-06
2009-06-30,426745494,4975324,421770170,그리스,2009-06
2009-06-30,367154832,219877727,147277105,필리핀,2009-06
2009-06-30,367000437,392021177,-25020740,브라질,2009-06
2009-06-30,365889185,475365769,-109476584,이란,2009-06
2009-06-30,364259660,254670297,109589363,태국,2009-06
2009-06-30,349592284,1481264306,-1131672022,사우디아라비아,2009-06
2009-06-30,348150186,254099384,94050802,영국,2009-06
2009-06-30,345832178,564866075,-219033897,말레이시아,2009-06
2009-06-30,326078469,20891606,305186863,폴란드,2009-06
2009-06-30,321992184,444553487,-122561303,러시아 연방,2009-06
2009-06-30,287242376,274676553,12565823,캐나다,2009-06
2009-06-30,283400353,126634066,156766287,네덜란드,2009-06
2009-06-30,271448660,5356237,266092423,슬로바키아,2009-06
2009-06-30,269202470,11980625,257221845,몰타,2009-06
2009-06-30,219870454,303847488,-83977034,이탈리아,2009-06
2009-06-30,216682386,409151,216273235,사이프러스,2009-06
2009-06-30,201989601,14120,201975481,바하마,2009-06
2009-06-30,190207723,34901374,155306349,튀르키예,2009-06
2009-06-30,182597165,338492634,-155895469,칠레,2009-06
2009-06-30,174972900,328020362,-153047462,프랑스,2009-06
2009-06-30,141149891,17287949,123861942,이집트,2009-06
2009-06-30,127655526,375046816,-247391290,카타르,2009-06
2009-06-30,127595823,80093693,47502130,스페인,2009-06
2009-06-30,122238283,31893469,90344814,헝가리,2009-06
2009-06-30,107470952,302092,107168860,시리아,2009-06
2009-06-30,101642882,189661962,-88019080,알제리,2009-06
2009-06-30,100725447,10429881,90295566,우즈베키스탄,2009-06
2009-06-30,95218222,49387035,45831187,남아프리카공화국,2009-06
2009-06-30,85495272,73154624,12340648,벨기에,2009-06
2009-06-30,81329915,243793,81086122,리비아,2009-06
2009-06-30,76434453,253035231,-176600778,노르웨이,2009-06
2009-06-30,73272764,12178848,61093916,방글라데시,2009-06
2009-06-30,71320097,1838521,69481576,요르단,2009-06
2009-06-30,70976016,20832781,50143235,나이지리아,2009-06
2009-06-30,70538788,0,70538788,영령 캐이맨 군도,2009-06
2009-06-30,65717897,30240778,35477119,체코공화국,2009-06
2009-06-30,64890616,656325572,-591434956,쿠웨이트,2009-06
2009-06-30,63015635,69373531,-6357896,핀란드,2009-06
2009-06-30,61987157,135291373,-73304216,오만,2009-06
2009-06-30,56871497,50979263,5892234,이스라엘,2009-06
2009-06-30,54229851,10228769,44001082,콜롬비아,2009-06
2009-06-30,52838218,45152979,7685239,우크라이나,2009-06
2009-06-30,50644712,48744478,1900234,파키스탄,2009-06
2009-06-30,48756061,98411392,-49655331,아르헨티나,2009-06
2009-06-30,44964970,79572093,-34607123,뉴질랜드,2009-06
2009-06-30,42127199,78011625,-35884426,오스트리아,2009-06
2009-06-30,39693046,36819426,2873620,페루,2009-06
2009-06-30,39609159,2341936,37267223,미얀마,2009-06
2009-06-30,38630144,157567515,-118937371,스웨덴,2009-06
2009-06-30,37323482,10960547,26362935,카자흐스탄,2009-06
2009-06-30,35479632,18603088,16876544,루마니아,2009-06
2009-06-30,34121916,5975723,28146193,슬로베니아,2009-06
2009-06-30,27754680,266153315,-238398635,이라크,2009-06
2009-06-30,27581532,44075,27537457,수단,2009-06
2009-06-30,26380497,723955,25656542,에쿠아도르,2009-06
2009-06-30,25385612,1803166,23582446,캄보디아,2009-06
2009-06-30,24894400,5785699,19108701,포루투갈,2009-06
2009-06-30,24810476,12649135,12161341,과테말라,2009-06
2009-06-30,23604782,10313534,13291248,모로코,2009-06
2009-06-30,22254845,195005,22059840,괌,2009-06
2009-06-30,22074079,73259014,-51184935,아일랜드,2009-06
2009-06-30,21981527,189814,21791713,니카라과,2009-06
2009-06-30,21833889,1165138,20668751,몽골,2009-06
2009-06-30,20461594,125309884,-104848290,스위스,2009-06
2009-06-30,20334801,72642,20262159,불령 폴리네시아,2009-06
2009-06-30,16758300,13748375,3009925,바레인,2009-06
2009-06-30,16127674,259223,15868451,베네주엘라,2009-06
2009-06-30,15441284,736149,14705135,레바논,2009-06
2009-06-30,14390255,49638264,-35248009,덴마크,2009-06
2009-06-30,13628081,12239983,1388098,코스타리카,2009-06
2009-06-30,13180207,1721241,11458966,튀니지,2009-06
2009-06-30,12771607,25444,12746163,아프카니스탄,2009-06
2009-06-30,12547000,4586980,7960020,스리랑카,2009-06
2009-06-30,11964517,116538,11847979,케냐,2009-06
2009-06-30,11917099,331969,11585130,예맨,2009-06
2009-06-30,11752910,3931,11748979,아제르바이잔,2009-06
2009-06-30,11570641,0,11570641,투르크멘,2009-06
2009-06-30,11327539,1431853,9895686,가나,2009-06
2009-06-30,11320632,11382985,-62353,앙골라,2009-06
2009-06-30,10514947,12379124,-1864177,푸에르토리코,2009-06
2009-06-30,10263646,2080934,8182712,불가리아,2009-06
2009-06-30,9238481,697380,8541101,리투아니아,2009-06
2009-06-30,6768909,1432020,5336889,라트비아,2009-06
2009-06-30,6398471,236,6398235,아르메니아,2009-06
2009-06-30,5934580,0,5934580,키르기스스탄,2009-06
2009-06-30,5766684,85563,5681121,라오스,2009-06
2009-06-30,5744283,1709,5742574,레소토,2009-06
2009-06-30,5728218,2346615,3381603,에스토니아,2009-06
2009-06-30,5617907,1711837,3906070,도미니카 공화국,2009-06
2009-06-30,5565727,551015,5014712,탄자니아,2009-06
2009-06-30,5439121,4250498,1188623,우루과이,2009-06
2009-06-30,5310618,19928,5290690,코트디봐르,2009-06
2009-06-30,5124865,2642010,2482855,기타국,2009-06
2009-06-30,4991376,6539572,-1548196,온두라스,2009-06
2009-06-30,4760923,478688,4282235,에티오피아,2009-06
2009-06-30,4362280,95940,4266340,베닝,2009-06
2009-06-30,4340080,257891,4082189,엘살바도르,2009-06
2009-06-30,3920427,459432,3460995,기니,2009-06
2009-06-30,3840261,669356,3170905,파라과이,2009-06
2009-06-30,3565085,467609,3097476,크로아티아,2009-06
2009-06-30,3532782,0,3532782,토고,2009-06
2009-06-30,3530502,55254378,-51723876,브루나이,2009-06
2009-06-30,3353742,173738,3180004,마다카스카르,2009-06
2009-06-30,3192146,18259,3173887,니제르,2009-06
2009-06-30,3186343,48636,3137707,모잠비크,2009-06
2009-06-30,3173292,6880578,-3707286,뉴 칼레도니아,2009-06
2009-06-30,2772807,174140,2598667,네팔,2009-06
2009-06-30,2679174,3488127,-808953,트리니다드 토바고,2009-06
2009-06-30,2563852,25157561,-22593709,파푸아 뉴기니,2009-06
2009-06-30,2397455,0,2397455,에리트리아,2009-06
2009-06-30,2367858,124775,2243083,콩고,2009-06
2009-06-30,2298252,123387,2174865,피지,2009-06
2009-06-30,2183575,58610,2124965,조지아,2009-06
2009-06-30,2175434,161015,2014419,카메룬,2009-06
2009-06-30,2104904,30339,2074565,모리셔스,2009-06
2009-06-30,1987891,114530,1873361,자마이카,2009-06
2009-06-30,1901722,8944,1892778,콩고민주공화국,2009-06
2009-06-30,1886127,127,1886000,지부티,2009-06
2009-06-30,1866949,27,1866922,아메리칸 사모아,2009-06
2009-06-30,1703109,86615,1616494,팔레스타인 해방기구(구),2009-06
2009-06-30,1602633,0,1602633,타지크,2009-06
2009-06-30,1597350,55161,1542189,세르비아 와 몬테네그로,2009-06
2009-06-30,1517626,2326222,-808596,룩셈부르그,2009-06
2009-06-30,1407404,29573,1377831,아이티,2009-06
2009-06-30,1403485,533622,869863,벨라루스,2009-06
2009-06-30,1310649,338391,972258,마카오,2009-06
2009-06-30,1217177,24,1217153,불령 리유니온 코모도 제도,2009-06
2009-06-30,1133671,68443,1065228,쿠바,2009-06
2009-06-30,1121029,332867,788162,세네갈,2009-06
2009-06-30,1072384,128972,943412,도미니카,2009-06
2009-06-30,1072030,0,1072030,버뮤다,2009-06
2009-06-30,1046802,0,1046802,마티니크,2009-06
2009-06-30,1030366,28040,1002326,가봉,2009-06
2009-06-30,996804,107930,888874,수리남,2009-06
2009-06-30,800300,83342,716958,마세도니아,2009-06
2009-06-30,762626,315921,446705,보스니아-헤르체고비나,2009-06
2009-06-30,754785,342249,412536,우간다,2009-06
2009-06-30,708972,0,708972,마이크로네시아,2009-06
2009-06-30,678326,7514728,-6836402,볼리비아,2009-06
2009-06-30,671105,1568297,-897192,알바니아,2009-06
2009-06-30,665816,5044,660772,네덜란드 열도,2009-06
2009-06-30,572666,62,572604,부르키나 파소,2009-06
2009-06-30,568072,0,568072,가이아나,2009-06
2009-06-30,556634,0,556634,챠드,2009-06
2009-06-30,517773,24884,492889,짐바브웨,2009-06
2009-06-30,506847,0,506847,아루바,2009-06
2009-06-30,497480,137,497343,북마리아나 군도,2009-06
2009-06-30,459740,228645,231095,말라위,2009-06
2009-06-30,437374,32210,405164,안도라,2009-06
2009-06-30,426089,2331762,-1905673,스와질랜드,2009-06
2009-06-30,383802,0,383802,바베이도스,2009-06
2009-06-30,378875,61360285,-60981410,적도 기니,2009-06
2009-06-30,347841,1507835,-1159994,나미비아,2009-06
2009-06-30,333639,47379,286260,사모아,2009-06
2009-06-30,295168,171939,123229,세이쉘,2009-06
2009-06-30,287549,593881,-306332,리히텐슈타인,2009-06
2009-06-30,284847,1843817,-1558970,모리타니,2009-06
2009-06-30,274990,557339,-282349,벨리제,2009-06
2009-06-30,266820,47938378,-47671558,잠비아,2009-06
2009-06-30,251842,6652,245190,바누아투,2009-06
2009-06-30,244667,1365931,-1121264,아이슬란드,2009-06
2009-06-30,212227,0,212227,그레나다,2009-06
2009-06-30,207227,21094,186133,몰디브,2009-06
2009-06-30,191204,55,191149,세인트 루시아,2009-06
2009-06-30,163861,0,163861,팔라우,2009-06
2009-06-30,148465,0,148465,불령 가이아나,2009-06
2009-06-30,138590,0,138590,부탄,2009-06
2009-06-30,129330,5534,123796,르완다,2009-06
2009-06-30,128741,0,128741,카보 베르데,2009-06
2009-06-30,128059,79755,48304,보츠와나,2009-06
2009-06-30,126652,5804171,-5677519,안티가 바부다,2009-06
2009-06-30,106330,0,106330,세인트 키츠 네비스,2009-06
2009-06-30,74596,475220,-400624,모나코,2009-06
2009-06-30,63045,0,63045,과델로프,2009-06
2009-06-30,59300,64682,-5382,기네비소,2009-06
2009-06-30,57661,410,57251,지브랄타,2009-06
2009-06-30,52536,1409888,-1357352,몰도바,2009-06
2009-06-30,48482,2984,45498,말리,2009-06
2009-06-30,43347,97,43250,감비아,2009-06
2009-06-30,40900,1851538,-1810638,솔로몬 군도,2009-06
2009-06-30,39212,213612,-174400,시에라 리온,2009-06
2009-06-30,26962,5460,21502,미령 버진군도,2009-06
2009-06-30,20124,2556525,-2536401,티모르,2009-06
2009-06-30,18790,0,18790,부룬디,2009-06
2009-06-30,15944,0,15944,메요트,2009-06
2009-06-30,10653,0,10653,영령 인도양,2009-06
2009-06-30,3964,0,3964,통가,2009-06
2009-06-30,2300,16494,-14194,중앙아프리카공화국,2009-06
2009-06-30,627,0,627,세인트 빈센트 그레나딘,2009-06
2009-06-30,249,4515,-4266,마이너 아우틀링 합중국 군도,2009-06
2009-06-30,10,0,10,앙귈라,2009-06
2009-06-30,4,1342,-1338,키리바티,2009-06
2009-06-30,0,280732,-280732,투르크 & 카이코스 군도,2009-06
2009-06-30,0,124,-124,교황청,2009-06
2009-06-30,0,2335,-2335,상토메 프린스페,2009-06
2009-06-30,0,2110,-2110,몬트세라트,2009-06
2009-06-30,0,36631,-36631,코스 군도,2009-06
2009-06-30,0,129336,-129336,산마리노,2009-06
2009-06-30,0,101366,-101366,그린랜드,2009-06
2009-06-30,0,86842,-86842,영령 버진군도,2009-06
2009-06-30,0,83327,-83327,쿡 아일랜드,2009-06
2009-07-31,7804229064,4540035055,3264194009,중국,2009-07
2009-07-31,3286677233,2581557688,705119545,미국,2009-07
2009-07-31,1859977452,4249367376,-2389389924,일본,2009-07
2009-07-31,1810648319,169094126,1641554193,홍콩,2009-07
2009-07-31,1345208713,751605530,593603183,싱가포르,2009-07
2009-07-31,800350793,993253172,-192902379,대만,2009-07
2009-07-31,743546677,390842463,352704214,인도,2009-07
2009-07-31,694427423,413574492,280852931,노르웨이,2009-07
2009-07-31,681962596,963517202,-281554606,독일,2009-07
2009-07-31,678621045,203816139,474804906,베트남,2009-07
2009-07-31,625611102,73629315,551981787,멕시코,2009-07
2009-07-31,608241252,76275,608164977,영령 버진군도,2009-07
2009-07-31,602238258,890133040,-287894782,인도네시아,2009-07
2009-07-31,504850838,1120460309,-615609471,호주,2009-07
2009-07-31,504080436,256941979,247138457,브라질,2009-07
2009-07-31,416518751,997983374,-581464623,아랍에미리트 연합,2009-07
2009-07-31,410897854,522902856,-112005002,말레이시아,2009-07
2009-07-31,409992208,1757254745,-1347262537,사우디아라비아,2009-07
2009-07-31,406123749,49290,406074459,라이베리아,2009-07
2009-07-31,405194716,173963106,231231610,네덜란드,2009-07
2009-07-31,388823963,237180179,151643784,필리핀,2009-07
2009-07-31,380843573,290607207,90236366,태국,2009-07
2009-07-31,377280312,470083708,-92803396,러시아 연방,2009-07
2009-07-31,346640839,18055888,328584951,폴란드,2009-07
2009-07-31,324440086,396902381,-72462295,이란,2009-07
2009-07-31,298813996,366647742,-67833746,캐나다,2009-07
2009-07-31,287247474,4070023,283177451,슬로바키아,2009-07
2009-07-31,269476916,269834465,-357549,영국,2009-07
2009-07-31,261063356,42439611,218623745,튀르키예,2009-07
2009-07-31,241558592,328331295,-86772703,칠레,2009-07
2009-07-31,215615600,134568935,81046665,파나마,2009-07
2009-07-31,195253939,296101636,-100847697,이탈리아,2009-07
2009-07-31,187741305,391310178,-203568873,프랑스,2009-07
2009-07-31,180743630,0,180743630,마샬군도,2009-07
2009-07-31,174462959,22092618,152370341,사이프러스,2009-07
2009-07-31,156862433,25310895,131551538,헝가리,2009-07
2009-07-31,135519830,67457379,68062451,스페인,2009-07
2009-07-31,133623903,47631708,85992195,알제리,2009-07
2009-07-31,119006883,2256217,116750666,우즈베키스탄,2009-07
2009-07-31,117898023,34987193,82910830,이집트,2009-07
2009-07-31,113447220,14661,113432559,리비아,2009-07
2009-07-31,109261232,87309993,21951239,벨기에,2009-07
2009-07-31,93632422,2536238,91096184,요르단,2009-07
2009-07-31,93532389,9885951,83646438,몰타,2009-07
2009-07-31,92789649,3029259,89760390,그리스,2009-07
2009-07-31,89964274,101493916,-11529642,남아프리카공화국,2009-07
2009-07-31,83435484,70864999,12570485,뉴질랜드,2009-07
2009-07-31,80649412,6139213,74510199,방글라데시,2009-07
2009-07-31,78662309,497290848,-418628539,카타르,2009-07
2009-07-31,72353428,22498960,49854468,나이지리아,2009-07
2009-07-31,67373963,11337159,56036804,콜롬비아,2009-07
2009-07-31,65426936,59733084,5693852,이스라엘,2009-07
2009-07-31,61384679,18005237,43379442,시리아,2009-07
2009-07-31,60318027,79342139,-19024112,핀란드,2009-07
2009-07-31,58938285,43286196,15652089,파키스탄,2009-07
2009-07-31,56688514,62597911,-5909397,오스트리아,2009-07
2009-07-31,56490239,24127434,32362805,체코공화국,2009-07
2009-07-31,54885809,15746,54870063,바하마,2009-07
2009-07-31,47442409,3184607,44257802,미얀마,2009-07
2009-07-31,46546055,735290935,-688744880,쿠웨이트,2009-07
2009-07-31,43848348,44474054,-625706,우크라이나,2009-07
2009-07-31,43153122,88315986,-45162864,스웨덴,2009-07
2009-07-31,42887769,20321207,22566562,바레인,2009-07
2009-07-31,42051324,19083413,22967911,아르헨티나,2009-07
2009-07-31,41005805,315737221,-274731416,이라크,2009-07
2009-07-31,40392543,112088569,-71696026,페루,2009-07
2009-07-31,36755826,113582733,-76826907,오만,2009-07
2009-07-31,34838177,3838691,30999486,베네주엘라,2009-07
2009-07-31,33210708,4841415,28369293,슬로베니아,2009-07
2009-07-31,33087413,530723,32556690,에쿠아도르,2009-07
2009-07-31,32373755,4880551,27493204,포루투갈,2009-07
2009-07-31,28055735,2694037,25361698,모로코,2009-07
2009-07-31,27767718,13387827,14379891,루마니아,2009-07
2009-07-31,25361108,12181011,13180097,과테말라,2009-07
2009-07-31,24930298,8263934,16666364,카자흐스탄,2009-07
2009-07-31,24260796,2132617,22128179,캄보디아,2009-07
2009-07-31,21067456,43811,21023645,괌,2009-07
2009-07-31,17362533,698297,16664236,레바논,2009-07
2009-07-31,17018919,334470,16684449,수단,2009-07
2009-07-31,16839231,56030502,-39191271,덴마크,2009-07
2009-07-31,16560466,22035,16538431,투르크멘,2009-07
2009-07-31,14944476,75432920,-60488444,아일랜드,2009-07
2009-07-31,14662297,6825373,7836924,앙골라,2009-07
2009-07-31,14639506,3482390,11157116,몽골,2009-07
2009-07-31,14550276,150741930,-136191654,스위스,2009-07
2009-07-31,14488242,8283301,6204941,푸에르토리코,2009-07
2009-07-31,13406390,62583,13343807,가나,2009-07
2009-07-31,13225480,10085272,3140208,코스타리카,2009-07
2009-07-31,13166083,116157,13049926,니카라과,2009-07
2009-07-31,12239456,3778023,8461433,스리랑카,2009-07
2009-07-31,11864240,894352,10969888,케냐,2009-07
2009-07-31,10543284,827474,9715810,아제르바이잔,2009-07
2009-07-31,9630747,850651,8780096,리투아니아,2009-07
2009-07-31,9402556,238044,9164512,예맨,2009-07
2009-07-31,9268799,14750,9254049,키르기스스탄,2009-07
2009-07-31,8161073,2629107,5531966,우루과이,2009-07
2009-07-31,7836754,2429598,5407156,튀니지,2009-07
2009-07-31,7730861,151699,7579162,마다카스카르,2009-07
2009-07-31,7688683,2222351,5466332,도미니카 공화국,2009-07
2009-07-31,7458144,220608,7237536,탄자니아,2009-07
2009-07-31,6805160,1573,6803587,르완다,2009-07
2009-07-31,6535100,2542829,3992271,온두라스,2009-07
2009-07-31,6496064,3535190,2960874,불가리아,2009-07
2009-07-31,6218774,1607362,4611412,크로아티아,2009-07
2009-07-31,6189570,24,6189546,코트디봐르,2009-07
2009-07-31,6056162,1211256,4844906,라트비아,2009-07
2009-07-31,5798648,28231,5770417,베닝,2009-07
2009-07-31,5795994,3472334,2323660,기타국,2009-07
2009-07-31,5230669,75063801,-69833132,브루나이,2009-07
2009-07-31,4810530,816111,3994419,기니,2009-07
2009-07-31,4699850,144351,4555499,라오스,2009-07
2009-07-31,4599552,482,4599070,지부티,2009-07
2009-07-31,4323281,1129745,3193536,에스토니아,2009-07
2009-07-31,3976564,0,3976564,레소토,2009-07
2009-07-31,3895162,662920,3232242,세네갈,2009-07
2009-07-31,3754940,789670,2965270,에티오피아,2009-07
2009-07-31,3576375,71231,3505144,네팔,2009-07
2009-07-31,3455157,107821,3347336,파라과이,2009-07
2009-07-31,3320838,415607,2905231,카메룬,2009-07
2009-07-31,3307290,229911,3077379,엘살바도르,2009-07
2009-07-31,3222501,66831,3155670,세르비아 와 몬테네그로,2009-07
2009-07-31,3124855,7572,3117283,아르메니아,2009-07
2009-07-31,3088805,4832151,-1743346,조지아,2009-07
2009-07-31,3059875,200743,2859132,콩고,2009-07
2009-07-31,3045080,128841,2916239,쿠바,2009-07
2009-07-31,3006053,2419692,586361,모잠비크,2009-07
2009-07-31,2870440,4628044,-1757604,트리니다드 토바고,2009-07
2009-07-31,2743863,68155995,-65412132,잠비아,2009-07
2009-07-31,2597250,171736,2425514,모리셔스,2009-07
2009-07-31,2512999,1536022,976977,콩고민주공화국,2009-07
2009-07-31,2433356,0,2433356,토고,2009-07
2009-07-31,2399455,456128,1943327,파푸아 뉴기니,2009-07
2009-07-31,2225931,7649083,-5423152,뉴 칼레도니아,2009-07
2009-07-31,1736719,437076,1299643,마카오,2009-07
2009-07-31,1666315,705014,961301,벨라루스,2009-07
2009-07-31,1647693,241,1647452,아메리칸 사모아,2009-07
2009-07-31,1622546,7307,1615239,아프카니스탄,2009-07
2009-07-31,1555332,511287,1044045,타지크,2009-07
2009-07-31,1471002,0,1471002,챠드,2009-07
2009-07-31,1444038,6021,1438017,말리,2009-07
2009-07-31,1247566,30,1247536,불령 리유니온 코모도 제도,2009-07
2009-07-31,1227224,287728,939496,말라위,2009-07
2009-07-31,1161917,238528,923389,짐바브웨,2009-07
2009-07-31,1098597,176959,921638,우간다,2009-07
2009-07-31,1074610,4302,1070308,벨리제,2009-07
2009-07-31,1048054,8943231,-7895177,볼리비아,2009-07
2009-07-31,847299,0,847299,부탄,2009-07
2009-07-31,836464,2443230,-1606766,룩셈부르그,2009-07
2009-07-31,804702,4269,800433,북마리아나 군도,2009-07
2009-07-31,760284,12548,747736,가이아나,2009-07
2009-07-31,739451,0,739451,부르키나 파소,2009-07
2009-07-31,738601,76,738525,버뮤다,2009-07
2009-07-31,736984,163100,573884,세이쉘,2009-07
2009-07-31,728823,17069,711754,알바니아,2009-07
2009-07-31,728332,0,728332,아루바,2009-07
2009-07-31,722928,45619,677309,팔레스타인 해방기구(구),2009-07
2009-07-31,721283,5000,716283,네덜란드 열도,2009-07
2009-07-31,719628,528737,190891,피지,2009-07
2009-07-31,686125,18699,667426,아이티,2009-07
2009-07-31,662927,0,662927,마이크로네시아,2009-07
2009-07-31,633674,0,633674,과델로프,2009-07
2009-07-31,614476,42526,571950,수리남,2009-07
2009-07-31,611013,59652,551361,바누아투,2009-07
2009-07-31,606432,86370,520062,도미니카,2009-07
2009-07-31,593999,102928,491071,자마이카,2009-07
2009-07-31,561549,5550,555999,불령 폴리네시아,2009-07
2009-07-31,558051,37877,520174,보스니아-헤르체고비나,2009-07
2009-07-31,529933,0,529933,불령 가이아나,2009-07
2009-07-31,500864,0,500864,니제르,2009-07
2009-07-31,475630,218,475412,모리타니,2009-07
2009-07-31,457434,26141,431293,시에라 리온,2009-07
2009-07-31,455210,2968756,-2513546,스와질랜드,2009-07
2009-07-31,408782,755095,-346313,아이슬란드,2009-07
2009-07-31,397378,77637,319741,가봉,2009-07
2009-07-31,383400,206811,176589,마세도니아,2009-07
2009-07-31,350092,0,350092,마티니크,2009-07
2009-07-31,307686,16755,290931,사모아,2009-07
2009-07-31,289895,0,289895,몰디브,2009-07
2009-07-31,248274,0,248274,팔라우,2009-07
2009-07-31,244352,937037,-692685,몰도바,2009-07
2009-07-31,241903,0,241903,바베이도스,2009-07
2009-07-31,224125,4647,219478,안티가 바부다,2009-07
2009-07-31,211542,49653,161889,보츠와나,2009-07
2009-07-31,196595,18416,178179,안도라,2009-07
2009-07-31,186420,65100,121320,기네비소,2009-07
2009-07-31,175834,0,175834,세인트 루시아,2009-07
2009-07-31,167279,0,167279,에리트리아,2009-07
2009-07-31,144943,19,144924,영령 캐이맨 군도,2009-07
2009-07-31,142067,1741,140326,감비아,2009-07
2009-07-31,112598,476266,-363668,리히텐슈타인,2009-07
2009-07-31,110024,2469314,-2359290,나미비아,2009-07
2009-07-31,64445,12908,51537,중앙아프리카공화국,2009-07
2009-07-31,64007,0,64007,카보 베르데,2009-07
2009-07-31,62640,0,62640,코모로스,2009-07
2009-07-31,56899,272,56627,투발루,2009-07
2009-07-31,41366,0,41366,노폴크 아일랜드,2009-07
2009-07-31,32508,28956801,-28924293,적도 기니,2009-07
2009-07-31,21452,0,21452,그레나다,2009-07
2009-07-31,20706,0,20706,지브랄타,2009-07
2009-07-31,20642,17470852,-17450210,티모르,2009-07
2009-07-31,19605,767191,-747586,솔로몬 군도,2009-07
2009-07-31,9995,0,9995,세인트 헬레나,2009-07
2009-07-31,6147,0,6147,쿡 아일랜드,2009-07
2009-07-31,4405,0,4405,미령 버진군도,2009-07
2009-07-31,3082,0,3082,상토메 프린스페,2009-07
2009-07-31,2184,0,2184,남조지아 & 남샌드위치 군도,2009-07
2009-07-31,1658,0,1658,키리바티,2009-07
2009-07-31,1640,136,1504,앙귈라,2009-07
2009-07-31,219,614796,-614577,모나코,2009-07
2009-07-31,177,4187,-4010,세인트 빈센트 그레나딘,2009-07
2009-07-31,33,39015,-38982,그린랜드,2009-07
2009-07-31,0,56,-56,산마리노,2009-07
2009-07-31,0,3064,-3064,포클랜드 군도,2009-07
2009-07-31,0,166140,-166140,토켈라우,2009-07
2009-07-31,0,19,-19,나우루,2009-07
2009-07-31,0,86,-86,투르크 & 카이코스 군도,2009-07
2009-07-31,0,1,-1,통가,2009-07
2009-08-31,7656799821,4480648274,3176151547,중국,2009-08
2009-08-31,3143716228,2455173805,688542423,미국,2009-08
2009-08-31,1788965745,4048158547,-2259192802,일본,2009-08
2009-08-31,1767895019,126559150,1641335869,홍콩,2009-08
2009-08-31,1041762379,708452942,333309437,싱가포르,2009-08
2009-08-31,854405102,1193476766,-339071664,독일,2009-08
2009-08-31,830394856,880259805,-49864949,대만,2009-08
2009-08-31,689432131,0,689432131,버뮤다,2009-08
2009-08-31,605219215,326690260,278528955,인도,2009-08
2009-08-31,554266324,230968806,323297518,베트남,2009-08
2009-08-31,543824426,128536836,415287590,멕시코,2009-08
2009-08-31,538120906,307933262,230187644,브라질,2009-08
2009-08-31,478603162,793570119,-314966957,인도네시아,2009-08
2009-08-31,472955503,1241038440,-768082937,호주,2009-08
2009-08-31,395811350,224619823,171191527,필리핀,2009-08
2009-08-31,373414854,529356574,-155941720,말레이시아,2009-08
2009-08-31,365702897,15719818,349983079,폴란드,2009-08
2009-08-31,352224066,263687625,88536441,태국,2009-08
2009-08-31,323930127,356494754,-32564627,러시아 연방,2009-08
2009-08-31,314007683,8809619,305198064,그리스,2009-08
2009-08-31,308588078,563410410,-254822332,이란,2009-08
2009-08-31,283986600,186062173,97924427,네덜란드,2009-08
2009-08-31,264748897,971334427,-706585530,아랍에미리트 연합,2009-08
2009-08-31,256502657,4471102,252031555,슬로바키아,2009-08
2009-08-31,251626931,1940030604,-1688403673,사우디아라비아,2009-08
2009-08-31,234364236,304213437,-69849201,캐나다,2009-08
2009-08-31,231869518,21970,231847548,라이베리아,2009-08
2009-08-31,206836482,269551468,-62714986,영국,2009-08
2009-08-31,191864427,86221761,105642666,튀르키예,2009-08
2009-08-31,169074151,343330313,-174256162,이탈리아,2009-08
2009-08-31,169007199,0,169007199,마샬군도,2009-08
2009-08-31,156622573,281261348,-124638775,프랑스,2009-08
2009-08-31,156341823,21768124,134573699,헝가리,2009-08
2009-08-31,154047043,21655645,132391398,파나마,2009-08
2009-08-31,152150899,8216318,143934581,몰타,2009-08
2009-08-31,141297274,251063215,-109765941,칠레,2009-08
2009-08-31,131272856,72745297,58527559,스페인,2009-08
2009-08-31,103003296,14205558,88797738,이집트,2009-08
2009-08-31,96313235,1771597,94541638,우즈베키스탄,2009-08
2009-08-31,93871074,173211577,-79340503,알제리,2009-08
2009-08-31,92190554,110715795,-18525241,남아프리카공화국,2009-08
2009-08-31,87658896,226565,87432331,리비아,2009-08
2009-08-31,84586334,9049407,75536927,방글라데시,2009-08
2009-08-31,80594293,736342990,-655748697,쿠웨이트,2009-08
2009-08-31,75875080,78091517,-2216437,벨기에,2009-08
2009-08-31,68269193,399923,67869270,시리아,2009-08
2009-08-31,61404186,48763029,12641157,이스라엘,2009-08
2009-08-31,60583836,51556725,9027111,아일랜드,2009-08
2009-08-31,59196175,23338272,35857903,체코공화국,2009-08
2009-08-31,58632797,1363941,57268856,요르단,2009-08
2009-08-31,56196121,81153344,-24957223,뉴질랜드,2009-08
2009-08-31,53318215,54406651,-1088436,오스트리아,2009-08
2009-08-31,52614163,157931,52456232,괌,2009-08
2009-08-31,51553919,11882122,39671797,콜롬비아,2009-08
2009-08-31,50887035,45870869,5016166,아르헨티나,2009-08
2009-08-31,50284237,5148710,45135527,나이지리아,2009-08
2009-08-31,49346696,27133747,22212949,파키스탄,2009-08
2009-08-31,48283579,508959028,-460675449,카타르,2009-08
2009-08-31,39358615,16429213,22929402,과테말라,2009-08
2009-08-31,39352202,14781882,24570320,루마니아,2009-08
2009-08-31,38977929,271652938,-232675009,오만,2009-08
2009-08-31,38931335,88073718,-49142383,우크라이나,2009-08
2009-08-31,38714141,1761526,36952615,에쿠아도르,2009-08
2009-08-31,37545297,3336768,34208529,슬로베니아,2009-08
2009-08-31,37116479,97578308,-60461829,페루,2009-08
2009-08-31,35505607,61285252,-25779645,핀란드,2009-08
2009-08-31,33694589,16486635,17207954,카자흐스탄,2009-08
2009-08-31,30945698,91605918,-60660220,스웨덴,2009-08
2009-08-31,27539136,380778777,-353239641,이라크,2009-08
2009-08-31,25597221,5409001,20188220,포루투갈,2009-08
2009-08-31,25337481,3660702,21676779,기타국,2009-08
2009-08-31,24749024,7401119,17347905,미얀마,2009-08
2009-08-31,24060748,0,24060748,불령 폴리네시아,2009-08
2009-08-31,22281063,1550904,20730159,베네주엘라,2009-08
2009-08-31,20176023,1933171,18242852,캄보디아,2009-08
2009-08-31,19941743,458031,19483712,수단,2009-08
2009-08-31,18194707,991279,17203428,예맨,2009-08
2009-08-31,17168661,11456925,5711736,모로코,2009-08
2009-08-31,16852370,1414,16850956,앙골라,2009-08
2009-08-31,16206431,3524954,12681477,스리랑카,2009-08
2009-08-31,15769150,122564680,-106795530,스위스,2009-08
2009-08-31,15511102,46310225,-30799123,바레인,2009-08
2009-08-31,12641681,1699101,10942580,튀니지,2009-08
2009-08-31,12155558,61713,12093845,니카라과,2009-08
2009-08-31,11815475,243194315,-231378840,노르웨이,2009-08
2009-08-31,11795912,1140923,10654989,레바논,2009-08
2009-08-31,11375675,542514,10833161,케냐,2009-08
2009-08-31,10136702,38108183,-27971481,덴마크,2009-08
2009-08-31,10037691,3469078,6568613,몽골,2009-08
2009-08-31,9808112,6797,9801315,키르기스스탄,2009-08
2009-08-31,9468241,2608647,6859594,가나,2009-08
2009-08-31,9249818,685555,8564263,리투아니아,2009-08
2009-08-31,9215032,26343607,-17128575,트리니다드 토바고,2009-08
2009-08-31,8145273,100,8145173,아제르바이잔,2009-08
2009-08-31,7486859,36102445,-28615586,브루나이,2009-08
2009-08-31,7485638,11184226,-3698588,코스타리카,2009-08
2009-08-31,7194355,889217,6305138,에티오피아,2009-08
2009-08-31,6364900,628303,5736597,기니,2009-08
2009-08-31,5825568,7657125,-1831557,푸에르토리코,2009-08
2009-08-31,5666615,2223491,3443124,도미니카 공화국,2009-08
2009-08-31,5606269,5166042,440227,불가리아,2009-08
2009-08-31,5497142,66084,5431058,투르크멘,2009-08
2009-08-31,5332332,150857,5181475,탄자니아,2009-08
2009-08-31,5248401,932019,4316382,크로아티아,2009-08
2009-08-31,4607833,2103679,2504154,온두라스,2009-08
2009-08-31,4573944,763106,3810838,라트비아,2009-08
2009-08-31,4548158,15202726,-10654568,라오스,2009-08
2009-08-31,4377467,2094326,2283141,우루과이,2009-08
2009-08-31,4192375,2740,4189635,레소토,2009-08
2009-08-31,3683285,184854,3498431,마다카스카르,2009-08
2009-08-31,3672908,656193,3016715,파라과이,2009-08
2009-08-31,3281854,1930371,1351483,파푸아 뉴기니,2009-08
2009-08-31,3237898,221294,3016604,엘살바도르,2009-08
2009-08-31,2963064,1677950,1285114,에스토니아,2009-08
2009-08-31,2934691,9748,2924943,아프카니스탄,2009-08
2009-08-31,2656496,447635,2208861,카메룬,2009-08
2009-08-31,2633210,2985,2630225,코트디봐르,2009-08
2009-08-31,2621309,450042,2171267,모잠비크,2009-08
2009-08-31,2450296,1224417,1225879,짐바브웨,2009-08
2009-08-31,2367964,180287,2187677,베닝,2009-08
2009-08-31,2335062,6580541,-4245479,토고,2009-08
2009-08-31,2321151,179740,2141411,모리셔스,2009-08
2009-08-31,2216613,409420,1807193,마카오,2009-08
2009-08-31,2212827,2942935,-730108,조지아,2009-08
2009-08-31,2195080,96620,2098460,세르비아 와 몬테네그로,2009-08
2009-08-31,2156288,1401403,754885,아이슬란드,2009-08
2009-08-31,2143214,0,2143214,지부티,2009-08
2009-08-31,2130043,4988560,-2858517,뉴 칼레도니아,2009-08
2009-08-31,2106683,24,2106659,부르키나 파소,2009-08
2009-08-31,2071984,6267153,-4195169,사이프러스,2009-08
2009-08-31,1978114,17473,1960641,팔레스타인 해방기구(구),2009-08
2009-08-31,1916411,1240249,676162,타지크,2009-08
2009-08-31,1635468,3706,1631762,부탄,2009-08
2009-08-31,1564240,3977897,-2413657,콩고민주공화국,2009-08
2009-08-31,1556090,997429,558661,세네갈,2009-08
2009-08-31,1550596,22,1550574,아메리칸 사모아,2009-08
2009-08-31,1530044,26770281,-25240237,적도 기니,2009-08
2009-08-31,1438110,140473,1297637,자마이카,2009-08
2009-08-31,1336539,518613,817926,벨라루스,2009-08
2009-08-31,1322510,67521,1254989,네팔,2009-08
2009-08-31,1273399,509972,763427,피지,2009-08
2009-08-31,1159709,13543,1146166,말라위,2009-08
2009-08-31,1111376,65378,1045998,아이티,2009-08
2009-08-31,1086691,28,1086663,나미비아,2009-08
2009-08-31,1077323,49,1077274,불령 리유니온 코모도 제도,2009-08
2009-08-31,999592,153938,845654,네덜란드 열도,2009-08
2009-08-31,957516,1816717,-859201,콩고,2009-08
2009-08-31,948255,16223,932032,알바니아,2009-08
2009-08-31,873134,131773,741361,아르메니아,2009-08
2009-08-31,847352,65960,781392,마이크로네시아,2009-08
2009-08-31,826419,0,826419,가이아나,2009-08
2009-08-31,793735,40832660,-40038925,잠비아,2009-08
2009-08-31,733416,387391,346025,쿠바,2009-08
2009-08-31,731986,464,731522,북마리아나 군도,2009-08
2009-08-31,666413,1812993,-1146580,스와질랜드,2009-08
2009-08-31,664946,641959,22987,우간다,2009-08
2009-08-31,663786,1227435,-563649,룩셈부르그,2009-08
2009-08-31,632638,444224,188414,마세도니아,2009-08
2009-08-31,625683,0,625683,수리남,2009-08
2009-08-31,578205,3196111,-2617906,볼리비아,2009-08
2009-08-31,534436,0,534436,마티니크,2009-08
2009-08-31,532137,0,532137,과델로프,2009-08
2009-08-31,512193,4689,507504,바하마,2009-08
2009-08-31,375404,92505,282899,벨리제,2009-08
2009-08-31,339546,93737,245809,도미니카,2009-08
2009-08-31,320078,0,320078,아루바,2009-08
2009-08-31,317674,11449,306225,세이쉘,2009-08
2009-08-31,307998,0,307998,바베이도스,2009-08
2009-08-31,259923,282842,-22919,리히텐슈타인,2009-08
2009-08-31,249653,234729,14924,모리타니,2009-08
2009-08-31,242146,0,242146,소말리아,2009-08
2009-08-31,238872,25936,212936,시에라 리온,2009-08
2009-08-31,231192,3053831,-2822639,가봉,2009-08
2009-08-31,199120,33735,165385,보츠와나,2009-08
2009-08-31,173900,0,173900,몰디브,2009-08
2009-08-31,122646,556,122090,노폴크 아일랜드,2009-08
2009-08-31,116409,0,116409,그레나다,2009-08
2009-08-31,115739,174686,-58947,사모아,2009-08
2009-08-31,109833,949933,-840100,솔로몬 군도,2009-08
2009-08-31,109782,5207865,-5098083,키리바티,2009-08
2009-08-31,102947,0,102947,세인트 빈센트 그레나딘,2009-08
2009-08-31,90265,783361,-693096,몰도바,2009-08
2009-08-31,80905,0,80905,중앙아프리카공화국,2009-08
2009-08-31,73644,0,73644,불령 가이아나,2009-08
2009-08-31,72286,186,72100,감비아,2009-08
2009-08-31,66155,0,66155,팔라우,2009-08
2009-08-31,66123,12178,53945,나우루,2009-08
2009-08-31,62575,0,62575,에리트리아,2009-08
2009-08-31,60121,0,60121,세인트 루시아,2009-08
2009-08-31,57799,0,57799,지브랄타,2009-08
2009-08-31,54830,0,54830,카보 베르데,2009-08
2009-08-31,51616,1870,49746,쿡 아일랜드,2009-08
2009-08-31,47011,0,47011,티모르,2009-08
2009-08-31,34273,0,34273,르완다,2009-08
2009-08-31,31252,57,31195,바누아투,2009-08
2009-08-31,23374,53724,-30350,안도라,2009-08
2009-08-31,18290,26147,-7857,안티가 바부다,2009-08
2009-08-31,16462,169675,-153213,보스니아-헤르체고비나,2009-08
2009-08-31,15860,0,15860,파로에 군도,2009-08
2009-08-31,14400,416955,-402555,모나코,2009-08
2009-08-31,7077,0,7077,챠드,2009-08
2009-08-31,3380,0,3380,영령 캐이맨 군도,2009-08
2009-08-31,252,710,-458,세인트 키츠 네비스,2009-08
2009-08-31,0,42288,-42288,토켈라우,2009-08
2009-08-31,0,1130,-1130,마이너 아우틀링 합중국 군도,2009-08
2009-08-31,0,928,-928,니제르,2009-08
2009-08-31,0,54693,-54693,그린랜드,2009-08
2009-08-31,0,130108,-130108,투르크 & 카이코스 군도,2009-08
2009-08-31,0,33202,-33202,기네비소,2009-08
2009-08-31,0,4121,-4121,몬트세라트,2009-08
2009-08-31,0,52650,-52650,남조지아 & 남샌드위치 군도,2009-08
2009-08-31,0,222,-222,말리,2009-08
2009-08-31,0,14928,-14928,통가,2009-08
2009-09-30,8363324548,5092462693,3270861855,중국,2009-09
2009-09-30,3387117003,2897353660,489763343,미국,2009-09
2009-09-30,2189255220,4612594175,-2423338955,일본,2009-09
2009-09-30,1696969684,148974689,1547994995,홍콩,2009-09
2009-09-30,1300874544,648741092,652133452,싱가포르,2009-09
2009-09-30,1041562792,221,1041562571,마샬군도,2009-09
2009-09-30,918155283,971755316,-53600033,대만,2009-09
2009-09-30,798015717,1219466265,-421450548,독일,2009-09
2009-09-30,784129201,104020713,680108488,멕시코,2009-09
2009-09-30,697631817,402725837,294905980,인도,2009-09
2009-09-30,649437259,250452147,398985112,베트남,2009-09
2009-09-30,633630419,804501572,-170871153,인도네시아,2009-09
2009-09-30,623815709,257775444,366040265,브라질,2009-09
2009-09-30,525415763,1371784084,-846368321,호주,2009-09
2009-09-30,462381538,159708043,302673495,파나마,2009-09
2009-09-30,449220779,269321923,179898856,필리핀,2009-09
2009-09-30,417589008,307835014,109753994,태국,2009-09
2009-09-30,400551718,17913544,382638174,폴란드,2009-09
2009-09-30,395995519,16821,395978698,라이베리아,2009-09
2009-09-30,392882836,587052542,-194169706,이란,2009-09
2009-09-30,391222055,666603201,-275381146,러시아 연방,2009-09
2009-09-30,374215323,500577881,-126362558,말레이시아,2009-09
2009-09-30,369959299,961265492,-591306193,아랍에미리트 연합,2009-09
2009-09-30,360885759,283261335,77624424,이탈리아,2009-09
2009-09-30,344318366,1979404419,-1635086053,사우디아라비아,2009-09
2009-09-30,341066055,258526998,82539057,네덜란드,2009-09
2009-09-30,303104344,324879239,-21774895,캐나다,2009-09
2009-09-30,296999735,33458250,263541485,튀르키예,2009-09
2009-09-30,287970368,233149118,54821250,영국,2009-09
2009-09-30,268547548,5509577,263037971,슬로바키아,2009-09
2009-09-30,213924111,242863595,-28939484,칠레,2009-09
2009-09-30,204392780,324794430,-120401650,프랑스,2009-09
2009-09-30,196890385,15983863,180906522,헝가리,2009-09
2009-09-30,178730444,2162278,176568166,그리스,2009-09
2009-09-30,176368700,4332,176364368,바하마,2009-09
2009-09-30,167690000,58776103,108913897,스페인,2009-09
2009-09-30,159331020,3149683,156181337,이집트,2009-09
2009-09-30,139150734,491785306,-352634572,카타르,2009-09
2009-09-30,127912036,215771834,-87859798,노르웨이,2009-09
2009-09-30,121947930,319169,121628761,리비아,2009-09
2009-09-30,117231148,121337536,-4106388,남아프리카공화국,2009-09
2009-09-30,108285323,89222431,19062892,벨기에,2009-09
2009-09-30,105906490,467161,105439329,시리아,2009-09
2009-09-30,105693980,18832058,86861922,방글라데시,2009-09
2009-09-30,98465187,34607479,63857708,알제리,2009-09
2009-09-30,96427210,3145342,93281868,요르단,2009-09
2009-09-30,94286307,2058883,92227424,우즈베키스탄,2009-09
2009-09-30,84460485,631965814,-547505329,쿠웨이트,2009-09
2009-09-30,83503436,12233680,71269756,콜롬비아,2009-09
2009-09-30,76308683,102547719,-26239036,페루,2009-09
2009-09-30,76065246,79521637,-3456391,뉴질랜드,2009-09
2009-09-30,69839001,24880510,44958491,파키스탄,2009-09
2009-09-30,69813349,65558028,4255321,이스라엘,2009-09
2009-09-30,68481554,29767679,38713875,체코공화국,2009-09
2009-09-30,60890539,3272398,57618141,사이프러스,2009-09
2009-09-30,57444953,84201703,-26756750,오스트리아,2009-09
2009-09-30,55997890,0,55997890,영령 버진군도,2009-09
2009-09-30,55198086,1951162,53246924,에쿠아도르,2009-09
2009-09-30,54293808,269891114,-215597306,오만,2009-09
2009-09-30,49233343,3977322,45256021,슬로베니아,2009-09
2009-09-30,46040785,29771809,16268976,아르헨티나,2009-09
2009-09-30,44246370,11908959,32337411,미얀마,2009-09
2009-09-30,43332291,63233265,-19900974,우크라이나,2009-09
2009-09-30,43326101,12002191,31323910,나이지리아,2009-09
2009-09-30,43019577,32346468,10673109,바레인,2009-09
2009-09-30,41768227,74438304,-32670077,스웨덴,2009-09
2009-09-30,40665752,16766446,23899306,루마니아,2009-09
2009-09-30,39577817,5143780,34434037,베네주엘라,2009-09
2009-09-30,38903958,555288928,-516384970,이라크,2009-09
2009-09-30,35437891,5924456,29513435,포루투갈,2009-09
2009-09-30,35297831,9662840,25634991,모로코,2009-09
2009-09-30,34873317,65352273,-30478956,핀란드,2009-09
2009-09-30,34215247,50089223,-15873976,아일랜드,2009-09
2009-09-30,33420442,34399,33386043,가이아나,2009-09
2009-09-30,33229841,7164803,26065038,앙골라,2009-09
2009-09-30,32499552,987345,31512207,수단,2009-09
2009-09-30,28596987,14374895,14222092,카자흐스탄,2009-09
2009-09-30,27662102,239492,27422610,케냐,2009-09
2009-09-30,24961674,1213809,23747865,과테말라,2009-09
2009-09-30,24268583,1655849,22612734,레바논,2009-09
2009-09-30,23582562,2136235,21446327,캄보디아,2009-09
2009-09-30,20486590,7181247,13305343,푸에르토리코,2009-09
2009-09-30,20448158,65839,20382319,괌,2009-09
2009-09-30,19447278,12096149,7351129,스리랑카,2009-09
2009-09-30,18779070,6,18779064,아제르바이잔,2009-09
2009-09-30,17907906,1516587,16391319,몽골,2009-09
2009-09-30,14963501,44199,14919302,니카라과,2009-09
2009-09-30,14519473,137071572,-122552099,스위스,2009-09
2009-09-30,14240922,419381,13821541,가나,2009-09
2009-09-30,13685954,14626410,-940456,코스타리카,2009-09
2009-09-30,12297094,44615781,-32318687,덴마크,2009-09
2009-09-30,11776741,349263,11427478,에티오피아,2009-09
2009-09-30,11511556,458951,11052605,탄자니아,2009-09
2009-09-30,11448591,1503451,9945140,튀니지,2009-09
2009-09-30,10908866,670033,10238833,예맨,2009-09
2009-09-30,9601233,2337336,7263897,도미니카 공화국,2009-09
2009-09-30,9437249,190960,9246289,키르기스스탄,2009-09
2009-09-30,8922791,491021,8431770,리투아니아,2009-09
2009-09-30,8263846,516276,7747570,파라과이,2009-09
2009-09-30,7554754,123610,7431144,코트디봐르,2009-09
2009-09-30,7471460,1486967,5984493,온두라스,2009-09
2009-09-30,7424628,0,7424628,지부티,2009-09
2009-09-30,6883374,6971035,-87661,몰타,2009-09
2009-09-30,6549703,1957652,4592051,우루과이,2009-09
2009-09-30,5773418,94502622,-88729204,브루나이,2009-09
2009-09-30,5610666,169715,5440951,모잠비크,2009-09
2009-09-30,5433367,25607,5407760,레소토,2009-09
2009-09-30,5156537,1417633,3738904,크로아티아,2009-09
2009-09-30,5092185,18439448,-13347263,뉴 칼레도니아,2009-09
2009-09-30,4973899,113524,4860375,라오스,2009-09
2009-09-30,4971930,405099,4566831,조지아,2009-09
2009-09-30,4895522,642153,4253369,세네갈,2009-09
2009-09-30,4561865,3650893,910972,불가리아,2009-09
2009-09-30,4518867,1651084,2867783,라트비아,2009-09
2009-09-30,4241907,259815,3982092,마다카스카르,2009-09
2009-09-30,4034863,3722778,312085,기타국,2009-09
2009-09-30,3990932,405428,3585504,엘살바도르,2009-09
2009-09-30,3892853,22920,3869933,토고,2009-09
2009-09-30,3532358,188742,3343616,콩고,2009-09
2009-09-30,3379811,834546,2545265,카메룬,2009-09
2009-09-30,3348277,507943,2840334,베닝,2009-09
2009-09-30,3347210,2256,3344954,아프카니스탄,2009-09
2009-09-30,3198003,16611325,-13413322,잠비아,2009-09
2009-09-30,3134151,306449,2827702,트리니다드 토바고,2009-09
2009-09-30,3063842,54673,3009169,투르크멘,2009-09
2009-09-30,2896606,44900238,-42003632,파푸아 뉴기니,2009-09
2009-09-30,2520590,683145,1837445,벨라루스,2009-09
2009-09-30,2473714,42016,2431698,쿠바,2009-09
2009-09-30,2452088,277703,2174385,모리셔스,2009-09
2009-09-30,2446953,42885,2404068,말라위,2009-09
2009-09-30,2222295,1396919,825376,에스토니아,2009-09
2009-09-30,2040288,7666818,-5626530,콩고민주공화국,2009-09
2009-09-30,1873223,17145,1856078,세르비아 와 몬테네그로,2009-09
2009-09-30,1768922,8365563,-6596641,타지크,2009-09
2009-09-30,1560856,2216526,-655670,아르메니아,2009-09
2009-09-30,1555829,116403,1439426,팔레스타인 해방기구(구),2009-09
2009-09-30,1553687,58,1553629,버뮤다,2009-09
2009-09-30,1461614,840048,621566,짐바브웨,2009-09
2009-09-30,1451118,132485,1318633,네덜란드 열도,2009-09
2009-09-30,1438154,161371,1276783,네팔,2009-09
2009-09-30,1422346,280194,1142152,마카오,2009-09
2009-09-30,1290378,133084,1157294,도미니카,2009-09
2009-09-30,1289910,99857,1190053,자마이카,2009-09
2009-09-30,1286377,20,1286357,불령 리유니온 코모도 제도,2009-09
2009-09-30,1283918,409303,874615,피지,2009-09
2009-09-30,1206211,0,1206211,바베이도스,2009-09
2009-09-30,1172407,0,1172407,수리남,2009-09
2009-09-30,1112885,22889,1089996,아이티,2009-09
2009-09-30,1067569,428077,639492,기니,2009-09
2009-09-30,975104,0,975104,마티니크,2009-09
2009-09-30,968074,34442,933632,가봉,2009-09
2009-09-30,943640,465017,478623,세이쉘,2009-09
2009-09-30,842418,569162,273256,우간다,2009-09
2009-09-30,833633,52995,780638,알바니아,2009-09
2009-09-30,819244,219280,599964,볼리비아,2009-09
2009-09-30,713258,44971,668287,북마리아나 군도,2009-09
2009-09-30,698553,52627,645926,불령 폴리네시아,2009-09
2009-09-30,696163,1372,694791,바누아투,2009-09
2009-09-30,640808,10995,629813,아메리칸 사모아,2009-09
2009-09-30,599801,0,599801,불령 가이아나,2009-09
2009-09-30,553518,3176046,-2622528,스와질랜드,2009-09
2009-09-30,536893,0,536893,영령 캐이맨 군도,2009-09
2009-09-30,511789,0,511789,아루바,2009-09
2009-09-30,502566,0,502566,과델로프,2009-09
2009-09-30,449640,9171,440469,부탄,2009-09
2009-09-30,449227,442,448785,부르키나 파소,2009-09
2009-09-30,438943,108060,330883,보츠와나,2009-09
2009-09-30,405464,2618270,-2212806,룩셈부르그,2009-09
2009-09-30,380807,430160,-49353,모리타니,2009-09
2009-09-30,378571,98065,280506,니제르,2009-09
2009-09-30,349215,0,349215,에리트리아,2009-09
2009-09-30,320375,1257619,-937244,마세도니아,2009-09
2009-09-30,316971,384907,-67936,아이슬란드,2009-09
2009-09-30,314875,24894,289981,마이크로네시아,2009-09
2009-09-30,304363,31394,272969,안도라,2009-09
2009-09-30,281519,7016,274503,시에라 리온,2009-09
2009-09-30,245819,1137043,-891224,리히텐슈타인,2009-09
2009-09-30,223595,885977,-662382,몰도바,2009-09
2009-09-30,209961,116799,93162,사모아,2009-09
2009-09-30,159812,0,159812,팔라우,2009-09
2009-09-30,144585,0,144585,챠드,2009-09
2009-09-30,140958,0,140958,르완다,2009-09
2009-09-30,139572,13724,125848,나미비아,2009-09
2009-09-30,124951,1374235,-1249284,솔로몬 군도,2009-09
2009-09-30,112635,0,112635,그레나다,2009-09
2009-09-30,108745,2347,106398,몰디브,2009-09
2009-09-30,99499,20539,78960,티모르,2009-09
2009-09-30,81960,76834,5126,보스니아-헤르체고비나,2009-09
2009-09-30,64620,0,64620,부룬디,2009-09
2009-09-30,51269,0,51269,소말리아,2009-09
2009-09-30,48064,0,48064,기네비소,2009-09
2009-09-30,43009,290,42719,말리,2009-09
2009-09-30,42063,0,42063,노폴크 아일랜드,2009-09
2009-09-30,42045,571,41474,세인트 루시아,2009-09
2009-09-30,35733,0,35733,메요트,2009-09
2009-09-30,34570,113264,-78694,중앙아프리카공화국,2009-09
2009-09-30,23769,0,23769,쿡 아일랜드,2009-09
2009-09-30,22800,0,22800,투발루,2009-09
2009-09-30,20220,6703,13517,안티가 바부다,2009-09
2009-09-30,19472,0,19472,카보 베르데,2009-09
2009-09-30,19035,725288,-706253,모나코,2009-09
2009-09-30,18937,53942,-35005,벨리제,2009-09
2009-09-30,14230,0,14230,코모로스,2009-09
2009-09-30,9747,34,9713,감비아,2009-09
2009-09-30,9060,0,9060,투르크 & 카이코스 군도,2009-09
2009-09-30,6300,1193505,-1187205,나우루,2009-09
2009-09-30,3885,0,3885,세인트 빈센트 그레나딘,2009-09
2009-09-30,3789,0,3789,보빗군도,2009-09
2009-09-30,3514,0,3514,통가,2009-09
2009-09-30,3066,149,2917,지브랄타,2009-09
2009-09-30,2896,0,2896,앙귈라,2009-09
2009-09-30,1012,0,1012,미령 버진군도,2009-09
2009-09-30,576,0,576,포클랜드 군도,2009-09
2009-09-30,0,185,-185,키리바티,2009-09
2009-09-30,0,11233,-11233,코스 군도,2009-09
2009-09-30,0,28992084,-28992084,적도 기니,2009-09
2009-09-30,0,6979,-6979,산마리노,2009-09
2009-09-30,0,37782,-37782,토켈라우,2009-09
2009-09-30,0,34600,-34600,그린랜드,2009-09
2009-09-30,0,902,-902,크리스마스 아일랜드,2009-09
2009-10-31,8178383088,4802770684,3375612404,중국,2009-10
2009-10-31,3190151618,2726210226,463941392,미국,2009-10
2009-10-31,2014269632,4777081621,-2762811989,일본,2009-10
2009-10-31,1881268385,116695580,1764572805,홍콩,2009-10
2009-10-31,1369761404,677634076,692127328,싱가포르,2009-10
2009-10-31,1023959366,39800000,984159366,마샬군도,2009-10
2009-10-31,954908882,952778189,2130693,대만,2009-10
2009-10-31,734150298,89655203,644495095,멕시코,2009-10
2009-10-31,719758711,337153508,382605203,브라질,2009-10
2009-10-31,695379696,264737179,430642517,베트남,2009-10
2009-10-31,672517124,481070810,191446314,인도,2009-10
2009-10-31,615121579,1071491467,-456369888,독일,2009-10
2009-10-31,614547125,889627309,-275080184,인도네시아,2009-10
2009-10-31,537911728,143012221,394899507,네덜란드,2009-10
2009-10-31,526241077,0,526241077,영령 캐이맨 군도,2009-10
2009-10-31,487358703,1433190765,-945832062,호주,2009-10
2009-10-31,438188029,247872472,190315557,필리핀,2009-10
2009-10-31,421902185,274067445,147834740,태국,2009-10
2009-10-31,417792141,19299368,398492773,폴란드,2009-10
2009-10-31,415205320,800931973,-385726653,말레이시아,2009-10
2009-10-31,403236949,390037298,13199651,프랑스,2009-10
2009-10-31,387741871,78824290,308917581,벨기에,2009-10
2009-10-31,384718999,4239407,380479592,그리스,2009-10
2009-10-31,380101287,503893168,-123791881,러시아 연방,2009-10
2009-10-31,361003436,457887866,-96884430,이란,2009-10
2009-10-31,354325268,1080495245,-726169977,아랍에미리트 연합,2009-10
2009-10-31,345903680,326979025,18924655,영국,2009-10
2009-10-31,318407798,327575894,-9168096,캐나다,2009-10
2009-10-31,286915787,2159411633,-1872495846,사우디아라비아,2009-10
2009-10-31,285088173,27963,285060210,라이베리아,2009-10
2009-10-31,283546048,5872925,277673123,슬로바키아,2009-10
2009-10-31,278384076,261950092,16433984,이탈리아,2009-10
2009-10-31,241884783,306931775,-65046992,칠레,2009-10
2009-10-31,237418875,32374794,205044081,튀르키예,2009-10
2009-10-31,203663549,24905218,178758331,헝가리,2009-10
2009-10-31,196817107,8960815,187856292,몰타,2009-10
2009-10-31,191807615,97346289,94461326,파나마,2009-10
2009-10-31,169855144,1532326,168322818,이집트,2009-10
2009-10-31,166485978,70601903,95884075,스페인,2009-10
2009-10-31,108799948,176011,108623937,리비아,2009-10
2009-10-31,106916597,163175472,-56258875,남아프리카공화국,2009-10
2009-10-31,99304068,2051687,97252381,요르단,2009-10
2009-10-31,93211330,434124,92777206,알제리,2009-10
2009-10-31,91569339,548293,91021046,우즈베키스탄,2009-10
2009-10-31,85635369,17119800,68515569,방글라데시,2009-10
2009-10-31,81798953,138217136,-56418183,페루,2009-10
2009-10-31,79246640,21398346,57848294,콜롬비아,2009-10
2009-10-31,76859793,33152691,43707102,체코공화국,2009-10
2009-10-31,67971223,84781858,-16810635,이스라엘,2009-10
2009-10-31,67623278,494102,67129176,시리아,2009-10
2009-10-31,63113125,1183776,61929349,에쿠아도르,2009-10
2009-10-31,62405819,176873235,-114467416,노르웨이,2009-10
2009-10-31,60984177,61565824,-581647,오스트리아,2009-10
2009-10-31,60901897,867739038,-806837141,쿠웨이트,2009-10
2009-10-31,57841109,5984961,51856148,루마니아,2009-10
2009-10-31,56483653,92945969,-36462316,스웨덴,2009-10
2009-10-31,54740959,419324266,-364583307,오만,2009-10
2009-10-31,53523349,10639984,42883365,나이지리아,2009-10
2009-10-31,52925657,84509255,-31583598,뉴질랜드,2009-10
2009-10-31,49460567,64244283,-14783716,아르헨티나,2009-10
2009-10-31,46633433,260796767,-214163334,이라크,2009-10
2009-10-31,42343826,733711235,-691367409,카타르,2009-10
2009-10-31,42071641,41000528,1071113,파키스탄,2009-10
2009-10-31,39883867,142856354,-102972487,스위스,2009-10
2009-10-31,38746092,86470296,-47724204,우크라이나,2009-10
2009-10-31,37674949,6704157,30970792,포루투갈,2009-10
2009-10-31,35738482,4166806,31571676,슬로베니아,2009-10
2009-10-31,35392192,44864745,-9472553,바레인,2009-10
2009-10-31,34048998,13379659,20669339,미얀마,2009-10
2009-10-31,28869599,86886260,-58016661,핀란드,2009-10
2009-10-31,27382686,540993,26841693,사이프러스,2009-10
2009-10-31,24975524,5377715,19597809,모로코,2009-10
2009-10-31,24466800,1964475,22502325,캄보디아,2009-10
2009-10-31,24150718,15202248,8948470,카자흐스탄,2009-10
2009-10-31,22047992,9789391,12258601,앙골라,2009-10
2009-10-31,21998193,14795,21983398,괌,2009-10
2009-10-31,21992715,4881743,17110972,베네주엘라,2009-10
2009-10-31,20189772,8586,20181186,불령 폴리네시아,2009-10
2009-10-31,20173137,1459523,18713614,과테말라,2009-10
2009-10-31,18993304,2003502,16989802,레바논,2009-10
2009-10-31,18585124,48887728,-30302604,덴마크,2009-10
2009-10-31,16948591,8779138,8169453,푸에르토리코,2009-10
2009-10-31,16493166,47532754,-31039588,아일랜드,2009-10
2009-10-31,16415355,721551,15693804,케냐,2009-10
2009-10-31,15752461,20514460,-4761999,스리랑카,2009-10
2009-10-31,15210268,1458379,13751889,가나,2009-10
2009-10-31,14861939,963969,13897970,몽골,2009-10
2009-10-31,14483652,7799012,6684640,수단,2009-10
2009-10-31,14226187,25509,14200678,아제르바이잔,2009-10
2009-10-31,13687566,309216,13378350,니카라과,2009-10
2009-10-31,12081987,1428912,10653075,튀니지,2009-10
2009-10-31,12038787,10398094,1640693,코스타리카,2009-10
2009-10-31,11914103,399862,11514241,기니,2009-10
2009-10-31,9870312,349131,9521181,마카오,2009-10
2009-10-31,9587896,128057,9459839,마다카스카르,2009-10
2009-10-31,9071638,1721,9069917,키르기스스탄,2009-10
2009-10-31,9067392,585296,8482096,리투아니아,2009-10
2009-10-31,8782642,681472,8101170,예맨,2009-10
2009-10-31,8506826,772954,7733872,크로아티아,2009-10
2009-10-31,8236989,243954,7993035,탄자니아,2009-10
2009-10-31,7682578,2834769,4847809,도미니카 공화국,2009-10
2009-10-31,7512872,199249,7313623,파라과이,2009-10
2009-10-31,7279103,1518206,5760897,온두라스,2009-10
2009-10-31,7090797,3762995,3327802,파푸아 뉴기니,2009-10
2009-10-31,7033155,1237110,5796045,라트비아,2009-10
2009-10-31,6640074,223016,6417058,코트디봐르,2009-10
2009-10-31,6541588,616,6540972,아프카니스탄,2009-10
2009-10-31,6162723,2460636,3702087,우루과이,2009-10
2009-10-31,6153870,657190,5496680,엘살바도르,2009-10
2009-10-31,5482756,3223053,2259703,불가리아,2009-10
2009-10-31,5268572,0,5268572,지부티,2009-10
2009-10-31,5044617,897110,4147507,라오스,2009-10
2009-10-31,4856492,2296,4854196,레소토,2009-10
2009-10-31,4828691,3716814,1111877,기타국,2009-10
2009-10-31,3991174,943924,3047250,에스토니아,2009-10
2009-10-31,3858094,319791,3538303,에티오피아,2009-10
2009-10-31,3740785,45836,3694949,모잠비크,2009-10
2009-10-31,3467848,193580,3274268,토고,2009-10
2009-10-31,3395184,61780,3333404,콩고,2009-10
2009-10-31,3082802,391310,2691492,조지아,2009-10
2009-10-31,2955173,14726,2940447,투르크멘,2009-10
2009-10-31,2841023,618876,2222147,모리셔스,2009-10
2009-10-31,2828226,672052,2156174,트리니다드 토바고,2009-10
2009-10-31,2764555,292578,2471977,베닝,2009-10
2009-10-31,2728669,136018,2592651,쿠바,2009-10
2009-10-31,2648889,12486202,-9837313,뉴 칼레도니아,2009-10
2009-10-31,2560457,4696658,-2136201,타지크,2009-10
2009-10-31,2548689,565800,1982889,세네갈,2009-10
2009-10-31,2400539,291702,2108837,카메룬,2009-10
2009-10-31,2361041,774101,1586940,벨라루스,2009-10
2009-10-31,2329376,0,2329376,적도 기니,2009-10
2009-10-31,2306645,3194778,-888133,콩고민주공화국,2009-10
2009-10-31,2178263,47359,2130904,네팔,2009-10
2009-10-31,2089229,81713708,-79624479,브루나이,2009-10
2009-10-31,2057803,209153,1848650,팔레스타인 해방기구(구),2009-10
2009-10-31,2000221,20443,1979778,세르비아 와 몬테네그로,2009-10
2009-10-31,1822569,21,1822548,불령 리유니온 코모도 제도,2009-10
2009-10-31,1734550,254815,1479735,가이아나,2009-10
2009-10-31,1720627,199936,1520691,짐바브웨,2009-10
2009-10-31,1672335,114292,1558043,말라위,2009-10
2009-10-31,1577171,21468234,-19891063,볼리비아,2009-10
2009-10-31,1559710,105,1559605,부탄,2009-10
2009-10-31,1515546,881439,634107,아르메니아,2009-10
2009-10-31,1511264,65596796,-64085532,가봉,2009-10
2009-10-31,1428988,26896,1402092,아이티,2009-10
2009-10-31,1381540,0,1381540,에리트리아,2009-10
2009-10-31,1298212,38076,1260136,티모르,2009-10
2009-10-31,1129457,67615,1061842,세이쉘,2009-10
2009-10-31,1110119,0,1110119,바베이도스,2009-10
2009-10-31,1098952,12938,1086014,시에라 리온,2009-10
2009-10-31,1048368,119298,929070,네덜란드 열도,2009-10
2009-10-31,1017437,0,1017437,수리남,2009-10
2009-10-31,1012457,434881,577576,자마이카,2009-10
2009-10-31,1000724,16107,984617,도미니카,2009-10
2009-10-31,974094,0,974094,버뮤다,2009-10
2009-10-31,956419,12,956407,르완다,2009-10
2009-10-31,820864,488731,332133,피지,2009-10
2009-10-31,665183,34739,630444,벨리제,2009-10
2009-10-31,645722,679597,-33875,모리타니,2009-10
2009-10-31,623716,17004,606712,알바니아,2009-10
2009-10-31,573330,507,572823,과델로프,2009-10
2009-10-31,546969,0,546969,부르키나 파소,2009-10
2009-10-31,544300,207069,337231,마세도니아,2009-10
2009-10-31,542388,0,542388,아루바,2009-10
2009-10-31,524938,2940946,-2416008,나미비아,2009-10
2009-10-31,524799,419206,105593,우간다,2009-10
2009-10-31,481797,1528942,-1047145,스와질랜드,2009-10
2009-10-31,473439,19294259,-18820820,잠비아,2009-10
2009-10-31,456370,0,456370,마티니크,2009-10
2009-10-31,432966,83251,349715,보스니아-헤르체고비나,2009-10
2009-10-31,422967,539247,-116280,바누아투,2009-10
2009-10-31,413703,73458,340245,보츠와나,2009-10
2009-10-31,411698,48187,363511,바하마,2009-10
2009-10-31,408492,58003,350489,북마리아나 군도,2009-10
2009-10-31,362957,0,362957,마이크로네시아,2009-10
2009-10-31,348441,752117,-403676,아이슬란드,2009-10
2009-10-31,318384,434876,-116492,리히텐슈타인,2009-10
2009-10-31,307278,6683,300595,사모아,2009-10
2009-10-31,301633,3083335,-2781702,룩셈부르그,2009-10
2009-10-31,294577,31,294546,감비아,2009-10
2009-10-31,256342,713064,-456722,몰도바,2009-10
2009-10-31,256011,0,256011,아메리칸 사모아,2009-10
2009-10-31,209875,0,209875,세인트 키츠 네비스,2009-10
2009-10-31,197297,1,197296,불령 가이아나,2009-10
2009-10-31,167891,845287,-677396,솔로몬 군도,2009-10
2009-10-31,152559,6,152553,그레나다,2009-10
2009-10-31,139968,34256,105712,안도라,2009-10
2009-10-31,136661,71424,65237,기네비소,2009-10
2009-10-31,118651,26662,91989,팔라우,2009-10
2009-10-31,112324,0,112324,세인트 루시아,2009-10
2009-10-31,99467,0,99467,부룬디,2009-10
2009-10-31,75982,0,75982,카보 베르데,2009-10
2009-10-31,63142,0,63142,영령 버진군도,2009-10
2009-10-31,55550,69286,-13736,중앙아프리카공화국,2009-10
2009-10-31,45337,13303,32034,안티가 바부다,2009-10
2009-10-31,42928,270,42658,몰디브,2009-10
2009-10-31,37046,0,37046,니제르,2009-10
2009-10-31,35362,103,35259,말리,2009-10
2009-10-31,34356,0,34356,산마리노,2009-10
2009-10-31,25708,0,25708,쿡 아일랜드,2009-10
2009-10-31,11842,8060,3782,통가,2009-10
2009-10-31,9097,0,9097,앙귈라,2009-10
2009-10-31,7013,0,7013,지브랄타,2009-10
2009-10-31,5605,7710,-2105,미령 버진군도,2009-10
2009-10-31,3753,669612,-665859,모나코,2009-10
2009-10-31,3055,0,3055,파로에 군도,2009-10
2009-10-31,1757,858,899,세인트 헬레나,2009-10
2009-10-31,964,0,964,소말리아,2009-10
2009-10-31,436,3600,-3164,챠드,2009-10
2009-10-31,0,2224,-2224,안타티카,2009-10
2009-10-31,0,24627,-24627,토켈라우,2009-10
2009-10-31,0,1277,-1277,나우루,2009-10
2009-10-31,0,515,-515,투발루,2009-10
2009-10-31,0,1823,-1823,몬트세라트,2009-10
2009-10-31,0,6625,-6625,상토메 프린스페,2009-10
2009-10-31,0,136911,-136911,그린랜드,2009-10
2009-10-31,0,98,-98,교황청,2009-10
2009-11-30,8162746466,5006994025,3155752441,중국,2009-11
2009-11-30,3485643547,2714512402,771131145,미국,2009-11
2009-11-30,2101004828,4390744666,-2289739838,일본,2009-11
2009-11-30,1986934711,130765772,1856168939,홍콩,2009-11
2009-11-30,1278806661,523680796,755125865,싱가포르,2009-11
2009-11-30,1018613372,933806503,84806869,대만,2009-11
2009-11-30,789196861,413161553,376035308,인도,2009-11
2009-11-30,671538123,212705817,458832306,베트남,2009-11
2009-11-30,630355394,74388313,555967081,멕시코,2009-11
2009-11-30,618125889,1149259302,-531133413,독일,2009-11
2009-11-30,584827169,4046,584823123,마샬군도,2009-11
2009-11-30,566662703,305618081,261044622,브라질,2009-11
2009-11-30,554336490,279139716,275196774,네덜란드,2009-11
2009-11-30,552725128,916086376,-363361248,인도네시아,2009-11
2009-11-30,495548439,262343338,233205101,태국,2009-11
2009-11-30,465845633,236131094,229714539,필리핀,2009-11
2009-11-30,460598440,1218413852,-757815412,호주,2009-11
2009-11-30,457546263,215910184,241636079,파나마,2009-11
2009-11-30,443187422,711513373,-268325951,말레이시아,2009-11
2009-11-30,431584667,6599994,424984673,몰타,2009-11
2009-11-30,379706035,1473784473,-1094078438,사우디아라비아,2009-11
2009-11-30,371965954,595023760,-223057806,러시아 연방,2009-11
2009-11-30,370651775,20963435,349688340,폴란드,2009-11
2009-11-30,366258772,680906191,-314647419,이란,2009-11
2009-11-30,352126307,301707827,50418480,영국,2009-11
2009-11-30,341848056,31836,341816220,라이베리아,2009-11
2009-11-30,335386556,262072947,73313609,캐나다,2009-11
2009-11-30,322645275,828772444,-506127169,아랍에미리트 연합,2009-11
2009-11-30,317293119,281484556,35808563,이탈리아,2009-11
2009-11-30,301977199,236,301976963,영령 캐이맨 군도,2009-11
2009-11-30,270146533,267605678,2540855,칠레,2009-11
2009-11-30,270141742,364028865,-93887123,프랑스,2009-11
2009-11-30,254754456,43451560,211302896,튀르키예,2009-11
2009-11-30,253678828,6576649,247102179,슬로바키아,2009-11
2009-11-30,206794516,64006428,142788088,스페인,2009-11
2009-11-30,200104915,26964687,173140228,헝가리,2009-11
2009-11-30,184483548,76442534,108041014,벨기에,2009-11
2009-11-30,169435813,274032062,-104596249,노르웨이,2009-11
2009-11-30,156013448,633758,155379690,사이프러스,2009-11
2009-11-30,153943387,2099024,151844363,이집트,2009-11
2009-11-30,126168976,471938,125697038,리비아,2009-11
2009-11-30,120197442,80963766,39233676,뉴질랜드,2009-11
2009-11-30,103113261,80563563,22549698,페루,2009-11
2009-11-30,93041639,2607785,90433854,요르단,2009-11
2009-11-30,91172582,1295408,89877174,우즈베키스탄,2009-11
2009-11-30,89562925,8188900,81374025,방글라데시,2009-11
2009-11-30,88828013,159742198,-70914185,남아프리카공화국,2009-11
2009-11-30,88727117,86494110,2233007,오스트리아,2009-11
2009-11-30,88159117,209860,87949257,알제리,2009-11
2009-11-30,78608079,846602761,-767994682,쿠웨이트,2009-11
2009-11-30,76982426,43447923,33534503,시리아,2009-11
2009-11-30,76097090,32587707,43509383,체코공화국,2009-11
2009-11-30,66429172,11066845,55362327,콜롬비아,2009-11
2009-11-30,63457319,57904242,5553077,이스라엘,2009-11
2009-11-30,62385760,259420,62126340,나이지리아,2009-11
2009-11-30,58779116,26365688,32413428,파키스탄,2009-11
2009-11-30,55452259,34424,55417835,바하마,2009-11
2009-11-30,54868283,89333010,-34464727,아르헨티나,2009-11
2009-11-30,52953279,701558,52251721,에쿠아도르,2009-11
2009-11-30,51127322,852301453,-801174131,카타르,2009-11
2009-11-30,47101462,4956319,42145143,슬로베니아,2009-11
2009-11-30,46141228,329220644,-283079416,오만,2009-11
2009-11-30,45363959,1028761,44335198,과테말라,2009-11
2009-11-30,45236890,148607540,-103370650,스웨덴,2009-11
2009-11-30,42636421,420453441,-377817020,이라크,2009-11
2009-11-30,38828751,38959454,-130703,바레인,2009-11
2009-11-30,37440487,59644909,-22204422,핀란드,2009-11
2009-11-30,35348646,5090082,30258564,포루투갈,2009-11
2009-11-30,34133124,80854065,-46720941,우크라이나,2009-11
2009-11-30,33202094,2989266,30212828,베네주엘라,2009-11
2009-11-30,31702422,7751637,23950785,그리스,2009-11
2009-11-30,29450424,11596121,17854303,카자흐스탄,2009-11
2009-11-30,26467028,2193813,24273215,수단,2009-11
2009-11-30,24880206,4675468,20204738,모로코,2009-11
2009-11-30,24481113,15292469,9188644,루마니아,2009-11
2009-11-30,22920063,5215,22914848,괌,2009-11
2009-11-30,22519531,12044417,10475114,미얀마,2009-11
2009-11-30,22330109,1106481,21223628,캄보디아,2009-11
2009-11-30,20696900,2637955,18058945,레바논,2009-11
2009-11-30,18105178,50581861,-32476683,아일랜드,2009-11
2009-11-30,17632769,10031572,7601197,푸에르토리코,2009-11
2009-11-30,17624087,4116716,13507371,스리랑카,2009-11
2009-11-30,17502871,0,17502871,앙골라,2009-11
2009-11-30,17338625,43023,17295602,니카라과,2009-11
2009-11-30,16678875,504708,16174167,케냐,2009-11
2009-11-30,16200563,601490,15599073,기니,2009-11
2009-11-30,15667015,231973905,-216306890,스위스,2009-11
2009-11-30,14643068,216407,14426661,에티오피아,2009-11
2009-11-30,13985381,1091944,12893437,튀니지,2009-11
2009-11-30,13586817,3122226,10464591,몽골,2009-11
2009-11-30,13494614,3329406,10165208,가나,2009-11
2009-11-30,12830340,47797616,-34967276,덴마크,2009-11
2009-11-30,10555441,11776274,-1220833,코스타리카,2009-11
2009-11-30,10413321,2224650,8188671,온두라스,2009-11
2009-11-30,9451335,21109272,-11657937,예맨,2009-11
2009-11-30,8021608,5032126,2989482,도미니카 공화국,2009-11
2009-11-30,7978728,1681,7977047,코트디봐르,2009-11
2009-11-30,7872185,3330,7868855,아제르바이잔,2009-11
2009-11-30,6919745,469245,6450500,키르기스스탄,2009-11
2009-11-30,6498295,3879458,2618837,불가리아,2009-11
2009-11-30,6025047,830441,5194606,리투아니아,2009-11
2009-11-30,5560420,2472743,3087677,탄자니아,2009-11
2009-11-30,5196333,1267025,3929308,라트비아,2009-11
2009-11-30,4877360,1249145,3628215,에스토니아,2009-11
2009-11-30,4822766,545468,4277298,파라과이,2009-11
2009-11-30,4687093,3536,4683557,아프카니스탄,2009-11
2009-11-30,4620137,1668140,2951997,크로아티아,2009-11
2009-11-30,4321420,67291689,-62970269,콩고,2009-11
2009-11-30,4166174,505391,3660783,라오스,2009-11
2009-11-30,4088608,2788493,1300115,우루과이,2009-11
2009-11-30,4075421,601804,3473617,조지아,2009-11
2009-11-30,3877584,1008767,2868817,카메룬,2009-11
2009-11-30,3765004,146,3764858,레소토,2009-11
2009-11-30,3665414,0,3665414,투르크멘,2009-11
2009-11-30,3591944,64361,3527583,네팔,2009-11
2009-11-30,3480987,757153,2723834,엘살바도르,2009-11
2009-11-30,3474456,23505115,-20030659,뉴 칼레도니아,2009-11
2009-11-30,3350778,515986,2834792,세네갈,2009-11
2009-11-30,3290661,11271446,-7980785,타지크,2009-11
2009-11-30,3250117,92585,3157532,마다카스카르,2009-11
2009-11-30,3004223,96986931,-93982708,브루나이,2009-11
2009-11-30,2987806,476510,2511296,마카오,2009-11
2009-11-30,2878863,18997,2859866,베닝,2009-11
2009-11-30,2827107,34788910,-31961803,적도 기니,2009-11
2009-11-30,2779610,139384,2640226,트리니다드 토바고,2009-11
2009-11-30,2759566,124825,2634741,모리셔스,2009-11
2009-11-30,2703981,4552830,-1848849,기타국,2009-11
2009-11-30,2636645,0,2636645,에리트리아,2009-11
2009-11-30,2595885,1035931,1559954,아르메니아,2009-11
2009-11-30,2406359,3461771,-1055412,콩고민주공화국,2009-11
2009-11-30,2395276,476076,1919200,모잠비크,2009-11
2009-11-30,2345184,513170,1832014,벨라루스,2009-11
2009-11-30,2091891,380665,1711226,토고,2009-11
2009-11-30,2086547,32,2086515,불령 리유니온 코모도 제도,2009-11
2009-11-30,2056325,491252,1565073,피지,2009-11
2009-11-30,2031921,0,2031921,부르키나 파소,2009-11
2009-11-30,1758304,80236,1678068,쿠바,2009-11
2009-11-30,1683145,142215,1540930,네덜란드 열도,2009-11
2009-11-30,1667608,3743,1663865,불령 폴리네시아,2009-11
2009-11-30,1650228,144995,1505233,아이티,2009-11
2009-11-30,1639970,138988,1500982,자마이카,2009-11
2009-11-30,1576100,0,1576100,챠드,2009-11
2009-11-30,1549434,0,1549434,지부티,2009-11
2009-11-30,1509550,13505,1496045,말라위,2009-11
2009-11-30,1451872,12149,1439723,알바니아,2009-11
2009-11-30,1449378,103520,1345858,짐바브웨,2009-11
2009-11-30,1403068,0,1403068,아메리칸 사모아,2009-11
2009-11-30,1401115,0,1401115,버뮤다,2009-11
2009-11-30,1256828,369136,887692,수리남,2009-11
2009-11-30,1176054,19242,1156812,세르비아,2009-11
2009-11-30,1166704,0,1166704,마티니크,2009-11
2009-11-30,1127241,0,1127241,과델로프,2009-11
2009-11-30,1114339,3981,1110358,바베이도스,2009-11
2009-11-30,1083706,3690959,-2607253,볼리비아,2009-11
2009-11-30,1057547,2090732,-1033185,파푸아 뉴기니,2009-11
2009-11-30,1024596,922171,102425,모리타니,2009-11
2009-11-30,874060,9395474,-8521414,가봉,2009-11
2009-11-30,871235,578,870657,르완다,2009-11
2009-11-30,862412,105,862307,마이크로네시아,2009-11
2009-11-30,672715,101722,570993,아루바,2009-11
2009-11-30,661754,196080,465674,벨리제,2009-11
2009-11-30,657082,256862,400220,마세도니아,2009-11
2009-11-30,601186,31777043,-31175857,잠비아,2009-11
2009-11-30,579567,1005655,-426088,팔레스타인 해방기구(구),2009-11
2009-11-30,578767,74723,504044,보츠와나,2009-11
2009-11-30,564945,196207,368738,도미니카,2009-11
2009-11-30,521419,376,521043,북마리아나 군도,2009-11
2009-11-30,517562,2248593,-1731031,룩셈부르그,2009-11
2009-11-30,495525,1447871,-952346,스와질랜드,2009-11
2009-11-30,481811,57408,424403,가이아나,2009-11
2009-11-30,454159,436847,17312,우간다,2009-11
2009-11-30,437504,81334,356170,사모아,2009-11
2009-11-30,400976,157314,243662,바누아투,2009-11
2009-11-30,375109,413334,-38225,세이쉘,2009-11
2009-11-30,287067,637689,-350622,아이슬란드,2009-11
2009-11-30,269739,238,269501,불령 가이아나,2009-11
2009-11-30,255756,32,255724,감비아,2009-11
2009-11-30,241356,33,241323,부탄,2009-11
2009-11-30,228458,84267,144191,보스니아-헤르체고비나,2009-11
2009-11-30,212924,346144,-133220,리히텐슈타인,2009-11
2009-11-30,191153,0,191153,몬테네그로,2009-11
2009-11-30,188784,1308637,-1119853,솔로몬 군도,2009-11
2009-11-30,161400,860,160540,그레나다,2009-11
2009-11-30,140763,24248,116515,시에라 리온,2009-11
2009-11-30,134254,360,133894,카보 베르데,2009-11
2009-11-30,133070,8421,124649,나미비아,2009-11
2009-11-30,122761,17315,105446,기네비소,2009-11
2009-11-30,90095,1445,88650,지브랄타,2009-11
2009-11-30,80853,244,80609,몰디브,2009-11
2009-11-30,71812,538282,-466470,몰도바,2009-11
2009-11-30,66058,0,66058,세인트 빈센트 그레나딘,2009-11
2009-11-30,59192,161239,-102047,안티가 바부다,2009-11
2009-11-30,55699,0,55699,세인트 루시아,2009-11
2009-11-30,45120,0,45120,몬트세라트,2009-11
2009-11-30,44713,0,44713,노폴크 아일랜드,2009-11
2009-11-30,41868,0,41868,영령 버진군도,2009-11
2009-11-30,40980,0,40980,소말리아,2009-11
2009-11-30,36872,28357,8515,팔라우,2009-11
2009-11-30,27997,0,27997,쿡 아일랜드,2009-11
2009-11-30,23973,749237,-725264,모나코,2009-11
2009-11-30,20314,0,20314,말리,2009-11
2009-11-30,14671,2196,12475,니제르,2009-11
2009-11-30,3562,62857,-59295,통가,2009-11
2009-11-30,3355,102,3253,세르비아 와 몬테네그로,2009-11
2009-11-30,2842,723,2119,나우루,2009-11
2009-11-30,1734,14171176,-14169442,티모르,2009-11
2009-11-30,847,180336,-179489,토켈라우,2009-11
2009-11-30,325,155,170,세인트 키츠 네비스,2009-11
2009-11-30,280,379,-99,앙귈라,2009-11
2009-11-30,0,7242,-7242,교황청,2009-11
2009-11-30,0,190483,-190483,그린랜드,2009-11
2009-11-30,0,62813,-62813,중앙아프리카공화국,2009-11
2009-11-30,0,659,-659,코스 군도,2009-11
2009-11-30,0,107606,-107606,안도라,2009-11
2009-11-30,0,833,-833,세인트 헬레나,2009-11
2009-12-31,9103778567,5308458736,3795319831,중국,2009-12
2009-12-31,3357742135,2907218092,450524043,미국,2009-12
2009-12-31,2066034758,5156185426,-3090150668,일본,2009-12
2009-12-31,1928671055,128763409,1799907646,홍콩,2009-12
2009-12-31,1453396848,1318308841,135088007,독일,2009-12
2009-12-31,1210585186,706389182,504196004,싱가포르,2009-12
2009-12-31,1143841979,874385849,269456130,대만,2009-12
2009-12-31,919161738,650,919161088,마샬군도,2009-12
2009-12-31,859003231,536310555,322692676,인도,2009-12
2009-12-31,796994221,475108,796519113,라이베리아,2009-12
2009-12-31,789944748,190217875,599726873,베트남,2009-12
2009-12-31,602704403,1066487407,-463783004,인도네시아,2009-12
2009-12-31,586770802,265120142,321650660,브라질,2009-12
2009-12-31,578973786,1370721968,-791748182,호주,2009-12
2009-12-31,555391245,107246675,448144570,멕시코,2009-12
2009-12-31,517777262,611083581,-93306319,이란,2009-12
2009-12-31,498310750,642423853,-144113103,말레이시아,2009-12
2009-12-31,484207976,290087607,194120369,태국,2009-12
2009-12-31,432076925,927081912,-495004987,러시아 연방,2009-12
2009-12-31,417478756,239264843,178213913,필리핀,2009-12
2009-12-31,383035508,25945238,357090270,폴란드,2009-12
2009-12-31,376488917,727560381,-351071464,아랍에미리트 연합,2009-12
2009-12-31,354930485,2189330214,-1834399729,사우디아라비아,2009-12
2009-12-31,345264786,303265995,41998791,영국,2009-12
2009-12-31,334060133,6916201,327143932,슬로바키아,2009-12
2009-12-31,333467018,171709081,161757937,네덜란드,2009-12
2009-12-31,327247967,329382836,-2134869,이탈리아,2009-12
2009-12-31,304391955,287728460,16663495,캐나다,2009-12
2009-12-31,247188662,268359440,-21170778,칠레,2009-12
2009-12-31,241063142,48290950,192772192,튀르키예,2009-12
2009-12-31,216788584,2190761,214597823,그리스,2009-12
2009-12-31,212554792,48941020,163613772,파나마,2009-12
2009-12-31,199890848,80675914,119214934,스페인,2009-12
2009-12-31,190971828,29817123,161154705,헝가리,2009-12
2009-12-31,174796510,386819547,-212023037,프랑스,2009-12
2009-12-31,165990380,39558486,126431894,이집트,2009-12
2009-12-31,132782535,210893,132571642,리비아,2009-12
2009-12-31,126647623,136332557,-9684934,남아프리카공화국,2009-12
2009-12-31,123330389,73408877,49921512,벨기에,2009-12
2009-12-31,111402726,71160153,40242573,알제리,2009-12
2009-12-31,110278273,2997737,107280536,요르단,2009-12
2009-12-31,108085041,224896691,-116811650,노르웨이,2009-12
2009-12-31,108045057,90416506,17628551,뉴질랜드,2009-12
2009-12-31,101149129,940340022,-839190893,카타르,2009-12
2009-12-31,96286372,56280118,40006254,페루,2009-12
2009-12-31,94187600,54945637,39241963,파키스탄,2009-12
2009-12-31,92076774,10303982,81772792,우즈베키스탄,2009-12
2009-12-31,91900963,518392579,-426491616,이라크,2009-12
2009-12-31,91441408,24977982,66463426,시리아,2009-12
2009-12-31,89999404,19627807,70371597,방글라데시,2009-12
2009-12-31,81305687,14192080,67113607,콜롬비아,2009-12
2009-12-31,73582877,50474609,23108268,체코공화국,2009-12
2009-12-31,71146158,1579043,69567115,사이프러스,2009-12
2009-12-31,70573592,59611629,10961963,이스라엘,2009-12
2009-12-31,69579663,536409921,-466830258,오만,2009-12
2009-12-31,61540210,821868975,-760328765,쿠웨이트,2009-12
2009-12-31,61233061,115278203,-54045142,오스트리아,2009-12
2009-12-31,57740323,83141183,-25400860,아르헨티나,2009-12
2009-12-31,52054924,8050938,44003986,몰타,2009-12
2009-12-31,50796697,51848052,-1051355,나이지리아,2009-12
2009-12-31,48098017,96050645,-47952628,우크라이나,2009-12
2009-12-31,47515122,123961542,-76446420,스웨덴,2009-12
2009-12-31,45979863,5946608,40033255,미얀마,2009-12
2009-12-31,45327313,1783755,43543558,과테말라,2009-12
2009-12-31,43120564,7838460,35282104,베네주엘라,2009-12
2009-12-31,39226395,50344615,-11118220,핀란드,2009-12
2009-12-31,39062667,1306343,37756324,에쿠아도르,2009-12
2009-12-31,36264566,37892274,-1627708,앙골라,2009-12
2009-12-31,35058948,17712568,17346380,루마니아,2009-12
2009-12-31,34423402,53288684,-18865282,덴마크,2009-12
2009-12-31,34024281,51513286,-17489005,바레인,2009-12
2009-12-31,32721650,2619171,30102479,캄보디아,2009-12
2009-12-31,32247340,690283,31557057,수단,2009-12
2009-12-31,30943539,5949588,24993951,포루투갈,2009-12
2009-12-31,28830930,3684576,25146354,모로코,2009-12
2009-12-31,28487133,16206411,12280722,카자흐스탄,2009-12
2009-12-31,26844812,20,26844792,불령 폴리네시아,2009-12
2009-12-31,26247068,6631613,19615455,슬로베니아,2009-12
2009-12-31,22834533,302,22834231,괌,2009-12
2009-12-31,21746728,51222295,-29475567,아일랜드,2009-12
2009-12-31,19909938,209409,19700529,니카라과,2009-12
2009-12-31,19821338,2970412,16850926,레바논,2009-12
2009-12-31,17978279,4387444,13590835,스리랑카,2009-12
2009-12-31,17616562,185961553,-168344991,스위스,2009-12
2009-12-31,17106151,2987,17103164,아제르바이잔,2009-12
2009-12-31,15297671,2438569,12859102,몽골,2009-12
2009-12-31,15248786,10433917,4814869,코스타리카,2009-12
2009-12-31,14981093,633823,14347270,케냐,2009-12
2009-12-31,14806491,2614306,12192185,가나,2009-12
2009-12-31,14768159,2060306,12707853,튀니지,2009-12
2009-12-31,13293822,40672,13253150,아프카니스탄,2009-12
2009-12-31,12487434,8449538,4037896,기타국,2009-12
2009-12-31,12200063,329006,11871057,온두라스,2009-12
2009-12-31,11042423,10642089,400334,푸에르토리코,2009-12
2009-12-31,9992700,3593678,6399022,도미니카 공화국,2009-12
2009-12-31,9680830,27651221,-17970391,예맨,2009-12
2009-12-31,8451534,585261,7866273,파라과이,2009-12
2009-12-31,8203043,1203473,6999570,리투아니아,2009-12
2009-12-31,7687542,556769,7130773,기니,2009-12
2009-12-31,7662834,145196,7517638,키르기스스탄,2009-12
2009-12-31,7618528,1064434,6554094,세네갈,2009-12
2009-12-31,7518510,190051,7328459,마다카스카르,2009-12
2009-12-31,7398394,1045523,6352871,라트비아,2009-12
2009-12-31,7358980,242276,7116704,코트디봐르,2009-12
2009-12-31,7057450,3891187,3166263,불가리아,2009-12
2009-12-31,6912307,3644165,3268142,우루과이,2009-12
2009-12-31,6577590,190042,6387548,라오스,2009-12
2009-12-31,6540225,105096,6435129,쿠바,2009-12
2009-12-31,6422926,55197258,-48774332,트리니다드 토바고,2009-12
2009-12-31,6407639,68330,6339309,보스니아-헤르체고비나,2009-12
2009-12-31,6357089,1289253,5067836,에스토니아,2009-12
2009-12-31,6005771,4427775,1577996,탄자니아,2009-12
2009-12-31,5320956,19049,5301907,레소토,2009-12
2009-12-31,5313274,502639,4810635,에티오피아,2009-12
2009-12-31,5043406,536918,4506488,마카오,2009-12
2009-12-31,5001663,823617,4178046,크로아티아,2009-12
2009-12-31,4987775,49237281,-44249506,브루나이,2009-12
2009-12-31,4680203,13800895,-9120692,뉴 칼레도니아,2009-12
2009-12-31,4154265,112716,4041549,네팔,2009-12
2009-12-31,3869859,867366,3002493,모리셔스,2009-12
2009-12-31,3624683,629102,2995581,엘살바도르,2009-12
2009-12-31,3295560,33528541,-30232981,파푸아 뉴기니,2009-12
2009-12-31,3009896,11,3009885,지부티,2009-12
2009-12-31,2990254,225277,2764977,모잠비크,2009-12
2009-12-31,2965758,6492443,-3526685,타지크,2009-12
2009-12-31,2964240,17257957,-14293717,카메룬,2009-12
2009-12-31,2935924,130804,2805120,베닝,2009-12
2009-12-31,2876916,252940,2623976,짐바브웨,2009-12
2009-12-31,2528574,174839,2353735,피지,2009-12
2009-12-31,2367688,62360093,-59992405,콩고,2009-12
2009-12-31,2263542,47447,2216095,투르크멘,2009-12
2009-12-31,2171074,1136884,1034190,조지아,2009-12
2009-12-31,1990983,47625658,-45634675,잠비아,2009-12
2009-12-31,1907688,537433,1370255,벨라루스,2009-12
2009-12-31,1884773,0,1884773,아메리칸 사모아,2009-12
2009-12-31,1880536,599660,1280876,팔레스타인 해방기구(구),2009-12
2009-12-31,1840973,34293,1806680,아이티,2009-12
2009-12-31,1788791,143062,1645729,자마이카,2009-12
2009-12-31,1693185,3120,1690065,네덜란드 열도,2009-12
2009-12-31,1603330,1928556,-325226,아르메니아,2009-12
2009-12-31,1494049,51,1493998,불령 리유니온 코모도 제도,2009-12
2009-12-31,1437535,0,1437535,아루바,2009-12
2009-12-31,1350655,7912,1342743,에리트리아,2009-12
2009-12-31,1342838,311494,1031344,볼리비아,2009-12
2009-12-31,1339214,117202,1222012,토고,2009-12
2009-12-31,1308043,149181220,-147873177,적도 기니,2009-12
2009-12-31,1303591,57512,1246079,세르비아,2009-12
2009-12-31,1277321,67267,1210054,바베이도스,2009-12
2009-12-31,1231034,0,1231034,마티니크,2009-12
2009-12-31,1224948,75828,1149120,시에라 리온,2009-12
2009-12-31,1208727,0,1208727,말라위,2009-12
2009-12-31,1044115,0,1044115,부탄,2009-12
2009-12-31,1012957,0,1012957,마이크로네시아,2009-12
2009-12-31,1008454,0,1008454,북마리아나 군도,2009-12
2009-12-31,959596,25227,934369,안도라,2009-12
2009-12-31,843000,217616,625384,우간다,2009-12
2009-12-31,829326,0,829326,과델로프,2009-12
2009-12-31,816976,4090,812886,알바니아,2009-12
2009-12-31,767356,0,767356,수리남,2009-12
2009-12-31,766798,912835,-146037,마세도니아,2009-12
2009-12-31,726652,80152,646500,가이아나,2009-12
2009-12-31,643260,1988007,-1344747,콩고민주공화국,2009-12
2009-12-31,593047,71223302,-70630255,가봉,2009-12
2009-12-31,561073,11,561062,벨리제,2009-12
2009-12-31,554010,25050,528960,르완다,2009-12
2009-12-31,542574,368265,174309,모리타니,2009-12
2009-12-31,539561,17708,521853,바하마,2009-12
2009-12-31,539379,8380807,-7841428,룩셈부르그,2009-12
2009-12-31,504471,1453650,-949179,솔로몬 군도,2009-12
2009-12-31,504392,36588,467804,세이쉘,2009-12
2009-12-31,461778,272266,189512,아이슬란드,2009-12
2009-12-31,461700,120586,341114,도미니카,2009-12
2009-12-31,451281,202751,248530,보츠와나,2009-12
2009-12-31,445600,0,445600,세인트 루시아,2009-12
2009-12-31,381725,13,381712,부르키나 파소,2009-12
2009-12-31,363543,2489766,-2126223,스와질랜드,2009-12
2009-12-31,357523,0,357523,몬테네그로,2009-12
2009-12-31,294749,51074,243675,나미비아,2009-12
2009-12-31,286299,0,286299,불령 가이아나,2009-12
2009-12-31,261055,490,260565,세인트 빈센트 그레나딘,2009-12
2009-12-31,238920,169,238751,몰디브,2009-12
2009-12-31,237298,143479,93819,바누아투,2009-12
2009-12-31,232845,423,232422,버뮤다,2009-12
2009-12-31,229489,1153614,-924125,안티가 바부다,2009-12
2009-12-31,189218,0,189218,앙귈라,2009-12
2009-12-31,174970,0,174970,노폴크 아일랜드,2009-12
2009-12-31,169544,0,169544,세인트 키츠 네비스,2009-12
2009-12-31,169019,1126670,-957651,리히텐슈타인,2009-12
2009-12-31,149779,1623,148156,니제르,2009-12
2009-12-31,136373,41,136332,영령 캐이맨 군도,2009-12
2009-12-31,132681,0,132681,카보 베르데,2009-12
2009-12-31,128161,2055,126106,사모아,2009-12
2009-12-31,106300,10590,95710,팔라우,2009-12
2009-12-31,103303,0,103303,그레나다,2009-12
2009-12-31,93314,62579,30735,기네비소,2009-12
2009-12-31,67894,0,67894,영령 버진군도,2009-12
2009-12-31,65370,0,65370,소말리아,2009-12
2009-12-31,64647,0,64647,투르크 & 카이코스 군도,2009-12
2009-12-31,55619,60379,-4760,몰도바,2009-12
2009-12-31,50697,592,50105,지브랄타,2009-12
2009-12-31,44013,59,43954,감비아,2009-12
2009-12-31,39460,2117,37343,부룬디,2009-12
2009-12-31,38700,0,38700,메요트,2009-12
2009-12-31,35951,4900,31051,산마리노,2009-12
2009-12-31,25708,0,25708,쿡 아일랜드,2009-12
2009-12-31,20767,501322,-480555,모나코,2009-12
2009-12-31,14504,0,14504,세인트 헬레나,2009-12
2009-12-31,10838,165412,-154574,통가,2009-12
2009-12-31,10010,60420,-50410,티모르,2009-12
2009-12-31,8975,0,8975,챠드,2009-12
2009-12-31,5130,0,5130,파로에 군도,2009-12
2009-12-31,4830,26625,-21795,중앙아프리카공화국,2009-12
2009-12-31,4383,0,4383,포클랜드 군도,2009-12
2009-12-31,3549,83996,-80447,그린랜드,2009-12
2009-12-31,1944,1292,652,상토메 프린스페,2009-12
2009-12-31,669,0,669,왈라스 & 퓨투나 군도,2009-12
2009-12-31,278,0,278,키리바티,2009-12
2009-12-31,63,4241,-4178,말리,2009-12
2009-12-31,0,84,-84,몬트세라트,2009-12
2009-12-31,0,81904,-81904,토켈라우,2009-12
2009-12-31,0,314,-314,마이너 아우틀링 합중국 군도,2009-12
2009-12-31,0,9924894,-9924894,교황청,2009-12
2009-12-31,0,321,-321,안타티카,2009-12
2009-12-31,0,1255,-1255,나우루,2009-12
2009-12-31,0,118,-118,크리스마스 아일랜드,2009-12
2009-12-31,0,231,-231,미령 버진군도,2009-12
2010-01-31,8845994500,4957173820,3888820680,중국,2010-01
2010-01-31,3057539746,2714163225,343376521,미국,2010-01
2010-01-31,1876023581,4200280908,-2324257327,일본,2010-01
2010-01-31,1633591813,118263916,1515327897,홍콩,2010-01
2010-01-31,1015450165,752938079,262512086,싱가포르,2010-01
2010-01-31,1001963956,980644571,21319385,대만,2010-01
2010-01-31,738042158,607296476,130745682,인도,2010-01
2010-01-31,630172112,189490842,440681270,베트남,2010-01
2010-01-31,598138722,128541492,469597230,멕시코,2010-01
2010-01-31,563579468,315315833,248263635,태국,2010-01
2010-01-31,533238863,45209,533193654,라이베리아,2010-01
2010-01-31,505413819,1349182766,-843768947,호주,2010-01
2010-01-31,500606118,210337921,290268197,브라질,2010-01
2010-01-31,474323592,1213042309,-738718717,인도네시아,2010-01
2010-01-31,435634743,1059096746,-623462003,독일,2010-01
2010-01-31,417193342,239919123,177274219,필리핀,2010-01
2010-01-31,392513028,602462727,-209949699,러시아 연방,2010-01
2010-01-31,369042765,1154317199,-785274434,아랍에미리트 연합,2010-01
2010-01-31,366975498,667426761,-300451263,이란,2010-01
2010-01-31,364186691,875166071,-510979380,말레이시아,2010-01
2010-01-31,354845428,16840239,338005189,폴란드,2010-01
2010-01-31,339778035,130951930,208826105,네덜란드,2010-01
2010-01-31,296096338,344941216,-48844878,캐나다,2010-01
2010-01-31,277350562,270086726,7263836,영국,2010-01
2010-01-31,272581981,6616302,265965679,슬로바키아,2010-01
2010-01-31,261951835,2051455324,-1789503489,사우디아라비아,2010-01
2010-01-31,248737261,419209762,-170472501,칠레,2010-01
2010-01-31,231975709,32404053,199571656,덴마크,2010-01
2010-01-31,210335965,260265974,-49930009,이탈리아,2010-01
2010-01-31,202822550,46995831,155826719,튀르키예,2010-01
2010-01-31,183238961,314768708,-131529747,프랑스,2010-01
2010-01-31,171045350,22015583,149029767,헝가리,2010-01
2010-01-31,154129974,75515933,78614041,스페인,2010-01
2010-01-31,144568719,308516920,-163948201,노르웨이,2010-01
2010-01-31,135104014,17013462,118090552,사이프러스,2010-01
2010-01-31,131225231,142660291,-11435060,파나마,2010-01
2010-01-31,128476712,91231943,37244769,이집트,2010-01
2010-01-31,125777999,14465291,111312708,그리스,2010-01
2010-01-31,113712789,561339600,-447626811,이라크,2010-01
2010-01-31,105858973,2101343,103757630,우즈베키스탄,2010-01
2010-01-31,95417711,96129996,-712285,벨기에,2010-01
2010-01-31,88123376,214,88123162,마샬군도,2010-01
2010-01-31,84212731,12834568,71378163,콜롬비아,2010-01
2010-01-31,82971494,159483615,-76512121,남아프리카공화국,2010-01
2010-01-31,77381668,43114304,34267364,아일랜드,2010-01
2010-01-31,74830243,6244400,68585843,방글라데시,2010-01
2010-01-31,72957611,6883804,66073807,알제리,2010-01
2010-01-31,72883904,3249569,69634335,요르단,2010-01
2010-01-31,70686447,24423540,46262907,체코공화국,2010-01
2010-01-31,68851558,83901402,-15049844,뉴질랜드,2010-01
2010-01-31,68439305,58645753,9793552,아르헨티나,2010-01
2010-01-31,63138873,62984266,154607,오스트리아,2010-01
2010-01-31,60237877,51799048,8438829,이스라엘,2010-01
2010-01-31,56048184,208,56047976,지브랄타,2010-01
2010-01-31,55746181,98477042,-42730861,페루,2010-01
2010-01-31,55296963,1160945,54136018,시리아,2010-01
2010-01-31,53613540,27889,53585651,리비아,2010-01
2010-01-31,47106744,21060185,26046559,파키스탄,2010-01
2010-01-31,45705040,15404191,30300849,루마니아,2010-01
2010-01-31,45622641,549279,45073362,에쿠아도르,2010-01
2010-01-31,42935541,343015619,-300080078,오만,2010-01
2010-01-31,42047596,5833217,36214379,슬로베니아,2010-01
2010-01-31,41135726,114407399,-73271673,스웨덴,2010-01
2010-01-31,40327958,19468371,20859587,나이지리아,2010-01
2010-01-31,40249350,1056766,39192584,아이슬란드,2010-01
2010-01-31,36276925,954910314,-918633389,쿠웨이트,2010-01
2010-01-31,32763974,73919880,-41155906,우크라이나,2010-01
2010-01-31,29962356,22329674,7632682,베네주엘라,2010-01
2010-01-31,26891209,62794888,-35903679,핀란드,2010-01
2010-01-31,25563166,8887525,16675641,포루투갈,2010-01
2010-01-31,24944556,8863120,16081436,미얀마,2010-01
2010-01-31,24920511,910112410,-885191899,카타르,2010-01
2010-01-31,24208751,38447909,-14239158,바레인,2010-01
2010-01-31,23192552,182213,23010339,아이티,2010-01
2010-01-31,23175215,4329858,18845357,캄보디아,2010-01
2010-01-31,23156288,7153,23149135,불령 폴리네시아,2010-01
2010-01-31,22634588,3739,22630849,괌,2010-01
2010-01-31,21944271,134284731,-112340460,스위스,2010-01
2010-01-31,20998745,5307126,15691619,모로코,2010-01
2010-01-31,20466914,23419483,-2952569,과테말라,2010-01
2010-01-31,17621796,3469278,14152518,스리랑카,2010-01
2010-01-31,17447640,17167283,280357,푸에르토리코,2010-01
2010-01-31,17095656,6331773,10763883,카자흐스탄,2010-01
2010-01-31,14890959,638621,14252338,레바논,2010-01
2010-01-31,13779318,1769145,12010173,수단,2010-01
2010-01-31,13206188,2161004,11045184,튀니지,2010-01
2010-01-31,12939854,14228936,-1289082,코스타리카,2010-01
2010-01-31,12721375,629670,12091705,가나,2010-01
2010-01-31,12017885,648313,11369572,케냐,2010-01
2010-01-31,11691702,23085,11668617,니카라과,2010-01
2010-01-31,10419977,640531,9779446,에티오피아,2010-01
2010-01-31,10125116,9190939,934177,몰타,2010-01
2010-01-31,9829096,64,9829032,앙골라,2010-01
2010-01-31,8850569,13574849,-4724280,예맨,2010-01
2010-01-31,8562704,188165,8374539,파라과이,2010-01
2010-01-31,8464116,36992,8427124,쿠바,2010-01
2010-01-31,8314805,15116,8299689,아제르바이잔,2010-01
2010-01-31,8031538,1969460,6062078,몽골,2010-01
2010-01-31,7344881,74502,7270379,라오스,2010-01
2010-01-31,6867323,827491,6039832,라트비아,2010-01
2010-01-31,6776323,282977,6493346,키르기스스탄,2010-01
2010-01-31,6611832,508011,6103821,온두라스,2010-01
2010-01-31,6565997,4717325,1848672,도미니카 공화국,2010-01
2010-01-31,6108270,61717,6046553,마다카스카르,2010-01
2010-01-31,5801658,1678,5799980,아프카니스탄,2010-01
2010-01-31,5710569,4127980,1582589,우루과이,2010-01
2010-01-31,5434049,934148,4499901,리투아니아,2010-01
2010-01-31,5404192,3661959,1742233,탄자니아,2010-01
2010-01-31,5288973,124296362,-119007389,브루나이,2010-01
2010-01-31,5147732,6307280,-1159548,불가리아,2010-01
2010-01-31,4964839,0,4964839,레소토,2010-01
2010-01-31,4903597,690887,4212710,에스토니아,2010-01
2010-01-31,4883626,915542,3968084,조지아,2010-01
2010-01-31,4574061,864567,3709494,카메룬,2010-01
2010-01-31,4138807,42173289,-38034482,파푸아 뉴기니,2010-01
2010-01-31,4019853,91888,3927965,코트디봐르,2010-01
2010-01-31,3691597,568390,3123207,세네갈,2010-01
2010-01-31,3661998,475501,3186497,모리셔스,2010-01
2010-01-31,3387426,10562109,-7174683,뉴 칼레도니아,2010-01
2010-01-31,3272733,0,3272733,에리트리아,2010-01
2010-01-31,3004754,953074,2051680,엘살바도르,2010-01
2010-01-31,2963802,705863,2257939,크로아티아,2010-01
2010-01-31,2961127,5055468,-2094341,기타국,2010-01
2010-01-31,2732182,2990,2729192,토고,2010-01
2010-01-31,2614075,41351,2572724,투르크멘,2010-01
2010-01-31,2280174,1145627,1134547,벨라루스,2010-01
2010-01-31,2239319,0,2239319,부르키나 파소,2010-01
2010-01-31,2164431,7596590,-5432159,타지크,2010-01
2010-01-31,2152845,397996,1754849,베닝,2010-01
2010-01-31,2051440,54233143,-52181703,트리니다드 토바고,2010-01
2010-01-31,1963303,8551435,-6588132,볼리비아,2010-01
2010-01-31,1777746,180925,1596821,모잠비크,2010-01
2010-01-31,1768556,0,1768556,지부티,2010-01
2010-01-31,1768498,0,1768498,아루바,2010-01
2010-01-31,1743237,95500,1647737,짐바브웨,2010-01
2010-01-31,1717242,21,1717221,불령 리유니온 코모도 제도,2010-01
2010-01-31,1673788,43172,1630616,보츠와나,2010-01
2010-01-31,1636778,65529288,-63892510,콩고,2010-01
2010-01-31,1443056,194,1442862,버뮤다,2010-01
2010-01-31,1406495,435745,970750,마카오,2010-01
2010-01-31,1291128,11,1291117,아메리칸 사모아,2010-01
2010-01-31,1275815,798,1275017,네덜란드 열도,2010-01
2010-01-31,1262901,129309,1133592,피지,2010-01
2010-01-31,1258387,52034,1206353,네팔,2010-01
2010-01-31,1054310,12472,1041838,북마리아나 군도,2010-01
2010-01-31,1017125,28717,988408,자마이카,2010-01
2010-01-31,975713,71059,904654,수리남,2010-01
2010-01-31,925817,88444,837373,바하마,2010-01
2010-01-31,886110,35774290,-34888180,잠비아,2010-01
2010-01-31,815043,0,815043,몬트세라트,2010-01
2010-01-31,807296,1376,805920,알바니아,2010-01
2010-01-31,782200,72331,709869,팔레스타인 해방기구(구),2010-01
2010-01-31,779138,1134208,-355070,세르비아,2010-01
2010-01-31,767370,3750,763620,세이쉘,2010-01
2010-01-31,697637,0,697637,바베이도스,2010-01
2010-01-31,684081,76907,607174,가봉,2010-01
2010-01-31,681344,63136,618208,가이아나,2010-01
2010-01-31,674974,21983,652991,우간다,2010-01
2010-01-31,645756,776,644980,과델로프,2010-01
2010-01-31,616448,872290,-255842,기니,2010-01
2010-01-31,537859,6083587,-5545728,룩셈부르그,2010-01
2010-01-31,533068,280632,252436,마세도니아,2010-01
2010-01-31,475312,0,475312,콩고민주공화국,2010-01
2010-01-31,468622,959471,-490849,아르메니아,2010-01
2010-01-31,433239,340955,92284,리히텐슈타인,2010-01
2010-01-31,373884,0,373884,바누아투,2010-01
2010-01-31,373087,2019402,-1646315,스와질랜드,2010-01
2010-01-31,331936,153860,178076,벨리제,2010-01
2010-01-31,306084,0,306084,티모르,2010-01
2010-01-31,300042,747374,-447332,모리타니,2010-01
2010-01-31,299526,28363,271163,안도라,2010-01
2010-01-31,269192,0,269192,마티니크,2010-01
2010-01-31,267016,85120,181896,마이크로네시아,2010-01
2010-01-31,266463,691,265772,도미니카,2010-01
2010-01-31,240881,14164,226717,몰디브,2010-01
2010-01-31,235755,0,235755,기네비소,2010-01
2010-01-31,228604,0,228604,불령 가이아나,2010-01
2010-01-31,213386,0,213386,부탄,2010-01
2010-01-31,196954,92345,104609,사모아,2010-01
2010-01-31,175159,1167,173992,르완다,2010-01
2010-01-31,175026,312,174714,안티가 바부다,2010-01
2010-01-31,160648,0,160648,영령 버진군도,2010-01
2010-01-31,132976,1469114,-1336138,말라위,2010-01
2010-01-31,123193,121233384,-121110191,적도 기니,2010-01
2010-01-31,122058,44618,77440,몰도바,2010-01
2010-01-31,118273,680942,-562669,솔로몬 군도,2010-01
2010-01-31,104508,0,104508,팔라우,2010-01
2010-01-31,99785,0,99785,영령 캐이맨 군도,2010-01
2010-01-31,88726,140389,-51663,시에라 리온,2010-01
2010-01-31,86688,0,86688,그레나다,2010-01
2010-01-31,83296,0,83296,노폴크 아일랜드,2010-01
2010-01-31,76672,126216,-49544,카보 베르데,2010-01
2010-01-31,74490,0,74490,니제르,2010-01
2010-01-31,70827,0,70827,세인트 키츠 네비스,2010-01
2010-01-31,66438,82860,-16422,보스니아-헤르체고비나,2010-01
2010-01-31,66150,16,66134,감비아,2010-01
2010-01-31,64356,438370,-374014,모나코,2010-01
2010-01-31,62709,0,62709,소말리아,2010-01
2010-01-31,47137,0,47137,세인트 루시아,2010-01
2010-01-31,42237,89,42148,나미비아,2010-01
2010-01-31,41793,0,41793,몬테네그로,2010-01
2010-01-31,40235,0,40235,부룬디,2010-01
2010-01-31,38561,0,38561,산마리노,2010-01
2010-01-31,26258,0,26258,세인트 빈센트 그레나딘,2010-01
2010-01-31,23696,0,23696,키리바티,2010-01
2010-01-31,7704,0,7704,챠드,2010-01
2010-01-31,2163,0,2163,영령 인도양,2010-01
2010-01-31,1856,58,1798,앙귈라,2010-01
2010-01-31,1064,0,1064,파로에 군도,2010-01
2010-01-31,227,0,227,미령 버진군도,2010-01
2010-01-31,0,1311,-1311,마이너 아우틀링 합중국 군도,2010-01
2010-01-31,0,58868,-58868,토켈라우,2010-01
2010-01-31,0,111,-111,투르크 & 카이코스 군도,2010-01
2010-01-31,0,220963,-220963,그린랜드,2010-01
2010-01-31,0,30779,-30779,통가,2010-01
2010-01-31,0,2801,-2801,코스 군도,2010-01
2010-01-31,0,18,-18,말리,2010-01
2010-02-28,7954960842,4659307182,3295653660,중국,2010-02
2010-02-28,3406384973,2871249956,535135017,미국,2010-02
2010-02-28,1952521443,4906026301,-2953504858,일본,2010-02
2010-02-28,1903182118,120272897,1782909221,홍콩,2010-02
2010-02-28,1096616448,540705462,555910986,싱가포르,2010-02
2010-02-28,976999571,993310137,-16310566,독일,2010-02
2010-02-28,942492387,879531535,62960852,대만,2010-02
2010-02-28,850217555,384972954,465244601,인도,2010-02
2010-02-28,796615743,0,796615743,영령 버진군도,2010-02
2010-02-28,693682442,209,693682233,마샬군도,2010-02
2010-02-28,666509958,47681,666462277,라이베리아,2010-02
2010-02-28,621564449,65723957,555840492,멕시코,2010-02
2010-02-28,602854780,967782680,-364927900,인도네시아,2010-02
2010-02-28,544277668,97,544277571,영령 캐이맨 군도,2010-02
2010-02-28,530153397,172430421,357722976,베트남,2010-02
2010-02-28,511764868,749758853,-237993985,말레이시아,2010-02
2010-02-28,485437158,278584917,206852241,태국,2010-02
2010-02-28,483789640,284173799,199615841,브라질,2010-02
2010-02-28,471053990,292560111,178493879,필리핀,2010-02
2010-02-28,404997398,852444128,-447446730,러시아 연방,2010-02
2010-02-28,401549331,1341121596,-939572265,호주,2010-02
2010-02-28,372595279,580195393,-207600114,이란,2010-02
2010-02-28,325261420,23053051,302208369,폴란드,2010-02
2010-02-28,303100605,292639963,10460642,캐나다,2010-02
2010-02-28,292045794,4954424,287091370,슬로바키아,2010-02
2010-02-28,279967723,797564288,-517596565,아랍에미리트 연합,2010-02
2010-02-28,278884656,319036515,-40151859,프랑스,2010-02
2010-02-28,272860687,221913341,50947346,영국,2010-02
2010-02-28,257992055,2121865066,-1863873011,사우디아라비아,2010-02
2010-02-28,244050777,337777368,-93726591,칠레,2010-02
2010-02-28,230176921,6817,230170104,바하마,2010-02
2010-02-28,227555681,44286275,183269406,튀르키예,2010-02
2010-02-28,223777028,28425971,195351057,헝가리,2010-02
2010-02-28,209158544,490436362,-281277818,네덜란드,2010-02
2010-02-28,197723573,294003442,-96279869,이탈리아,2010-02
2010-02-28,141425867,67695563,73730304,스페인,2010-02
2010-02-28,122719351,6461450,116257901,방글라데시,2010-02
2010-02-28,115866441,1731321,114135120,우즈베키스탄,2010-02
2010-02-28,113102012,140222448,-27120436,이집트,2010-02
2010-02-28,111135896,16523035,94612861,시리아,2010-02
2010-02-28,106794261,127693384,-20899123,남아프리카공화국,2010-02
2010-02-28,101834031,65705505,36128526,벨기에,2010-02
2010-02-28,96276008,6117952,90158056,포루투갈,2010-02
2010-02-28,90297458,12053603,78243855,콜롬비아,2010-02
2010-02-28,84572030,192181894,-107609864,알제리,2010-02
2010-02-28,82585781,2167988,80417793,요르단,2010-02
2010-02-28,78156241,122944669,-44788428,페루,2010-02
2010-02-28,78124095,221718724,-143594629,노르웨이,2010-02
2010-02-28,76841675,29947388,46894287,파키스탄,2010-02
2010-02-28,73463449,36129461,37333988,리비아,2010-02
2010-02-28,72205739,58226611,13979128,이스라엘,2010-02
2010-02-28,62964691,42422260,20542431,나이지리아,2010-02
2010-02-28,61358412,828303428,-766945016,쿠웨이트,2010-02
2010-02-28,59772955,22454228,37318727,체코공화국,2010-02
2010-02-28,56999196,60583363,-3584167,아르헨티나,2010-02
2010-02-28,51285784,59357812,-8072028,오스트리아,2010-02
2010-02-28,48084580,364796257,-316711677,이라크,2010-02
2010-02-28,46141054,490618,45650436,에쿠아도르,2010-02
2010-02-28,44828811,34858551,9970260,바레인,2010-02
2010-02-28,42452870,344759054,-302306184,오만,2010-02
2010-02-28,39649786,8378376,31271410,미얀마,2010-02
2010-02-28,39619256,105442352,-65823096,스웨덴,2010-02
2010-02-28,39214726,906398525,-867183799,카타르,2010-02
2010-02-28,39202074,3241629,35960445,베네주엘라,2010-02
2010-02-28,38202612,38686062,-483450,예맨,2010-02
2010-02-28,37446094,764772,36681322,크로아티아,2010-02
2010-02-28,36779184,3569605,33209579,슬로베니아,2010-02
2010-02-28,36073151,76251529,-40178378,우크라이나,2010-02
2010-02-28,33377722,78120997,-44743275,뉴질랜드,2010-02
2010-02-28,30756802,78230223,-47473421,핀란드,2010-02
2010-02-28,29804696,27731387,2073309,과테말라,2010-02
2010-02-28,26592994,3470499,23122495,그리스,2010-02
2010-02-28,25886828,5072907,20813921,루마니아,2010-02
2010-02-28,25002181,3006143,21996038,튀니지,2010-02
2010-02-28,24042281,3841690,20200591,모로코,2010-02
2010-02-28,22919937,24934669,-2014732,카자흐스탄,2010-02
2010-02-28,22065079,3037,22062042,괌,2010-02
2010-02-28,20918434,24790412,-3871978,파나마,2010-02
2010-02-28,20764754,1857611,18907143,캄보디아,2010-02
2010-02-28,18877719,150873231,-131995512,스위스,2010-02
2010-02-28,17068159,2945245,14122914,가나,2010-02
2010-02-28,17040240,18515961,-1475721,앙골라,2010-02
2010-02-28,14739389,5395218,9344171,스리랑카,2010-02
2010-02-28,14530188,1358271,13171917,레바논,2010-02
2010-02-28,14367906,10503147,3864759,푸에르토리코,2010-02
2010-02-28,14270955,52460000,-38189045,덴마크,2010-02
2010-02-28,13163200,24536667,-11373467,몰타,2010-02
2010-02-28,12401645,3990542,8411103,수단,2010-02
2010-02-28,11170723,3496799,7673924,몽골,2010-02
2010-02-28,10625372,1667362,8958010,도미니카 공화국,2010-02
2010-02-28,10064610,44655312,-34590702,아일랜드,2010-02
2010-02-28,9526060,101825,9424235,니카라과,2010-02
2010-02-28,9379616,1220667,8158949,리투아니아,2010-02
2010-02-28,8806328,10379631,-1573303,코스타리카,2010-02
2010-02-28,8695495,2791348,5904147,우루과이,2010-02
2010-02-28,8332548,234475,8098073,케냐,2010-02
2010-02-28,8327189,2471,8324718,키르기스스탄,2010-02
2010-02-28,7811265,104997,7706268,파라과이,2010-02
2010-02-28,7755707,4735693,3020014,온두라스,2010-02
2010-02-28,7670619,84,7670535,아제르바이잔,2010-02
2010-02-28,7652610,147164,7505446,마다카스카르,2010-02
2010-02-28,7554915,164829,7390086,아이티,2010-02
2010-02-28,6272349,1113319,5159030,기니,2010-02
2010-02-28,6203377,115420,6087957,라오스,2010-02
2010-02-28,5875874,2674653,3201221,탄자니아,2010-02
2010-02-28,5804857,61740,5743117,레소토,2010-02
2010-02-28,5267213,136482988,-131215775,브루나이,2010-02
2010-02-28,5203742,0,5203742,코트디봐르,2010-02
2010-02-28,5017000,0,5017000,상토메 프린스페,2010-02
2010-02-28,4922182,3758796,1163386,불가리아,2010-02
2010-02-28,4615202,9823045,-5207843,뉴 칼레도니아,2010-02
2010-02-28,4510529,48532046,-44021517,파푸아 뉴기니,2010-02
2010-02-28,4395752,1104752,3291000,라트비아,2010-02
2010-02-28,4365311,4,4365307,부르키나 파소,2010-02
2010-02-28,4309797,82079,4227718,투르크멘,2010-02
2010-02-28,4190182,4813,4185369,아프카니스탄,2010-02
2010-02-28,4092426,65257071,-61164645,트리니다드 토바고,2010-02
2010-02-28,3644426,700657,2943769,에티오피아,2010-02
2010-02-28,3431445,274265,3157180,세네갈,2010-02
2010-02-28,3353600,799940,2553660,조지아,2010-02
2010-02-28,3015891,158270,2857621,모잠비크,2010-02
2010-02-28,2807015,585991,2221024,카메룬,2010-02
2010-02-28,2656094,369164,2286930,베닝,2010-02
2010-02-28,2564535,20979516,-18414981,에스토니아,2010-02
2010-02-28,2528296,8144183,-5615887,타지크,2010-02
2010-02-28,2441158,696,2440462,아메리칸 사모아,2010-02
2010-02-28,2404247,4872167,-2467920,기타국,2010-02
2010-02-28,2312834,50026,2262808,콩고,2010-02
2010-02-28,2308076,491906,1816170,마카오,2010-02
2010-02-28,2299773,4815059,-2515286,사이프러스,2010-02
2010-02-28,2101874,377203,1724671,토고,2010-02
2010-02-28,2088621,588091,1500530,엘살바도르,2010-02
2010-02-28,2065786,0,2065786,지부티,2010-02
2010-02-28,1789313,6084536,-4295223,세르비아,2010-02
2010-02-28,1710613,17890510,-16179897,모리셔스,2010-02
2010-02-28,1573703,952565,621138,벨라루스,2010-02
2010-02-28,1560473,96397,1464076,가이아나,2010-02
2010-02-28,1224507,79600,1144907,네팔,2010-02
2010-02-28,1216818,4036687,-2819869,룩셈부르그,2010-02
2010-02-28,1197811,1560,1196251,불령 리유니온 코모도 제도,2010-02
2010-02-28,1188447,22774,1165673,네덜란드 열도,2010-02
2010-02-28,1182226,4244,1177982,아르메니아,2010-02
2010-02-28,1176831,776267,400564,우간다,2010-02
2010-02-28,1113185,30030,1083155,불령 폴리네시아,2010-02
2010-02-28,1101117,214401,886716,자마이카,2010-02
2010-02-28,1082241,181317,900924,수리남,2010-02
2010-02-28,1063659,1165,1062494,쿠바,2010-02
2010-02-28,1032431,1416375,-383944,콩고민주공화국,2010-02
2010-02-28,1005787,125038495,-124032708,적도 기니,2010-02
2010-02-28,974026,989035,-15009,마세도니아,2010-02
2010-02-28,962787,460266,502521,아이슬란드,2010-02
2010-02-28,955810,224132,731678,짐바브웨,2010-02
2010-02-28,925278,176878,748400,볼리비아,2010-02
2010-02-28,912083,1273747,-361664,알바니아,2010-02
2010-02-28,847704,0,847704,챠드,2010-02
2010-02-28,819035,1293434,-474399,피지,2010-02
2010-02-28,774440,86897,687543,세이쉘,2010-02
2010-02-28,749534,16361,733173,가봉,2010-02
2010-02-28,741320,6460,734860,북마리아나 군도,2010-02
2010-02-28,714022,0,714022,말라위,2010-02
2010-02-28,663897,0,663897,바누아투,2010-02
2010-02-28,639507,42560,596947,마이크로네시아,2010-02
2010-02-28,603651,0,603651,아루바,2010-02
2010-02-28,602365,2230,600135,에리트리아,2010-02
2010-02-28,572710,0,572710,마티니크,2010-02
2010-02-28,561282,6721,554561,바베이도스,2010-02
2010-02-28,559001,15775713,-15216712,말리,2010-02
2010-02-28,546669,28288412,-27741743,잠비아,2010-02
2010-02-28,511599,0,511599,과델로프,2010-02
2010-02-28,462658,209527,253131,모리타니,2010-02
2010-02-28,407711,0,407711,니제르,2010-02
2010-02-28,379874,0,379874,보츠와나,2010-02
2010-02-28,374419,64128,310291,안도라,2010-02
2010-02-28,365085,25370,339715,도미니카,2010-02
2010-02-28,354100,134275,219825,팔레스타인 해방기구(구),2010-02
2010-02-28,347088,1072668,-725580,솔로몬 군도,2010-02
2010-02-28,346306,0,346306,팔라우,2010-02
2010-02-28,329792,11038,318754,사모아,2010-02
2010-02-28,327935,0,327935,불령 가이아나,2010-02
2010-02-28,298961,167636,131325,시에라 리온,2010-02
2010-02-28,292405,951812,-659407,스와질랜드,2010-02
2010-02-28,276026,0,276026,부탄,2010-02
2010-02-28,274505,1595439,-1320934,리히텐슈타인,2010-02
2010-02-28,267886,418836,-150950,몰디브,2010-02
2010-02-28,246823,56034,190789,몰도바,2010-02
2010-02-28,230566,0,230566,버뮤다,2010-02
2010-02-28,176836,7989,168847,세인트 루시아,2010-02
2010-02-28,176595,179,176416,벨리제,2010-02
2010-02-28,135347,20440,114907,보스니아-헤르체고비나,2010-02
2010-02-28,133681,31,133650,세인트 키츠 네비스,2010-02
2010-02-28,130054,1749520,-1619466,나미비아,2010-02
2010-02-28,122570,0,122570,카보 베르데,2010-02
2010-02-28,122321,10,122311,그레나다,2010-02
2010-02-28,90352,0,90352,몬테네그로,2010-02
2010-02-28,85999,0,85999,소말리아,2010-02
2010-02-28,81906,32338,49568,감비아,2010-02
2010-02-28,79589,0,79589,노폴크 아일랜드,2010-02
2010-02-28,70096,8880,61216,몬트세라트,2010-02
2010-02-28,57815,20406,37409,르완다,2010-02
2010-02-28,50873,43,50830,지브랄타,2010-02
2010-02-28,35856,0,35856,세인트 빈센트 그레나딘,2010-02
2010-02-28,30633,0,30633,부룬디,2010-02
2010-02-28,25700,28,25672,앙귈라,2010-02
2010-02-28,24000,0,24000,투발루,2010-02
2010-02-28,15636,374,15262,안티가 바부다,2010-02
2010-02-28,15332,683350,-668018,모나코,2010-02
2010-02-28,9093,7824,1269,티모르,2010-02
2010-02-28,7035,0,7035,쿡 아일랜드,2010-02
2010-02-28,607,0,607,키리바티,2010-02
2010-02-28,280,7348,-7068,토켈라우,2010-02
2010-02-28,0,25270,-25270,통가,2010-02
2010-02-28,0,3167444,-3167444,나우루,2010-02
2010-02-28,0,189116,-189116,그린랜드,2010-02
2010-02-28,0,25808,-25808,중앙아프리카공화국,2010-02
2010-02-28,0,411,-411,남조지아 & 남샌드위치 군도,2010-02
2010-02-28,0,2008,-2008,세인트 헬레나,2010-02
2010-03-31,9761155649,5802132819,3959022830,중국,2010-03
2010-03-31,4072583755,3724315007,348268748,미국,2010-03
2010-03-31,2124224922,5757367486,-3633142564,일본,2010-03
2010-03-31,2109175034,165287197,1943887837,홍콩,2010-03
2010-03-31,1277542255,1175285833,102256422,독일,2010-03
2010-03-31,1178592009,1103511563,75080446,대만,2010-03
2010-03-31,1088271287,568922936,519348351,싱가포르,2010-03
2010-03-31,863298908,494184631,369114277,인도,2010-03
2010-03-31,822865401,1270596010,-447730609,인도네시아,2010-03
2010-03-31,784424318,136201305,648223013,멕시코,2010-03
2010-03-31,696618200,221186471,475431729,베트남,2010-03
2010-03-31,606105615,977576151,-371470536,말레이시아,2010-03
2010-03-31,599787345,316126171,283661174,브라질,2010-03
2010-03-31,587049089,1328100743,-741051654,호주,2010-03
2010-03-31,547993030,295036195,252956835,필리핀,2010-03
2010-03-31,510110714,888525388,-378414674,러시아 연방,2010-03
2010-03-31,490199927,393181119,97018808,태국,2010-03
2010-03-31,427642050,667842715,-240200665,이란,2010-03
2010-03-31,402537252,380884410,21652842,캐나다,2010-03
2010-03-31,395339827,100897744,294442083,벨기에,2010-03
2010-03-31,384987165,1099,384986066,라이베리아,2010-03
2010-03-31,366522982,18382633,348140349,폴란드,2010-03
2010-03-31,365082100,1911954527,-1546872427,사우디아라비아,2010-03
2010-03-31,361212152,955785536,-594573384,아랍에미리트 연합,2010-03
2010-03-31,346546974,8960966,337586008,몰타,2010-03
2010-03-31,331215569,8231139,322984430,슬로바키아,2010-03
2010-03-31,307366192,46942532,260423660,튀르키예,2010-03
2010-03-31,286230818,406278260,-120047442,네덜란드,2010-03
2010-03-31,280694742,13217836,267476906,파나마,2010-03
2010-03-31,266122667,296665660,-30542993,영국,2010-03
2010-03-31,241715345,250,241715095,마샬군도,2010-03
2010-03-31,225191463,24770887,200420576,헝가리,2010-03
2010-03-31,224994397,338115993,-113121596,이탈리아,2010-03
2010-03-31,217462320,311177007,-93714687,칠레,2010-03
2010-03-31,173895357,368686477,-194791120,프랑스,2010-03
2010-03-31,164993264,91365258,73628006,이집트,2010-03
2010-03-31,158093629,79134813,78958816,스페인,2010-03
2010-03-31,147747767,313959568,-166211801,이라크,2010-03
2010-03-31,141395061,204223424,-62828363,남아프리카공화국,2010-03
2010-03-31,134182007,61675969,72506038,아일랜드,2010-03
2010-03-31,124890039,1968872,122921167,우즈베키스탄,2010-03
2010-03-31,123586282,16892195,106694087,콜롬비아,2010-03
2010-03-31,118298073,10116486,108181587,방글라데시,2010-03
2010-03-31,114111176,319842463,-205731287,노르웨이,2010-03
2010-03-31,107904192,2371835,105532357,요르단,2010-03
2010-03-31,90716649,34409974,56306675,알제리,2010-03
2010-03-31,87310901,29375753,57935148,체코공화국,2010-03
2010-03-31,86601269,20384994,66216275,리비아,2010-03
2010-03-31,85266358,351212,84915146,시리아,2010-03
2010-03-31,84420904,26364169,58056735,아르헨티나,2010-03
2010-03-31,78128855,110554545,-32425690,뉴질랜드,2010-03
2010-03-31,77395452,69255174,8140278,오스트리아,2010-03
2010-03-31,76974498,7580524,69393974,나이지리아,2010-03
2010-03-31,71861383,87285772,-15424389,이스라엘,2010-03
2010-03-31,70582795,5097187,65485608,그리스,2010-03
2010-03-31,68647178,73784946,-5137768,페루,2010-03
2010-03-31,65113208,928330482,-863217274,쿠웨이트,2010-03
2010-03-31,58708569,686061,58022508,에쿠아도르,2010-03
2010-03-31,58026152,27580739,30445413,파키스탄,2010-03
2010-03-31,53355125,128781985,-75426860,스웨덴,2010-03
2010-03-31,50433028,4526180,45906848,기타국,2010-03
2010-03-31,48405958,13026968,35378990,베네주엘라,2010-03
2010-03-31,45651229,66960099,-21308870,핀란드,2010-03
2010-03-31,44482251,5297379,39184872,슬로베니아,2010-03
2010-03-31,43755118,67696531,-23941413,우크라이나,2010-03
2010-03-31,42695897,675440,42020457,아이슬란드,2010-03
2010-03-31,36157964,26263706,9894258,카자흐스탄,2010-03
2010-03-31,34899890,388647382,-353747492,오만,2010-03
2010-03-31,33528241,10339748,23188493,루마니아,2010-03
2010-03-31,30617454,8782686,21834768,미얀마,2010-03
2010-03-31,29397608,1003207944,-973810336,카타르,2010-03
2010-03-31,28541987,15958520,12583467,과테말라,2010-03
2010-03-31,28020551,7414906,20605645,포루투갈,2010-03
2010-03-31,27431431,4285887,23145544,캄보디아,2010-03
2010-03-31,25516187,5027352,20488835,모로코,2010-03
2010-03-31,24115543,1890409,22225134,레바논,2010-03
2010-03-31,23482152,119047,23363105,괌,2010-03
2010-03-31,22707950,76303,22631647,불령 폴리네시아,2010-03
2010-03-31,21531121,220440896,-198909775,스위스,2010-03
2010-03-31,20916381,21620505,-704124,바레인,2010-03
2010-03-31,20645842,3176043,17469799,튀니지,2010-03
2010-03-31,20492994,44814179,-24321185,덴마크,2010-03
2010-03-31,18662984,1948753,16714231,수단,2010-03
2010-03-31,17768470,6665843,11102627,스리랑카,2010-03
2010-03-31,16292309,17969424,-1677115,코스타리카,2010-03
2010-03-31,15770950,2753272,13017678,가나,2010-03
2010-03-31,14747018,156279,14590739,케냐,2010-03
2010-03-31,14392216,2218356,12173860,불가리아,2010-03
2010-03-31,14135570,2389670,11745900,몽골,2010-03
2010-03-31,13825932,4895169,8930763,도미니카 공화국,2010-03
2010-03-31,12398614,743372,11655242,니카라과,2010-03
2010-03-31,12278751,40636964,-28358213,예맨,2010-03
2010-03-31,11711844,561,11711283,키르기스스탄,2010-03
2010-03-31,11020292,327168,10693124,파라과이,2010-03
2010-03-31,10814784,866,10813918,아제르바이잔,2010-03
2010-03-31,10435678,2809,10432869,코트디봐르,2010-03
2010-03-31,9679441,13102335,-3422894,온두라스,2010-03
2010-03-31,9414131,16347092,-6932961,푸에르토리코,2010-03
2010-03-31,9196666,3411023,5785643,우루과이,2010-03
2010-03-31,9140799,34215857,-25075058,앙골라,2010-03
2010-03-31,9080477,1480577,7599900,리투아니아,2010-03
2010-03-31,8903080,2221365,6681715,탄자니아,2010-03
2010-03-31,8753573,48833,8704740,쿠바,2010-03
2010-03-31,7237880,100456,7137424,레소토,2010-03
2010-03-31,7002803,237013,6765790,라오스,2010-03
2010-03-31,6939801,727998,6211803,라트비아,2010-03
2010-03-31,6817350,1141124,5676226,엘살바도르,2010-03
2010-03-31,6297638,326469,5971169,마다카스카르,2010-03
2010-03-31,5770782,2655999,3114783,파푸아 뉴기니,2010-03
2010-03-31,5560543,101833366,-96272823,브루나이,2010-03
2010-03-31,5360800,307563,5053237,에티오피아,2010-03
2010-03-31,4904371,35212,4869159,투르크멘,2010-03
2010-03-31,4655127,5457745,-802618,카메룬,2010-03
2010-03-31,4503451,28776,4474675,르완다,2010-03
2010-03-31,4496184,1250207,3245977,트리니다드 토바고,2010-03
2010-03-31,4354317,17165709,-12811392,뉴 칼레도니아,2010-03
2010-03-31,4105206,10939119,-6833913,타지크,2010-03
2010-03-31,4097550,411778,3685772,조지아,2010-03
2010-03-31,4061179,5265157,-1203978,크로아티아,2010-03
2010-03-31,4057830,25014455,-20956625,사이프러스,2010-03
2010-03-31,4006608,1820272,2186336,벨라루스,2010-03
2010-03-31,3903974,1009473,2894501,에스토니아,2010-03
2010-03-31,3828425,865333,2963092,세네갈,2010-03
2010-03-31,3748996,0,3748996,베닝,2010-03
2010-03-31,3567318,43461,3523857,콩고,2010-03
2010-03-31,2999972,775599,2224373,기니,2010-03
2010-03-31,2756546,71808,2684738,자마이카,2010-03
2010-03-31,2745237,1135697,1609540,팔레스타인 해방기구(구),2010-03
2010-03-31,2703254,25501,2677753,모잠비크,2010-03
2010-03-31,2638958,334540,2304418,모리셔스,2010-03
2010-03-31,2435421,20867635,-18432214,볼리비아,2010-03
2010-03-31,2309204,7253,2301951,아이티,2010-03
2010-03-31,2265459,2837694,-572235,룩셈부르그,2010-03
2010-03-31,1916492,520344,1396148,마카오,2010-03
2010-03-31,1821310,21,1821289,불령 리유니온 코모도 제도,2010-03
2010-03-31,1788818,2807,1786011,아메리칸 사모아,2010-03
2010-03-31,1715398,3381028,-1665630,세르비아,2010-03
2010-03-31,1693602,74203,1619399,네팔,2010-03
2010-03-31,1643648,35907,1607741,지부티,2010-03
2010-03-31,1641827,10496,1631331,아프카니스탄,2010-03
2010-03-31,1598413,152421,1445992,도미니카,2010-03
2010-03-31,1475900,3384,1472516,아르메니아,2010-03
2010-03-31,1460177,6652841,-5192664,콩고민주공화국,2010-03
2010-03-31,1459069,634713,824356,피지,2010-03
2010-03-31,1453433,545748,907685,우간다,2010-03
2010-03-31,1374231,80423,1293808,말라위,2010-03
2010-03-31,1158651,0,1158651,마티니크,2010-03
2010-03-31,1113401,32035,1081366,수리남,2010-03
2010-03-31,1085811,0,1085811,토고,2010-03
2010-03-31,1074096,11621,1062475,알바니아,2010-03
2010-03-31,1074008,505785,568223,세이쉘,2010-03
2010-03-31,1055276,11934,1043342,네덜란드 열도,2010-03
2010-03-31,1034670,147365,887305,가이아나,2010-03
2010-03-31,990199,1670,988529,벨리제,2010-03
2010-03-31,943158,23229805,-22286647,잠비아,2010-03
2010-03-31,818345,0,818345,아루바,2010-03
2010-03-31,814861,0,814861,가봉,2010-03
2010-03-31,809410,0,809410,에리트리아,2010-03
2010-03-31,772310,94361,677949,짐바브웨,2010-03
2010-03-31,721768,1354367,-632599,스와질랜드,2010-03
2010-03-31,665378,6808,658570,부탄,2010-03
2010-03-31,633564,43804,589760,바베이도스,2010-03
2010-03-31,597260,187730,409530,모리타니,2010-03
2010-03-31,544009,53514,490495,안도라,2010-03
2010-03-31,477747,98015,379732,시에라 리온,2010-03
2010-03-31,454515,129,454386,영령 캐이맨 군도,2010-03
2010-03-31,426645,100169,326476,보츠와나,2010-03
2010-03-31,420178,96029,324149,바하마,2010-03
2010-03-31,385462,0,385462,불령 가이아나,2010-03
2010-03-31,354223,1180,353043,북마리아나 군도,2010-03
2010-03-31,341948,42249,299699,마이크로네시아,2010-03
2010-03-31,294250,323443,-29193,마세도니아,2010-03
2010-03-31,272695,0,272695,안티가 바부다,2010-03
2010-03-31,262875,358,262517,버뮤다,2010-03
2010-03-31,234489,643327,-408838,솔로몬 군도,2010-03
2010-03-31,232502,720164,-487662,나미비아,2010-03
2010-03-31,211481,131565,79916,바누아투,2010-03
2010-03-31,208491,134,208357,카보 베르데,2010-03
2010-03-31,200951,0,200951,과델로프,2010-03
2010-03-31,185091,6891,178200,몰디브,2010-03
2010-03-31,183803,1818609,-1634806,몰도바,2010-03
2010-03-31,179173,156164,23009,보스니아-헤르체고비나,2010-03
2010-03-31,171434,50226,121208,감비아,2010-03
2010-03-31,161344,38673,122671,사모아,2010-03
2010-03-31,153418,0,153418,그레나다,2010-03
2010-03-31,121441,0,121441,팔라우,2010-03
2010-03-31,113238,364471,-251233,리히텐슈타인,2010-03
2010-03-31,109521,0,109521,세인트 키츠 네비스,2010-03
2010-03-31,96735,0,96735,세인트 루시아,2010-03
2010-03-31,91443,0,91443,몬테네그로,2010-03
2010-03-31,82330,19,82311,부룬디,2010-03
2010-03-31,75678,0,75678,지브랄타,2010-03
2010-03-31,65014,0,65014,영령 버진군도,2010-03
2010-03-31,54648,12,54636,부르키나 파소,2010-03
2010-03-31,41947,28,41919,중앙아프리카공화국,2010-03
2010-03-31,40928,1322,39606,통가,2010-03
2010-03-31,38991,0,38991,노폴크 아일랜드,2010-03
2010-03-31,38678,17050179,-17011501,말리,2010-03
2010-03-31,36940,0,36940,티모르,2010-03
2010-03-31,35748,6962,28786,니제르,2010-03
2010-03-31,34133,912,33221,쿡 아일랜드,2010-03
2010-03-31,17240,593519,-576279,모나코,2010-03
2010-03-31,10326,0,10326,기네비소,2010-03
2010-03-31,10171,113247556,-113237385,적도 기니,2010-03
2010-03-31,7900,0,7900,앙귈라,2010-03
2010-03-31,4498,0,4498,챠드,2010-03
2010-03-31,783,81981,-81198,그린랜드,2010-03
2010-03-31,415,0,415,포클랜드 군도,2010-03
2010-03-31,124,0,124,키리바티,2010-03
2010-03-31,80,0,80,보빗군도,2010-03
2010-03-31,0,151800,-151800,스발비드 군도,2010-03
2010-03-31,0,1000,-1000,맨섬,2010-03
2010-03-31,0,38,-38,나우루,2010-03
2010-03-31,0,324,-324,코모로스,2010-03
2010-03-31,0,2200,-2200,미령 버진군도,2010-03
2010-03-31,0,40014,-40014,토켈라우,2010-03
2010-03-31,0,25747,-25747,교황청,2010-03
2010-04-30,9911316633,6263521392,3647795241,중국,2010-04
2010-04-30,4338592803,3691618881,646973922,미국,2010-04
2010-04-30,2195317214,5610105952,-3414788738,일본,2010-04
2010-04-30,2054124682,142419359,1911705323,홍콩,2010-04
2010-04-30,1284376560,551796188,732580372,싱가포르,2010-04
2010-04-30,1192761671,1101370262,91391409,대만,2010-04
2010-04-30,909861573,560691651,349169922,인도,2010-04
2010-04-30,859464393,260056338,599408055,베트남,2010-04
2010-04-30,817754318,1103354550,-285600232,독일,2010-04
2010-04-30,804216567,95876707,708339860,멕시코,2010-04
2010-04-30,792830931,1353375643,-560544712,인도네시아,2010-04
2010-04-30,733066342,6573738,726492604,포루투갈,2010-04
2010-04-30,692906026,220498597,472407429,브라질,2010-04
2010-04-30,662062445,1667525723,-1005463278,호주,2010-04
2010-04-30,552489000,279282357,273206643,영국,2010-04
2010-04-30,551924305,828,551923477,마샬군도,2010-04
2010-04-30,531776365,740903274,-209126909,러시아 연방,2010-04
2010-04-30,509857116,337223614,172633502,태국,2010-04
2010-04-30,489291495,776123540,-286832045,말레이시아,2010-04
2010-04-30,477324360,1103569666,-626245306,아랍에미리트 연합,2010-04
2010-04-30,447162129,274391066,172771063,필리핀,2010-04
2010-04-30,439114854,837300840,-398185986,이란,2010-04
2010-04-30,379827317,9026215,370801102,파나마,2010-04
2010-04-30,373761595,302878797,70882798,캐나다,2010-04
2010-04-30,357324978,258498486,98826492,노르웨이,2010-04
2010-04-30,354878179,2325348302,-1970470123,사우디아라비아,2010-04
2010-04-30,346035035,397796047,-51761012,칠레,2010-04
2010-04-30,341343828,6974994,334368834,슬로바키아,2010-04
2010-04-30,334398755,51730,334347025,라이베리아,2010-04
2010-04-30,333334392,15623010,317711382,폴란드,2010-04
2010-04-30,309521424,51948678,257572746,튀르키예,2010-04
2010-04-30,305487677,329606895,-24119218,이탈리아,2010-04
2010-04-30,266597183,271002502,-4405319,네덜란드,2010-04
2010-04-30,195709304,21323113,174386191,헝가리,2010-04
2010-04-30,189016829,27237051,161779778,리비아,2010-04
2010-04-30,177456844,332010473,-154553629,프랑스,2010-04
2010-04-30,171186919,75233577,95953342,스페인,2010-04
2010-04-30,159987804,138837634,21150170,남아프리카공화국,2010-04
2010-04-30,152751292,57655488,95095804,이집트,2010-04
2010-04-30,138430686,4887458,133543228,그리스,2010-04
2010-04-30,132078080,88521411,43556669,벨기에,2010-04
2010-04-30,124132066,9190069,114941997,방글라데시,2010-04
2010-04-30,122604566,2099147,120505419,우즈베키스탄,2010-04
2010-04-30,117972470,488345,117484125,시리아,2010-04
2010-04-30,116114001,46443468,69670533,나이지리아,2010-04
2010-04-30,113607603,14606993,99000610,콜롬비아,2010-04
2010-04-30,106594734,31122135,75472599,체코공화국,2010-04
2010-04-30,105639246,3282359,102356887,요르단,2010-04
2010-04-30,100085490,17674,100067816,알제리,2010-04
2010-04-30,99175885,9047478,90128407,몰타,2010-04
2010-04-30,98706859,19495066,79211793,파키스탄,2010-04
2010-04-30,91474995,74713892,16761103,오스트리아,2010-04
2010-04-30,88063264,307283728,-219220464,이라크,2010-04
2010-04-30,86896050,88731585,-1835535,뉴질랜드,2010-04
2010-04-30,82426011,831851,81594160,아이슬란드,2010-04
2010-04-30,80630648,71902967,8727681,페루,2010-04
2010-04-30,74192489,71186138,3006351,이스라엘,2010-04
2010-04-30,64034095,879082643,-815048548,카타르,2010-04
2010-04-30,63915521,39682315,24233206,우크라이나,2010-04
2010-04-30,58504365,32546863,25957502,아르헨티나,2010-04
2010-04-30,58491735,755973034,-697481299,쿠웨이트,2010-04
2010-04-30,54230805,1507316,52723489,에쿠아도르,2010-04
2010-04-30,50958655,395935529,-344976874,오만,2010-04
2010-04-30,47753420,88538297,-40784877,스웨덴,2010-04
2010-04-30,47563582,12020368,35543214,미얀마,2010-04
2010-04-30,47542800,6499009,41043791,슬로베니아,2010-04
2010-04-30,43618307,70745254,-27126947,핀란드,2010-04
2010-04-30,39764053,163472675,-123708622,스위스,2010-04
2010-04-30,38007254,19426749,18580505,카자흐스탄,2010-04
2010-04-30,36354076,802254,35551822,크로아티아,2010-04
2010-04-30,35978827,1673500,34305327,베네주엘라,2010-04
2010-04-30,35636838,14935468,20701370,예맨,2010-04
2010-04-30,34533911,2278040,32255871,튀니지,2010-04
2010-04-30,30892389,42624100,-11731711,바레인,2010-04
2010-04-30,29942498,6407564,23534934,모로코,2010-04
2010-04-30,29507970,2848675,26659295,캄보디아,2010-04
2010-04-30,29333083,56903536,-27570453,아일랜드,2010-04
2010-04-30,26078912,1208730,24870182,레바논,2010-04
2010-04-30,25108193,5517694,19590499,과테말라,2010-04
2010-04-30,21798933,15423854,6375079,루마니아,2010-04
2010-04-30,19350207,51196441,-31846234,덴마크,2010-04
2010-04-30,18144437,11503819,6640618,코스타리카,2010-04
2010-04-30,17869757,2389999,15479758,가나,2010-04
2010-04-30,17220761,2923,17217838,아제르바이잔,2010-04
2010-04-30,16140686,289163,15851523,몽골,2010-04
2010-04-30,15544934,716753,14828181,기니,2010-04
2010-04-30,15027759,3791496,11236263,도미니카 공화국,2010-04
2010-04-30,14613817,4124331,10489486,스리랑카,2010-04
2010-04-30,13744108,16566013,-2821905,푸에르토리코,2010-04
2010-04-30,13676186,823770,12852416,수단,2010-04
2010-04-30,12971856,237391,12734465,콩고,2010-04
2010-04-30,12158155,115684,12042471,니카라과,2010-04
2010-04-30,12023178,37761,11985417,파라과이,2010-04
2010-04-30,11913632,3772114,8141518,우루과이,2010-04
2010-04-30,11053925,1750,11052175,코트디봐르,2010-04
2010-04-30,10896308,194920,10701388,라오스,2010-04
2010-04-30,10522018,762309,9759709,케냐,2010-04
2010-04-30,10005721,7775753,2229968,온두라스,2010-04
2010-04-30,9947216,6561,9940655,쿠바,2010-04
2010-04-30,9467601,285218,9182383,탄자니아,2010-04
2010-04-30,9145721,25,9145696,키르기스스탄,2010-04
2010-04-30,8975181,1434745,7540436,리투아니아,2010-04
2010-04-30,8680439,5759793,2920646,불가리아,2010-04
2010-04-30,8176332,15902310,-7725978,앙골라,2010-04
2010-04-30,6561362,107580,6453782,자마이카,2010-04
2010-04-30,6088984,1080549,5008435,파푸아 뉴기니,2010-04
2010-04-30,5520936,97113,5423823,마다카스카르,2010-04
2010-04-30,5506138,48933,5457205,투르크멘,2010-04
2010-04-30,5278816,89509722,-84230906,브루나이,2010-04
2010-04-30,5193876,1025812,4168064,라트비아,2010-04
2010-04-30,4582086,73559419,-68977333,적도 기니,2010-04
2010-04-30,4514725,790502,3724223,엘살바도르,2010-04
2010-04-30,4497193,2390,4494803,레소토,2010-04
2010-04-30,4449506,11385803,-6936297,뉴 칼레도니아,2010-04
2010-04-30,4169531,1437810,2731721,세네갈,2010-04
2010-04-30,4107381,0,4107381,베닝,2010-04
2010-04-30,4016892,2302674,1714218,조지아,2010-04
2010-04-30,3996588,2813,3993775,토고,2010-04
2010-04-30,3970445,7415521,-3445076,트리니다드 토바고,2010-04
2010-04-30,3861989,1547518,2314471,에스토니아,2010-04
2010-04-30,3728125,0,3728125,지부티,2010-04
2010-04-30,3660308,29559,3630749,괌,2010-04
2010-04-30,3638946,746056,2892890,카메룬,2010-04
2010-04-30,3612892,62227,3550665,모잠비크,2010-04
2010-04-30,3572195,10674938,-7102743,벨라루스,2010-04
2010-04-30,3345826,3558622,-212796,기타국,2010-04
2010-04-30,3220080,12,3220068,르완다,2010-04
2010-04-30,2852019,3872464,-1020445,사이프러스,2010-04
2010-04-30,2820392,70265,2750127,세르비아,2010-04
2010-04-30,2705623,759808,1945815,에티오피아,2010-04
2010-04-30,2631723,114635,2517088,모리셔스,2010-04
2010-04-30,2631443,0,2631443,아메리칸 사모아,2010-04
2010-04-30,2348462,25488115,-23139653,잠비아,2010-04
2010-04-30,2318712,194324,2124388,팔레스타인 해방기구(구),2010-04
2010-04-30,2250967,65513,2185454,네팔,2010-04
2010-04-30,2115355,298124,1817231,마카오,2010-04
2010-04-30,1903653,1991178,-87525,룩셈부르그,2010-04
2010-04-30,1780776,11868,1768908,아프카니스탄,2010-04
2010-04-30,1746097,8963610,-7217513,타지크,2010-04
2010-04-30,1684704,459418,1225286,피지,2010-04
2010-04-30,1610827,37488,1573339,네덜란드 열도,2010-04
2010-04-30,1591252,15547,1575705,세이쉘,2010-04
2010-04-30,1559544,575,1558969,불령 리유니온 코모도 제도,2010-04
2010-04-30,1538677,286226,1252451,볼리비아,2010-04
2010-04-30,1531866,10332202,-8800336,콩고민주공화국,2010-04
2010-04-30,1492225,22894,1469331,시에라 리온,2010-04
2010-04-30,1453752,418746,1035006,짐바브웨,2010-04
2010-04-30,1318064,0,1318064,부르키나 파소,2010-04
2010-04-30,1308301,194666,1113635,수리남,2010-04
2010-04-30,1302792,17295,1285497,가봉,2010-04
2010-04-30,1284842,27866,1256976,아이티,2010-04
2010-04-30,1142801,69365,1073436,도미니카,2010-04
2010-04-30,1141275,267869,873406,가이아나,2010-04
2010-04-30,1063257,10648332,-9585075,말라위,2010-04
2010-04-30,1058552,29023,1029529,바베이도스,2010-04
2010-04-30,1031558,672342,359216,우간다,2010-04
2010-04-30,1011878,2397674,-1385796,스와질랜드,2010-04
2010-04-30,1006959,7201,999758,알바니아,2010-04
2010-04-30,920104,19741,900363,불령 폴리네시아,2010-04
2010-04-30,885914,0,885914,아루바,2010-04
2010-04-30,875434,32540,842894,안도라,2010-04
2010-04-30,829360,0,829360,챠드,2010-04
2010-04-30,811419,75854,735565,북마리아나 군도,2010-04
2010-04-30,802697,631927,170770,모리타니,2010-04
2010-04-30,787526,0,787526,부탄,2010-04
2010-04-30,723402,0,723402,마티니크,2010-04
2010-04-30,676125,3077,673048,벨리제,2010-04
2010-04-30,650040,0,650040,마이크로네시아,2010-04
2010-04-30,625177,0,625177,에리트리아,2010-04
2010-04-30,526657,42214,484443,아르메니아,2010-04
2010-04-30,476064,917,475147,과델로프,2010-04
2010-04-30,453551,0,453551,버뮤다,2010-04
2010-04-30,421742,1026,420716,안티가 바부다,2010-04
2010-04-30,371727,0,371727,불령 가이아나,2010-04
2010-04-30,349940,0,349940,사모아,2010-04
2010-04-30,286094,117301,168793,바하마,2010-04
2010-04-30,251457,55288,196169,감비아,2010-04
2010-04-30,230158,11412,218746,영령 캐이맨 군도,2010-04
2010-04-30,219526,60195,159331,보츠와나,2010-04
2010-04-30,189720,40642,149078,몰디브,2010-04
2010-04-30,188073,1000,187073,세인트 루시아,2010-04
2010-04-30,171573,0,171573,그레나다,2010-04
2010-04-30,166918,784,166134,몬테네그로,2010-04
2010-04-30,163755,2664,161091,마세도니아,2010-04
2010-04-30,159461,39609,119852,중앙아프리카공화국,2010-04
2010-04-30,155877,485565,-329688,몰도바,2010-04
2010-04-30,136858,351479,-214621,보스니아-헤르체고비나,2010-04
2010-04-30,126778,323611,-196833,리히텐슈타인,2010-04
2010-04-30,126303,3403,122900,영령 버진군도,2010-04
2010-04-30,124471,1745,122726,팔라우,2010-04
2010-04-30,118541,0,118541,코모로스,2010-04
2010-04-30,115975,0,115975,카보 베르데,2010-04
2010-04-30,100228,0,100228,소말리아,2010-04
2010-04-30,85160,0,85160,노폴크 아일랜드,2010-04
2010-04-30,78678,713683,-635005,나미비아,2010-04
2010-04-30,57080,2865,54215,쿡 아일랜드,2010-04
2010-04-30,47101,5816,41285,바누아투,2010-04
2010-04-30,45595,458579,-412984,모나코,2010-04
2010-04-30,44190,6000,38190,통가,2010-04
2010-04-30,42477,0,42477,티모르,2010-04
2010-04-30,31959,3268,28691,산마리노,2010-04
2010-04-30,30645,0,30645,투르크 & 카이코스 군도,2010-04
2010-04-30,29075,4464636,-4435561,솔로몬 군도,2010-04
2010-04-30,27197,7887,19310,말리,2010-04
2010-04-30,20720,0,20720,니제르,2010-04
2010-04-30,18000,0,18000,기네비소,2010-04
2010-04-30,14154,0,14154,메요트,2010-04
2010-04-30,13689,412,13277,세인트 빈센트 그레나딘,2010-04
2010-04-30,10327,299,10028,지브랄타,2010-04
2010-04-30,5720,50543,-44823,토켈라우,2010-04
2010-04-30,2992,0,2992,몬트세라트,2010-04
2010-04-30,271,0,271,키리바티,2010-04
2010-04-30,227,0,227,세인트 키츠 네비스,2010-04
2010-04-30,0,52487269,-52487269,니우에,2010-04
2010-04-30,0,117,-117,세인트 헬레나,2010-04
2010-04-30,0,653,-653,코스 군도,2010-04
2010-04-30,0,1178,-1178,불령 남부지역,2010-04
2010-04-30,0,267,-267,크리스마스 아일랜드,2010-04
2010-04-30,0,2259422,-2259422,나우루,2010-04
2010-04-30,0,250693,-250693,그린랜드,2010-04
2010-04-30,0,2139,-2139,미령 버진군도,2010-04
2010-04-30,0,58,-58,앙귈라,2010-04
2010-05-31,9605689273,6038184856,3567504417,중국,2010-05
2010-05-31,4157684544,3499066314,658618230,미국,2010-05
2010-05-31,2333540724,148002837,2185537887,홍콩,2010-05
2010-05-31,2261134956,4873913401,-2612778445,일본,2010-05
2010-05-31,1614939219,631886320,983052899,싱가포르,2010-05
2010-05-31,1150737268,1132187301,18549967,대만,2010-05
2010-05-31,915983595,503689592,412294003,인도,2010-05
2010-05-31,843090585,360647683,482442902,네덜란드,2010-05
2010-05-31,792288992,90025656,702263336,멕시코,2010-05
2010-05-31,786525855,1025720892,-239195037,인도네시아,2010-05
2010-05-31,735725132,239950080,495775052,베트남,2010-05
2010-05-31,706628157,260118368,446509789,브라질,2010-05
2010-05-31,623965767,1202261808,-578296041,독일,2010-05
2010-05-31,595568556,0,595568556,마샬군도,2010-05
2010-05-31,528992111,1378453757,-849461646,호주,2010-05
2010-05-31,519747520,924138091,-404390571,러시아 연방,2010-05
2010-05-31,509375641,344028917,165346724,태국,2010-05
2010-05-31,491870832,610845976,-118975144,이란,2010-05
2010-05-31,448987440,823619593,-374632153,말레이시아,2010-05
2010-05-31,443450993,330529399,112921594,필리핀,2010-05
2010-05-31,395428997,2295772984,-1900343987,사우디아라비아,2010-05
2010-05-31,385288787,7269996,378018791,슬로바키아,2010-05
2010-05-31,384074779,1363813685,-979738906,아랍에미리트 연합,2010-05
2010-05-31,367930936,260460324,107470612,영국,2010-05
2010-05-31,345856111,22148396,323707715,폴란드,2010-05
2010-05-31,335299303,212113960,123185343,노르웨이,2010-05
2010-05-31,334670504,5579,334664925,라이베리아,2010-05
2010-05-31,313245178,48671426,264573752,튀르키예,2010-05
2010-05-31,313053807,427987687,-114933880,캐나다,2010-05
2010-05-31,299496344,20,299496324,영령 캐이맨 군도,2010-05
2010-05-31,227616918,5296599,222320319,그리스,2010-05
2010-05-31,223569513,309573945,-86004432,이탈리아,2010-05
2010-05-31,194999373,131,194999242,버뮤다,2010-05
2010-05-31,194960129,75959753,119000376,스페인,2010-05
2010-05-31,181447698,29833516,151614182,헝가리,2010-05
2010-05-31,179046534,49174558,129871976,이집트,2010-05
2010-05-31,170818695,335042497,-164223802,칠레,2010-05
2010-05-31,164609241,316183408,-151574167,프랑스,2010-05
2010-05-31,148912506,159862146,-10949640,남아프리카공화국,2010-05
2010-05-31,132610510,76711038,55899472,오스트리아,2010-05
2010-05-31,132471560,944876,131526684,리비아,2010-05
2010-05-31,124664296,9168286,115496010,방글라데시,2010-05
2010-05-31,117401453,85962196,31439257,벨기에,2010-05
2010-05-31,116762024,2243548,114518476,우즈베키스탄,2010-05
2010-05-31,116614168,31106602,85507566,파나마,2010-05
2010-05-31,115512616,72624,115439992,알제리,2010-05
2010-05-31,114780458,628398,114152060,시리아,2010-05
2010-05-31,113664246,328856277,-215192031,이라크,2010-05
2010-05-31,112300028,47248924,65051104,콜롬비아,2010-05
2010-05-31,110550377,2878294,107672083,요르단,2010-05
2010-05-31,93139224,26347045,66792179,체코공화국,2010-05
2010-05-31,92940505,36981899,55958606,카자흐스탄,2010-05
2010-05-31,83815356,82188481,1626875,페루,2010-05
2010-05-31,83503229,990085,82513144,에쿠아도르,2010-05
2010-05-31,82336289,984385,81351904,아이슬란드,2010-05
2010-05-31,78140979,318140862,-239999883,오만,2010-05
2010-05-31,77876993,102319985,-24442992,뉴질랜드,2010-05
2010-05-31,77184864,73584108,3600756,아르헨티나,2010-05
2010-05-31,76679181,60153632,16525549,이스라엘,2010-05
2010-05-31,75101918,8471117,66630801,몰타,2010-05
2010-05-31,74789442,652160,74137282,케냐,2010-05
2010-05-31,68932710,34612010,34320700,파키스탄,2010-05
2010-05-31,62990393,18784551,44205842,나이지리아,2010-05
2010-05-31,57693312,1135928153,-1078234841,쿠웨이트,2010-05
2010-05-31,57531490,1064210439,-1006678949,카타르,2010-05
2010-05-31,56340647,56553885,-213238,핀란드,2010-05
2010-05-31,49912043,125573286,-75661243,스웨덴,2010-05
2010-05-31,49334471,205439,49129032,바하마,2010-05
2010-05-31,49048262,59345692,-10297430,우크라이나,2010-05
2010-05-31,48202170,16581919,31620251,베네주엘라,2010-05
2010-05-31,48152557,7355492,40797065,미얀마,2010-05
2010-05-31,46139035,6666577,39472458,사이프러스,2010-05
2010-05-31,46092357,4804412,41287945,슬로베니아,2010-05
2010-05-31,40583157,874601,39708556,스와질랜드,2010-05
2010-05-31,34483433,55203146,-20719713,바레인,2010-05
2010-05-31,33753870,302852,33451018,가이아나,2010-05
2010-05-31,32410847,4376630,28034217,모로코,2010-05
2010-05-31,31942131,1645371,30296760,레바논,2010-05
2010-05-31,31905838,75106,31830732,괌,2010-05
2010-05-31,30708664,2918315,27790349,튀니지,2010-05
2010-05-31,28835638,8901580,19934058,과테말라,2010-05
2010-05-31,26371188,5768584,20602604,포루투갈,2010-05
2010-05-31,23536550,50011994,-26475444,덴마크,2010-05
2010-05-31,23396736,13300,23383436,불령 폴리네시아,2010-05
2010-05-31,22754121,3595779,19158342,캄보디아,2010-05
2010-05-31,20479834,6558353,13921481,루마니아,2010-05
2010-05-31,18114444,3306031,14808413,몽골,2010-05
2010-05-31,17769741,3423426,14346315,스리랑카,2010-05
2010-05-31,17761920,152508913,-134746993,스위스,2010-05
2010-05-31,17149115,10823364,6325751,코스타리카,2010-05
2010-05-31,16192073,600858,15591215,수단,2010-05
2010-05-31,15479107,4652044,10827063,도미니카 공화국,2010-05
2010-05-31,14920985,20647,14900338,아제르바이잔,2010-05
2010-05-31,14751647,340607,14411040,가나,2010-05
2010-05-31,13928751,10971108,2957643,푸에르토리코,2010-05
2010-05-31,12664638,1232523,11432115,니카라과,2010-05
2010-05-31,12528522,13337253,-808731,예맨,2010-05
2010-05-31,11161516,4934022,6227494,온두라스,2010-05
2010-05-31,10667487,1598802,9068685,리투아니아,2010-05
2010-05-31,10569650,62019,10507631,파라과이,2010-05
2010-05-31,10261105,445432,9815673,자마이카,2010-05
2010-05-31,9987260,46,9987214,앙골라,2010-05
2010-05-31,9633834,62025842,-52392008,아일랜드,2010-05
2010-05-31,8815944,845,8815099,코트디봐르,2010-05
2010-05-31,8219664,1014736,7204928,라트비아,2010-05
2010-05-31,8167992,10142579,-1974587,불가리아,2010-05
2010-05-31,7340202,0,7340202,키르기스스탄,2010-05
2010-05-31,6898241,3034026,3864215,우루과이,2010-05
2010-05-31,6278606,61477,6217129,라오스,2010-05
2010-05-31,6270184,8558,6261626,레소토,2010-05
2010-05-31,5988498,10845162,-4856664,탄자니아,2010-05
2010-05-31,5889229,43739217,-37849988,파푸아 뉴기니,2010-05
2010-05-31,5507098,1222288,4284810,엘살바도르,2010-05
2010-05-31,5465299,1646251,3819048,콩고,2010-05
2010-05-31,5457393,1546824,3910569,세네갈,2010-05
2010-05-31,5437835,24369988,-18932153,뉴 칼레도니아,2010-05
2010-05-31,5179260,84252,5095008,투르크멘,2010-05
2010-05-31,4742208,93457,4648751,네팔,2010-05
2010-05-31,4609665,14237288,-9627623,기타국,2010-05
2010-05-31,4561038,1018212,3542826,크로아티아,2010-05
2010-05-31,4223247,294480,3928767,카메룬,2010-05
2010-05-31,4140670,376558,3764112,마카오,2010-05
2010-05-31,4131662,2303,4129359,아프카니스탄,2010-05
2010-05-31,3933592,1319757,2613835,트리니다드 토바고,2010-05
2010-05-31,3902317,63485110,-59582793,브루나이,2010-05
2010-05-31,3890662,1163219,2727443,에스토니아,2010-05
2010-05-31,3394381,49505,3344876,마다카스카르,2010-05
2010-05-31,3315593,136148,3179445,모리셔스,2010-05
2010-05-31,3208130,0,3208130,모잠비크,2010-05
2010-05-31,3156207,2937748,218459,벨라루스,2010-05
2010-05-31,3099092,875043,2224049,베닝,2010-05
2010-05-31,3091413,2121832,969581,조지아,2010-05
2010-05-31,2876355,496351,2380004,보스니아-헤르체고비나,2010-05
2010-05-31,2850985,3229,2847756,르완다,2010-05
2010-05-31,2467759,166,2467593,부르키나 파소,2010-05
2010-05-31,2220816,43716,2177100,아이티,2010-05
2010-05-31,2214151,857101,1357050,에티오피아,2010-05
2010-05-31,2025392,6596726,-4571334,쿠바,2010-05
2010-05-31,1904176,233727,1670449,짐바브웨,2010-05
2010-05-31,1876855,6249370,-4372515,타지크,2010-05
2010-05-31,1834144,33322,1800822,팔레스타인 해방기구,2010-05
2010-05-31,1721792,42063,1679729,토고,2010-05
2010-05-31,1677433,134968,1542465,수리남,2010-05
2010-05-31,1624166,317131,1307035,볼리비아,2010-05
2010-05-31,1603119,3047,1600072,지부티,2010-05
2010-05-31,1558450,260327,1298123,시에라 리온,2010-05
2010-05-31,1501024,910169,590855,아르메니아,2010-05
2010-05-31,1418212,12156556,-10738344,콩고민주공화국,2010-05
2010-05-31,1333166,141023,1192143,네덜란드 열도,2010-05
2010-05-31,1203288,5342662,-4139374,룩셈부르그,2010-05
2010-05-31,1149987,0,1149987,에리트리아,2010-05
2010-05-31,1100114,16523,1083591,세르비아,2010-05
2010-05-31,1069139,107419,961720,모리타니,2010-05
2010-05-31,1049902,0,1049902,마티니크,2010-05
2010-05-31,1047789,822,1046967,마이크로네시아,2010-05
2010-05-31,984123,42594,941529,알바니아,2010-05
2010-05-31,974454,35162,939292,바베이도스,2010-05
2010-05-31,938276,4051941,-3113665,말라위,2010-05
2010-05-31,931337,5292,926045,불령 리유니온 코모도 제도,2010-05
2010-05-31,877777,725987,151790,기니,2010-05
2010-05-31,861843,3209895,-2348052,피지,2010-05
2010-05-31,694654,0,694654,아루바,2010-05
2010-05-31,674632,2071,672561,몰디브,2010-05
2010-05-31,635686,5030,630656,도미니카,2010-05
2010-05-31,633543,24373050,-23739507,잠비아,2010-05
2010-05-31,587442,125681,461761,가봉,2010-05
2010-05-31,534044,98752,435292,우간다,2010-05
2010-05-31,502236,133800,368436,북마리아나 군도,2010-05
2010-05-31,450281,5939,444342,부탄,2010-05
2010-05-31,415092,0,415092,적도 기니,2010-05
2010-05-31,358808,117281,241527,마세도니아,2010-05
2010-05-31,358451,90756,267695,안도라,2010-05
2010-05-31,351394,349479,1915,리히텐슈타인,2010-05
2010-05-31,350735,767,349968,과델로프,2010-05
2010-05-31,330044,0,330044,바누아투,2010-05
2010-05-31,321427,538682,-217255,세이쉘,2010-05
2010-05-31,314811,0,314811,사모아,2010-05
2010-05-31,301265,0,301265,불령 가이아나,2010-05
2010-05-31,256646,682015,-425369,솔로몬 군도,2010-05
2010-05-31,235963,0,235963,그레나다,2010-05
2010-05-31,213844,936502,-722658,나미비아,2010-05
2010-05-31,187186,11487,175699,보츠와나,2010-05
2010-05-31,161639,0,161639,벨리제,2010-05
2010-05-31,148596,49259,99337,몰도바,2010-05
2010-05-31,146014,0,146014,소말리아,2010-05
2010-05-31,136890,0,136890,몬테네그로,2010-05
2010-05-31,126843,1689,125154,니제르,2010-05
2010-05-31,107767,6384,101383,아메리칸 사모아,2010-05
2010-05-31,84536,1488,83048,안티가 바부다,2010-05
2010-05-31,84282,2670887,-2586605,지브랄타,2010-05
2010-05-31,84217,29714,54503,감비아,2010-05
2010-05-31,81341,535808,-454467,모나코,2010-05
2010-05-31,79890,84,79806,세인트 키츠 네비스,2010-05
2010-05-31,78475,382,78093,산마리노,2010-05
2010-05-31,69875,74,69801,영령 버진군도,2010-05
2010-05-31,61523,15103552,-15042029,말리,2010-05
2010-05-31,57100,0,57100,쿡 아일랜드,2010-05
2010-05-31,51711,0,51711,코모로스,2010-05
2010-05-31,50680,0,50680,세인트 루시아,2010-05
2010-05-31,41948,0,41948,노폴크 아일랜드,2010-05
2010-05-31,40483,0,40483,세인트 빈센트 그레나딘,2010-05
2010-05-31,36240,0,36240,팔라우,2010-05
2010-05-31,25200,18287,6913,티모르,2010-05
2010-05-31,24694,379,24315,카보 베르데,2010-05
2010-05-31,18482,0,18482,메요트,2010-05
2010-05-31,13745,0,13745,중앙아프리카공화국,2010-05
2010-05-31,11103,0,11103,통가,2010-05
2010-05-31,7043,108097,-101054,앙귈라,2010-05
2010-05-31,5697,213998,-208301,그린랜드,2010-05
2010-05-31,3763,0,3763,챠드,2010-05
2010-05-31,2235,0,2235,기네비소,2010-05
2010-05-31,1623,0,1623,영령 인도양,2010-05
2010-05-31,1034,0,1034,남조지아 & 남샌드위치 군도,2010-05
2010-05-31,0,48682,-48682,코스 군도,2010-05
2010-05-31,0,11,-11,세인트 헬레나,2010-05
2010-05-31,0,2843,-2843,마이너 아우틀링 합중국 군도,2010-05
2010-05-31,0,5135758,-5135758,나우루,2010-05
2010-05-31,0,99667,-99667,토켈라우,2010-05
2010-05-31,0,789,-789,부룬디,2010-05
2010-06-30,9550810959,6015806358,3535004601,중국,2010-06
2010-06-30,4466322929,3687235743,779087186,미국,2010-06
2010-06-30,2367823540,5577277026,-3209453486,일본,2010-06
2010-06-30,2324134640,176623210,2147511430,홍콩,2010-06
2010-06-30,1556390014,1109421478,446968536,독일,2010-06
2010-06-30,1453992503,685067143,768925360,싱가포르,2010-06
2010-06-30,1249235290,22,1249235268,버뮤다,2010-06
2010-06-30,1182326778,1145491084,36835694,대만,2010-06
2010-06-30,1055854686,389384664,666470022,네덜란드,2010-06
2010-06-30,901132065,386979464,514152601,인도,2010-06
2010-06-30,815357509,1168643161,-353285652,인도네시아,2010-06
2010-06-30,803822531,267800611,536021920,베트남,2010-06
2010-06-30,771483641,54822,771428819,라이베리아,2010-06
2010-06-30,736620168,148800131,587820037,멕시코,2010-06
2010-06-30,703838100,379170857,324667243,브라질,2010-06
2010-06-30,689279655,25707107,663572548,파나마,2010-06
2010-06-30,614143234,940963422,-326820188,러시아 연방,2010-06
2010-06-30,566394756,307729047,258665709,영국,2010-06
2010-06-30,544671011,705042865,-160371854,말레이시아,2010-06
2010-06-30,543665989,417146568,126519421,태국,2010-06
2010-06-30,500334799,819747535,-319412736,아랍에미리트 연합,2010-06
2010-06-30,475686923,1781628706,-1305941783,사우디아라비아,2010-06
2010-06-30,468431435,301234027,167197408,필리핀,2010-06
2010-06-30,456535573,652694221,-196158648,이란,2010-06
2010-06-30,455294468,1732280669,-1276986201,호주,2010-06
2010-06-30,384767797,7512400,377255397,슬로바키아,2010-06
2010-06-30,363212046,459105563,-95893517,캐나다,2010-06
2010-06-30,355725466,25171688,330553778,폴란드,2010-06
2010-06-30,313141296,32473328,280667968,튀르키예,2010-06
2010-06-30,302354591,0,302354591,마샬군도,2010-06
2010-06-30,302123025,340860873,-38737848,이탈리아,2010-06
2010-06-30,237184185,221926964,15257221,칠레,2010-06
2010-06-30,209286624,57368488,151918136,이집트,2010-06
2010-06-30,192242759,191190091,1052668,남아프리카공화국,2010-06
2010-06-30,177028637,32675431,144353206,헝가리,2010-06
2010-06-30,173949679,425306532,-251356853,프랑스,2010-06
2010-06-30,164944329,3524969,161419360,요르단,2010-06
2010-06-30,157890178,53454938,104435240,몰타,2010-06
2010-06-30,154013651,35905941,118107710,사이프러스,2010-06
2010-06-30,134644158,10897392,123746766,방글라데시,2010-06
2010-06-30,133181418,123622,133057796,알제리,2010-06
2010-06-30,129060355,63732368,65327987,스페인,2010-06
2010-06-30,126227408,194598317,-68370909,이라크,2010-06
2010-06-30,125874119,108327863,17546256,벨기에,2010-06
2010-06-30,124332560,94227706,30104854,오스트리아,2010-06
2010-06-30,123493045,21485618,102007427,시리아,2010-06
2010-06-30,119961833,2321172,117640661,우즈베키스탄,2010-06
2010-06-30,112075980,42221432,69854548,페루,2010-06
2010-06-30,107496986,64216228,43280758,콜롬비아,2010-06
2010-06-30,97514891,23901578,73613313,체코공화국,2010-06
2010-06-30,97367069,727921346,-630554277,쿠웨이트,2010-06
2010-06-30,87750723,51825392,35925331,이스라엘,2010-06
2010-06-30,82366246,43729332,38636914,아르헨티나,2010-06
2010-06-30,81748754,32508566,49240188,리비아,2010-06
2010-06-30,79104939,1115990,77988949,에쿠아도르,2010-06
2010-06-30,77821998,112096751,-34274753,뉴질랜드,2010-06
2010-06-30,74592173,24914846,49677327,파키스탄,2010-06
2010-06-30,68124018,13674013,54450005,나이지리아,2010-06
2010-06-30,58043868,79451697,-21407829,핀란드,2010-06
2010-06-30,57181220,39578698,17602522,우크라이나,2010-06
2010-06-30,56699333,256231516,-199532183,오만,2010-06
2010-06-30,49319909,119581929,-70262020,스웨덴,2010-06
2010-06-30,45781939,28600475,17181464,루마니아,2010-06
2010-06-30,43870997,5974480,37896517,슬로베니아,2010-06
2010-06-30,40374321,2265459,38108862,아이슬란드,2010-06
2010-06-30,39286064,35085566,4200498,카자흐스탄,2010-06
2010-06-30,35827134,4871231,30955903,포루투갈,2010-06
2010-06-30,35687961,973926166,-938238205,카타르,2010-06
2010-06-30,34655436,2921029,31734407,튀니지,2010-06
2010-06-30,33699115,227153,33471962,가이아나,2010-06
2010-06-30,30161720,45627620,-15465900,모로코,2010-06
2010-06-30,30013186,4275895,25737291,미얀마,2010-06
2010-06-30,29547662,5717476,23830186,캄보디아,2010-06
2010-06-30,29022894,2719769,26303125,레바논,2010-06
2010-06-30,28032756,10086926,17945830,과테말라,2010-06
2010-06-30,27443978,171026663,-143582685,스위스,2010-06
2010-06-30,26692776,22482361,4210415,베네주엘라,2010-06
2010-06-30,25590049,0,25590049,불령 폴리네시아,2010-06
2010-06-30,23169161,50021903,-26852742,덴마크,2010-06
2010-06-30,21557796,4884621,16673175,불가리아,2010-06
2010-06-30,20320938,443,20320495,아프카니스탄,2010-06
2010-06-30,19940051,1141489,18798562,케냐,2010-06
2010-06-30,19552776,2316454,17236322,수단,2010-06
2010-06-30,19077379,2791290,16286089,몽골,2010-06
2010-06-30,18949585,583,18949002,아제르바이잔,2010-06
2010-06-30,18835430,56853890,-38018460,바레인,2010-06
2010-06-30,17201762,25429570,-8227808,그리스,2010-06
2010-06-30,16665354,9917614,6747740,코스타리카,2010-06
2010-06-30,16359265,4146300,12212965,앙골라,2010-06
2010-06-30,16177668,390618722,-374441054,노르웨이,2010-06
2010-06-30,16139006,18814785,-2675779,푸에르토리코,2010-06
2010-06-30,16124239,1436420,14687819,니카라과,2010-06
2010-06-30,16024759,233307,15791452,가나,2010-06
2010-06-30,15232292,612733,14619559,파라과이,2010-06
2010-06-30,14768830,5748016,9020814,스리랑카,2010-06
2010-06-30,14404960,4660159,9744801,우루과이,2010-06
2010-06-30,13159697,4652177,8507520,도미니카 공화국,2010-06
2010-06-30,11927430,43680796,-31753366,아일랜드,2010-06
2010-06-30,11704653,1567568,10137085,리투아니아,2010-06
2010-06-30,8735663,0,8735663,코트디봐르,2010-06
2010-06-30,8686334,38967729,-30281395,예맨,2010-06
2010-06-30,8597827,50377,8547450,레소토,2010-06
2010-06-30,8343540,15168572,-6825032,온두라스,2010-06
2010-06-30,7847704,602274,7245430,라트비아,2010-06
2010-06-30,7091476,102836,6988640,키르기스스탄,2010-06
2010-06-30,6559875,546349,6013526,탄자니아,2010-06
2010-06-30,6260005,1563102,4696903,트리니다드 토바고,2010-06
2010-06-30,6229045,218659,6010386,라오스,2010-06
2010-06-30,5679580,3681635,1997945,엘살바도르,2010-06
2010-06-30,5480264,17,5480247,투르크멘,2010-06
2010-06-30,5220050,1065804,4154246,크로아티아,2010-06
2010-06-30,4754671,405894,4348777,베닝,2010-06
2010-06-30,4690426,164606,4525820,아이티,2010-06
2010-06-30,4325399,0,4325399,적도 기니,2010-06
2010-06-30,4164506,609348,3555158,괌,2010-06
2010-06-30,4071142,1114838,2956304,에스토니아,2010-06
2010-06-30,3788405,19442863,-15654458,조지아,2010-06
2010-06-30,3612572,217166205,-213553633,브루나이,2010-06
2010-06-30,3571597,4644605,-1073008,벨라루스,2010-06
2010-06-30,3401372,235424,3165948,쿠바,2010-06
2010-06-30,3393483,5373513,-1980030,파푸아 뉴기니,2010-06
2010-06-30,3368156,376926,2991230,카메룬,2010-06
2010-06-30,3367399,767398,2600001,모잠비크,2010-06
2010-06-30,3330117,9428332,-6098215,기타국,2010-06
2010-06-30,3139923,23716817,-20576894,뉴 칼레도니아,2010-06
2010-06-30,2942843,6869522,-3926679,콩고,2010-06
2010-06-30,2839384,47044,2792340,마다카스카르,2010-06
2010-06-30,2662502,8681045,-6018543,타지크,2010-06
2010-06-30,2614969,329494,2285475,모리셔스,2010-06
2010-06-30,2600044,43641457,-41041413,기니,2010-06
2010-06-30,2413328,1550462,862866,세네갈,2010-06
2010-06-30,2384334,0,2384334,에리트리아,2010-06
2010-06-30,2333321,4539765,-2206444,볼리비아,2010-06
2010-06-30,2151917,1549978,601939,피지,2010-06
2010-06-30,2122281,141324,1980957,마카오,2010-06
2010-06-30,2117810,150912,1966898,세이쉘,2010-06
2010-06-30,2088224,446766,1641458,짐바브웨,2010-06
2010-06-30,2058128,62889,1995239,네팔,2010-06
2010-06-30,2043725,85515,1958210,네덜란드 열도,2010-06
2010-06-30,1814311,5507,1808804,토고,2010-06
2010-06-30,1709080,10257841,-8548761,콩고민주공화국,2010-06
2010-06-30,1635177,21001,1614176,안도라,2010-06
2010-06-30,1612423,1003554,608869,에티오피아,2010-06
2010-06-30,1563502,27440,1536062,세르비아,2010-06
2010-06-30,1416960,182152,1234808,바베이도스,2010-06
2010-06-30,1409962,42592,1367370,마이크로네시아,2010-06
2010-06-30,1395857,846,1395011,아르메니아,2010-06
2010-06-30,1378064,42458,1335606,팔레스타인 해방기구,2010-06
2010-06-30,1361795,2400146,-1038351,룩셈부르그,2010-06
2010-06-30,1321163,369373,951790,자마이카,2010-06
2010-06-30,1144162,891,1143271,지부티,2010-06
2010-06-30,1137845,91067,1046778,가봉,2010-06
2010-06-30,1127127,42630,1084497,도미니카,2010-06
2010-06-30,1105806,6099,1099707,알바니아,2010-06
2010-06-30,1103559,28,1103531,부탄,2010-06
2010-06-30,1094748,67513,1027235,아루바,2010-06
2010-06-30,1059424,0,1059424,마티니크,2010-06
2010-06-30,1037697,31408,1006289,불령 리유니온 코모도 제도,2010-06
2010-06-30,884453,85709,798744,우간다,2010-06
2010-06-30,879548,2764089,-1884541,스와질랜드,2010-06
2010-06-30,806814,21983,784831,보츠와나,2010-06
2010-06-30,730805,0,730805,부르키나 파소,2010-06
2010-06-30,730531,130,730401,니제르,2010-06
2010-06-30,696925,58346,638579,모리타니,2010-06
2010-06-30,660978,12,660966,르완다,2010-06
2010-06-30,582288,5292141,-4709853,말라위,2010-06
2010-06-30,529369,27180080,-26650711,잠비아,2010-06
2010-06-30,490759,89375,401384,시에라 리온,2010-06
2010-06-30,478177,614,477563,과델로프,2010-06
2010-06-30,472207,138819,333388,바하마,2010-06
2010-06-30,463347,1406267,-942920,나미비아,2010-06
2010-06-30,434544,123343,311201,벨리제,2010-06
2010-06-30,412479,66860,345619,북마리아나 군도,2010-06
2010-06-30,377403,259216,118187,수리남,2010-06
2010-06-30,368322,0,368322,영령 캐이맨 군도,2010-06
2010-06-30,366152,0,366152,그레나다,2010-06
2010-06-30,357346,701576,-344230,리히텐슈타인,2010-06
2010-06-30,355341,19184,336157,사모아,2010-06
2010-06-30,323768,71,323697,불령 가이아나,2010-06
2010-06-30,314095,174989,139106,바누아투,2010-06
2010-06-30,278598,2007,276591,세인트 루시아,2010-06
2010-06-30,225531,3561,221970,안티가 바부다,2010-06
2010-06-30,181125,0,181125,챠드,2010-06
2010-06-30,172340,39038,133302,보스니아-헤르체고비나,2010-06
2010-06-30,170747,82,170665,아메리칸 사모아,2010-06
2010-06-30,162751,378405,-215654,모나코,2010-06
2010-06-30,148918,4877,144041,팔라우,2010-06
2010-06-30,128536,188,128348,몰디브,2010-06
2010-06-30,126436,95827,30609,몰도바,2010-06
2010-06-30,107637,194,107443,투르크 & 카이코스 군도,2010-06
2010-06-30,86952,0,86952,카보 베르데,2010-06
2010-06-30,80609,943084,-862475,마세도니아,2010-06
2010-06-30,78629,738029,-659400,솔로몬 군도,2010-06
2010-06-30,72258,76,72182,감비아,2010-06
2010-06-30,64223,0,64223,몬테네그로,2010-06
2010-06-30,44441,50,44391,미령 버진군도,2010-06
2010-06-30,44176,13169,31007,말리,2010-06
2010-06-30,35373,33956,1417,쿡 아일랜드,2010-06
2010-06-30,31905,1165,30740,세인트 키츠 네비스,2010-06
2010-06-30,30875,0,30875,세인트 빈센트 그레나딘,2010-06
2010-06-30,24918,10470,14448,영령 버진군도,2010-06
2010-06-30,24480,658,23822,투발루,2010-06
2010-06-30,21176,0,21176,산마리노,2010-06
2010-06-30,16237,0,16237,지브랄타,2010-06
2010-06-30,15775,0,15775,남조지아 & 남샌드위치 군도,2010-06
2010-06-30,14068,0,14068,파로에 군도,2010-06
2010-06-30,12722,0,12722,메요트,2010-06
2010-06-30,3006,81734,-78728,그린랜드,2010-06
2010-06-30,941,0,941,세인트 마틴,2010-06
2010-06-30,93,0,93,티모르,2010-06
2010-06-30,0,24463,-24463,기네비소,2010-06
2010-06-30,0,21189,-21189,중앙아프리카공화국,2010-06
2010-06-30,0,143270,-143270,토켈라우,2010-06
2010-06-30,0,85,-85,몬트세라트,2010-06
2010-06-30,0,3273943,-3273943,나우루,2010-06
2010-06-30,0,20297,-20297,포클랜드 군도,2010-06
2010-06-30,0,3714,-3714,세인트 헬레나,2010-06
2010-06-30,0,25911,-25911,통가,2010-06
2010-07-31,9878814065,6035353350,3843460715,중국,2010-07
2010-07-31,4540970111,3506440597,1034529514,미국,2010-07
2010-07-31,2485476304,5695859843,-3210383539,일본,2010-07
2010-07-31,2089795417,162962934,1926832483,홍콩,2010-07
2010-07-31,1209982688,1219912781,-9930093,대만,2010-07
2010-07-31,1172894708,624783329,548111379,싱가포르,2010-07
2010-07-31,1054789178,422397198,632391980,인도,2010-07
2010-07-31,982921286,1215530067,-232608781,독일,2010-07
2010-07-31,862378329,268839727,593538602,베트남,2010-07
2010-07-31,809066529,156693639,652372890,멕시코,2010-07
2010-07-31,773494059,1079593791,-306099732,인도네시아,2010-07
2010-07-31,729128334,415855553,313272781,브라질,2010-07
2010-07-31,701657881,62720,701595161,라이베리아,2010-07
2010-07-31,677590396,882177328,-204586932,러시아 연방,2010-07
2010-07-31,622925415,1977480722,-1354555307,호주,2010-07
2010-07-31,563057330,257533110,305524220,영국,2010-07
2010-07-31,558689733,901670802,-342981069,말레이시아,2010-07
2010-07-31,550429402,751534,549677868,마샬군도,2010-07
2010-07-31,536937900,331217433,205720467,태국,2010-07
2010-07-31,500089583,280590022,219499561,필리핀,2010-07
2010-07-31,451382609,6780179,444602430,슬로바키아,2010-07
2010-07-31,396945517,285848372,111097145,네덜란드,2010-07
2010-07-31,380711449,29593051,351118398,폴란드,2010-07
2010-07-31,377841433,2166186927,-1788345494,사우디아라비아,2010-07
2010-07-31,376930826,973646168,-596715342,아랍에미리트 연합,2010-07
2010-07-31,375005538,43635956,331369582,몰타,2010-07
2010-07-31,366740959,262224,366478735,리비아,2010-07
2010-07-31,362255952,450010305,-87754353,이란,2010-07
2010-07-31,339612582,347569817,-7957235,프랑스,2010-07
2010-07-31,339349635,38718789,300630846,튀르키예,2010-07
2010-07-31,334234771,314970653,19264118,캐나다,2010-07
2010-07-31,275573861,333840636,-58266775,이탈리아,2010-07
2010-07-31,259794937,361392389,-101597452,칠레,2010-07
2010-07-31,259321409,35126976,224194433,파나마,2010-07
2010-07-31,192087132,5777599,186309533,그리스,2010-07
2010-07-31,191506206,34120054,157386152,헝가리,2010-07
2010-07-31,172546937,47765840,124781097,이집트,2010-07
2010-07-31,151887989,183286031,-31398042,남아프리카공화국,2010-07
2010-07-31,148473166,91240011,57233155,벨기에,2010-07
2010-07-31,139631747,8484894,131146853,방글라데시,2010-07
2010-07-31,137565812,45007055,92558757,콜롬비아,2010-07
2010-07-31,130904643,105359071,25545572,스페인,2010-07
2010-07-31,129193586,52688757,76504829,알제리,2010-07
2010-07-31,123360099,636269325,-512909226,쿠웨이트,2010-07
2010-07-31,115169570,1725002,113444568,우즈베키스탄,2010-07
2010-07-31,114857765,26423092,88434673,카자흐스탄,2010-07
2010-07-31,113615122,36004581,77610541,사이프러스,2010-07
2010-07-31,102401565,3266459,99135106,요르단,2010-07
2010-07-31,101822302,420782,101401520,시리아,2010-07
2010-07-31,96543235,405021631,-308478396,노르웨이,2010-07
2010-07-31,92580007,27937533,64642474,체코공화국,2010-07
2010-07-31,91706733,177860545,-86153812,이라크,2010-07
2010-07-31,81961229,58266015,23695214,아르헨티나,2010-07
2010-07-31,77172954,260914635,-183741681,오만,2010-07
2010-07-31,74711703,62591985,12119718,이스라엘,2010-07
2010-07-31,70304172,77531550,-7227378,페루,2010-07
2010-07-31,69813236,5080140,64733096,나이지리아,2010-07
2010-07-31,65020407,83516648,-18496241,우크라이나,2010-07
2010-07-31,64895926,529290,64366636,에쿠아도르,2010-07
2010-07-31,62018798,22585005,39433793,파키스탄,2010-07
2010-07-31,55761492,102588497,-46827005,스웨덴,2010-07
2010-07-31,55130525,63664447,-8533922,오스트리아,2010-07
2010-07-31,54992912,100192312,-45199400,핀란드,2010-07
2010-07-31,54603260,1396353,53206907,아이슬란드,2010-07
2010-07-31,51983302,8661087,43322215,미얀마,2010-07
2010-07-31,49842202,101369756,-51527554,뉴질랜드,2010-07
2010-07-31,46815476,831866296,-785050820,카타르,2010-07
2010-07-31,44960185,5877916,39082269,슬로베니아,2010-07
2010-07-31,37930166,4193832,33736334,튀니지,2010-07
2010-07-31,37784303,24446690,13337613,예맨,2010-07
2010-07-31,37448499,50,37448449,지브랄타,2010-07
2010-07-31,34183072,26065559,8117513,베네주엘라,2010-07
2010-07-31,30023206,15367891,14655315,과테말라,2010-07
2010-07-31,29335138,10684381,18650757,루마니아,2010-07
2010-07-31,29115259,38731747,-9616488,모로코,2010-07
2010-07-31,29044278,2184108,26860170,캄보디아,2010-07
2010-07-31,28405594,6847046,21558548,포루투갈,2010-07
2010-07-31,24037143,1189449,22847694,레바논,2010-07
2010-07-31,23052467,161090671,-138038204,스위스,2010-07
2010-07-31,22819257,27681,22791576,불령 폴리네시아,2010-07
2010-07-31,22509109,19369579,3139530,푸에르토리코,2010-07
2010-07-31,22265018,48666295,-26401277,덴마크,2010-07
2010-07-31,21366334,10911939,10454395,코스타리카,2010-07
2010-07-31,21163971,195,21163776,아제르바이잔,2010-07
2010-07-31,20601319,3275678,17325641,스리랑카,2010-07
2010-07-31,19805399,60337457,-40532058,바레인,2010-07
2010-07-31,18712725,2622544,16090181,우루과이,2010-07
2010-07-31,18428032,3090187,15337845,가나,2010-07
2010-07-31,17091255,58416273,-41325018,아일랜드,2010-07
2010-07-31,16922082,1517864,15404218,리투아니아,2010-07
2010-07-31,16711649,11757800,4953849,앙골라,2010-07
2010-07-31,15831687,6267581,9564106,몽골,2010-07
2010-07-31,14465691,1711091,12754600,케냐,2010-07
2010-07-31,14465685,1588009,12877676,니카라과,2010-07
2010-07-31,13832744,1237558,12595186,수단,2010-07
2010-07-31,13732365,4215459,9516906,탄자니아,2010-07
2010-07-31,13659646,3762588,9897058,도미니카 공화국,2010-07
2010-07-31,11916414,708544,11207870,파라과이,2010-07
2010-07-31,10980684,10724,10969960,투르크멘,2010-07
2010-07-31,10329610,9419204,910406,온두라스,2010-07
2010-07-31,9027272,3665,9023607,레소토,2010-07
2010-07-31,8720124,2266344,6453780,엘살바도르,2010-07
2010-07-31,8545276,2681584,5863692,기타국,2010-07
2010-07-31,8511277,108828,8402449,키르기스스탄,2010-07
2010-07-31,8391457,2091265,6300192,라트비아,2010-07
2010-07-31,8184898,155918,8028980,코트디봐르,2010-07
2010-07-31,8082267,141294934,-133212667,브루나이,2010-07
2010-07-31,6934585,152356,6782229,라오스,2010-07
2010-07-31,6769789,15335631,-8565842,뉴 칼레도니아,2010-07
2010-07-31,6725950,2212258,4513692,에스토니아,2010-07
2010-07-31,5351434,76752,5274682,카메룬,2010-07
2010-07-31,4407024,3293922,1113102,불가리아,2010-07
2010-07-31,4330396,1244247,3086149,트리니다드 토바고,2010-07
2010-07-31,4180607,319275,3861332,괌,2010-07
2010-07-31,4155606,1092837,3062769,베닝,2010-07
2010-07-31,4035322,2904188,1131134,세네갈,2010-07
2010-07-31,4029024,985975,3043049,크로아티아,2010-07
2010-07-31,3998540,624212,3374328,조지아,2010-07
2010-07-31,3904477,1478549,2425928,모리셔스,2010-07
2010-07-31,3744416,6616,3737800,아프카니스탄,2010-07
2010-07-31,3580624,88010,3492614,네팔,2010-07
2010-07-31,3257015,172583,3084432,짐바브웨,2010-07
2010-07-31,3100493,2478849,621644,벨라루스,2010-07
2010-07-31,3087613,215769,2871844,모잠비크,2010-07
2010-07-31,2828228,1526028,1302200,에티오피아,2010-07
2010-07-31,2827513,8639955,-5812442,타지크,2010-07
2010-07-31,2751270,305576,2445694,마카오,2010-07
2010-07-31,2714605,229224,2485381,아이티,2010-07
2010-07-31,2711396,32042,2679354,쿠바,2010-07
2010-07-31,2387361,769093,1618268,파푸아 뉴기니,2010-07
2010-07-31,2317076,64220,2252856,마다카스카르,2010-07
2010-07-31,2174677,152922,2021755,콩고,2010-07
2010-07-31,2146759,2319345,-172586,룩셈부르그,2010-07
2010-07-31,2109136,18462,2090674,도미니카,2010-07
2010-07-31,2034559,0,2034559,나우루,2010-07
2010-07-31,2002064,26314,1975750,지부티,2010-07
2010-07-31,1868843,0,1868843,토고,2010-07
2010-07-31,1828380,0,1828380,부르키나 파소,2010-07
2010-07-31,1662249,10733217,-9070968,콩고민주공화국,2010-07
2010-07-31,1575914,962774,613140,피지,2010-07
2010-07-31,1519121,29438,1489683,가이아나,2010-07
2010-07-31,1328243,354623,973620,자마이카,2010-07
2010-07-31,1233198,739717,493481,기니,2010-07
2010-07-31,1214547,31176869,-29962322,잠비아,2010-07
2010-07-31,1193231,37927,1155304,세이쉘,2010-07
2010-07-31,1190320,0,1190320,부탄,2010-07
2010-07-31,1160949,5163,1155786,아르메니아,2010-07
2010-07-31,1116071,44483762,-43367691,볼리비아,2010-07
2010-07-31,1009967,0,1009967,불령 리유니온 코모도 제도,2010-07
2010-07-31,1005734,424928,580806,우간다,2010-07
2010-07-31,980143,163529,816614,수리남,2010-07
2010-07-31,970804,71100,899704,네덜란드 열도,2010-07
2010-07-31,913260,53771,859489,보츠와나,2010-07
2010-07-31,895458,0,895458,아루바,2010-07
2010-07-31,870245,512421,357824,몰도바,2010-07
2010-07-31,864367,221661,642706,바베이도스,2010-07
2010-07-31,834284,15250,819034,팔레스타인 해방기구,2010-07
2010-07-31,822230,410323,411907,말라위,2010-07
2010-07-31,801512,31586,769926,르완다,2010-07
2010-07-31,774430,0,774430,에리트리아,2010-07
2010-07-31,774078,0,774078,챠드,2010-07
2010-07-31,746154,0,746154,마티니크,2010-07
2010-07-31,736445,4237666,-3501221,세르비아,2010-07
2010-07-31,646770,42560,604210,마이크로네시아,2010-07
2010-07-31,585400,398294,187106,니제르,2010-07
2010-07-31,500591,275887,224704,바하마,2010-07
2010-07-31,484193,460,483733,아메리칸 사모아,2010-07
2010-07-31,430616,41986,388630,시에라 리온,2010-07
2010-07-31,425688,244,425444,과델로프,2010-07
2010-07-31,416640,49732,366908,벨리제,2010-07
2010-07-31,364632,1115629,-750997,스와질랜드,2010-07
2010-07-31,361122,0,361122,북마리아나 군도,2010-07
2010-07-31,357430,7430,350000,바누아투,2010-07
2010-07-31,320237,0,320237,불령 가이아나,2010-07
2010-07-31,300733,0,300733,티모르,2010-07
2010-07-31,284424,9916,274508,안도라,2010-07
2010-07-31,278755,17066950,-16788195,가봉,2010-07
2010-07-31,240625,22927,217698,알바니아,2010-07
2010-07-31,234587,32009,202578,마세도니아,2010-07
2010-07-31,232607,869646,-637039,솔로몬 군도,2010-07
2010-07-31,229157,422833,-193676,리히텐슈타인,2010-07
2010-07-31,219308,99303,120005,보스니아-헤르체고비나,2010-07
2010-07-31,216003,0,216003,영령 캐이맨 군도,2010-07
2010-07-31,209374,364869,-155495,나미비아,2010-07
2010-07-31,202003,250143,-48140,사모아,2010-07
2010-07-31,186133,0,186133,기네비소,2010-07
2010-07-31,174193,396851,-222658,모리타니,2010-07
2010-07-31,171000,0,171000,세인트 루시아,2010-07
2010-07-31,139147,0,139147,몬테네그로,2010-07
2010-07-31,137522,0,137522,팔라우,2010-07
2010-07-31,130819,139,130680,몰디브,2010-07
2010-07-31,106204,0,106204,노폴크 아일랜드,2010-07
2010-07-31,84597,28,84569,감비아,2010-07
2010-07-31,83720,0,83720,그레나다,2010-07
2010-07-31,73185,0,73185,세인트 빈센트 그레나딘,2010-07
2010-07-31,56676,0,56676,버뮤다,2010-07
2010-07-31,54356,1737,52619,안티가 바부다,2010-07
2010-07-31,52369,600162,-547793,모나코,2010-07
2010-07-31,25611,2968,22643,세인트 키츠 네비스,2010-07
2010-07-31,15588,6344,9244,부룬디,2010-07
2010-07-31,11574,0,11574,투르크 & 카이코스 군도,2010-07
2010-07-31,5831,0,5831,교황청,2010-07
2010-07-31,2990,32588,-29598,앙귈라,2010-07
2010-07-31,2900,0,2900,영령 인도양,2010-07
2010-07-31,2037,84112,-82075,그린랜드,2010-07
2010-07-31,1115,559657,-558542,카보 베르데,2010-07
2010-07-31,388,0,388,키리바티,2010-07
2010-07-31,305,0,305,몬트세라트,2010-07
2010-07-31,0,82,-82,세인트 헬레나,2010-07
2010-07-31,0,29066773,-29066773,말리,2010-07
2010-07-31,0,790,-790,맨섬,2010-07
2010-07-31,0,3789,-3789,통가,2010-07
2010-07-31,0,1000,-1000,영령 버진군도,2010-07
2010-07-31,0,29,-29,코스 군도,2010-07
2010-07-31,0,86519,-86519,토켈라우,2010-07
2010-07-31,0,826,-826,산마리노,2010-07
2010-07-31,0,41473752,-41473752,적도 기니,2010-07
2010-07-31,0,585,-585,미령 버진군도,2010-07
2010-08-31,9612204216,5830149929,3782054287,중국,2010-08
2010-08-31,4050745180,3274562930,776182250,미국,2010-08
2010-08-31,2413490771,5479687795,-3066197024,일본,2010-08
2010-08-31,2162058130,154293299,2007764831,홍콩,2010-08
2010-08-31,1328214063,1153590520,174623543,대만,2010-08
2010-08-31,1058848725,636038797,422809928,싱가포르,2010-08
2010-08-31,955465444,414549322,540916122,인도,2010-08
2010-08-31,788435685,228179847,560255838,베트남,2010-08
2010-08-31,740572072,118968851,621603221,멕시코,2010-08
2010-08-31,637569975,404222496,233347479,브라질,2010-08
2010-08-31,618569190,767661134,-149091944,러시아 연방,2010-08
2010-08-31,593751490,1100422400,-506670910,인도네시아,2010-08
2010-08-31,586919245,0,586919245,영령 캐이맨 군도,2010-08
2010-08-31,545755742,331904489,213851253,태국,2010-08
2010-08-31,519294870,179713495,339581375,파나마,2010-08
2010-08-31,505374334,7097778,498276556,슬로바키아,2010-08
2010-08-31,493533668,1345265487,-851731819,독일,2010-08
2010-08-31,458670203,703138288,-244468085,말레이시아,2010-08
2010-08-31,456684486,342694056,113990430,필리핀,2010-08
2010-08-31,453208692,23477316,429731376,폴란드,2010-08
2010-08-31,437079234,1830149004,-1393069770,호주,2010-08
2010-08-31,377534321,2252900413,-1875366092,사우디아라비아,2010-08
2010-08-31,323806024,962308230,-638502206,아랍에미리트 연합,2010-08
2010-08-31,318138916,339121226,-20982310,프랑스,2010-08
2010-08-31,305541297,318802044,-13260747,영국,2010-08
2010-08-31,299753201,384447002,-84693801,네덜란드,2010-08
2010-08-31,298735423,295574833,3160590,캐나다,2010-08
2010-08-31,294996461,321455671,-26459210,이탈리아,2010-08
2010-08-31,272939154,392945457,-120006303,칠레,2010-08
2010-08-31,265300760,47190560,218110200,튀르키예,2010-08
2010-08-31,264238575,27336819,236901756,이집트,2010-08
2010-08-31,240305381,618901717,-378596336,이란,2010-08
2010-08-31,209990308,43983440,166006868,헝가리,2010-08
2010-08-31,142742198,0,142742198,영령 버진군도,2010-08
2010-08-31,138760121,63149471,75610650,이스라엘,2010-08
2010-08-31,134093372,190798601,-56705229,남아프리카공화국,2010-08
2010-08-31,132374621,52845115,79529506,콜롬비아,2010-08
2010-08-31,128930322,16336,128913986,알제리,2010-08
2010-08-31,127164013,91251083,35912930,스페인,2010-08
2010-08-31,119584559,1554221,118030338,우즈베키스탄,2010-08
2010-08-31,117808630,127042009,-9233379,벨기에,2010-08
2010-08-31,112756480,69706,112686774,라이베리아,2010-08
2010-08-31,109074897,14754833,94320064,방글라데시,2010-08
2010-08-31,97417523,10107365,87310158,몰타,2010-08
2010-08-31,96244400,586431,95657969,시리아,2010-08
2010-08-31,94403843,25512892,68890951,체코공화국,2010-08
2010-08-31,88945342,3302485,85642857,그리스,2010-08
2010-08-31,85489386,2157236,83332150,요르단,2010-08
2010-08-31,78196260,94666928,-16470668,뉴질랜드,2010-08
2010-08-31,77824054,84082174,-6258120,아르헨티나,2010-08
2010-08-31,69501442,1039473884,-969972442,쿠웨이트,2010-08
2010-08-31,68533759,3433020,65100739,리비아,2010-08
2010-08-31,64150135,42620491,21529644,나이지리아,2010-08
2010-08-31,62194313,266892019,-204697706,오만,2010-08
2010-08-31,61258886,51802933,9455953,우크라이나,2010-08
2010-08-31,60125330,66395621,-6270291,페루,2010-08
2010-08-31,58940251,90669981,-31729730,오스트리아,2010-08
2010-08-31,57366067,14565809,42800258,슬로베니아,2010-08
2010-08-31,56776377,202247307,-145470930,이라크,2010-08
2010-08-31,56521863,0,56521863,마샬군도,2010-08
2010-08-31,53745325,5361773,48383552,베네주엘라,2010-08
2010-08-31,53305793,22401951,30903842,파키스탄,2010-08
2010-08-31,51839508,18940428,32899080,루마니아,2010-08
2010-08-31,47377384,99000405,-51623021,핀란드,2010-08
2010-08-31,45468810,113072268,-67603458,스웨덴,2010-08
2010-08-31,40256224,367501,39888723,스와질랜드,2010-08
2010-08-31,39876017,1581186,38294831,에쿠아도르,2010-08
2010-08-31,31963620,26646312,5317308,카자흐스탄,2010-08
2010-08-31,29309248,18179225,11130023,미얀마,2010-08
2010-08-31,27712030,939100822,-911388792,카타르,2010-08
2010-08-31,27485595,3157598,24327997,캄보디아,2010-08
2010-08-31,26116865,10048616,16068249,과테말라,2010-08
2010-08-31,25409976,5711692,19698284,모로코,2010-08
2010-08-31,23108134,8814,23099320,괌,2010-08
2010-08-31,22336404,213948,22122456,가나,2010-08
2010-08-31,22303113,5195696,17107417,스리랑카,2010-08
2010-08-31,22118985,7741111,14377874,포루투갈,2010-08
2010-08-31,21324340,808433,20515907,레바논,2010-08
2010-08-31,20823628,152161234,-131337606,스위스,2010-08
2010-08-31,19915328,42717100,-22801772,덴마크,2010-08
2010-08-31,19028345,38656,18989689,투르크멘,2010-08
2010-08-31,16921348,564,16920784,아제르바이잔,2010-08
2010-08-31,16720411,24039,16696372,레소토,2010-08
2010-08-31,16546244,10669159,5877085,코스타리카,2010-08
2010-08-31,16183705,3868803,12314902,몽골,2010-08
2010-08-31,14574274,20393302,-5819028,앙골라,2010-08
2010-08-31,14114280,206683,13907597,케냐,2010-08
2010-08-31,12908789,3004417,9904372,튀니지,2010-08
2010-08-31,12497580,605590,11891990,수단,2010-08
2010-08-31,12461543,1170200,11291343,우루과이,2010-08
2010-08-31,12266603,18624640,-6358037,푸에르토리코,2010-08
2010-08-31,11740977,11978425,-237448,탄자니아,2010-08
2010-08-31,11676764,418544,11258220,파라과이,2010-08
2010-08-31,11585397,3756425,7828972,도미니카 공화국,2010-08
2010-08-31,11312183,1865,11310318,아프카니스탄,2010-08
2010-08-31,10917719,1984506,8933213,리투아니아,2010-08
2010-08-31,9929826,1522166,8407660,니카라과,2010-08
2010-08-31,9767930,49574668,-39806738,아일랜드,2010-08
2010-08-31,9390079,197244,9192835,키르기스스탄,2010-08
2010-08-31,9356068,393212173,-383856105,노르웨이,2010-08
2010-08-31,9252956,32414,9220542,코트디봐르,2010-08
2010-08-31,9010310,60150010,-51139700,바레인,2010-08
2010-08-31,7832217,58189,7774028,콩고,2010-08
2010-08-31,7086542,6120646,965896,온두라스,2010-08
2010-08-31,6955675,689350,6266325,라트비아,2010-08
2010-08-31,6195170,26629082,-20433912,예맨,2010-08
2010-08-31,6108828,14778209,-8669381,불가리아,2010-08
2010-08-31,4694389,1681134,3013255,엘살바도르,2010-08
2010-08-31,4690946,395736,4295210,기니,2010-08
2010-08-31,4552058,359653,4192405,쿠바,2010-08
2010-08-31,4275895,1640818,2635077,모리셔스,2010-08
2010-08-31,4048212,842936,3205276,조지아,2010-08
2010-08-31,4042684,990482,3052202,세네갈,2010-08
2010-08-31,3945724,167775,3777949,마다카스카르,2010-08
2010-08-31,3917575,1230750,2686825,에스토니아,2010-08
2010-08-31,3861171,971980,2889191,트리니다드 토바고,2010-08
2010-08-31,3860364,11850835,-7990471,뉴 칼레도니아,2010-08
2010-08-31,3852786,638826,3213960,베닝,2010-08
2010-08-31,3841582,5355849,-1514267,기타국,2010-08
2010-08-31,3636024,17502773,-13866749,라오스,2010-08
2010-08-31,3557653,99197,3458456,네팔,2010-08
2010-08-31,3315284,694610,2620674,카메룬,2010-08
2010-08-31,2922417,185,2922232,지부티,2010-08
2010-08-31,2918802,37389157,-34470355,잠비아,2010-08
2010-08-31,2834556,2786172,48384,벨라루스,2010-08
2010-08-31,2824662,918607,1906055,크로아티아,2010-08
2010-08-31,2747391,1305962,1441429,에티오피아,2010-08
2010-08-31,2348683,92859,2255824,자마이카,2010-08
2010-08-31,2299596,108308,2191288,아이티,2010-08
2010-08-31,2267075,113441768,-111174693,브루나이,2010-08
2010-08-31,2263926,1265,2262661,모잠비크,2010-08
2010-08-31,1986665,434312,1552353,짐바브웨,2010-08
2010-08-31,1972603,7912918,-5940315,사이프러스,2010-08
2010-08-31,1919765,8815827,-6896062,타지크,2010-08
2010-08-31,1906614,669344,1237270,우간다,2010-08
2010-08-31,1854043,0,1854043,부탄,2010-08
2010-08-31,1760102,1800718,-40616,룩셈부르그,2010-08
2010-08-31,1688775,4664356,-2975581,세르비아,2010-08
2010-08-31,1584369,397915,1186454,수리남,2010-08
2010-08-31,1566223,264196,1302027,말라위,2010-08
2010-08-31,1395144,132283,1262861,토고,2010-08
2010-08-31,1369126,243878,1125248,마카오,2010-08
2010-08-31,1364690,3535578,-2170888,파푸아 뉴기니,2010-08
2010-08-31,1309256,0,1309256,팔레스타인 해방기구,2010-08
2010-08-31,1303991,494,1303497,아르메니아,2010-08
2010-08-31,1300208,119662,1180546,가이아나,2010-08
2010-08-31,1277317,21129,1256188,말리,2010-08
2010-08-31,1269571,47172,1222399,세이쉘,2010-08
2010-08-31,1231182,13144,1218038,르완다,2010-08
2010-08-31,1194400,40,1194360,불령 리유니온 코모도 제도,2010-08
2010-08-31,1172620,5918550,-4745930,볼리비아,2010-08
2010-08-31,1164936,22849,1142087,시에라 리온,2010-08
2010-08-31,1144804,23884,1120920,알바니아,2010-08
2010-08-31,1100761,1282847,-182086,피지,2010-08
2010-08-31,1060376,12132679,-11072303,콩고민주공화국,2010-08
2010-08-31,1006134,7651,998483,네덜란드 열도,2010-08
2010-08-31,986872,0,986872,가봉,2010-08
2010-08-31,826468,57457,769011,바베이도스,2010-08
2010-08-31,674552,38961,635591,바하마,2010-08
2010-08-31,638032,144,637888,도미니카,2010-08
2010-08-31,629638,1761451,-1131813,아이슬란드,2010-08
2010-08-31,582904,933,581971,벨리제,2010-08
2010-08-31,553492,314378,239114,모리타니,2010-08
2010-08-31,483840,411582,72258,아루바,2010-08
2010-08-31,449616,267071,182545,마세도니아,2010-08
2010-08-31,440003,1098,438905,과델로프,2010-08
2010-08-31,428997,86501,342496,마이크로네시아,2010-08
2010-08-31,390767,973,389794,북마리아나 군도,2010-08
2010-08-31,368241,501129,-132888,리히텐슈타인,2010-08
2010-08-31,348610,318844,29766,보스니아-헤르체고비나,2010-08
2010-08-31,327515,0,327515,마티니크,2010-08
2010-08-31,298902,0,298902,불령 가이아나,2010-08
2010-08-31,269344,0,269344,티모르,2010-08
2010-08-31,251185,4862,246323,아메리칸 사모아,2010-08
2010-08-31,250983,75865,175118,불령 폴리네시아,2010-08
2010-08-31,241928,0,241928,몬테네그로,2010-08
2010-08-31,210508,366504,-155996,나미비아,2010-08
2010-08-31,209190,30149,179041,보츠와나,2010-08
2010-08-31,195439,346,195093,카보 베르데,2010-08
2010-08-31,161388,4498,156890,몰디브,2010-08
2010-08-31,155488,0,155488,산마리노,2010-08
2010-08-31,151985,5717,146268,감비아,2010-08
2010-08-31,145721,696765,-551044,몰도바,2010-08
2010-08-31,145622,369100,-223478,사모아,2010-08
2010-08-31,133545,345,133200,니제르,2010-08
2010-08-31,132079,0,132079,버뮤다,2010-08
2010-08-31,125443,74,125369,그레나다,2010-08
2010-08-31,115892,0,115892,코모로스,2010-08
2010-08-31,114920,189695,-74775,모나코,2010-08
2010-08-31,113628,0,113628,세인트 루시아,2010-08
2010-08-31,112773,0,112773,소말리아,2010-08
2010-08-31,93933,0,93933,팔라우,2010-08
2010-08-31,89407,80644,8763,안도라,2010-08
2010-08-31,74420,39103,35317,세인트 키츠 네비스,2010-08
2010-08-31,65657,0,65657,지브랄타,2010-08
2010-08-31,63661,21614,42047,안티가 바부다,2010-08
2010-08-31,57921,0,57921,에리트리아,2010-08
2010-08-31,56769,71759,-14990,중앙아프리카공화국,2010-08
2010-08-31,55013,0,55013,국제통화기금,2010-08
2010-08-31,52873,0,52873,노폴크 아일랜드,2010-08
2010-08-31,48620,0,48620,메요트,2010-08
2010-08-31,45951,0,45951,부르키나 파소,2010-08
2010-08-31,42015,879507,-837492,솔로몬 군도,2010-08
2010-08-31,25884,798,25086,챠드,2010-08
2010-08-31,20108,0,20108,세인트 빈센트 그레나딘,2010-08
2010-08-31,7200,0,7200,투발루,2010-08
2010-08-31,6416,582,5834,남조지아 & 남샌드위치 군도,2010-08
2010-08-31,5802,42957655,-42951853,적도 기니,2010-08
2010-08-31,5255,13,5242,앙귈라,2010-08
2010-08-31,3376,0,3376,영령 인도양,2010-08
2010-08-31,3260,14419,-11159,쿡 아일랜드,2010-08
2010-08-31,1195,78744,-77549,토켈라우,2010-08
2010-08-31,264,2624,-2360,바누아투,2010-08
2010-08-31,50,129935,-129885,그린랜드,2010-08
2010-08-31,2,0,2,상토메 프린스페,2010-08
2010-08-31,0,2111,-2111,피트카이른,2010-08
2010-08-31,0,1053,-1053,세인트 헬레나,2010-08
2010-08-31,0,7858,-7858,키리바티,2010-08
2010-08-31,0,3375133,-3375133,나우루,2010-08
2010-08-31,0,15,-15,보빗군도,2010-08
2010-08-31,0,8621,-8621,안타티카,2010-08
2010-08-31,0,33,-33,포클랜드 군도,2010-08
2010-09-30,9714201518,5866007925,3848193593,중국,2010-09
2010-09-30,4149300882,3316215810,833085072,미국,2010-09
2010-09-30,2377541636,5371262333,-2993720697,일본,2010-09
2010-09-30,2041916588,182933012,1858983576,홍콩,2010-09
2010-09-30,1469669911,613106328,856563583,싱가포르,2010-09
2010-09-30,1209252899,1217266416,-8013517,대만,2010-09
2010-09-30,1013802776,375892882,637909894,인도,2010-09
2010-09-30,858723234,344104334,514618900,베트남,2010-09
2010-09-30,803390230,134611871,668778359,멕시코,2010-09
2010-09-30,733125995,3958,733122037,영령 버진군도,2010-09
2010-09-30,700734464,824941151,-124206687,러시아 연방,2010-09
2010-09-30,676762433,421489810,255272623,브라질,2010-09
2010-09-30,668345631,1318068150,-649722519,인도네시아,2010-09
2010-09-30,603595208,238421429,365173779,영국,2010-09
2010-09-30,583325076,1852425891,-1269100815,호주,2010-09
2010-09-30,535053899,1200867379,-665813480,독일,2010-09
2010-09-30,533076681,1318,533075363,바누아투,2010-09
2010-09-30,505758800,366745666,139013134,태국,2010-09
2010-09-30,482681205,658730467,-176049262,말레이시아,2010-09
2010-09-30,472632441,42756553,429875888,튀르키예,2010-09
2010-09-30,470319981,256820736,213499245,필리핀,2010-09
2010-09-30,433342305,2124607,431217698,파나마,2010-09
2010-09-30,420792631,1069547101,-648754470,아랍에미리트 연합,2010-09
2010-09-30,412647967,25614754,387033213,폴란드,2010-09
2010-09-30,396363936,90955800,305408136,벨기에,2010-09
2010-09-30,378775548,13524555,365250993,슬로바키아,2010-09
2010-09-30,356463089,347190947,9272142,캐나다,2010-09
2010-09-30,354238514,273307494,80931020,네덜란드,2010-09
2010-09-30,343212832,306117399,37095433,이탈리아,2010-09
2010-09-30,339359995,254323972,85036023,노르웨이,2010-09
2010-09-30,338495307,327896882,10598425,프랑스,2010-09
2010-09-30,336227223,2245460641,-1909233418,사우디아라비아,2010-09
2010-09-30,292735151,6437,292728714,라이베리아,2010-09
2010-09-30,265373337,339964936,-74591599,칠레,2010-09
2010-09-30,239565296,527305759,-287740463,이란,2010-09
2010-09-30,221721100,30405326,191315774,헝가리,2010-09
2010-09-30,200501360,234631,200266729,마샬군도,2010-09
2010-09-30,180930530,108433683,72496847,이집트,2010-09
2010-09-30,179044843,5257,179039586,알제리,2010-09
2010-09-30,167600207,27601,167572606,바하마,2010-09
2010-09-30,130864819,1520767,129344052,우즈베키스탄,2010-09
2010-09-30,128882044,24076304,104805740,방글라데시,2010-09
2010-09-30,124764147,75338440,49425707,스페인,2010-09
2010-09-30,121877874,25894089,95983785,콜롬비아,2010-09
2010-09-30,120642721,406779480,-286136759,이라크,2010-09
2010-09-30,119191051,219317342,-100126291,남아프리카공화국,2010-09
2010-09-30,96550636,25049514,71501122,체코공화국,2010-09
2010-09-30,96308042,18078171,78229871,시리아,2010-09
2010-09-30,87950358,1652893,86297465,요르단,2010-09
2010-09-30,75222274,50042049,25180225,아르헨티나,2010-09
2010-09-30,74012752,52988618,21024134,페루,2010-09
2010-09-30,69711192,1252075,68459117,에쿠아도르,2010-09
2010-09-30,69380394,223490,69156904,리비아,2010-09
2010-09-30,69331434,82910471,-13579037,뉴질랜드,2010-09
2010-09-30,67684991,733364932,-665679941,쿠웨이트,2010-09
2010-09-30,67623379,62155871,5467508,이스라엘,2010-09
2010-09-30,65497768,99931491,-34433723,오스트리아,2010-09
2010-09-30,61555215,75406887,-13851672,우크라이나,2010-09
2010-09-30,61257167,250907452,-189650285,오만,2010-09
2010-09-30,54341904,2572908,51768996,베네주엘라,2010-09
2010-09-30,54314314,24898239,29416075,나이지리아,2010-09
2010-09-30,47332890,75879772,-28546882,핀란드,2010-09
2010-09-30,47046070,63311571,-16265501,파키스탄,2010-09
2010-09-30,44865120,19314250,25550870,미얀마,2010-09
2010-09-30,44690718,90314979,-45624261,스웨덴,2010-09
2010-09-30,43977653,37986215,5991438,카자흐스탄,2010-09
2010-09-30,40270969,5899380,34371589,슬로베니아,2010-09
2010-09-30,35529566,3263491,32266075,튀니지,2010-09
2010-09-30,31395794,17869769,13526025,루마니아,2010-09
2010-09-30,29686234,2250367,27435867,과테말라,2010-09
2010-09-30,28454624,1109181779,-1080727155,카타르,2010-09
2010-09-30,28073358,47516699,-19443341,아일랜드,2010-09
2010-09-30,27486665,1954096,25532569,레바논,2010-09
2010-09-30,26731661,27734,26703927,불령 폴리네시아,2010-09
2010-09-30,26304886,10899821,15405065,모로코,2010-09
2010-09-30,25538148,4006788,21531360,캄보디아,2010-09
2010-09-30,24820938,6408190,18412748,포루투갈,2010-09
2010-09-30,24146044,231842,23914202,괌,2010-09
2010-09-30,24022697,4507460,19515237,스리랑카,2010-09
2010-09-30,23770891,156986992,-133216101,스위스,2010-09
2010-09-30,21348970,1300582,20048388,우루과이,2010-09
2010-09-30,17552787,8276118,9276669,코스타리카,2010-09
2010-09-30,17538783,71349610,-53810827,바레인,2010-09
2010-09-30,17520809,1400526,16120283,몽골,2010-09
2010-09-30,17470377,10898957,6571420,불가리아,2010-09
2010-09-30,16791938,40281239,-23489301,덴마크,2010-09
2010-09-30,16495099,448472,16046627,수단,2010-09
2010-09-30,16489873,14545209,1944664,푸에르토리코,2010-09
2010-09-30,16266891,733841,15533050,가나,2010-09
2010-09-30,15741202,4500,15736702,안티가 바부다,2010-09
2010-09-30,14091870,12575,14079295,레소토,2010-09
2010-09-30,13373548,359298,13014250,보스니아-헤르체고비나,2010-09
2010-09-30,12820430,2149490,10670940,그리스,2010-09
2010-09-30,12707647,6419533,6288114,앙골라,2010-09
2010-09-30,12685168,835326,11849842,케냐,2010-09
2010-09-30,11838160,31245,11806915,파라과이,2010-09
2010-09-30,11762889,895,11761994,아제르바이잔,2010-09
2010-09-30,11049898,689511,10360387,니카라과,2010-09
2010-09-30,10743386,10598008,145378,탄자니아,2010-09
2010-09-30,10307593,6269821,4037772,몰타,2010-09
2010-09-30,9926480,83077,9843403,키르기스스탄,2010-09
2010-09-30,9742795,62145,9680650,코트디봐르,2010-09
2010-09-30,9502097,2887510,6614587,온두라스,2010-09
2010-09-30,9313604,3907347,5406257,도미니카 공화국,2010-09
2010-09-30,9000634,2353822,6646812,리투아니아,2010-09
2010-09-30,8111839,1239194,6872645,라트비아,2010-09
2010-09-30,7395241,53534,7341707,투르크멘,2010-09
2010-09-30,6472315,1086570,5385745,에티오피아,2010-09
2010-09-30,6390006,197222,6192784,라오스,2010-09
2010-09-30,5919975,2005554,3914421,엘살바도르,2010-09
2010-09-30,5856793,35935737,-30078944,예맨,2010-09
2010-09-30,5451432,11427284,-5975852,뉴 칼레도니아,2010-09
2010-09-30,5233435,5117025,116410,에스토니아,2010-09
2010-09-30,4890317,92043504,-87153187,브루나이,2010-09
2010-09-30,4504476,907104,3597372,세네갈,2010-09
2010-09-30,4409524,1252,4408272,아프카니스탄,2010-09
2010-09-30,4292249,260959,4031290,조지아,2010-09
2010-09-30,4118960,4456772,-337812,크로아티아,2010-09
2010-09-30,4047541,510778,3536763,벨라루스,2010-09
2010-09-30,3623144,785029,2838115,모리셔스,2010-09
2010-09-30,3500219,515726,2984493,베닝,2010-09
2010-09-30,3407355,42471997,-39064642,파푸아 뉴기니,2010-09
2010-09-30,3057262,257640,2799622,카메룬,2010-09
2010-09-30,2944868,1388900,1555968,피지,2010-09
2010-09-30,2915312,45002,2870310,네팔,2010-09
2010-09-30,2871706,4116766,-1245060,기타국,2010-09
2010-09-30,2819792,5636554,-2816762,타지크,2010-09
2010-09-30,2711938,7897899,-5185961,사이프러스,2010-09
2010-09-30,2540552,212927,2327625,모잠비크,2010-09
2010-09-30,2442276,20,2442256,지부티,2010-09
2010-09-30,2388118,1118066,1270052,트리니다드 토바고,2010-09
2010-09-30,2377917,250122,2127795,콩고,2010-09
2010-09-30,2372232,126476,2245756,짐바브웨,2010-09
2010-09-30,2309127,230668,2078459,마다카스카르,2010-09
2010-09-30,2228015,1905916,322099,룩셈부르그,2010-09
2010-09-30,1983884,78973,1904911,아르메니아,2010-09
2010-09-30,1894242,357595,1536647,쿠바,2010-09
2010-09-30,1876912,0,1876912,부르키나 파소,2010-09
2010-09-30,1872214,6616,1865598,가봉,2010-09
2010-09-30,1729000,3415,1725585,토고,2010-09
2010-09-30,1709157,105208,1603949,네덜란드 열도,2010-09
2010-09-30,1655394,208345,1447049,아이티,2010-09
2010-09-30,1642465,37244,1605221,가이아나,2010-09
2010-09-30,1573591,15149,1558442,말리,2010-09
2010-09-30,1534601,7299543,-5764942,세르비아,2010-09
2010-09-30,1528809,1740,1527069,부탄,2010-09
2010-09-30,1524403,182728,1341675,우간다,2010-09
2010-09-30,1491024,312998,1178026,자마이카,2010-09
2010-09-30,1438624,234783,1203841,마카오,2010-09
2010-09-30,1319216,0,1319216,에리트리아,2010-09
2010-09-30,1142434,0,1142434,팔레스타인 해방기구,2010-09
2010-09-30,1078517,42534215,-41455698,잠비아,2010-09
2010-09-30,1024569,4066140,-3041571,콩고민주공화국,2010-09
2010-09-30,969369,1228377,-259008,세이쉘,2010-09
2010-09-30,964917,38031576,-37066659,볼리비아,2010-09
2010-09-30,924960,20,924940,불령 리유니온 코모도 제도,2010-09
2010-09-30,902887,1086979,-184092,기니,2010-09
2010-09-30,878826,10396,868430,알바니아,2010-09
2010-09-30,800894,1138441,-337547,스와질랜드,2010-09
2010-09-30,760460,135362,625098,수리남,2010-09
2010-09-30,752722,432662,320060,모리타니,2010-09
2010-09-30,645060,151784,493276,말라위,2010-09
2010-09-30,623841,451144,172697,아이슬란드,2010-09
2010-09-30,606564,41861,564703,도미니카,2010-09
2010-09-30,502588,3504,499084,마이크로네시아,2010-09
2010-09-30,474599,0,474599,아루바,2010-09
2010-09-30,471032,588,470444,영령 캐이맨 군도,2010-09
2010-09-30,439325,0,439325,마티니크,2010-09
2010-09-30,428109,0,428109,북마리아나 군도,2010-09
2010-09-30,408822,0,408822,몰디브,2010-09
2010-09-30,402842,213711,189131,마세도니아,2010-09
2010-09-30,386645,107,386538,아메리칸 사모아,2010-09
2010-09-30,383049,35627,347422,안도라,2010-09
2010-09-30,369244,0,369244,카보 베르데,2010-09
2010-09-30,359062,536352,-177290,몰도바,2010-09
2010-09-30,342686,47434,295252,사모아,2010-09
2010-09-30,293159,628169,-335010,리히텐슈타인,2010-09
2010-09-30,281730,33819935,-33538205,적도 기니,2010-09
2010-09-30,234859,0,234859,르완다,2010-09
2010-09-30,229738,80771,148967,시에라 리온,2010-09
2010-09-30,222233,0,222233,몬테네그로,2010-09
2010-09-30,209040,0,209040,소말리아,2010-09
2010-09-30,186311,381775,-195464,모나코,2010-09
2010-09-30,183875,0,183875,세인트 키츠 네비스,2010-09
2010-09-30,161464,471,160993,과델로프,2010-09
2010-09-30,160642,283383,-122741,벨리제,2010-09
2010-09-30,158938,41109,117829,나미비아,2010-09
2010-09-30,155149,1342953,-1187804,솔로몬 군도,2010-09
2010-09-30,150406,0,150406,세인트 빈센트 그레나딘,2010-09
2010-09-30,128392,83913,44479,바베이도스,2010-09
2010-09-30,115209,0,115209,불령 가이아나,2010-09
2010-09-30,99622,360409,-260787,니제르,2010-09
2010-09-30,90753,0,90753,그레나다,2010-09
2010-09-30,82425,5458,76967,산마리노,2010-09
2010-09-30,72946,3014,69932,보츠와나,2010-09
2010-09-30,62482,3708,58774,상토메 프린스페,2010-09
2010-09-30,61154,0,61154,세인트 루시아,2010-09
2010-09-30,58128,126907,-68779,중앙아프리카공화국,2010-09
2010-09-30,52386,0,52386,버뮤다,2010-09
2010-09-30,52225,0,52225,노폴크 아일랜드,2010-09
2010-09-30,41312,2203,39109,쿡 아일랜드,2010-09
2010-09-30,26050,0,26050,팔라우,2010-09
2010-09-30,23254,19078,4176,감비아,2010-09
2010-09-30,16203,0,16203,지브랄타,2010-09
2010-09-30,14928,0,14928,챠드,2010-09
2010-09-30,13195,68320,-55125,몬트세라트,2010-09
2010-09-30,8264,0,8264,피트카이른,2010-09
2010-09-30,7802,18255,-10453,티모르,2010-09
2010-09-30,7506,22250,-14744,코모로스,2010-09
2010-09-30,1847,11,1836,미령 버진군도,2010-09
2010-09-30,1024,0,1024,파로에 군도,2010-09
2010-09-30,946,0,946,왈라스 & 퓨투나 군도,2010-09
2010-09-30,300,0,300,키리바티,2010-09
2010-09-30,27,0,27,영령 인도양,2010-09
2010-09-30,0,22,-22,투르크 & 카이코스 군도,2010-09
2010-09-30,0,2041,-2041,통가,2010-09
2010-09-30,0,18290,-18290,교황청,2010-09
2010-09-30,0,24187,-24187,그린랜드,2010-09
2010-09-30,0,11,-11,안타티카,2010-09
2010-09-30,0,40,-40,앙귈라,2010-09
2010-09-30,0,1276,-1276,나우루,2010-09
2010-09-30,0,56558,-56558,토켈라우,2010-09
2010-10-31,10348323534,6569309380,3779014154,중국,2010-10
2010-10-31,4777592881,3197839444,1579753437,미국,2010-10
2010-10-31,2666567994,5435657665,-2769089671,일본,2010-10
2010-10-31,2231244743,222206000,2009038743,홍콩,2010-10
2010-10-31,1458509531,826487939,632021592,싱가포르,2010-10
2010-10-31,1358037903,1203869175,154168728,대만,2010-10
2010-10-31,1250426767,463722709,786704058,인도,2010-10
2010-10-31,972549208,1175263028,-202713820,독일,2010-10
2010-10-31,948494601,424616753,523877848,베트남,2010-10
2010-10-31,875347737,600,875347137,라이베리아,2010-10
2010-10-31,804353969,95582987,708770982,멕시코,2010-10
2010-10-31,798388603,990909475,-192520872,인도네시아,2010-10
2010-10-31,722347822,929194414,-206846592,러시아 연방,2010-10
2010-10-31,720391583,243347186,477044397,영국,2010-10
2010-10-31,717203588,568914367,148289221,브라질,2010-10
2010-10-31,701130456,1797959643,-1096829187,호주,2010-10
2010-10-31,650560393,872055751,-221495358,아랍에미리트 연합,2010-10
2010-10-31,642790407,0,642790407,영령 캐이맨 군도,2010-10
2010-10-31,619474700,326538686,292936014,태국,2010-10
2010-10-31,541336007,850285137,-308949130,말레이시아,2010-10
2010-10-31,488521533,301248651,187272882,필리핀,2010-10
2010-10-31,455112933,267541070,187571863,이탈리아,2010-10
2010-10-31,442112153,56196517,385915636,파나마,2010-10
2010-10-31,418190070,12740414,405449656,슬로바키아,2010-10
2010-10-31,412819644,373686360,39133284,네덜란드,2010-10
2010-10-31,392074208,2339854709,-1947780501,사우디아라비아,2010-10
2010-10-31,387674139,374627005,13047134,프랑스,2010-10
2010-10-31,371485681,25988530,345497151,폴란드,2010-10
2010-10-31,368475142,46158120,322317022,튀르키예,2010-10
2010-10-31,366209052,409600972,-43391920,캐나다,2010-10
2010-10-31,325447123,294993471,30453652,이란,2010-10
2010-10-31,237024131,1261141288,-1024117157,쿠웨이트,2010-10
2010-10-31,234906411,99464,234806947,바하마,2010-10
2010-10-31,224832856,29094394,195738462,헝가리,2010-10
2010-10-31,220312972,88013,220224959,알제리,2010-10
2010-10-31,214864879,357011312,-142146433,칠레,2010-10
2010-10-31,196310430,90934039,105376391,이집트,2010-10
2010-10-31,189670178,78042163,111628015,스페인,2010-10
2010-10-31,168292598,816896,167475702,에쿠아도르,2010-10
2010-10-31,157573786,59736478,97837308,이스라엘,2010-10
2010-10-31,136579608,92213296,44366312,벨기에,2010-10
2010-10-31,136212544,282921863,-146709319,남아프리카공화국,2010-10
2010-10-31,132208896,569665734,-437456838,이라크,2010-10
2010-10-31,128727300,32797109,95930191,콜롬비아,2010-10
2010-10-31,127874437,3761750,124112687,요르단,2010-10
2010-10-31,126243820,29636650,96607170,체코공화국,2010-10
2010-10-31,121194665,2144992,119049673,우즈베키스탄,2010-10
2010-10-31,118261210,10428909,107832301,방글라데시,2010-10
2010-10-31,114218440,9254547,104963893,시리아,2010-10
2010-10-31,99380981,111402741,-12021760,뉴질랜드,2010-10
2010-10-31,88537291,110860312,-22323021,페루,2010-10
2010-10-31,88115265,2078,88113187,마샬군도,2010-10
2010-10-31,86008633,138351729,-52343096,아르헨티나,2010-10
2010-10-31,85659114,67776,85591338,리비아,2010-10
2010-10-31,77541422,165139931,-87598509,스위스,2010-10
2010-10-31,75364414,88923439,-13559025,오스트리아,2010-10
2010-10-31,73773005,30365103,43407902,우크라이나,2010-10
2010-10-31,73551202,3758576,69792626,그리스,2010-10
2010-10-31,70972581,116587194,-45614613,스웨덴,2010-10
2010-10-31,58200000,8911306,49288694,슬로베니아,2010-10
2010-10-31,58135323,53601715,4533608,나이지리아,2010-10
2010-10-31,56063704,28548151,27515553,파키스탄,2010-10
2010-10-31,50004453,1832843,48171610,베네주엘라,2010-10
2010-10-31,47413210,1626099,45787111,사이프러스,2010-10
2010-10-31,44458606,386369145,-341910539,오만,2010-10
2010-10-31,43496368,21547671,21948697,카자흐스탄,2010-10
2010-10-31,42009359,87792844,-45783485,핀란드,2010-10
2010-10-31,41751290,39158357,2592933,루마니아,2010-10
2010-10-31,38973525,25744112,13229413,미얀마,2010-10
2010-10-31,34640293,3535214,31105079,캄보디아,2010-10
2010-10-31,31226706,904663306,-873436600,카타르,2010-10
2010-10-31,30606396,5915258,24691138,포루투갈,2010-10
2010-10-31,30308286,2019989,28288297,레바논,2010-10
2010-10-31,29892626,5322543,24570083,파푸아 뉴기니,2010-10
2010-10-31,28606933,2470575,26136358,튀니지,2010-10
2010-10-31,28189616,39,28189577,아제르바이잔,2010-10
2010-10-31,26696532,50696126,-23999594,덴마크,2010-10
2010-10-31,25304778,5260140,20044638,스리랑카,2010-10
2010-10-31,25227685,41776,25185909,괌,2010-10
2010-10-31,24290092,5411283,18878809,모로코,2010-10
2010-10-31,23544660,3325986,20218674,과테말라,2010-10
2010-10-31,19687162,97833841,-78146679,바레인,2010-10
2010-10-31,19661612,12615075,7046537,푸에르토리코,2010-10
2010-10-31,18710390,4755856,13954534,몽골,2010-10
2010-10-31,18694020,12099251,6594769,코스타리카,2010-10
2010-10-31,18112895,2628387,15484508,가나,2010-10
2010-10-31,17702453,523259,17179194,케냐,2010-10
2010-10-31,14798986,11864814,2934172,불가리아,2010-10
2010-10-31,14665769,937895,13727874,니카라과,2010-10
2010-10-31,14349494,55551043,-41201549,아일랜드,2010-10
2010-10-31,14345926,0,14345926,앙골라,2010-10
2010-10-31,13178776,294021585,-280842809,노르웨이,2010-10
2010-10-31,12133631,7328466,4805165,몰타,2010-10
2010-10-31,11962434,4069398,7893036,도미니카 공화국,2010-10
2010-10-31,11904531,1854621,10049910,우루과이,2010-10
2010-10-31,11769063,2541275,9227788,온두라스,2010-10
2010-10-31,10824871,61867802,-51042931,예맨,2010-10
2010-10-31,10661609,691825,9969784,수단,2010-10
2010-10-31,10219112,0,10219112,투르크멘,2010-10
2010-10-31,10135367,72451,10062916,키르기스스탄,2010-10
2010-10-31,10068990,1441525,8627465,라트비아,2010-10
2010-10-31,9758886,2080609,7678277,리투아니아,2010-10
2010-10-31,9519862,343854,9176008,파라과이,2010-10
2010-10-31,9346505,151861,9194644,라오스,2010-10
2010-10-31,8548819,942080,7606739,탄자니아,2010-10
2010-10-31,7788049,15942,7772107,레소토,2010-10
2010-10-31,7776830,3397951,4378879,에스토니아,2010-10
2010-10-31,7385836,316134,7069702,쿠바,2010-10
2010-10-31,6256618,25498102,-19241484,트리니다드 토바고,2010-10
2010-10-31,5585689,88,5585601,코트디봐르,2010-10
2010-10-31,5276744,3467719,1809025,기타국,2010-10
2010-10-31,4674493,1646590,3027903,엘살바도르,2010-10
2010-10-31,4658495,1348228,3310267,모리셔스,2010-10
2010-10-31,4616435,31656,4584779,모잠비크,2010-10
2010-10-31,4414341,398056,4016285,카메룬,2010-10
2010-10-31,4245643,539941,3705702,조지아,2010-10
2010-10-31,4033929,719721,3314208,벨라루스,2010-10
2010-10-31,3895122,158512150,-154617028,브루나이,2010-10
2010-10-31,3832540,1005888,2826652,크로아티아,2010-10
2010-10-31,3769370,15772105,-12002735,뉴 칼레도니아,2010-10
2010-10-31,3648263,927493,2720770,베닝,2010-10
2010-10-31,3320697,662209,2658488,에티오피아,2010-10
2010-10-31,3227101,173519,3053582,네덜란드 열도,2010-10
2010-10-31,2981512,0,2981512,마티니크,2010-10
2010-10-31,2866651,7362913,-4496262,타지크,2010-10
2010-10-31,2702404,158053,2544351,수리남,2010-10
2010-10-31,2563062,10796167,-8233105,콩고민주공화국,2010-10
2010-10-31,2511311,0,2511311,팔레스타인 해방기구,2010-10
2010-10-31,2493365,210475,2282890,콩고,2010-10
2010-10-31,2336388,90986,2245402,마다카스카르,2010-10
2010-10-31,2333779,37,2333742,토고,2010-10
2010-10-31,2260613,68222,2192391,네팔,2010-10
2010-10-31,2233387,32450467,-30217080,볼리비아,2010-10
2010-10-31,2222610,10335,2212275,아프카니스탄,2010-10
2010-10-31,2176068,498347,1677721,알바니아,2010-10
2010-10-31,1853918,1729882,124036,룩셈부르그,2010-10
2010-10-31,1767259,2193359,-426100,피지,2010-10
2010-10-31,1728383,0,1728383,지부티,2010-10
2010-10-31,1647457,1035846,611611,세네갈,2010-10
2010-10-31,1603730,333354,1270376,자마이카,2010-10
2010-10-31,1597079,23893,1573186,아이티,2010-10
2010-10-31,1418388,343693,1074695,마카오,2010-10
2010-10-31,1406462,475774,930688,우간다,2010-10
2010-10-31,1381865,0,1381865,부르키나 파소,2010-10
2010-10-31,1366229,0,1366229,아루바,2010-10
2010-10-31,1300263,4400552,-3100289,스와질랜드,2010-10
2010-10-31,1219836,264500,955336,짐바브웨,2010-10
2010-10-31,1176353,1361701,-185348,아이슬란드,2010-10
2010-10-31,1166503,100920,1065583,세이쉘,2010-10
2010-10-31,1156268,6942,1149326,부탄,2010-10
2010-10-31,1137163,686431,450732,아르메니아,2010-10
2010-10-31,1115369,6300414,-5185045,세르비아,2010-10
2010-10-31,1083861,0,1083861,바베이도스,2010-10
2010-10-31,1074777,24809,1049968,가봉,2010-10
2010-10-31,986565,247396,739169,기니,2010-10
2010-10-31,935774,0,935774,버뮤다,2010-10
2010-10-31,850675,4603,846072,불령 리유니온 코모도 제도,2010-10
2010-10-31,825683,0,825683,불령 가이아나,2010-10
2010-10-31,757410,14161,743249,니제르,2010-10
2010-10-31,736464,93692,642772,도미니카,2010-10
2010-10-31,698071,79337,618734,벨리제,2010-10
2010-10-31,697726,275,697451,과델로프,2010-10
2010-10-31,680267,650056,30211,모리타니,2010-10
2010-10-31,659525,0,659525,북마리아나 군도,2010-10
2010-10-31,623085,125233,497852,가이아나,2010-10
2010-10-31,606965,324330,282635,말라위,2010-10
2010-10-31,589703,0,589703,마이크로네시아,2010-10
2010-10-31,568229,31311679,-30743450,잠비아,2010-10
2010-10-31,562640,67681,494959,불령 폴리네시아,2010-10
2010-10-31,540268,1425503,-885235,나미비아,2010-10
2010-10-31,538896,14574,524322,에리트리아,2010-10
2010-10-31,488709,9194,479515,바누아투,2010-10
2010-10-31,471333,34750,436583,보츠와나,2010-10
2010-10-31,449434,789579,-340145,몰도바,2010-10
2010-10-31,412958,2829,410129,세인트 루시아,2010-10
2010-10-31,403969,827245,-423276,리히텐슈타인,2010-10
2010-10-31,384985,264413,120572,보스니아-헤르체고비나,2010-10
2010-10-31,381816,0,381816,그레나다,2010-10
2010-10-31,328723,3722,325001,르완다,2010-10
2010-10-31,266369,27324,239045,사모아,2010-10
2010-10-31,259454,189355,70099,마세도니아,2010-10
2010-10-31,253138,228,252910,팔라우,2010-10
2010-10-31,226842,0,226842,서사하라,2010-10
2010-10-31,223826,23061,200765,몰디브,2010-10
2010-10-31,218450,0,218450,몬테네그로,2010-10
2010-10-31,173870,0,173870,세인트 키츠 네비스,2010-10
2010-10-31,167585,0,167585,산마리노,2010-10
2010-10-31,147730,50,147680,아메리칸 사모아,2010-10
2010-10-31,131371,415591,-284220,모나코,2010-10
2010-10-31,130748,0,130748,기네비소,2010-10
2010-10-31,129980,1559,128421,감비아,2010-10
2010-10-31,129870,15984,113886,안도라,2010-10
2010-10-31,128685,0,128685,챠드,2010-10
2010-10-31,116744,0,116744,지브랄타,2010-10
2010-10-31,114847,3894050,-3779203,시에라 리온,2010-10
2010-10-31,113778,0,113778,카보 베르데,2010-10
2010-10-31,108672,0,108672,노폴크 아일랜드,2010-10
2010-10-31,96032,0,96032,세인트 빈센트 그레나딘,2010-10
2010-10-31,95239,78868038,-78772799,적도 기니,2010-10
2010-10-31,71151,0,71151,소말리아,2010-10
2010-10-31,65576,0,65576,투발루,2010-10
2010-10-31,62523,614230,-551707,솔로몬 군도,2010-10
2010-10-31,37893,0,37893,티모르,2010-10
2010-10-31,36430,0,36430,영령 버진군도,2010-10
2010-10-31,29198,127,29071,쿡 아일랜드,2010-10
2010-10-31,27399,13387,14012,안티가 바부다,2010-10
2010-10-31,19925,0,19925,말리,2010-10
2010-10-31,16057,0,16057,메요트,2010-10
2010-10-31,15417,1067,14350,미령 버진군도,2010-10
2010-10-31,14810,0,14810,투르크 & 카이코스 군도,2010-10
2010-10-31,13160,43,13117,보빗군도,2010-10
2010-10-31,7319,11741,-4422,피트카이른,2010-10
2010-10-31,5166,0,5166,남조지아 & 남샌드위치 군도,2010-10
2010-10-31,2900,0,2900,영령 인도양,2010-10
2010-10-31,0,45,-45,세인트 헬레나,2010-10
2010-10-31,0,95,-95,코모로스,2010-10
2010-10-31,0,3367465,-3367465,나우루,2010-10
2010-10-31,0,18261,-18261,교황청,2010-10
2010-10-31,0,80183,-80183,토켈라우,2010-10
2010-10-31,0,1098,-1098,상토메 프린스페,2010-10
2010-10-31,0,244501,-244501,그린랜드,2010-10
2010-10-31,0,57,-57,앙귈라,2010-10
2010-11-30,10586575214,6999303038,3587272176,중국,2010-11
2010-11-30,4447906701,3353670989,1094235712,미국,2010-11
2010-11-30,2784634187,5460279901,-2675645714,일본,2010-11
2010-11-30,2224595332,150137110,2074458222,홍콩,2010-11
2010-11-30,1360103281,1244226965,115876316,대만,2010-11
2010-11-30,1341343170,685045425,656297745,싱가포르,2010-11
2010-11-30,1232909333,200317228,1032592105,노르웨이,2010-11
2010-11-30,937267278,545237515,392029763,인도,2010-11
2010-11-30,906755555,369315000,537440555,베트남,2010-11
2010-11-30,858855342,1209618826,-350763484,인도네시아,2010-11
2010-11-30,766829815,1300752897,-533923082,독일,2010-11
2010-11-30,728366265,952845922,-224479657,러시아 연방,2010-11
2010-11-30,645589936,178232375,467357561,멕시코,2010-11
2010-11-30,607982561,2166116497,-1558133936,호주,2010-11
2010-11-30,598773602,701577094,-102803492,말레이시아,2010-11
2010-11-30,593961360,726674290,-132712930,브라질,2010-11
2010-11-30,578042672,281092371,296950301,필리핀,2010-11
2010-11-30,557796497,345969353,211827144,태국,2010-11
2010-11-30,508887000,970675157,-461788157,아랍에미리트 연합,2010-11
2010-11-30,425886263,293523347,132362916,영국,2010-11
2010-11-30,420014601,2686585908,-2266571307,사우디아라비아,2010-11
2010-11-30,411480479,469955282,-58474803,이란,2010-11
2010-11-30,367182777,287179660,80003117,이탈리아,2010-11
2010-11-30,360290212,372254363,-11964151,캐나다,2010-11
2010-11-30,346259426,9384236,336875190,슬로바키아,2010-11
2010-11-30,338822950,495207707,-156384757,네덜란드,2010-11
2010-11-30,338640663,20330733,318309930,폴란드,2010-11
2010-11-30,327093420,38360343,288733077,튀르키예,2010-11
2010-11-30,326577019,24639,326552380,라이베리아,2010-11
2010-11-30,248002461,17090350,230912111,파나마,2010-11
2010-11-30,244228033,315862177,-71634144,칠레,2010-11
2010-11-30,237370424,407180846,-169810422,프랑스,2010-11
2010-11-30,235882784,8702858,227179926,몰타,2010-11
2010-11-30,233560504,99984678,133575826,이집트,2010-11
2010-11-30,168471009,71028232,97442777,헝가리,2010-11
2010-11-30,154189998,78681725,75508273,스페인,2010-11
2010-11-30,145516773,15788603,129728170,방글라데시,2010-11
2010-11-30,143537642,201620267,-58082625,남아프리카공화국,2010-11
2010-11-30,127594000,9695,127584305,마샬군도,2010-11
2010-11-30,124543184,33197396,91345788,체코공화국,2010-11
2010-11-30,122446808,102192380,20254428,벨기에,2010-11
2010-11-30,120749482,952528,119796954,우즈베키스탄,2010-11
2010-11-30,119923413,34757566,85165847,시리아,2010-11
2010-11-30,117594169,50850655,66743514,콜롬비아,2010-11
2010-11-30,111292955,318215,110974740,알제리,2010-11
2010-11-30,109426422,1224518,108201904,에쿠아도르,2010-11
2010-11-30,105491299,3081696,102409603,요르단,2010-11
2010-11-30,99681610,3925549,95756061,베네주엘라,2010-11
2010-11-30,90759938,4785412,85974526,그리스,2010-11
2010-11-30,89500481,100904884,-11404403,뉴질랜드,2010-11
2010-11-30,89147228,93221242,-4074014,오스트리아,2010-11
2010-11-30,87157486,54925569,32231917,아르헨티나,2010-11
2010-11-30,86559570,23663618,62895952,페루,2010-11
2010-11-30,86258337,69970712,16287625,이스라엘,2010-11
2010-11-30,81502676,144155031,-62652355,스웨덴,2010-11
2010-11-30,81056142,32892328,48163814,카자흐스탄,2010-11
2010-11-30,77809916,37332664,40477252,리비아,2010-11
2010-11-30,76606740,1074876677,-998269937,쿠웨이트,2010-11
2010-11-30,75426142,385075999,-309649857,이라크,2010-11
2010-11-30,74688471,77820533,-3132062,우크라이나,2010-11
2010-11-30,72915114,9258783,63656331,사이프러스,2010-11
2010-11-30,66286718,85637044,-19350326,나이지리아,2010-11
2010-11-30,61011882,108542075,-47530193,핀란드,2010-11
2010-11-30,59375396,54870253,4505143,파키스탄,2010-11
2010-11-30,57155417,18998070,38157347,슬로베니아,2010-11
2010-11-30,52085044,16894296,35190748,루마니아,2010-11
2010-11-30,51408677,441515322,-390106645,오만,2010-11
2010-11-30,50714395,19356,50695039,바하마,2010-11
2010-11-30,48572197,2551809,46020388,튀니지,2010-11
2010-11-30,48406493,907346812,-858940319,카타르,2010-11
2010-11-30,47886324,26021854,21864470,미얀마,2010-11
2010-11-30,44335617,194995544,-150659927,스위스,2010-11
2010-11-30,29267137,4766156,24500981,캄보디아,2010-11
2010-11-30,29063548,6856107,22207441,포루투갈,2010-11
2010-11-30,28183370,52696142,-24512772,덴마크,2010-11
2010-11-30,28146036,3766708,24379328,스리랑카,2010-11
2010-11-30,27417174,7813378,19603796,모로코,2010-11
2010-11-30,27353416,32122,27321294,불령 폴리네시아,2010-11
2010-11-30,23335015,3919254,19415761,과테말라,2010-11
2010-11-30,21519440,2266419,19253021,레바논,2010-11
2010-11-30,21012734,54699939,-33687205,아일랜드,2010-11
2010-11-30,20734225,3154142,17580083,가나,2010-11
2010-11-30,19395927,932177,18463750,니카라과,2010-11
2010-11-30,19342427,1635737,17706690,우루과이,2010-11
2010-11-30,18711303,3835659,14875644,몽골,2010-11
2010-11-30,15777261,13779607,1997654,코스타리카,2010-11
2010-11-30,15207115,71069520,-55862405,예맨,2010-11
2010-11-30,15147558,1437395,13710163,케냐,2010-11
2010-11-30,15142478,6796,15135682,아제르바이잔,2010-11
2010-11-30,14608220,12242096,2366124,도미니카 공화국,2010-11
2010-11-30,14032748,0,14032748,투르크멘,2010-11
2010-11-30,13789378,12733198,1056180,바레인,2010-11
2010-11-30,13523102,2942026,10581076,앙골라,2010-11
2010-11-30,12473933,18883194,-6409261,불가리아,2010-11
2010-11-30,11160534,150452079,-139291545,브루나이,2010-11
2010-11-30,11040509,572729,10467780,파푸아 뉴기니,2010-11
2010-11-30,10629364,751057,9878307,수단,2010-11
2010-11-30,10499173,583992,9915181,파라과이,2010-11
2010-11-30,9466473,5340,9461133,레소토,2010-11
2010-11-30,8983429,15406597,-6423168,푸에르토리코,2010-11
2010-11-30,8436255,2053439,6382816,라트비아,2010-11
2010-11-30,8349736,1597333,6752403,키르기스스탄,2010-11
2010-11-30,7793546,6832352,961194,탄자니아,2010-11
2010-11-30,7536205,213876,7322329,라오스,2010-11
2010-11-30,7479997,1313747,6166250,크로아티아,2010-11
2010-11-30,6941337,1910266,5031071,리투아니아,2010-11
2010-11-30,6681197,51753,6629444,코트디봐르,2010-11
2010-11-30,6659956,8666011,-2006055,에스토니아,2010-11
2010-11-30,6612856,47404884,-40792028,트리니다드 토바고,2010-11
2010-11-30,6565682,1698069,4867613,온두라스,2010-11
2010-11-30,5903507,1030490,4873017,조지아,2010-11
2010-11-30,5872798,302536,5570262,쿠바,2010-11
2010-11-30,5752344,19641708,-13889364,뉴 칼레도니아,2010-11
2010-11-30,4894275,1089848,3804427,엘살바도르,2010-11
2010-11-30,4063427,489975,3573452,세네갈,2010-11
2010-11-30,3909705,716732,3192973,모리셔스,2010-11
2010-11-30,3900326,172725,3727601,카메룬,2010-11
2010-11-30,3681409,34120,3647289,괌,2010-11
2010-11-30,3588062,67178,3520884,콩고,2010-11
2010-11-30,3553797,1748919,1804878,에티오피아,2010-11
2010-11-30,3370223,10236466,-6866243,타지크,2010-11
2010-11-30,3120967,108098,3012869,네팔,2010-11
2010-11-30,2947869,1374278,1573591,베닝,2010-11
2010-11-30,2895999,350473,2545526,마카오,2010-11
2010-11-30,2846255,671866,2174389,벨라루스,2010-11
2010-11-30,2803750,49264,2754486,아프카니스탄,2010-11
2010-11-30,2755112,0,2755112,에리트리아,2010-11
2010-11-30,2543737,42152,2501585,팔레스타인 해방기구,2010-11
2010-11-30,2517663,547049,1970614,우간다,2010-11
2010-11-30,2499959,194648,2305311,보스니아-헤르체고비나,2010-11
2010-11-30,2381943,92367,2289576,마다카스카르,2010-11
2010-11-30,2344974,38104376,-35759402,네덜란드 열도,2010-11
2010-11-30,2158079,0,2158079,부탄,2010-11
2010-11-30,2140627,362124,1778503,아이티,2010-11
2010-11-30,2059041,9982,2049059,보츠와나,2010-11
2010-11-30,1920126,6592870,-4672744,룩셈부르그,2010-11
2010-11-30,1908783,0,1908783,불령 리유니온 코모도 제도,2010-11
2010-11-30,1868695,0,1868695,토고,2010-11
2010-11-30,1751526,12761011,-11009485,기타국,2010-11
2010-11-30,1750763,2609,1748154,알바니아,2010-11
2010-11-30,1608252,324029,1284223,모잠비크,2010-11
2010-11-30,1587363,682,1586681,지부티,2010-11
2010-11-30,1394370,94221,1300149,아르메니아,2010-11
2010-11-30,1283356,21593,1261763,바베이도스,2010-11
2010-11-30,1231166,16263315,-15032149,아루바,2010-11
2010-11-30,1226991,1991,1225000,르완다,2010-11
2010-11-30,1222547,1510463,-287916,피지,2010-11
2010-11-30,1161886,565720,596166,자마이카,2010-11
2010-11-30,1153833,1260703,-106870,아이슬란드,2010-11
2010-11-30,1151035,15367223,-14216188,말리,2010-11
2010-11-30,1146666,687263,459403,스와질랜드,2010-11
2010-11-30,1103544,6639999,-5536455,세르비아,2010-11
2010-11-30,1099670,18590859,-17491189,볼리비아,2010-11
2010-11-30,926233,11657002,-10730769,가봉,2010-11
2010-11-30,922987,41968,881019,가이아나,2010-11
2010-11-30,893080,105359,787721,짐바브웨,2010-11
2010-11-30,890683,314,890369,과델로프,2010-11
2010-11-30,845722,0,845722,부르키나 파소,2010-11
2010-11-30,837257,0,837257,말라위,2010-11
2010-11-30,815851,88430,727421,수리남,2010-11
2010-11-30,808167,0,808167,마티니크,2010-11
2010-11-30,790999,296034,494965,모리타니,2010-11
2010-11-30,635642,731157,-95515,기니,2010-11
2010-11-30,578751,33250252,-32671501,잠비아,2010-11
2010-11-30,505767,215467,290300,마이크로네시아,2010-11
2010-11-30,497717,37614,460103,벨리제,2010-11
2010-11-30,497364,120097,377267,세이쉘,2010-11
2010-11-30,489729,0,489729,사모아,2010-11
2010-11-30,415348,13701,401647,북마리아나 군도,2010-11
2010-11-30,408890,0,408890,불령 가이아나,2010-11
2010-11-30,379786,0,379786,몰디브,2010-11
2010-11-30,356238,1433197,-1076959,리히텐슈타인,2010-11
2010-11-30,354082,174115,179967,니제르,2010-11
2010-11-30,346481,13154088,-12807607,콩고민주공화국,2010-11
2010-11-30,326378,34908,291470,도미니카,2010-11
2010-11-30,325607,194573,131034,마세도니아,2010-11
2010-11-30,316174,421697,-105523,바누아투,2010-11
2010-11-30,244455,49605,194850,티모르,2010-11
2010-11-30,224534,14466,210068,세인트 루시아,2010-11
2010-11-30,214757,0,214757,영령 캐이맨 군도,2010-11
2010-11-30,208957,27655,181302,시에라 리온,2010-11
2010-11-30,201109,14849,186260,산마리노,2010-11
2010-11-30,193159,0,193159,그레나다,2010-11
2010-11-30,171236,0,171236,키리바티,2010-11
2010-11-30,158163,20819,137344,안티가 바부다,2010-11
2010-11-30,156296,726780,-570484,몰도바,2010-11
2010-11-30,155259,0,155259,버뮤다,2010-11
2010-11-30,152416,13508,138908,아메리칸 사모아,2010-11
2010-11-30,91580,0,91580,투르크 & 카이코스 군도,2010-11
2010-11-30,90014,55,89959,카보 베르데,2010-11
2010-11-30,86612,0,86612,지브랄타,2010-11
2010-11-30,74856,0,74856,소말리아,2010-11
2010-11-30,74664,21,74643,영령 버진군도,2010-11
2010-11-30,69574,21874,47700,나미비아,2010-11
2010-11-30,64416,0,64416,세인트 빈센트 그레나딘,2010-11
2010-11-30,64012,528744,-464732,모나코,2010-11
2010-11-30,61031,0,61031,적도 기니,2010-11
2010-11-30,57408,14627,42781,팔라우,2010-11
2010-11-30,55162,1366626,-1311464,솔로몬 군도,2010-11
2010-11-30,28856,52726,-23870,토켈라우,2010-11
2010-11-30,27720,0,27720,쿡 아일랜드,2010-11
2010-11-30,24832,5300,19532,감비아,2010-11
2010-11-30,23017,143384,-120367,상토메 프린스페,2010-11
2010-11-30,23000,0,23000,챠드,2010-11
2010-11-30,17351,7680,9671,안도라,2010-11
2010-11-30,15850,2197,13653,세인트 키츠 네비스,2010-11
2010-11-30,14716,387691,-372975,통가,2010-11
2010-11-30,13510,0,13510,중앙아프리카공화국,2010-11
2010-11-30,13370,1224,12146,몬테네그로,2010-11
2010-11-30,12221,0,12221,부룬디,2010-11
2010-11-30,6087,204054,-197967,그린랜드,2010-11
2010-11-30,3332,33,3299,앙귈라,2010-11
2010-11-30,1775,115,1660,미령 버진군도,2010-11
2010-11-30,1712,0,1712,파로에 군도,2010-11
2010-11-30,1146,0,1146,세인트 마틴,2010-11
2010-11-30,540,0,540,기네비소,2010-11
2010-11-30,0,6747,-6747,세인트 헬레나,2010-11
2010-11-30,0,72,-72,코스 군도,2010-11
2010-12-31,11067787000,6537352666,4530434334,중국,2010-12
2010-12-31,4350433455,3566312355,784121100,미국,2010-12
2010-12-31,2671524631,5928397978,-3256873347,일본,2010-12
2010-12-31,2186986967,202531727,1984455240,홍콩,2010-12
2010-12-31,1716034502,1265478098,450556404,대만,2010-12
2010-12-31,1338939638,593199300,745740338,러시아 연방,2010-12
2010-12-31,1263005666,1424486831,-161481165,독일,2010-12
2010-12-31,1190515734,0,1190515734,마샬군도,2010-12
2010-12-31,1189289425,732751754,456537671,싱가포르,2010-12
2010-12-31,1044308576,514841482,529467094,인도,2010-12
2010-12-31,1031330239,344844102,686486137,베트남,2010-12
2010-12-31,909705958,1288074210,-378368252,인도네시아,2010-12
2010-12-31,834113467,1127104152,-292990685,아랍에미리트 연합,2010-12
2010-12-31,710398102,504503088,205895014,브라질,2010-12
2010-12-31,705323490,171767554,533555936,멕시코,2010-12
2010-12-31,633473504,277779403,355694101,영국,2010-12
2010-12-31,591937067,380929106,211007961,태국,2010-12
2010-12-31,549039328,291988295,257051033,필리핀,2010-12
2010-12-31,548819966,2035422425,-1486602459,호주,2010-12
2010-12-31,541960712,2640988002,-2099027290,사우디아라비아,2010-12
2010-12-31,532876113,36699475,496176638,파나마,2010-12
2010-12-31,509664701,808275114,-298610413,말레이시아,2010-12
2010-12-31,502918255,328101702,174816553,네덜란드,2010-12
2010-12-31,462932642,562764018,-99831376,이란,2010-12
2010-12-31,368821711,334742273,34079438,이탈리아,2010-12
2010-12-31,342770717,27346940,315423777,폴란드,2010-12
2010-12-31,334169635,402900850,-68731215,캐나다,2010-12
2010-12-31,316848830,8440023,308408807,슬로바키아,2010-12
2010-12-31,306402513,31787858,274614655,튀르키예,2010-12
2010-12-31,245195673,76086310,169109363,이집트,2010-12
2010-12-31,230965056,411102380,-180137324,프랑스,2010-12
2010-12-31,225565059,431289032,-205723973,칠레,2010-12
2010-12-31,222403664,7088451,215315213,몰타,2010-12
2010-12-31,213662124,13689500,199972624,방글라데시,2010-12
2010-12-31,194693608,33219281,161474327,헝가리,2010-12
2010-12-31,182405257,89199429,93205828,스페인,2010-12
2010-12-31,150964458,213060428,-62095970,남아프리카공화국,2010-12
2010-12-31,144449700,3222067,141227633,그리스,2010-12
2010-12-31,138859217,105577850,33281367,벨기에,2010-12
2010-12-31,129808193,96529,129711664,알제리,2010-12
2010-12-31,125509921,12221756,113288165,리비아,2010-12
2010-12-31,125137521,1615601,123521920,우즈베키스탄,2010-12
2010-12-31,123136318,5453986,117682332,베네주엘라,2010-12
2010-12-31,119540821,47622150,71918671,시리아,2010-12
2010-12-31,118911703,56892107,62019596,콜롬비아,2010-12
2010-12-31,115359392,29831202,85528190,체코공화국,2010-12
2010-12-31,114876987,58541867,56335120,덴마크,2010-12
2010-12-31,112505098,4991400,107513698,요르단,2010-12
2010-12-31,109259943,108929439,330504,뉴질랜드,2010-12
2010-12-31,98004317,773656055,-675651738,쿠웨이트,2010-12
2010-12-31,95187686,104338784,-9151098,우크라이나,2010-12
2010-12-31,91576846,71058833,20518013,이스라엘,2010-12
2010-12-31,86510568,615255905,-528745337,이라크,2010-12
2010-12-31,85827417,215972582,-130145165,페루,2010-12
2010-12-31,78854811,50333786,28521025,파키스탄,2010-12
2010-12-31,73360903,113485805,-40124902,아르헨티나,2010-12
2010-12-31,69003962,0,69003962,중앙아프리카공화국,2010-12
2010-12-31,67680451,1510791,66169660,에쿠아도르,2010-12
2010-12-31,67436124,141048138,-73612014,오스트리아,2010-12
2010-12-31,67362318,10493861,56868457,슬로베니아,2010-12
2010-12-31,67295092,39559,67255533,라이베리아,2010-12
2010-12-31,65420366,211788939,-146368573,나이지리아,2010-12
2010-12-31,64195634,414818706,-350623072,노르웨이,2010-12
2010-12-31,61518186,442571139,-381052953,오만,2010-12
2010-12-31,58157414,165855915,-107698501,스웨덴,2010-12
2010-12-31,57025756,117655072,-60629316,핀란드,2010-12
2010-12-31,56816300,55253917,1562383,루마니아,2010-12
2010-12-31,44850333,12295900,32554433,미얀마,2010-12
2010-12-31,42631047,39414362,3216685,카자흐스탄,2010-12
2010-12-31,39263934,1486353303,-1447089369,카타르,2010-12
2010-12-31,34454014,870289,33583725,라오스,2010-12
2010-12-31,33841246,3159532,30681714,캄보디아,2010-12
2010-12-31,32654228,180187600,-147533372,스위스,2010-12
2010-12-31,29954205,6296684,23657521,포루투갈,2010-12
2010-12-31,28374419,17177,28357242,불령 폴리네시아,2010-12
2010-12-31,28224340,5733285,22491055,스리랑카,2010-12
2010-12-31,28004446,372971,27631475,괌,2010-12
2010-12-31,27170055,14328827,12841228,모로코,2010-12
2010-12-31,25801347,3156551,22644796,과테말라,2010-12
2010-12-31,22599145,2258336,20340809,가나,2010-12
2010-12-31,22489216,2940367,19548849,튀니지,2010-12
2010-12-31,20149810,37220600,-17070790,바레인,2010-12
2010-12-31,20009028,2190140,17818888,레바논,2010-12
2010-12-31,19891497,60830,19830667,투르크멘,2010-12
2010-12-31,18587988,1978692,16609296,우루과이,2010-12
2010-12-31,18223305,928672,17294633,케냐,2010-12
2010-12-31,18002672,4468482,13534190,몽골,2010-12
2010-12-31,17956655,53404803,-35448148,아일랜드,2010-12
2010-12-31,17391975,9901124,7490851,코스타리카,2010-12
2010-12-31,15672798,89717,15583081,앙골라,2010-12
2010-12-31,14569479,1298888,13270591,니카라과,2010-12
2010-12-31,13233624,24233295,-10999671,불가리아,2010-12
2010-12-31,13142793,40608158,-27465365,예맨,2010-12
2010-12-31,12987647,114,12987533,아제르바이잔,2010-12
2010-12-31,12565803,15674250,-3108447,탄자니아,2010-12
2010-12-31,12446502,3196874,9249628,도미니카 공화국,2010-12
2010-12-31,10791181,15111122,-4319941,푸에르토리코,2010-12
2010-12-31,9852449,2192225,7660224,수단,2010-12
2010-12-31,9737947,218847,9519100,파라과이,2010-12
2010-12-31,9422872,1396985,8025887,라트비아,2010-12
2010-12-31,9291429,2145456,7145973,에스토니아,2010-12
2010-12-31,7831720,263250,7568470,키르기스스탄,2010-12
2010-12-31,7442429,1591018,5851411,온두라스,2010-12
2010-12-31,6665647,460548,6205099,쿠바,2010-12
2010-12-31,6427354,1449,6425905,코트디봐르,2010-12
2010-12-31,6080289,1770101,4310188,리투아니아,2010-12
2010-12-31,5887270,133023639,-127136369,브루나이,2010-12
2010-12-31,5864404,5345,5859059,아프카니스탄,2010-12
2010-12-31,5619274,1123338,4495936,에티오피아,2010-12
2010-12-31,5463722,66027249,-60563527,트리니다드 토바고,2010-12
2010-12-31,5135559,9234791,-4099232,사이프러스,2010-12
2010-12-31,5021712,0,5021712,콩고,2010-12
2010-12-31,4967199,4912832,54367,파푸아 뉴기니,2010-12
2010-12-31,4889820,3232856,1656964,엘살바도르,2010-12
2010-12-31,4870206,1048881,3821325,크로아티아,2010-12
2010-12-31,4869459,146179,4723280,카메룬,2010-12
2010-12-31,4809015,18815167,-14006152,뉴 칼레도니아,2010-12
2010-12-31,4645707,1273243,3372464,알바니아,2010-12
2010-12-31,4252524,4470,4248054,토고,2010-12
2010-12-31,4148084,749732,3398352,벨라루스,2010-12
2010-12-31,3919576,580208,3339368,마카오,2010-12
2010-12-31,3655396,326183,3329213,베닝,2010-12
2010-12-31,3641201,362548,3278653,우간다,2010-12
2010-12-31,3629620,68912,3560708,네팔,2010-12
2010-12-31,3557028,157122,3399906,시에라 리온,2010-12
2010-12-31,3210746,1679,3209067,영령 버진군도,2010-12
2010-12-31,3088014,373081,2714933,세네갈,2010-12
2010-12-31,3086421,56,3086365,지부티,2010-12
2010-12-31,2956768,529242,2427526,조지아,2010-12
2010-12-31,2907759,262396,2645363,모리셔스,2010-12
2010-12-31,2857522,10773936,-7916414,타지크,2010-12
2010-12-31,2734085,4359610,-1625525,모잠비크,2010-12
2010-12-31,2375947,39646454,-37270507,볼리비아,2010-12
2010-12-31,2313670,115441,2198229,가이아나,2010-12
2010-12-31,2279917,29563,2250354,레소토,2010-12
2010-12-31,2271089,373630,1897459,자마이카,2010-12
2010-12-31,2185606,253553,1932053,마다카스카르,2010-12
2010-12-31,2170604,470223,1700381,아이티,2010-12
2010-12-31,2165241,4779531,-2614290,룩셈부르그,2010-12
2010-12-31,2161060,2556,2158504,아르메니아,2010-12
2010-12-31,2104044,22314,2081730,짐바브웨,2010-12
2010-12-31,1902166,615,1901551,바하마,2010-12
2010-12-31,1781197,849731,931466,피지,2010-12
2010-12-31,1641054,543113,1097941,기니,2010-12
2010-12-31,1631838,34,1631804,부탄,2010-12
2010-12-31,1574460,742431,832029,몰디브,2010-12
2010-12-31,1571621,88835,1482786,보츠와나,2010-12
2010-12-31,1525948,4216112,-2690164,기타국,2010-12
2010-12-31,1460883,2570,1458313,네덜란드 열도,2010-12
2010-12-31,1436179,667485,768694,세르비아,2010-12
2010-12-31,1425323,35758,1389565,바베이도스,2010-12
2010-12-31,1327809,120954,1206855,세이쉘,2010-12
2010-12-31,1214665,0,1214665,불령 리유니온 코모도 제도,2010-12
2010-12-31,1204172,62578,1141594,팔레스타인 해방기구,2010-12
2010-12-31,1203680,0,1203680,가봉,2010-12
2010-12-31,1140636,6181179,-5040543,콩고민주공화국,2010-12
2010-12-31,1091491,41903,1049588,마이크로네시아,2010-12
2010-12-31,1048335,98419,949916,말라위,2010-12
2010-12-31,960746,0,960746,과델로프,2010-12
2010-12-31,907273,17782,889491,수리남,2010-12
2010-12-31,898662,36708118,-35809456,잠비아,2010-12
2010-12-31,778700,0,778700,벨리제,2010-12
2010-12-31,778211,0,778211,부르키나 파소,2010-12
2010-12-31,770978,1145358,-374380,니제르,2010-12
2010-12-31,733450,0,733450,마티니크,2010-12
2010-12-31,711398,1563375,-851977,아이슬란드,2010-12
2010-12-31,709584,1841148,-1131564,모리타니,2010-12
2010-12-31,658721,1599,657122,북마리아나 군도,2010-12
2010-12-31,656987,0,656987,아루바,2010-12
2010-12-31,547405,797297,-249892,사모아,2010-12
2010-12-31,505225,0,505225,불령 가이아나,2010-12
2010-12-31,442263,274,441989,영령 캐이맨 군도,2010-12
2010-12-31,413205,799539,-386334,리히텐슈타인,2010-12
2010-12-31,404679,376104,28575,보스니아-헤르체고비나,2010-12
2010-12-31,368400,111459,256941,바누아투,2010-12
2010-12-31,361736,403170,-41434,스와질랜드,2010-12
2010-12-31,304089,52338,251751,나미비아,2010-12
2010-12-31,285677,411126,-125449,몰도바,2010-12
2010-12-31,275409,0,275409,몬테네그로,2010-12
2010-12-31,252044,0,252044,에리트리아,2010-12
2010-12-31,247818,0,247818,버뮤다,2010-12
2010-12-31,232203,290,231913,감비아,2010-12
2010-12-31,227363,13748,213615,안도라,2010-12
2010-12-31,191692,2700,188992,세인트 키츠 네비스,2010-12
2010-12-31,181926,153441,28485,마세도니아,2010-12
2010-12-31,170915,0,170915,노폴크 아일랜드,2010-12
2010-12-31,164211,15,164196,아메리칸 사모아,2010-12
2010-12-31,157090,516388,-359298,모나코,2010-12
2010-12-31,157068,74250,82818,티모르,2010-12
2010-12-31,145420,28147,117273,도미니카,2010-12
2010-12-31,137378,13423,123955,안티가 바부다,2010-12
2010-12-31,127703,2030,125673,팔라우,2010-12
2010-12-31,116239,0,116239,그레나다,2010-12
2010-12-31,105775,98,105677,몬트세라트,2010-12
2010-12-31,103402,2414174,-2310772,솔로몬 군도,2010-12
2010-12-31,95769,0,95769,부룬디,2010-12
2010-12-31,80306,4766,75540,산마리노,2010-12
2010-12-31,74234,125093079,-125018845,적도 기니,2010-12
2010-12-31,69034,0,69034,세인트 루시아,2010-12
2010-12-31,65766,4281,61485,카보 베르데,2010-12
2010-12-31,63500,28055,35445,토켈라우,2010-12
2010-12-31,48244,0,48244,파로에 군도,2010-12
2010-12-31,38268,0,38268,코모로스,2010-12
2010-12-31,36853,0,36853,세인트 빈센트 그레나딘,2010-12
2010-12-31,33052,12133,20919,르완다,2010-12
2010-12-31,32982,0,32982,미령 버진군도,2010-12
2010-12-31,23726,0,23726,안타티카,2010-12
2010-12-31,21835,57,21778,쿡 아일랜드,2010-12
2010-12-31,21812,377626,-355814,통가,2010-12
2010-12-31,19563,0,19563,챠드,2010-12
2010-12-31,14810,0,14810,투르크 & 카이코스 군도,2010-12
2010-12-31,12835,8080,4755,말리,2010-12
2010-12-31,7529,0,7529,지브랄타,2010-12
2010-12-31,7200,0,7200,투발루,2010-12
2010-12-31,1510,0,1510,영령 인도양,2010-12
2010-12-31,52,933,-881,상토메 프린스페,2010-12
2010-12-31,0,4464488,-4464488,나우루,2010-12
2010-12-31,0,217,-217,세인트 피레 미켈론,2010-12
2010-12-31,0,18634,-18634,앙귈라,2010-12
2010-12-31,0,134,-134,키리바티,2010-12
2010-12-31,0,5455,-5455,세인트 헬레나,2010-12
2010-12-31,0,40815,-40815,그린랜드,2010-12
2011-01-31,10029211217,7070041186,2959170031,중국,2011-01
2011-01-31,4143179382,3118614964,1024564418,미국,2011-01
2011-01-31,2938130750,5190063480,-2251932730,일본,2011-01
2011-01-31,2368098461,185532900,2182565561,홍콩,2011-01
2011-01-31,2278399242,430762882,1847636360,프랑스,2011-01
2011-01-31,1525671375,1264351815,261319560,대만,2011-01
2011-01-31,1433746417,168400411,1265346006,멕시코,2011-01
2011-01-31,1253912146,841060841,412851305,싱가포르,2011-01
2011-01-31,1138163224,756409442,381753782,인도,2011-01
2011-01-31,976589431,1548912715,-572323284,인도네시아,2011-01
2011-01-31,972256499,404689676,567566823,베트남,2011-01
2011-01-31,876843280,1262203432,-385360152,독일,2011-01
2011-01-31,728640027,508263609,220376418,브라질,2011-01
2011-01-31,722742863,784256835,-61513972,러시아 연방,2011-01
2011-01-31,674018481,346002382,328016099,필리핀,2011-01
2011-01-31,645210978,4110,645206868,영령 버진군도,2011-01
2011-01-31,614225306,373590620,240634686,태국,2011-01
2011-01-31,597821605,2527568543,-1929746938,사우디아라비아,2011-01
2011-01-31,593815341,2340671443,-1746856102,호주,2011-01
2011-01-31,584706840,1235839632,-651132792,아랍에미리트 연합,2011-01
2011-01-31,577790260,988424831,-410634571,말레이시아,2011-01
2011-01-31,527796974,111700,527685274,라이베리아,2011-01
2011-01-31,504670553,256796773,247873780,영국,2011-01
2011-01-31,460342537,355291977,105050560,이탈리아,2011-01
2011-01-31,435828262,910218846,-474390584,이란,2011-01
2011-01-31,426649515,403869336,22780179,네덜란드,2011-01
2011-01-31,372829666,74622161,298207505,튀르키예,2011-01
2011-01-31,351478835,399885002,-48406167,캐나다,2011-01
2011-01-31,350715433,0,350715433,마샬군도,2011-01
2011-01-31,339889919,19443889,320446030,폴란드,2011-01
2011-01-31,319503910,8738774,310765136,슬로바키아,2011-01
2011-01-31,225385789,1112025452,-886639663,쿠웨이트,2011-01
2011-01-31,220618027,434430554,-213812527,칠레,2011-01
2011-01-31,215069133,30962616,184106517,이집트,2011-01
2011-01-31,209037831,43510452,165527379,파나마,2011-01
2011-01-31,176052077,123031152,53020925,벨기에,2011-01
2011-01-31,166418660,112333498,54085162,스페인,2011-01
2011-01-31,149538571,44975658,104562913,헝가리,2011-01
2011-01-31,135197252,178,135197074,영령 캐이맨 군도,2011-01
2011-01-31,125567735,210356113,-84788378,남아프리카공화국,2011-01
2011-01-31,125003145,10128682,114874463,방글라데시,2011-01
2011-01-31,124142707,1779502,122363205,우즈베키스탄,2011-01
2011-01-31,118778134,973373,117804761,시리아,2011-01
2011-01-31,112881369,46250466,66630903,콜롬비아,2011-01
2011-01-31,108189505,68185248,40004257,이스라엘,2011-01
2011-01-31,106282513,11930943,94351570,요르단,2011-01
2011-01-31,98652414,501975,98150439,알제리,2011-01
2011-01-31,93762314,27673300,66089014,체코공화국,2011-01
2011-01-31,84756723,252117696,-167360973,페루,2011-01
2011-01-31,84381949,159519176,-75137227,아르헨티나,2011-01
2011-01-31,77825863,45399323,32426540,우크라이나,2011-01
2011-01-31,77720435,60884646,16835789,핀란드,2011-01
2011-01-31,75716442,34401,75682041,중앙아프리카공화국,2011-01
2011-01-31,74980778,727673682,-652692904,이라크,2011-01
2011-01-31,74344066,46697,74297369,리비아,2011-01
2011-01-31,73472127,2629836,70842291,에쿠아도르,2011-01
2011-01-31,69152258,3859679,65292579,그리스,2011-01
2011-01-31,65581658,55486111,10095547,파키스탄,2011-01
2011-01-31,64772831,8083767,56689064,슬로베니아,2011-01
2011-01-31,63675984,582461983,-518785999,오만,2011-01
2011-01-31,62517009,67589820,-5072811,나이지리아,2011-01
2011-01-31,60814416,16484666,44329750,미얀마,2011-01
2011-01-31,55311814,108356160,-53044346,뉴질랜드,2011-01
2011-01-31,53859362,294,53859068,지브랄타,2011-01
2011-01-31,50203877,84544907,-34341030,오스트리아,2011-01
2011-01-31,49297269,10032143,39265126,바하마,2011-01
2011-01-31,43935375,168319042,-124383667,스웨덴,2011-01
2011-01-31,41838265,29200026,12638239,카자흐스탄,2011-01
2011-01-31,36942921,20300957,16641964,루마니아,2011-01
2011-01-31,33002293,5783457,27218836,캄보디아,2011-01
2011-01-31,32150857,3132415,29018442,베네주엘라,2011-01
2011-01-31,32146480,2661863,29484617,과테말라,2011-01
2011-01-31,32109078,1759758138,-1727649060,카타르,2011-01
2011-01-31,29198967,52182078,-22983111,덴마크,2011-01
2011-01-31,28973958,49538305,-20564347,모로코,2011-01
2011-01-31,28469725,33808447,-5338722,사이프러스,2011-01
2011-01-31,25942669,6375929,19566740,스리랑카,2011-01
2011-01-31,24858967,731750,24127217,가나,2011-01
2011-01-31,24121170,2146,24119024,아제르바이잔,2011-01
2011-01-31,23780896,67450863,-43669967,아일랜드,2011-01
2011-01-31,22227594,182574443,-160346849,스위스,2011-01
2011-01-31,21746307,7559085,14187222,포루투갈,2011-01
2011-01-31,20932579,292742549,-271809970,노르웨이,2011-01
2011-01-31,19340738,3880223,15460515,몽골,2011-01
2011-01-31,19241280,2717640,16523640,레바논,2011-01
2011-01-31,17830348,13735607,4094741,코스타리카,2011-01
2011-01-31,15551694,62244075,-46692381,바레인,2011-01
2011-01-31,15262106,2660949,12601157,우루과이,2011-01
2011-01-31,14475613,874946,13600667,니카라과,2011-01
2011-01-31,14422190,383541,14038649,파라과이,2011-01
2011-01-31,14149062,2850647,11298415,튀니지,2011-01
2011-01-31,13945400,594700,13350700,케냐,2011-01
2011-01-31,12936869,114455,12822414,앙골라,2011-01
2011-01-31,12859202,18107247,-5248045,푸에르토리코,2011-01
2011-01-31,12372355,10682611,1689744,온두라스,2011-01
2011-01-31,10286276,213138,10073138,수단,2011-01
2011-01-31,9825598,72727,9752871,아프카니스탄,2011-01
2011-01-31,9492115,5204683,4287432,도미니카 공화국,2011-01
2011-01-31,9292190,204922,9087268,라오스,2011-01
2011-01-31,9132377,1081402,8050975,에티오피아,2011-01
2011-01-31,9125456,1295396,7830060,라트비아,2011-01
2011-01-31,9108571,1851619,7256952,리투아니아,2011-01
2011-01-31,9100774,1009406,8091368,에스토니아,2011-01
2011-01-31,8890133,1245816,7644317,크로아티아,2011-01
2011-01-31,8133097,102772538,-94639441,예맨,2011-01
2011-01-31,8022611,201270,7821341,키르기스스탄,2011-01
2011-01-31,7669825,7740408,-70583,불가리아,2011-01
2011-01-31,7313205,6715968,597237,몰타,2011-01
2011-01-31,7295513,0,7295513,투르크멘,2011-01
2011-01-31,7095362,624871,6470491,쿠바,2011-01
2011-01-31,6944056,174282478,-167338422,브루나이,2011-01
2011-01-31,5825872,327277,5498595,마카오,2011-01
2011-01-31,5306885,53894147,-48587262,파푸아 뉴기니,2011-01
2011-01-31,5304627,52490,5252137,코트디봐르,2011-01
2011-01-31,5186366,10846627,-5660261,뉴 칼레도니아,2011-01
2011-01-31,4686966,174927,4512039,보스니아-헤르체고비나,2011-01
2011-01-31,4675404,250340,4425064,카메룬,2011-01
2011-01-31,4602299,1109471,3492828,탄자니아,2011-01
2011-01-31,4532121,82886,4449235,마이크로네시아,2011-01
2011-01-31,4511130,1722287,2788843,모리셔스,2011-01
2011-01-31,4308521,834335,3474186,조지아,2011-01
2011-01-31,4211332,1569429,2641903,엘살바도르,2011-01
2011-01-31,4151779,489072,3662707,세네갈,2011-01
2011-01-31,3631199,7549250,-3918051,타지크,2011-01
2011-01-31,3522826,349097,3173729,짐바브웨,2011-01
2011-01-31,3449506,307505,3142001,괌,2011-01
2011-01-31,3364679,52589749,-49225070,트리니다드 토바고,2011-01
2011-01-31,3337327,4962051,-1624724,모잠비크,2011-01
2011-01-31,3248724,0,3248724,지부티,2011-01
2011-01-31,3235136,45578,3189558,시에라 리온,2011-01
2011-01-31,3164626,12688,3151938,레소토,2011-01
2011-01-31,3158999,437434,2721565,우간다,2011-01
2011-01-31,2871210,964919,1906291,베닝,2011-01
2011-01-31,2801245,1473163,1328082,피지,2011-01
2011-01-31,2741954,0,2741954,토고,2011-01
2011-01-31,2676168,182147,2494021,마다카스카르,2011-01
2011-01-31,2669726,660616,2009110,벨라루스,2011-01
2011-01-31,2630220,20843,2609377,콩고,2011-01
2011-01-31,2618515,208928,2409587,아르메니아,2011-01
2011-01-31,2542115,77436,2464679,네팔,2011-01
2011-01-31,1977131,1857970,119161,룩셈부르그,2011-01
2011-01-31,1912127,176067,1736060,말라위,2011-01
2011-01-31,1903087,199,1902888,알바니아,2011-01
2011-01-31,1900367,22717,1877650,가이아나,2011-01
2011-01-31,1830709,92630849,-90800140,잠비아,2011-01
2011-01-31,1568601,0,1568601,르완다,2011-01
2011-01-31,1461455,5993154,-4531699,기타국,2011-01
2011-01-31,1424197,0,1424197,부르키나 파소,2011-01
2011-01-31,1404307,1039477,364830,기니,2011-01
2011-01-31,1397301,199420,1197881,팔레스타인 해방기구,2011-01
2011-01-31,1364214,899328,464886,자마이카,2011-01
2011-01-31,1267790,133,1267657,과델로프,2011-01
2011-01-31,1254728,97207,1157521,아이티,2011-01
2011-01-31,1247364,29359,1218005,모리타니,2011-01
2011-01-31,1162931,36627754,-35464823,볼리비아,2011-01
2011-01-31,1105695,13115864,-12010169,콩고민주공화국,2011-01
2011-01-31,1085566,2560527,-1474961,벨리제,2011-01
2011-01-31,1077822,44636,1033186,수리남,2011-01
2011-01-31,1075780,0,1075780,불령 리유니온 코모도 제도,2011-01
2011-01-31,1038141,10468,1027673,세이쉘,2011-01
2011-01-31,993921,0,993921,가봉,2011-01
2011-01-31,909606,0,909606,부탄,2011-01
2011-01-31,876075,23941975,-23065900,세르비아,2011-01
2011-01-31,784246,1055,783191,안티가 바부다,2011-01
2011-01-31,774645,0,774645,마티니크,2011-01
2011-01-31,752283,210416,541867,니제르,2011-01
2011-01-31,730860,52845,678015,나미비아,2011-01
2011-01-31,684045,10729,673316,북마리아나 군도,2011-01
2011-01-31,618614,457665,160949,스와질랜드,2011-01
2011-01-31,541304,74346,466958,사모아,2011-01
2011-01-31,527755,4979,522776,네덜란드 열도,2011-01
2011-01-31,516224,44830,471394,불령 폴리네시아,2011-01
2011-01-31,503479,0,503479,세인트 루시아,2011-01
2011-01-31,420134,284054,136080,몰도바,2011-01
2011-01-31,386108,350069,36039,모나코,2011-01
2011-01-31,364166,61888,302278,도미니카,2011-01
2011-01-31,330193,16223,313970,바누아투,2011-01
2011-01-31,300245,175939,124306,마세도니아,2011-01
2011-01-31,298535,362276,-63741,리히텐슈타인,2011-01
2011-01-31,234713,4194,230519,보츠와나,2011-01
2011-01-31,226727,276009185,-275782458,적도 기니,2011-01
2011-01-31,222776,0,222776,소말리아,2011-01
2011-01-31,221757,0,221757,팔라우,2011-01
2011-01-31,219185,19,219166,바베이도스,2011-01
2011-01-31,165731,71736,93995,아메리칸 사모아,2011-01
2011-01-31,150687,0,150687,아루바,2011-01
2011-01-31,148734,0,148734,불령 가이아나,2011-01
2011-01-31,143234,452,142782,몰디브,2011-01
2011-01-31,141324,248316,-106992,솔로몬 군도,2011-01
2011-01-31,126206,0,126206,노폴크 아일랜드,2011-01
2011-01-31,125025,2425840,-2300815,아이슬란드,2011-01
2011-01-31,121348,23224,98124,쿡 아일랜드,2011-01
2011-01-31,102098,0,102098,산마리노,2011-01
2011-01-31,99517,0,99517,그레나다,2011-01
2011-01-31,97503,0,97503,버뮤다,2011-01
2011-01-31,91064,0,91064,부룬디,2011-01
2011-01-31,85175,13920,71255,티모르,2011-01
2011-01-31,83938,11355,72583,카보 베르데,2011-01
2011-01-31,82402,33914191,-33831789,말리,2011-01
2011-01-31,77825,1235,76590,세인트 키츠 네비스,2011-01
2011-01-31,70005,0,70005,세인트 빈센트 그레나딘,2011-01
2011-01-31,46165,166636,-120471,토켈라우,2011-01
2011-01-31,44209,71,44138,감비아,2011-01
2011-01-31,43507,0,43507,에리트리아,2011-01
2011-01-31,36800,0,36800,기네비소,2011-01
2011-01-31,32580,0,32580,미령 버진군도,2011-01
2011-01-31,11717,7987,3730,안도라,2011-01
2011-01-31,10589,28944,-18355,몬테네그로,2011-01
2011-01-31,8400,0,8400,몬트세라트,2011-01
2011-01-31,7830,0,7830,파로에 군도,2011-01
2011-01-31,7366,498,6868,키리바티,2011-01
2011-01-31,2640,139380,-136740,통가,2011-01
2011-01-31,2600,0,2600,상토메 프린스페,2011-01
2011-01-31,1927,144215,-142288,앙귈라,2011-01
2011-01-31,924,0,924,안타티카,2011-01
2011-01-31,0,4116,-4116,투발루,2011-01
2011-01-31,0,35367,-35367,그린랜드,2011-01
2011-01-31,0,1139978,-1139978,나우루,2011-01
2011-02-28,9577541711,5308447663,4269094048,중국,2011-02
2011-02-28,3812273860,2967042304,845231556,미국,2011-02
2011-02-28,2701368512,5230045819,-2528677307,일본,2011-02
2011-02-28,2085626661,153833372,1931793289,홍콩,2011-02
2011-02-28,1549796506,678860671,870935835,싱가포르,2011-02
2011-02-28,1397253737,1024260189,372993548,대만,2011-02
2011-02-28,1379181115,505551883,873629232,브라질,2011-02
2011-02-28,1076801369,544482180,532319189,인도,2011-02
2011-02-28,932396093,1270992267,-338596174,독일,2011-02
2011-02-28,895497205,1278800448,-383303243,인도네시아,2011-02
2011-02-28,761839808,425469615,336370193,베트남,2011-02
2011-02-28,715943649,156334535,559609114,멕시코,2011-02
2011-02-28,639696059,629733103,9962956,러시아 연방,2011-02
2011-02-28,595037146,112467,594924679,라이베리아,2011-02
2011-02-28,575248655,428137424,147111231,태국,2011-02
2011-02-28,489051646,270757000,218294646,필리핀,2011-02
2011-02-28,469119980,955009772,-485889792,아랍에미리트 연합,2011-02
2011-02-28,467598482,1668451462,-1200852980,호주,2011-02
2011-02-28,444236052,2665900383,-2221664331,사우디아라비아,2011-02
2011-02-28,411107026,794989211,-383882185,말레이시아,2011-02
2011-02-28,367913772,306093757,61820015,이탈리아,2011-02
2011-02-28,353714793,227002595,126712198,네덜란드,2011-02
2011-02-28,351347027,77744372,273602655,튀르키예,2011-02
2011-02-28,307986501,736214437,-428227936,이란,2011-02
2011-02-28,306022504,25146826,280875678,폴란드,2011-02
2011-02-28,301086377,457084870,-155998493,캐나다,2011-02
2011-02-28,299619200,7170576,292448624,슬로바키아,2011-02
2011-02-28,252939585,205524540,47415045,노르웨이,2011-02
2011-02-28,250814973,161638755,89176218,브루나이,2011-02
2011-02-28,227858654,216130959,11727695,영국,2011-02
2011-02-28,206867336,0,206867336,마샬군도,2011-02
2011-02-28,198811970,279830009,-81018039,남아프리카공화국,2011-02
2011-02-28,196360172,7088976,189271196,몰타,2011-02
2011-02-28,185203932,47653860,137550072,이스라엘,2011-02
2011-02-28,175647608,307440914,-131793306,프랑스,2011-02
2011-02-28,164913701,79747960,85165741,스페인,2011-02
2011-02-28,152202298,523778915,-371576617,칠레,2011-02
2011-02-28,145356224,147501834,-2145610,이집트,2011-02
2011-02-28,144363966,29655454,114708512,헝가리,2011-02
2011-02-28,142640836,80486070,62154766,벨기에,2011-02
2011-02-28,137038635,11109729,125928906,방글라데시,2011-02
2011-02-28,126966533,2302757,124663776,파나마,2011-02
2011-02-28,108165587,67696097,40469490,콜롬비아,2011-02
2011-02-28,105480081,2308733,103171348,우즈베키스탄,2011-02
2011-02-28,103112413,671597663,-568485250,이라크,2011-02
2011-02-28,86262352,36470574,49791778,체코공화국,2011-02
2011-02-28,85338253,170408594,-85070341,페루,2011-02
2011-02-28,84425109,51134986,33290123,알제리,2011-02
2011-02-28,84225080,282010,83943070,시리아,2011-02
2011-02-28,82932511,4916011,78016500,기타국,2011-02
2011-02-28,82814403,96409835,-13595432,핀란드,2011-02
2011-02-28,79680840,5254149,74426691,요르단,2011-02
2011-02-28,79445279,1250179643,-1170734364,쿠웨이트,2011-02
2011-02-28,77563592,86149953,-8586361,뉴질랜드,2011-02
2011-02-28,75928309,6818800,69109509,슬로베니아,2011-02
2011-02-28,72805500,39820320,32985180,아르헨티나,2011-02
2011-02-28,71778403,94638675,-22860272,나이지리아,2011-02
2011-02-28,60117990,3004553,57113437,에쿠아도르,2011-02
2011-02-28,59640564,31178699,28461865,파키스탄,2011-02
2011-02-28,55416343,41066192,14350151,우크라이나,2011-02
2011-02-28,54972377,83043525,-28071148,오스트리아,2011-02
2011-02-28,44794365,129960640,-85166275,스웨덴,2011-02
2011-02-28,43015281,19205725,23809556,카자흐스탄,2011-02
2011-02-28,42584546,15087331,27497215,미얀마,2011-02
2011-02-28,33625320,442557949,-408932629,오만,2011-02
2011-02-28,33513216,196,33513020,불령 폴리네시아,2011-02
2011-02-28,33074257,7547743,25526514,포루투갈,2011-02
2011-02-28,29049786,172638539,-143588753,스위스,2011-02
2011-02-28,28041016,3828962,24212054,조지아,2011-02
2011-02-28,25963738,4376406,21587332,모로코,2011-02
2011-02-28,25776032,4541913,21234119,캄보디아,2011-02
2011-02-28,24400503,3286193,21114310,베네주엘라,2011-02
2011-02-28,24083871,17758931,6324940,과테말라,2011-02
2011-02-28,22912666,15735532,7177134,루마니아,2011-02
2011-02-28,22777525,1169549802,-1146772277,카타르,2011-02
2011-02-28,21757898,3205402,18552496,가나,2011-02
2011-02-28,21012276,45214504,-24202228,덴마크,2011-02
2011-02-28,20462968,4096225,16366743,스리랑카,2011-02
2011-02-28,20138762,623935,19514827,리비아,2011-02
2011-02-28,19381891,12778213,6603678,코스타리카,2011-02
2011-02-28,18827179,17037739,1789440,푸에르토리코,2011-02
2011-02-28,18542353,1247780,17294573,몽골,2011-02
2011-02-28,18307499,2917201,15390298,그리스,2011-02
2011-02-28,16674618,1261222,15413396,니카라과,2011-02
2011-02-28,15854105,647939,15206166,라오스,2011-02
2011-02-28,15515947,1730678,13785269,케냐,2011-02
2011-02-28,15412346,543566,14868780,수단,2011-02
2011-02-28,15354037,87863314,-72509277,바레인,2011-02
2011-02-28,15329285,2732915,12596370,우루과이,2011-02
2011-02-28,14306123,0,14306123,투르크멘,2011-02
2011-02-28,13886726,8992969,4893757,불가리아,2011-02
2011-02-28,13815193,2083333,11731860,레바논,2011-02
2011-02-28,13034823,432103,12602720,앙골라,2011-02
2011-02-28,12835830,1766777,11069053,리투아니아,2011-02
2011-02-28,11565970,14744620,-3178650,온두라스,2011-02
2011-02-28,10945265,46488599,-35543334,아일랜드,2011-02
2011-02-28,10513190,4842463,5670727,도미니카 공화국,2011-02
2011-02-28,9503036,76133,9426903,키르기스스탄,2011-02
2011-02-28,9223540,1789859,7433681,라트비아,2011-02
2011-02-28,8736070,21643215,-12907145,쿠바,2011-02
2011-02-28,8571186,0,8571186,아제르바이잔,2011-02
2011-02-28,8028592,3053885,4974707,튀니지,2011-02
2011-02-28,6407489,221422,6186067,파라과이,2011-02
2011-02-28,6388269,1578,6386691,코트디봐르,2011-02
2011-02-28,6311386,62154892,-55843506,예맨,2011-02
2011-02-28,5623812,9081822,-3458010,탄자니아,2011-02
2011-02-28,5604469,63166053,-57561584,트리니다드 토바고,2011-02
2011-02-28,5524521,833813,4690708,카메룬,2011-02
2011-02-28,5452043,2090061,3361982,엘살바도르,2011-02
2011-02-28,5235259,2599350,2635909,크로아티아,2011-02
2011-02-28,4682548,1118208,3564340,에스토니아,2011-02
2011-02-28,4560339,9659463,-5099124,콩고,2011-02
2011-02-28,4322599,897535,3425064,벨라루스,2011-02
2011-02-28,4014880,36262496,-32247616,파푸아 뉴기니,2011-02
2011-02-28,3951839,371995,3579844,세네갈,2011-02
2011-02-28,3789696,1934971,1854725,모리셔스,2011-02
2011-02-28,3543086,12575544,-9032458,뉴 칼레도니아,2011-02
2011-02-28,3361927,51695,3310232,레소토,2011-02
2011-02-28,3073503,422981,2650522,괌,2011-02
2011-02-28,3011910,135625,2876285,팔레스타인 해방기구,2011-02
2011-02-28,2994981,279920,2715061,마카오,2011-02
2011-02-28,2766639,84738761,-81972122,사이프러스,2011-02
2011-02-28,2508283,3520135,-1011852,모잠비크,2011-02
2011-02-28,2498467,0,2498467,가봉,2011-02
2011-02-28,2341654,54478,2287176,가이아나,2011-02
2011-02-28,2231250,679153,1552097,에티오피아,2011-02
2011-02-28,2145373,586805,1558568,베닝,2011-02
2011-02-28,2051449,1093,2050356,지부티,2011-02
2011-02-28,1977070,782264,1194806,짐바브웨,2011-02
2011-02-28,1882719,14835,1867884,네덜란드 열도,2011-02
2011-02-28,1881951,357378,1524573,네팔,2011-02
2011-02-28,1866172,5026220,-3160048,타지크,2011-02
2011-02-28,1778974,104545,1674429,아이티,2011-02
2011-02-28,1692143,3328,1688815,알바니아,2011-02
2011-02-28,1675360,0,1675360,아루바,2011-02
2011-02-28,1618376,30985,1587391,마다카스카르,2011-02
2011-02-28,1615122,117414,1497708,아르메니아,2011-02
2011-02-28,1562925,78202,1484723,바하마,2011-02
2011-02-28,1499687,1567512,-67825,룩셈부르그,2011-02
2011-02-28,1417662,307624,1110038,우간다,2011-02
2011-02-28,1381856,0,1381856,영령 버진군도,2011-02
2011-02-28,1367661,561,1367100,아프카니스탄,2011-02
2011-02-28,1259286,603984,655302,자마이카,2011-02
2011-02-28,1257249,0,1257249,부탄,2011-02
2011-02-28,1247398,30553,1216845,수리남,2011-02
2011-02-28,1033652,1044098,-10446,피지,2011-02
2011-02-28,1011408,65542,945866,토고,2011-02
2011-02-28,977471,2523806,-1546335,세르비아,2011-02
2011-02-28,937294,0,937294,불령 리유니온 코모도 제도,2011-02
2011-02-28,907167,91731,815436,보스니아-헤르체고비나,2011-02
2011-02-28,900712,0,900712,마티니크,2011-02
2011-02-28,890802,73817,816985,보츠와나,2011-02
2011-02-28,861921,25367,836554,세이쉘,2011-02
2011-02-28,859586,255499,604087,모리타니,2011-02
2011-02-28,849550,4651769,-3802219,콩고민주공화국,2011-02
2011-02-28,774103,1373,772730,바베이도스,2011-02
2011-02-28,746021,27075807,-26329786,볼리비아,2011-02
2011-02-28,602916,3648,599268,부르키나 파소,2011-02
2011-02-28,580539,115,580424,버뮤다,2011-02
2011-02-28,519469,25274,494195,르완다,2011-02
2011-02-28,517638,0,517638,에리트리아,2011-02
2011-02-28,514263,369407,144856,스와질랜드,2011-02
2011-02-28,506192,511,505681,북마리아나 군도,2011-02
2011-02-28,504820,11,504809,과델로프,2011-02
2011-02-28,492769,519743,-26974,기니,2011-02
2011-02-28,489752,916378,-426626,아이슬란드,2011-02
2011-02-28,483312,450305,33007,리히텐슈타인,2011-02
2011-02-28,459054,57888,401166,몬테네그로,2011-02
2011-02-28,409854,313745,96109,시에라 리온,2011-02
2011-02-28,402222,53909,348313,마이크로네시아,2011-02
2011-02-28,375274,0,375274,영령 캐이맨 군도,2011-02
2011-02-28,374711,3367,371344,도미니카,2011-02
2011-02-28,364764,95,364669,말라위,2011-02
2011-02-28,299105,22914847,-22615742,잠비아,2011-02
2011-02-28,293319,1729,291590,안티가 바부다,2011-02
2011-02-28,266325,190792,75533,마세도니아,2011-02
2011-02-28,256767,153077,103690,모나코,2011-02
2011-02-28,237771,7003,230768,몰디브,2011-02
2011-02-28,226537,0,226537,세인트 루시아,2011-02
2011-02-28,208293,0,208293,산마리노,2011-02
2011-02-28,188216,878015,-689799,바누아투,2011-02
2011-02-28,170059,17123,152936,아메리칸 사모아,2011-02
2011-02-28,158048,534,157514,미령 버진군도,2011-02
2011-02-28,154721,0,154721,사모아,2011-02
2011-02-28,142241,0,142241,나미비아,2011-02
2011-02-28,136480,0,136480,벨리제,2011-02
2011-02-28,133213,17278,115935,티모르,2011-02
2011-02-28,126975,128499,-1524,몰도바,2011-02
2011-02-28,122664,4265,118399,감비아,2011-02
2011-02-28,120437,16458245,-16337808,말리,2011-02
2011-02-28,107884,145,107739,그레나다,2011-02
2011-02-28,94889,0,94889,세인트 빈센트 그레나딘,2011-02
2011-02-28,89085,0,89085,불령 가이아나,2011-02
2011-02-28,88932,80953231,-80864299,적도 기니,2011-02
2011-02-28,78650,0,78650,세인트 키츠 네비스,2011-02
2011-02-28,73819,0,73819,팔라우,2011-02
2011-02-28,58446,0,58446,쿡 아일랜드,2011-02
2011-02-28,40672,0,40672,불령 남부지역,2011-02
2011-02-28,40088,9641,30447,몬트세라트,2011-02
2011-02-28,30053,0,30053,카보 베르데,2011-02
2011-02-28,29355,0,29355,중앙아프리카공화국,2011-02
2011-02-28,29160,45,29115,보빗군도,2011-02
2011-02-28,28305,816626,-788321,솔로몬 군도,2011-02
2011-02-28,25746,0,25746,통가,2011-02
2011-02-28,19448,22,19426,부룬디,2011-02
2011-02-28,18484,64771,-46287,안도라,2011-02
2011-02-28,13659,37997,-24338,기네비소,2011-02
2011-02-28,13382,0,13382,지브랄타,2011-02
2011-02-28,11675,0,11675,키리바티,2011-02
2011-02-28,6080,0,6080,챠드,2011-02
2011-02-28,538,56726,-56188,니우에,2011-02
2011-02-28,270,0,270,앙귈라,2011-02
2011-02-28,0,307421,-307421,세인트 헬레나,2011-02
2011-02-28,0,500,-500,투발루,2011-02
2011-02-28,0,7164630,-7164630,나우루,2011-02
2011-02-28,0,3800,-3800,크리스마스 아일랜드,2011-02
2011-02-28,0,534324,-534324,니제르,2011-02
2011-02-28,0,48496,-48496,토켈라우,2011-02
2011-03-31,11518731476,7892766833,3625964643,중국,2011-03
2011-03-31,4643161735,3910511886,732649849,미국,2011-03
2011-03-31,3257020652,6291154862,-3034134210,일본,2011-03
2011-03-31,2566588464,199604528,2366983936,홍콩,2011-03
2011-03-31,1949357564,1316531845,632825719,대만,2011-03
2011-03-31,1764461876,745935103,1018526773,싱가포르,2011-03
2011-03-31,1318614480,36779,1318577701,라이베리아,2011-03
2011-03-31,1171151336,1268502203,-97350867,인도네시아,2011-03
2011-03-31,1137402881,611780624,525622257,인도,2011-03
2011-03-31,1128867092,447602094,681264998,베트남,2011-03
2011-03-31,1022135772,90291,1022045481,마샬군도,2011-03
2011-03-31,891209571,1106541455,-215331884,러시아 연방,2011-03
2011-03-31,820903034,393089807,427813227,브라질,2011-03
2011-03-31,787920542,211369855,576550687,멕시코,2011-03
2011-03-31,784678193,1512834296,-728156103,독일,2011-03
2011-03-31,673031281,510044740,162986541,태국,2011-03
2011-03-31,654626607,298207796,356418811,영국,2011-03
2011-03-31,623112043,972253111,-349141068,말레이시아,2011-03
2011-03-31,620948936,2922672324,-2301723388,사우디아라비아,2011-03
2011-03-31,618565761,1029257607,-410691846,아랍에미리트 연합,2011-03
2011-03-31,586865686,2478710427,-1891844741,호주,2011-03
2011-03-31,552286788,370504729,181782059,이탈리아,2011-03
2011-03-31,522231893,341483542,180748351,필리핀,2011-03
2011-03-31,466016230,558966810,-92950580,프랑스,2011-03
2011-03-31,448656271,10220327,438435944,슬로바키아,2011-03
2011-03-31,437077024,85299944,351777080,튀르키예,2011-03
2011-03-31,434090515,455920312,-21829797,캐나다,2011-03
2011-03-31,404204637,1127413995,-723209358,이란,2011-03
2011-03-31,398055322,9356377,388698945,포루투갈,2011-03
2011-03-31,370980574,316935155,54045419,네덜란드,2011-03
2011-03-31,356751779,35570370,321181409,폴란드,2011-03
2011-03-31,248944991,1989247,246955744,파나마,2011-03
2011-03-31,225774418,406107399,-180332981,칠레,2011-03
2011-03-31,189631230,122766186,66865044,벨기에,2011-03
2011-03-31,183118289,277821503,-94703214,스웨덴,2011-03
2011-03-31,170766078,8656728,162109350,몰타,2011-03
2011-03-31,164384833,89949591,74435242,스페인,2011-03
2011-03-31,161119768,31348460,129771308,콜롬비아,2011-03
2011-03-31,157095810,29426468,127669342,헝가리,2011-03
2011-03-31,154763146,324368011,-169604865,남아프리카공화국,2011-03
2011-03-31,145570891,62968037,82602854,이스라엘,2011-03
2011-03-31,144456893,128132022,16324871,뉴질랜드,2011-03
2011-03-31,144297659,226804568,-82506909,페루,2011-03
2011-03-31,141330391,17480787,123849604,방글라데시,2011-03
2011-03-31,117722647,5991547,111731100,요르단,2011-03
2011-03-31,113006865,57011480,55995385,체코공화국,2011-03
2011-03-31,112495120,2608426,109886694,우즈베키스탄,2011-03
2011-03-31,102134926,0,102134926,맨섬,2011-03
2011-03-31,99764292,448420,99315872,시리아,2011-03
2011-03-31,98430467,791090764,-692660297,이라크,2011-03
2011-03-31,96031192,35051433,60979759,아르헨티나,2011-03
2011-03-31,93478843,41526946,51951897,우크라이나,2011-03
2011-03-31,92318710,18815952,73502758,알제리,2011-03
2011-03-31,91512235,109214750,-17702515,오스트리아,2011-03
2011-03-31,89716529,84524176,5192353,핀란드,2011-03
2011-03-31,87803318,78555394,9247924,이집트,2011-03
2011-03-31,85185982,70793296,14392686,파키스탄,2011-03
2011-03-31,82994422,25290927,57703495,나이지리아,2011-03
2011-03-31,81468073,990958,80477115,에쿠아도르,2011-03
2011-03-31,78879688,7603420,71276268,슬로베니아,2011-03
2011-03-31,70684497,99036444,-28351947,베네주엘라,2011-03
2011-03-31,62067926,1111411527,-1049343601,쿠웨이트,2011-03
2011-03-31,60816130,28961642,31854488,카자흐스탄,2011-03
2011-03-31,56814033,411977576,-355163543,오만,2011-03
2011-03-31,54391375,20996633,33394742,미얀마,2011-03
2011-03-31,51581139,26451230,25129909,루마니아,2011-03
2011-03-31,41912702,6342508,35570194,캄보디아,2011-03
2011-03-31,40441861,1675820255,-1635378394,카타르,2011-03
2011-03-31,39885792,48308182,-8422390,과테말라,2011-03
2011-03-31,39369623,3404458,35965165,그리스,2011-03
2011-03-31,37861821,4031444,33830377,몽골,2011-03
2011-03-31,36335815,117977,36217838,괌,2011-03
2011-03-31,33765991,7694011,26071980,모로코,2011-03
2011-03-31,33593712,7683267,25910445,스리랑카,2011-03
2011-03-31,31635360,222421075,-190785715,스위스,2011-03
2011-03-31,30706798,67634513,-36927715,덴마크,2011-03
2011-03-31,30146458,1431789,28714669,가나,2011-03
2011-03-31,27932414,2912846,25019568,레바논,2011-03
2011-03-31,23400255,15604036,7796219,코스타리카,2011-03
2011-03-31,23210536,0,23210536,투르크멘,2011-03
2011-03-31,22794359,145,22794214,아제르바이잔,2011-03
2011-03-31,21682422,330831,21351591,파라과이,2011-03
2011-03-31,20877461,56553347,-35675886,아일랜드,2011-03
2011-03-31,20845823,3425432,17420391,우루과이,2011-03
2011-03-31,19267382,6562064,12705318,불가리아,2011-03
2011-03-31,19031943,2567901,16464042,케냐,2011-03
2011-03-31,18104847,328944,17775903,앙골라,2011-03
2011-03-31,17794850,934682,16860168,수단,2011-03
2011-03-31,16936937,256459,16680478,라오스,2011-03
2011-03-31,16633051,1745150,14887901,리투아니아,2011-03
2011-03-31,16089229,2531360,13557869,니카라과,2011-03
2011-03-31,15345157,22729141,-7383984,푸에르토리코,2011-03
2011-03-31,14509915,22559443,-8049528,바레인,2011-03
2011-03-31,13882807,6816108,7066699,도미니카 공화국,2011-03
2011-03-31,13468061,125249,13342812,키르기스스탄,2011-03
2011-03-31,13027941,3454963,9572978,튀니지,2011-03
2011-03-31,12929206,12543804,385402,온두라스,2011-03
2011-03-31,12329234,280514987,-268185753,노르웨이,2011-03
2011-03-31,9316020,24310297,-14994277,엘살바도르,2011-03
2011-03-31,8946026,263930521,-254984495,브루나이,2011-03
2011-03-31,8611467,60726393,-52114926,트리니다드 토바고,2011-03
2011-03-31,8447473,1718639,6728834,라트비아,2011-03
2011-03-31,8145057,79943186,-71798129,예맨,2011-03
2011-03-31,7779276,7850355,-71079,에스토니아,2011-03
2011-03-31,6952746,5843526,1109220,파푸아 뉴기니,2011-03
2011-03-31,6131243,9081622,-2950379,탄자니아,2011-03
2011-03-31,5674660,355948,5318712,리비아,2011-03
2011-03-31,5593755,885422,4708333,카메룬,2011-03
2011-03-31,5285519,304574,4980945,마카오,2011-03
2011-03-31,5148933,660041,4488892,모리셔스,2011-03
2011-03-31,4942896,4703845,239051,쿠바,2011-03
2011-03-31,4736282,846379,3889903,벨라루스,2011-03
2011-03-31,4734048,0,4734048,코트디봐르,2011-03
2011-03-31,4679218,4088452,590766,나우루,2011-03
2011-03-31,4457721,8165,4449556,네덜란드 열도,2011-03
2011-03-31,4366824,20300722,-15933898,뉴 칼레도니아,2011-03
2011-03-31,4328482,4061578,266904,조지아,2011-03
2011-03-31,4304648,9884357,-5579709,콩고,2011-03
2011-03-31,4303987,2156938,2147049,에티오피아,2011-03
2011-03-31,4295312,12951994,-8656682,타지크,2011-03
2011-03-31,4269432,819517,3449915,베닝,2011-03
2011-03-31,4128030,143568,3984462,마다카스카르,2011-03
2011-03-31,4020547,266061,3754486,팔레스타인 해방기구,2011-03
2011-03-31,3920348,0,3920348,영령 버진군도,2011-03
2011-03-31,3808673,170325,3638348,네팔,2011-03
2011-03-31,3784234,466823,3317411,세네갈,2011-03
2011-03-31,3504436,765,3503671,토고,2011-03
2011-03-31,3235083,94194434,-90959351,사이프러스,2011-03
2011-03-31,3152559,54361321,-51208762,볼리비아,2011-03
2011-03-31,3051469,1615618,1435851,크로아티아,2011-03
2011-03-31,2497641,530377,1967264,아이티,2011-03
2011-03-31,2339110,3312274,-973164,룩셈부르그,2011-03
2011-03-31,2326031,599664,1726367,우간다,2011-03
2011-03-31,2324786,12786,2312000,바베이도스,2011-03
2011-03-31,2241040,0,2241040,지부티,2011-03
2011-03-31,2208280,0,2208280,아루바,2011-03
2011-03-31,2110632,2715,2107917,아르메니아,2011-03
2011-03-31,2066223,394768,1671455,바하마,2011-03
2011-03-31,2045596,14663982,-12618386,모잠비크,2011-03
2011-03-31,2001286,654538,1346748,자마이카,2011-03
2011-03-31,1993459,20932,1972527,아프카니스탄,2011-03
2011-03-31,1979539,286598,1692941,보스니아-헤르체고비나,2011-03
2011-03-31,1940150,0,1940150,부르키나 파소,2011-03
2011-03-31,1922384,1140073,782311,기니,2011-03
2011-03-31,1875547,5372635,-3497088,가봉,2011-03
2011-03-31,1711144,1494,1709650,불령 리유니온 코모도 제도,2011-03
2011-03-31,1689027,9755,1679272,알바니아,2011-03
2011-03-31,1579328,19506,1559822,안도라,2011-03
2011-03-31,1564405,759484,804921,짐바브웨,2011-03
2011-03-31,1466800,555345,911455,세르비아,2011-03
2011-03-31,1387458,33082,1354376,레소토,2011-03
2011-03-31,1346065,1,1346064,르완다,2011-03
2011-03-31,1288771,13825914,-12537143,콩고민주공화국,2011-03
2011-03-31,1193284,1135666,57618,아이슬란드,2011-03
2011-03-31,1141997,96267,1045730,마이크로네시아,2011-03
2011-03-31,1124474,71464,1053010,가이아나,2011-03
2011-03-31,1103033,63113507,-62010474,잠비아,2011-03
2011-03-31,1073593,1260321,-186728,피지,2011-03
2011-03-31,1036449,6388914,-5352465,기타국,2011-03
2011-03-31,1025980,271243,754737,세이쉘,2011-03
2011-03-31,1015562,38,1015524,마티니크,2011-03
2011-03-31,1001006,67337,933669,시에라 리온,2011-03
2011-03-31,955727,18727913,-17772186,말리,2011-03
2011-03-31,874937,45845,829092,불령 폴리네시아,2011-03
2011-03-31,825118,587691,237427,스와질랜드,2011-03
2011-03-31,802879,44237,758642,수리남,2011-03
2011-03-31,725911,404734,321177,모리타니,2011-03
2011-03-31,714677,4332,710345,과델로프,2011-03
2011-03-31,689647,62854,626793,보츠와나,2011-03
2011-03-31,671346,211,671135,부탄,2011-03
2011-03-31,608744,0,608744,그레나다,2011-03
2011-03-31,533998,0,533998,불령 가이아나,2011-03
2011-03-31,532642,0,532642,영령 캐이맨 군도,2011-03
2011-03-31,489900,63853,426047,말라위,2011-03
2011-03-31,482674,3293,479381,벨리제,2011-03
2011-03-31,433975,4,433971,나미비아,2011-03
2011-03-31,423073,622092,-199019,리히텐슈타인,2011-03
2011-03-31,421288,39,421249,버뮤다,2011-03
2011-03-31,407196,378690,28506,바누아투,2011-03
2011-03-31,401408,16427,384981,티모르,2011-03
2011-03-31,381547,32697,348850,북마리아나 군도,2011-03
2011-03-31,372400,38257,334143,몰디브,2011-03
2011-03-31,311901,382443,-70542,모나코,2011-03
2011-03-31,303404,0,303404,세인트 루시아,2011-03
2011-03-31,287494,729,286765,몬테네그로,2011-03
2011-03-31,285728,2868,282860,안티가 바부다,2011-03
2011-03-31,268645,118697,149948,도미니카,2011-03
2011-03-31,215263,1565442,-1350179,마세도니아,2011-03
2011-03-31,211001,0,211001,사모아,2011-03
2011-03-31,177733,8074,169659,산마리노,2011-03
2011-03-31,176343,56501,119842,토켈라우,2011-03
2011-03-31,161794,21,161773,감비아,2011-03
2011-03-31,151164,2096912,-1945748,몰도바,2011-03
2011-03-31,147360,0,147360,통가,2011-03
2011-03-31,123308,20786,102522,아메리칸 사모아,2011-03
2011-03-31,114591,82101021,-81986430,적도 기니,2011-03
2011-03-31,74545,1452,73093,팔라우,2011-03
2011-03-31,73186,1469,71717,카보 베르데,2011-03
2011-03-31,70209,346,69863,미령 버진군도,2011-03
2011-03-31,69622,0,69622,니제르,2011-03
2011-03-31,66849,0,66849,세인트 빈센트 그레나딘,2011-03
2011-03-31,54600,44732,9868,세인트 키츠 네비스,2011-03
2011-03-31,36782,2022071,-1985289,솔로몬 군도,2011-03
2011-03-31,32678,1617,31061,쿡 아일랜드,2011-03
2011-03-31,32665,1245,31420,중앙아프리카공화국,2011-03
2011-03-31,31743,0,31743,투발루,2011-03
2011-03-31,25582,0,25582,보빗군도,2011-03
2011-03-31,17102,0,17102,지브랄타,2011-03
2011-03-31,14041,0,14041,포클랜드 군도,2011-03
2011-03-31,8118,0,8118,키리바티,2011-03
2011-03-31,5240,7312,-2072,상토메 프린스페,2011-03
2011-03-31,4646,0,4646,챠드,2011-03
2011-03-31,2100,97718,-95618,몬트세라트,2011-03
2011-03-31,720,0,720,에리트리아,2011-03
2011-03-31,611,0,611,니우에,2011-03
2011-03-31,405,337684,-337279,그린랜드,2011-03
2011-03-31,0,16,-16,세인트 헬레나,2011-03
2011-03-31,0,8118,-8118,교황청,2011-03
2011-03-31,0,61233,-61233,파로에 군도,2011-03
2011-03-31,0,51,-51,앙귈라,2011-03
2011-04-30,10807465994,7634944863,3172521131,중국,2011-04
2011-04-30,5094082851,3819253227,1274829624,미국,2011-04
2011-04-30,3575084786,5827116173,-2252031387,일본,2011-04
2011-04-30,2611215292,255451581,2355763711,홍콩,2011-04
2011-04-30,2027181263,766475522,1260705741,싱가포르,2011-04
2011-04-30,1703653770,1340414663,363239107,대만,2011-04
2011-04-30,1579277086,2889790,1576387296,나이지리아,2011-04
2011-04-30,1437769253,457052486,980716767,브라질,2011-04
2011-04-30,1182297719,468658787,713638932,베트남,2011-04
2011-04-30,1094949635,1402025971,-307076336,인도네시아,2011-04
2011-04-30,1015339825,636724460,378615365,인도,2011-04
2011-04-30,879984314,1426720711,-546736397,독일,2011-04
2011-04-30,800978276,810973133,-9994857,러시아 연방,2011-04
2011-04-30,790370917,177904545,612466372,멕시코,2011-04
2011-04-30,702142030,6799388,695342642,몰타,2011-04
2011-04-30,651843720,1868332446,-1216488726,호주,2011-04
2011-04-30,646397434,3571135468,-2924738034,사우디아라비아,2011-04
2011-04-30,645267259,286492761,358774498,영국,2011-04
2011-04-30,638382752,454535636,183847116,태국,2011-04
2011-04-30,607418621,1394816015,-787397394,아랍에미리트 연합,2011-04
2011-04-30,569898468,286327064,283571404,필리핀,2011-04
2011-04-30,543060241,487661520,55398721,프랑스,2011-04
2011-04-30,523315323,859227121,-335911798,말레이시아,2011-04
2011-04-30,493328142,46324137,447004005,튀르키예,2011-04
2011-04-30,491828265,57362,491770903,라이베리아,2011-04
2011-04-30,423589273,803135514,-379546241,이란,2011-04
2011-04-30,420488421,571971219,-151482798,캐나다,2011-04
2011-04-30,413555148,283,413554865,마샬군도,2011-04
2011-04-30,372949829,28509458,344440371,폴란드,2011-04
2011-04-30,368211410,11785947,356425463,슬로바키아,2011-04
2011-04-30,303392880,329092814,-25699934,이탈리아,2011-04
2011-04-30,294493017,21636972,272856045,파나마,2011-04
2011-04-30,284255857,477864796,-193608939,네덜란드,2011-04
2011-04-30,196147451,130680455,65466996,벨기에,2011-04
2011-04-30,180306156,40237535,140068621,그리스,2011-04
2011-04-30,173490337,447726610,-274236273,칠레,2011-04
2011-04-30,168066103,95171774,72894329,스페인,2011-04
2011-04-30,164073804,30506326,133567478,이집트,2011-04
2011-04-30,152241226,344621243,-192380017,남아프리카공화국,2011-04
2011-04-30,147478969,61112668,86366301,이스라엘,2011-04
2011-04-30,142600234,875505,141724729,우즈베키스탄,2011-04
2011-04-30,135497929,29869921,105628008,콜롬비아,2011-04
2011-04-30,124484618,19132209,105352409,방글라데시,2011-04
2011-04-30,117179642,32506292,84673350,헝가리,2011-04
2011-04-30,115714329,169398221,-53683892,페루,2011-04
2011-04-30,104762341,501386006,-396623665,이라크,2011-04
2011-04-30,103536118,131414745,-27878627,뉴질랜드,2011-04
2011-04-30,103508084,35210343,68297741,우크라이나,2011-04
2011-04-30,99446781,3653620,95793161,요르단,2011-04
2011-04-30,95979225,386511679,-290532454,노르웨이,2011-04
2011-04-30,95225077,9422789,85802288,알제리,2011-04
2011-04-30,91441696,41875172,49566524,체코공화국,2011-04
2011-04-30,91408990,53767052,37641938,시리아,2011-04
2011-04-30,86738389,7689530,79048859,슬로베니아,2011-04
2011-04-30,79519527,39813372,39706155,아르헨티나,2011-04
2011-04-30,72019708,133970135,-61950427,오스트리아,2011-04
2011-04-30,71324429,47370356,23954073,파키스탄,2011-04
2011-04-30,69954566,1931875,68022691,에쿠아도르,2011-04
2011-04-30,69642335,3862960,65779375,베네주엘라,2011-04
2011-04-30,67473495,462726993,-395253498,오만,2011-04
2011-04-30,67233428,343736,66889692,괌,2011-04
2011-04-30,60599479,22441176,38158303,미얀마,2011-04
2011-04-30,60314129,219151501,-158837372,스웨덴,2011-04
2011-04-30,55299184,84772714,-29473530,핀란드,2011-04
2011-04-30,53165297,1387130196,-1333964899,쿠웨이트,2011-04
2011-04-30,48737968,32831313,15906655,카자흐스탄,2011-04
2011-04-30,44531688,1464625035,-1420093347,카타르,2011-04
2011-04-30,41542938,26470425,15072513,루마니아,2011-04
2011-04-30,40280538,65316854,-25036316,아일랜드,2011-04
2011-04-30,38646395,303021,38343374,바하마,2011-04
2011-04-30,38320923,5946177,32374746,캄보디아,2011-04
2011-04-30,36111128,22,36111106,불령 폴리네시아,2011-04
2011-04-30,35148229,92577,35055652,가이아나,2011-04
2011-04-30,33844978,8658835,25186143,포루투갈,2011-04
2011-04-30,32609940,5655092,26954848,모로코,2011-04
2011-04-30,32286798,206627691,-174340893,스위스,2011-04
2011-04-30,31957563,15324960,16632603,몽골,2011-04
2011-04-30,31054626,7757251,23297375,스리랑카,2011-04
2011-04-30,30398396,52687766,-22289370,덴마크,2011-04
2011-04-30,30284607,3186375,27098232,레바논,2011-04
2011-04-30,30060161,996176,29063985,가나,2011-04
2011-04-30,26677406,3102284,23575122,불가리아,2011-04
2011-04-30,26568985,88122377,-61553392,과테말라,2011-04
2011-04-30,24995493,0,24995493,투르크멘,2011-04
2011-04-30,20288374,138118,20150256,앙골라,2011-04
2011-04-30,18678665,5848089,12830576,니카라과,2011-04
2011-04-30,18328896,1739747,16589149,우루과이,2011-04
2011-04-30,18026711,10744011,7282700,코스타리카,2011-04
2011-04-30,17219615,10966209,6253406,바레인,2011-04
2011-04-30,17132838,16653859,478979,푸에르토리코,2011-04
2011-04-30,16732968,12,16732956,아제르바이잔,2011-04
2011-04-30,15055239,2044779,13010460,케냐,2011-04
2011-04-30,13850315,181085,13669230,라오스,2011-04
2011-04-30,13786385,312722,13473663,파라과이,2011-04
2011-04-30,13502218,3784556,9717662,튀니지,2011-04
2011-04-30,12353309,21,12353288,키르기스스탄,2011-04
2011-04-30,12146212,11798495,347717,온두라스,2011-04
2011-04-30,11917619,1761533,10156086,라트비아,2011-04
2011-04-30,11662675,924983,10737692,수단,2011-04
2011-04-30,10987581,83534030,-72546449,브루나이,2011-04
2011-04-30,10219871,2325614,7894257,리투아니아,2011-04
2011-04-30,10055419,6873373,3182046,도미니카 공화국,2011-04
2011-04-30,8717846,61340335,-52622489,트리니다드 토바고,2011-04
2011-04-30,8623475,1734307,6889168,에티오피아,2011-04
2011-04-30,8416338,1393916,7022422,엘살바도르,2011-04
2011-04-30,7763559,420401,7343158,탄자니아,2011-04
2011-04-30,7428433,23933,7404500,레소토,2011-04
2011-04-30,6958548,799889,6158659,기니,2011-04
2011-04-30,6695245,4932,6690313,아프카니스탄,2011-04
2011-04-30,6654978,78509441,-71854463,예맨,2011-04
2011-04-30,5678851,630537,5048314,벨라루스,2011-04
2011-04-30,5622047,1516649,4105398,에스토니아,2011-04
2011-04-30,5570811,533165,5037646,파푸아 뉴기니,2011-04
2011-04-30,5143444,565991,4577453,카메룬,2011-04
2011-04-30,4554678,2795433,1759245,조지아,2011-04
2011-04-30,4497974,400587,4097387,세네갈,2011-04
2011-04-30,4351616,281076,4070540,마카오,2011-04
2011-04-30,4292548,79941,4212607,모잠비크,2011-04
2011-04-30,4074346,19346193,-15271847,뉴 칼레도니아,2011-04
2011-04-30,4035562,205193,3830369,네팔,2011-04
2011-04-30,3925483,1818988,2106495,크로아티아,2011-04
2011-04-30,3906344,365638,3540706,모리셔스,2011-04
2011-04-30,3839346,10561731,-6722385,타지크,2011-04
2011-04-30,3743875,9940579,-6196704,콩고,2011-04
2011-04-30,3606409,410521,3195888,쿠바,2011-04
2011-04-30,3591169,1005725,2585444,우간다,2011-04
2011-04-30,3487238,34053764,-30566526,리비아,2011-04
2011-04-30,3250986,51690,3199296,코트디봐르,2011-04
2011-04-30,3059235,1420031,1639204,베닝,2011-04
2011-04-30,2896872,238243,2658629,팔레스타인 해방기구,2011-04
2011-04-30,2831726,54050,2777676,수리남,2011-04
2011-04-30,2756620,103720279,-100963659,볼리비아,2011-04
2011-04-30,2559601,8023259,-5463658,기타국,2011-04
2011-04-30,2471389,157355,2314034,영령 버진군도,2011-04
2011-04-30,2470045,1430938,1039107,아이슬란드,2011-04
2011-04-30,2450561,37564202,-35113641,사이프러스,2011-04
2011-04-30,2419809,0,2419809,지부티,2011-04
2011-04-30,2300980,291131,2009849,아이티,2011-04
2011-04-30,2099595,2090,2097505,부르키나 파소,2011-04
2011-04-30,2075637,1140,2074497,불령 리유니온 코모도 제도,2011-04
2011-04-30,1958657,3269327,-1310670,룩셈부르그,2011-04
2011-04-30,1836826,247551,1589275,짐바브웨,2011-04
2011-04-30,1791758,0,1791758,마이크로네시아,2011-04
2011-04-30,1757288,115,1757173,토고,2011-04
2011-04-30,1683929,58296,1625633,마다카스카르,2011-04
2011-04-30,1637570,1242593,394977,자마이카,2011-04
2011-04-30,1583487,139,1583348,과델로프,2011-04
2011-04-30,1554204,46341823,-44787619,잠비아,2011-04
2011-04-30,1551588,141910,1409678,세이쉘,2011-04
2011-04-30,1442427,531367,911060,스와질랜드,2011-04
2011-04-30,1391082,181021,1210061,가봉,2011-04
2011-04-30,1320811,4578664,-3257853,말라위,2011-04
2011-04-30,1253657,5316,1248341,아르메니아,2011-04
2011-04-30,1141048,11418100,-10277052,세르비아,2011-04
2011-04-30,1117394,386,1117008,부탄,2011-04
2011-04-30,1067771,19992,1047779,말리,2011-04
2011-04-30,1035032,15536,1019496,알바니아,2011-04
2011-04-30,1022513,1597485,-574972,피지,2011-04
2011-04-30,996925,61090,935835,아루바,2011-04
2011-04-30,995738,56,995682,마티니크,2011-04
2011-04-30,990893,756066,234827,모리타니,2011-04
2011-04-30,972789,17291372,-16318583,콩고민주공화국,2011-04
2011-04-30,917272,51968004,-51050732,네덜란드 열도,2011-04
2011-04-30,810872,0,810872,몬테네그로,2011-04
2011-04-30,587620,845,586775,북마리아나 군도,2011-04
2011-04-30,582968,460681,122287,보스니아-헤르체고비나,2011-04
2011-04-30,580952,124331,456621,벨리제,2011-04
2011-04-30,579216,0,579216,니제르,2011-04
2011-04-30,566926,49306,517620,도미니카,2011-04
2011-04-30,506374,116992,389382,마세도니아,2011-04
2011-04-30,503271,31068,472203,보츠와나,2011-04
2011-04-30,480867,0,480867,불령 가이아나,2011-04
2011-04-30,459606,17020,442586,바베이도스,2011-04
2011-04-30,380439,93541,286898,시에라 리온,2011-04
2011-04-30,372265,0,372265,영령 캐이맨 군도,2011-04
2011-04-30,337690,1673233,-1335543,바누아투,2011-04
2011-04-30,328344,0,328344,에리트리아,2011-04
2011-04-30,313799,0,313799,감비아,2011-04
2011-04-30,307354,208060,99294,그레나다,2011-04
2011-04-30,302481,0,302481,코모로스,2011-04
2011-04-30,275704,509677,-233973,모나코,2011-04
2011-04-30,255183,7854,247329,몰디브,2011-04
2011-04-30,226736,498161,-271425,리히텐슈타인,2011-04
2011-04-30,218461,0,218461,적도 기니,2011-04
2011-04-30,195631,72,195559,버뮤다,2011-04
2011-04-30,175095,0,175095,세인트 키츠 네비스,2011-04
2011-04-30,172500,0,172500,챠드,2011-04
2011-04-30,172435,7114,165321,나미비아,2011-04
2011-04-30,169463,0,169463,세인트 루시아,2011-04
2011-04-30,169095,1134,167961,카보 베르데,2011-04
2011-04-30,164755,19540,145215,팔라우,2011-04
2011-04-30,150636,1307290,-1156654,안티가 바부다,2011-04
2011-04-30,136441,1236235,-1099794,솔로몬 군도,2011-04
2011-04-30,115964,11961,104003,아메리칸 사모아,2011-04
2011-04-30,115478,177706,-62228,몰도바,2011-04
2011-04-30,108813,0,108813,사모아,2011-04
2011-04-30,107358,71947,35411,중앙아프리카공화국,2011-04
2011-04-30,97956,0,97956,부룬디,2011-04
2011-04-30,85510,229,85281,산마리노,2011-04
2011-04-30,83229,36,83193,르완다,2011-04
2011-04-30,73946,0,73946,티모르,2011-04
2011-04-30,72138,0,72138,기네비소,2011-04
2011-04-30,53539,0,53539,메요트,2011-04
2011-04-30,45923,0,45923,소말리아,2011-04
2011-04-30,30700,0,30700,세인트 헬레나,2011-04
2011-04-30,30350,0,30350,세인트 빈센트 그레나딘,2011-04
2011-04-30,11359,4071005,-4059646,나우루,2011-04
2011-04-30,8683,37337,-28654,안도라,2011-04
2011-04-30,6090,1281,4809,지브랄타,2011-04
2011-04-30,2214,0,2214,키리바티,2011-04
2011-04-30,1011,137592,-136581,그린랜드,2011-04
2011-04-30,909,0,909,투르크 & 카이코스 군도,2011-04
2011-04-30,450,0,450,상토메 프린스페,2011-04
2011-04-30,330,255,75,쿡 아일랜드,2011-04
2011-04-30,295,29682,-29387,토켈라우,2011-04
2011-04-30,286,0,286,왈라스 & 퓨투나 군도,2011-04
2011-04-30,0,5991,-5991,크리스마스 아일랜드,2011-04
2011-04-30,0,388,-388,코스 군도,2011-04
2011-04-30,0,262822,-262822,몬트세라트,2011-04
2011-04-30,0,27,-27,안타티카,2011-04
2011-05-31,11294812145,7775044086,3519768059,중국,2011-05
2011-05-31,5171509689,4470666160,700843529,미국,2011-05
2011-05-31,3058715128,5560189625,-2501474497,일본,2011-05
2011-05-31,2759156235,190383630,2568772605,홍콩,2011-05
2011-05-31,2147141742,711315926,1435825816,싱가포르,2011-05
2011-05-31,1555755314,1259678874,296076440,대만,2011-05
2011-05-31,1459441643,1123848105,335593538,러시아 연방,2011-05
2011-05-31,1151931764,1488791543,-336859779,인도네시아,2011-05
2011-05-31,1085870458,383136232,702734226,베트남,2011-05
2011-05-31,943918339,756858237,187060102,인도,2011-05
2011-05-31,909262207,134865,909127342,라이베리아,2011-05
2011-05-31,882358126,1496583788,-614225662,독일,2011-05
2011-05-31,831911138,484300639,347610499,브라질,2011-05
2011-05-31,762758951,251596990,511161961,멕시코,2011-05
2011-05-31,717309839,2906468634,-2189158795,사우디아라비아,2011-05
2011-05-31,683531269,1755033214,-1071501945,호주,2011-05
2011-05-31,668698958,0,668698958,버뮤다,2011-05
2011-05-31,630447118,471207838,159239280,태국,2011-05
2011-05-31,619999664,1578976066,-958976402,아랍에미리트 연합,2011-05
2011-05-31,575855688,315379573,260476115,필리핀,2011-05
2011-05-31,549523848,294024649,255499199,영국,2011-05
2011-05-31,534267302,743001930,-208734628,말레이시아,2011-05
2011-05-31,503087006,95702912,407384094,튀르키예,2011-05
2011-05-31,494636633,944097328,-449460695,이란,2011-05
2011-05-31,470807722,776961021,-306153299,캐나다,2011-05
2011-05-31,415119066,360802506,54316560,이탈리아,2011-05
2011-05-31,389927248,0,389927248,마샬군도,2011-05
2011-05-31,357539274,26587788,330951486,폴란드,2011-05
2011-05-31,324522711,10768710,313754001,슬로바키아,2011-05
2011-05-31,260986181,6514000,254472181,그리스,2011-05
2011-05-31,250677977,474292489,-223614512,네덜란드,2011-05
2011-05-31,240370174,451646008,-211275834,프랑스,2011-05
2011-05-31,214016206,20860541,193155665,파나마,2011-05
2011-05-31,188699690,465454180,-276754490,칠레,2011-05
2011-05-31,181827202,138757208,43069994,벨기에,2011-05
2011-05-31,169376483,91113215,78263268,스페인,2011-05
2011-05-31,158097566,266662204,-108564638,남아프리카공화국,2011-05
2011-05-31,151121426,49830951,101290475,콜롬비아,2011-05
2011-05-31,139538529,57448915,82089614,이스라엘,2011-05
2011-05-31,134084772,18606897,115477875,방글라데시,2011-05
2011-05-31,124718036,976605,123741431,우즈베키스탄,2011-05
2011-05-31,119673155,37919544,81753611,체코공화국,2011-05
2011-05-31,114979987,42856700,72123287,헝가리,2011-05
2011-05-31,112140149,80606901,31533248,이집트,2011-05
2011-05-31,111135661,63093107,48042554,덴마크,2011-05
2011-05-31,110734627,182042605,-71307978,페루,2011-05
2011-05-31,105566788,519321,105047467,알제리,2011-05
2011-05-31,105105522,8332642,96772880,슬로베니아,2011-05
2011-05-31,93167831,179419065,-86251234,스웨덴,2011-05
2011-05-31,92505536,10964682,81540854,요르단,2011-05
2011-05-31,92405674,1020230101,-927824427,이라크,2011-05
2011-05-31,87624234,62266359,25357875,우크라이나,2011-05
2011-05-31,79322832,239781831,-160458999,오만,2011-05
2011-05-31,77844825,1452821200,-1374976375,쿠웨이트,2011-05
2011-05-31,77297891,2117297,75180594,나이지리아,2011-05
2011-05-31,73468884,111848632,-38379748,오스트리아,2011-05
2011-05-31,72722077,90967254,-18245177,아르헨티나,2011-05
2011-05-31,70330206,9919678,60410528,미얀마,2011-05
2011-05-31,66560857,3017926,63542931,에쿠아도르,2011-05
2011-05-31,65471526,2322954,63148572,라트비아,2011-05
2011-05-31,65332025,164717381,-99385356,뉴질랜드,2011-05
2011-05-31,57453328,42630857,14822471,카자흐스탄,2011-05
2011-05-31,55486461,41259878,14226583,파키스탄,2011-05
2011-05-31,52796033,11492049,41303984,몰타,2011-05
2011-05-31,52610278,228668046,-176057768,스위스,2011-05
2011-05-31,48963326,81152846,-32189520,핀란드,2011-05
2011-05-31,46487955,56809806,-10321851,아일랜드,2011-05
2011-05-31,45777395,5569438,40207957,시리아,2011-05
2011-05-31,44505960,615746,43890214,사이프러스,2011-05
2011-05-31,42267087,16132349,26134738,모로코,2011-05
2011-05-31,40171076,279973,39891103,바하마,2011-05
2011-05-31,40107138,90,40107048,투르크멘,2011-05
2011-05-31,37919181,0,37919181,불령 폴리네시아,2011-05
2011-05-31,37279624,26771990,10507634,과테말라,2011-05
2011-05-31,36664426,35170685,1493741,루마니아,2011-05
2011-05-31,36525041,1592119200,-1555594159,카타르,2011-05
2011-05-31,35764687,4856647,30908040,베네주엘라,2011-05
2011-05-31,35040858,7513362,27527496,포루투갈,2011-05
2011-05-31,34543566,4486502,30057064,몽골,2011-05
2011-05-31,31162371,5516629,25645742,캄보디아,2011-05
2011-05-31,27822683,5897938,21924745,스리랑카,2011-05
2011-05-31,23973618,2448973,21524645,가나,2011-05
2011-05-31,22997606,9862008,13135598,우루과이,2011-05
2011-05-31,21688929,51009699,-29320770,바레인,2011-05
2011-05-31,20681356,229388046,-208706690,노르웨이,2011-05
2011-05-31,19994500,28774456,-8779956,니카라과,2011-05
2011-05-31,18399321,11569100,6830221,코스타리카,2011-05
2011-05-31,17401650,1777617,15624033,수단,2011-05
2011-05-31,17258671,3058536,14200135,레바논,2011-05
2011-05-31,15040520,4067943,10972577,튀니지,2011-05
2011-05-31,14601913,1113176,13488737,케냐,2011-05
2011-05-31,13917223,199560,13717663,앙골라,2011-05
2011-05-31,12687259,538955,12148304,파라과이,2011-05
2011-05-31,12560570,2097944,10462626,엘살바도르,2011-05
2011-05-31,12317754,179256,12138498,라오스,2011-05
2011-05-31,11957605,1053854,10903751,키르기스스탄,2011-05
2011-05-31,11918972,2676,11916296,아제르바이잔,2011-05
2011-05-31,11203044,7438454,3764590,뉴 칼레도니아,2011-05
2011-05-31,10697247,29569568,-18872321,온두라스,2011-05
2011-05-31,10356727,4798973,5557754,에스토니아,2011-05
2011-05-31,10189187,2168592,8020595,에티오피아,2011-05
2011-05-31,10113975,9184097,929878,도미니카 공화국,2011-05
2011-05-31,9647547,19290745,-9643198,푸에르토리코,2011-05
2011-05-31,9176935,18093216,-8916281,불가리아,2011-05
2011-05-31,7913655,127062143,-119148488,브루나이,2011-05
2011-05-31,7098580,60448350,-53349770,트리니다드 토바고,2011-05
2011-05-31,6944001,457570,6486431,탄자니아,2011-05
2011-05-31,6878371,2397886,4480485,리투아니아,2011-05
2011-05-31,6799223,30642,6768581,레소토,2011-05
2011-05-31,5987387,197854760,-191867373,예맨,2011-05
2011-05-31,5823835,0,5823835,코트디봐르,2011-05
2011-05-31,5773205,35634638,-29861433,카메룬,2011-05
2011-05-31,5167338,688,5166650,아프카니스탄,2011-05
2011-05-31,5068924,1022609,4046315,세네갈,2011-05
2011-05-31,5030841,4357810,673031,조지아,2011-05
2011-05-31,4708441,8338859,-3630418,나우루,2011-05
2011-05-31,4618382,530,4617852,지부티,2011-05
2011-05-31,4579441,579966,3999475,리비아,2011-05
2011-05-31,4177325,13417660,-9240335,타지크,2011-05
2011-05-31,4031616,197859,3833757,마카오,2011-05
2011-05-31,3904155,11045292,-7141137,콩고민주공화국,2011-05
2011-05-31,3819746,1116951,2702795,크로아티아,2011-05
2011-05-31,3753614,186014,3567600,쿠바,2011-05
2011-05-31,3648723,47941279,-44292556,잠비아,2011-05
2011-05-31,3567202,192546,3374656,모리셔스,2011-05
2011-05-31,3337693,359291,2978402,네팔,2011-05
2011-05-31,3303061,110476,3192585,모잠비크,2011-05
2011-05-31,3267452,37826,3229626,베닝,2011-05
2011-05-31,3191544,185587,3005957,괌,2011-05
2011-05-31,2941670,8071944,-5130274,콩고,2011-05
2011-05-31,2912755,627111,2285644,벨라루스,2011-05
2011-05-31,2740058,2524631,215427,파푸아 뉴기니,2011-05
2011-05-31,2650317,49034275,-46383958,볼리비아,2011-05
2011-05-31,2339010,80428,2258582,팔레스타인 해방기구,2011-05
2011-05-31,2177436,782205,1395231,기니,2011-05
2011-05-31,2161923,13,2161910,르완다,2011-05
2011-05-31,2147199,7139345,-4992146,기타국,2011-05
2011-05-31,2090602,86601,2004001,네덜란드 열도,2011-05
2011-05-31,2031617,32449,1999168,아루바,2011-05
2011-05-31,1975470,0,1975470,토고,2011-05
2011-05-31,1951988,176028,1775960,아이티,2011-05
2011-05-31,1885480,1063,1884417,아르메니아,2011-05
2011-05-31,1852970,727234,1125736,피지,2011-05
2011-05-31,1815094,1029480,785614,우간다,2011-05
2011-05-31,1797390,52566,1744824,세이쉘,2011-05
2011-05-31,1744163,8954576,-7210413,가봉,2011-05
2011-05-31,1721736,767920,953816,짐바브웨,2011-05
2011-05-31,1685522,5830723,-4145201,룩셈부르그,2011-05
2011-05-31,1661641,0,1661641,마티니크,2011-05
2011-05-31,1650791,1893212,-242421,자마이카,2011-05
2011-05-31,1598165,1416,1596749,부탄,2011-05
2011-05-31,1401184,227454,1173730,영령 버진군도,2011-05
2011-05-31,1383784,491983,891801,스와질랜드,2011-05
2011-05-31,1323851,45257,1278594,바베이도스,2011-05
2011-05-31,1316903,92114,1224789,마다카스카르,2011-05
2011-05-31,1293088,228337,1064751,가이아나,2011-05
2011-05-31,1290893,3589,1287304,벨리제,2011-05
2011-05-31,1212934,955,1211979,말리,2011-05
2011-05-31,1199525,368,1199157,과델로프,2011-05
2011-05-31,1199159,989456,209703,아이슬란드,2011-05
2011-05-31,1085664,0,1085664,부르키나 파소,2011-05
2011-05-31,1071045,36532,1034513,수리남,2011-05
2011-05-31,1038289,10314932,-9276643,세르비아,2011-05
2011-05-31,912125,206218,705907,보스니아-헤르체고비나,2011-05
2011-05-31,898571,842834,55737,모리타니,2011-05
2011-05-31,859254,0,859254,불령 리유니온 코모도 제도,2011-05
2011-05-31,703823,93168,610655,보츠와나,2011-05
2011-05-31,691084,301,690783,알바니아,2011-05
2011-05-31,621936,164158,457778,바누아투,2011-05
2011-05-31,620984,0,620984,불령 가이아나,2011-05
2011-05-31,599313,0,599313,에리트리아,2011-05
2011-05-31,581622,69925,511697,시에라 리온,2011-05
2011-05-31,544973,1695,543278,마이크로네시아,2011-05
2011-05-31,517422,29753,487669,도미니카,2011-05
2011-05-31,462537,15332,447205,마세도니아,2011-05
2011-05-31,461011,8214975,-7753964,말라위,2011-05
2011-05-31,414401,0,414401,영령 캐이맨 군도,2011-05
2011-05-31,408636,419671,-11035,모나코,2011-05
2011-05-31,396641,29618,367023,사모아,2011-05
2011-05-31,371412,14002,357410,몰디브,2011-05
2011-05-31,364372,421438,-57066,리히텐슈타인,2011-05
2011-05-31,337518,116644,220874,나미비아,2011-05
2011-05-31,326915,13239,313676,몬테네그로,2011-05
2011-05-31,283166,92,283074,티모르,2011-05
2011-05-31,270944,49008,221936,북마리아나 군도,2011-05
2011-05-31,208682,0,208682,마이너 아우틀링 합중국 군도,2011-05
2011-05-31,205165,17,205148,감비아,2011-05
2011-05-31,181643,1874,179769,그레나다,2011-05
2011-05-31,180640,0,180640,세인트 루시아,2011-05
2011-05-31,177055,0,177055,팔라우,2011-05
2011-05-31,169465,1066171,-896706,솔로몬 군도,2011-05
2011-05-31,129698,0,129698,산마리노,2011-05
2011-05-31,116440,300170,-183730,몰도바,2011-05
2011-05-31,111179,0,111179,아메리칸 사모아,2011-05
2011-05-31,101022,0,101022,기네비소,2011-05
2011-05-31,67090,3244,63846,세인트 키츠 네비스,2011-05
2011-05-31,65619,468,65151,세인트 빈센트 그레나딘,2011-05
2011-05-31,60464,13267750,-13207286,니제르,2011-05
2011-05-31,56932,0,56932,코모로스,2011-05
2011-05-31,52373,446,51927,부룬디,2011-05
2011-05-31,51370,91351,-39981,안티가 바부다,2011-05
2011-05-31,48115,0,48115,챠드,2011-05
2011-05-31,47992,0,47992,적도 기니,2011-05
2011-05-31,24293,2169,22124,카보 베르데,2011-05
2011-05-31,12192,173,12019,지브랄타,2011-05
2011-05-31,8542,26667,-18125,통가,2011-05
2011-05-31,4600,0,4600,쿡 아일랜드,2011-05
2011-05-31,2040,0,2040,중앙아프리카공화국,2011-05
2011-05-31,1515,0,1515,키리바티,2011-05
2011-05-31,661,0,661,세인트 헬레나,2011-05
2011-05-31,580,1395,-815,미령 버진군도,2011-05
2011-05-31,417,37,380,상토메 프린스페,2011-05
2011-05-31,0,67782,-67782,토켈라우,2011-05
2011-05-31,0,445697,-445697,안타티카,2011-05
2011-05-31,0,16289,-16289,안도라,2011-05
2011-05-31,0,279,-279,크리스마스 아일랜드,2011-05
2011-05-31,0,51459,-51459,몬트세라트,2011-05
2011-05-31,0,913668,-913668,니우에,2011-05
2011-05-31,0,366,-366,앙귈라,2011-05
2011-05-31,0,89233,-89233,서사하라,2011-05
2011-05-31,0,562774,-562774,그린랜드,2011-05
2011-05-31,0,329,-329,보빗군도,2011-05
2011-05-31,0,108,-108,코스 군도,2011-05
2011-06-30,11126425492,7473499713,3652925779,중국,2011-06
2011-06-30,4969268572,3917066450,1052202122,미국,2011-06
2011-06-30,3402468503,6139412810,-2736944307,일본,2011-06
2011-06-30,2312012166,219366813,2092645353,홍콩,2011-06
2011-06-30,1666510691,682882426,983628265,싱가포르,2011-06
2011-06-30,1495463393,1241073697,254389696,대만,2011-06
2011-06-30,1313241122,1215121712,98119410,인도네시아,2011-06
2011-06-30,1039279686,355503897,683775789,베트남,2011-06
2011-06-30,1033084859,575518218,457566641,브라질,2011-06
2011-06-30,953146840,794680880,158465960,인도,2011-06
2011-06-30,860590329,795442497,65147832,러시아 연방,2011-06
2011-06-30,830994892,1260671294,-429676402,독일,2011-06
2011-06-30,736611454,263382365,473229089,멕시코,2011-06
2011-06-30,702034039,2278537391,-1576503352,호주,2011-06
2011-06-30,642478058,982827809,-340349751,이란,2011-06
2011-06-30,639038808,579296344,59742464,태국,2011-06
2011-06-30,593039399,3212725543,-2619686144,사우디아라비아,2011-06
2011-06-30,574583255,44711,574538544,라이베리아,2011-06
2011-06-30,559672538,1405270671,-845598133,아랍에미리트 연합,2011-06
2011-06-30,557582209,305965865,251616344,필리핀,2011-06
2011-06-30,519721845,529113283,-9391438,캐나다,2011-06
2011-06-30,500254697,22150035,478104662,사이프러스,2011-06
2011-06-30,497800158,50063679,447736479,튀르키예,2011-06
2011-06-30,492192821,1032079132,-539886311,말레이시아,2011-06
2011-06-30,448000687,69474,447931213,마샬군도,2011-06
2011-06-30,430626690,442165045,-11538355,네덜란드,2011-06
2011-06-30,376237410,326931609,49305801,영국,2011-06
2011-06-30,357890314,346580253,11310061,이탈리아,2011-06
2011-06-30,326288242,673971374,-347683132,프랑스,2011-06
2011-06-30,310101107,4652795,305448312,파나마,2011-06
2011-06-30,297510193,34043011,263467182,몰타,2011-06
2011-06-30,282711686,27247737,255463949,폴란드,2011-06
2011-06-30,282527609,14420619,268106990,슬로바키아,2011-06
2011-06-30,248339873,1416493414,-1168153541,쿠웨이트,2011-06
2011-06-30,246639296,51064596,195574700,이스라엘,2011-06
2011-06-30,228262133,116839858,111422275,벨기에,2011-06
2011-06-30,227705810,307853960,-80148150,칠레,2011-06
2011-06-30,223234765,3623616,219611149,그리스,2011-06
2011-06-30,204472355,0,204472355,맨섬,2011-06
2011-06-30,202323655,230334039,-28010384,남아프리카공화국,2011-06
2011-06-30,169668048,81924716,87743332,스페인,2011-06
2011-06-30,149978987,25084881,124894106,콜롬비아,2011-06
2011-06-30,144582846,68116858,76465988,이집트,2011-06
2011-06-30,142204755,34095361,108109394,체코공화국,2011-06
2011-06-30,140209573,938201,139271372,우즈베키스탄,2011-06
2011-06-30,137674845,17151599,120523246,방글라데시,2011-06
2011-06-30,132170986,128587648,3583338,뉴질랜드,2011-06
2011-06-30,130883358,117505,130765853,중앙아프리카공화국,2011-06
2011-06-30,113111977,30905339,82206638,헝가리,2011-06
2011-06-30,112127201,74583249,37543952,페루,2011-06
2011-06-30,107484974,47462081,60022893,아르헨티나,2011-06
2011-06-30,104562023,11846531,92715492,슬로베니아,2011-06
2011-06-30,97248282,1551887,95696395,나이지리아,2011-06
2011-06-30,94367068,4152712,90214356,요르단,2011-06
2011-06-30,93996940,382650661,-288653721,오만,2011-06
2011-06-30,92302904,48585500,43717404,알제리,2011-06
2011-06-30,91915700,498316559,-406400859,이라크,2011-06
2011-06-30,90858529,6480419,84378110,기타국,2011-06
2011-06-30,87510353,236813858,-149303505,스위스,2011-06
2011-06-30,86250383,144001727,-57751344,노르웨이,2011-06
2011-06-30,81890272,33173287,48716985,우크라이나,2011-06
2011-06-30,74762586,295390056,-220627470,스웨덴,2011-06
2011-06-30,71793643,1477696,70315947,에쿠아도르,2011-06
2011-06-30,70861211,43874389,26986822,파키스탄,2011-06
2011-06-30,66386416,141670477,-75284061,오스트리아,2011-06
2011-06-30,64495905,64086830,409075,핀란드,2011-06
2011-06-30,63328098,1802131,61525967,라트비아,2011-06
2011-06-30,57571729,33353783,24217946,카자흐스탄,2011-06
2011-06-30,54527123,412918,54114205,베네주엘라,2011-06
2011-06-30,53750118,305784,53444334,시리아,2011-06
2011-06-30,49807435,15624644,34182791,미얀마,2011-06
2011-06-30,47160327,1925502453,-1878342126,카타르,2011-06
2011-06-30,44194627,20309852,23884775,루마니아,2011-06
2011-06-30,39192772,11282059,27910713,몽골,2011-06
2011-06-30,39157668,0,39157668,투르크멘,2011-06
2011-06-30,38018447,6362800,31655647,캄보디아,2011-06
2011-06-30,36999954,12416301,24583653,과테말라,2011-06
2011-06-30,34978636,58285837,-23307201,덴마크,2011-06
2011-06-30,34888913,5244210,29644703,모로코,2011-06
2011-06-30,31934162,7043334,24890828,포루투갈,2011-06
2011-06-30,27572976,4735359,22837617,스리랑카,2011-06
2011-06-30,26158689,52639365,-26480676,아일랜드,2011-06
2011-06-30,25007395,3615144,21392251,가나,2011-06
2011-06-30,23202850,2903896,20298954,레바논,2011-06
2011-06-30,23050821,9070745,13980076,우루과이,2011-06
2011-06-30,21620810,20691780,929030,푸에르토리코,2011-06
2011-06-30,20266946,37844,20229102,파라과이,2011-06
2011-06-30,19681515,80768466,-61086951,바레인,2011-06
2011-06-30,18345578,13253443,5092135,코스타리카,2011-06
2011-06-30,18296646,5703977,12592669,니카라과,2011-06
2011-06-30,17292358,17234990,57368,불가리아,2011-06
2011-06-30,16980005,4113854,12866151,튀니지,2011-06
2011-06-30,14723510,507063,14216447,수단,2011-06
2011-06-30,14663032,93894,14569138,아제르바이잔,2011-06
2011-06-30,14590922,305267,14285655,쿠바,2011-06
2011-06-30,14573392,2639464,11933928,케냐,2011-06
2011-06-30,13127805,12243077,884728,온두라스,2011-06
2011-06-30,13107122,98,13107024,앙골라,2011-06
2011-06-30,12929397,2021431,10907966,리투아니아,2011-06
2011-06-30,12817476,56356352,-43538876,파푸아 뉴기니,2011-06
2011-06-30,12800948,12250237,550711,도미니카 공화국,2011-06
2011-06-30,12759514,221890,12537624,라오스,2011-06
2011-06-30,11961252,2327933,9633319,에티오피아,2011-06
2011-06-30,11485833,19517678,-8031845,뉴 칼레도니아,2011-06
2011-06-30,11368073,87943826,-76575753,트리니다드 토바고,2011-06
2011-06-30,11362841,9108,11353733,키르기스스탄,2011-06
2011-06-30,10681899,4636159,6045740,에스토니아,2011-06
2011-06-30,8493787,0,8493787,코트디봐르,2011-06
2011-06-30,7725956,578381,7147575,탄자니아,2011-06
2011-06-30,7619688,1368554,6251134,엘살바도르,2011-06
2011-06-30,7206617,130822517,-123615900,브루나이,2011-06
2011-06-30,7183293,510979,6672314,카메룬,2011-06
2011-06-30,6809547,4133547,2676000,조지아,2011-06
2011-06-30,6436544,11610360,-5173816,콩고,2011-06
2011-06-30,6260640,2978527,3282113,세네갈,2011-06
2011-06-30,6083684,1806928,4276756,피지,2011-06
2011-06-30,5769555,572460,5197095,베닝,2011-06
2011-06-30,4724421,121768428,-117044007,예맨,2011-06
2011-06-30,4714512,5091,4709421,레소토,2011-06
2011-06-30,4681520,2360,4679160,아프카니스탄,2011-06
2011-06-30,4669401,183654,4485747,모리셔스,2011-06
2011-06-30,4473831,1690543,2783288,벨라루스,2011-06
2011-06-30,4470789,140376,4330413,네팔,2011-06
2011-06-30,4367884,482770,3885114,기니,2011-06
2011-06-30,4345580,1312414,3033166,크로아티아,2011-06
2011-06-30,4128303,7738,4120565,가봉,2011-06
2011-06-30,3940813,681814,3258999,리비아,2011-06
2011-06-30,3832583,400963,3431620,마카오,2011-06
2011-06-30,3678566,156692,3521874,괌,2011-06
2011-06-30,3561236,6490265,-2929029,타지크,2011-06
2011-06-30,3351709,179957,3171752,팔레스타인 해방기구,2011-06
2011-06-30,3285408,1863766,1421642,스와질랜드,2011-06
2011-06-30,3203990,0,3203990,지부티,2011-06
2011-06-30,2588722,757,2587965,아르메니아,2011-06
2011-06-30,2572902,555835,2017067,보스니아-헤르체고비나,2011-06
2011-06-30,2390566,107672,2282894,모잠비크,2011-06
2011-06-30,2254588,53368,2201220,네덜란드 열도,2011-06
2011-06-30,2254321,15129941,-12875620,세르비아,2011-06
2011-06-30,2101238,0,2101238,토고,2011-06
2011-06-30,2090701,4119041,-2028340,룩셈부르그,2011-06
2011-06-30,1997577,0,1997577,마티니크,2011-06
2011-06-30,1995535,66770706,-64775171,볼리비아,2011-06
2011-06-30,1936169,11563823,-9627654,콩고민주공화국,2011-06
2011-06-30,1926998,395847,1531151,아이티,2011-06
2011-06-30,1857773,500,1857273,아루바,2011-06
2011-06-30,1825271,186205,1639066,짐바브웨,2011-06
2011-06-30,1788466,75547,1712919,가이아나,2011-06
2011-06-30,1654599,176054,1478545,바하마,2011-06
2011-06-30,1652867,73508,1579359,세이쉘,2011-06
2011-06-30,1617156,689,1616467,알바니아,2011-06
2011-06-30,1601695,1760633,-158938,우간다,2011-06
2011-06-30,1533408,928510,604898,모리타니,2011-06
2011-06-30,1422891,41038907,-39616016,잠비아,2011-06
2011-06-30,1415039,2061632,-646593,자마이카,2011-06
2011-06-30,1360344,8702,1351642,부르키나 파소,2011-06
2011-06-30,1339086,49128,1289958,불령 폴리네시아,2011-06
2011-06-30,1260567,100608,1159959,과델로프,2011-06
2011-06-30,1245373,363024,882349,마다카스카르,2011-06
2011-06-30,1160448,0,1160448,수리남,2011-06
2011-06-30,1134567,27734,1106833,사모아,2011-06
2011-06-30,1086433,0,1086433,부탄,2011-06
2011-06-30,1043699,1362012,-318313,아이슬란드,2011-06
2011-06-30,998012,223488,774524,시에라 리온,2011-06
2011-06-30,943549,161,943388,니제르,2011-06
2011-06-30,924727,0,924727,불령 리유니온 코모도 제도,2011-06
2011-06-30,819439,0,819439,불령 가이아나,2011-06
2011-06-30,786895,71523,715372,보츠와나,2011-06
2011-06-30,719066,459,718607,벨리제,2011-06
2011-06-30,695499,0,695499,영령 캐이맨 군도,2011-06
2011-06-30,680052,108188,571864,마이크로네시아,2011-06
2011-06-30,658341,1164124,-505783,바누아투,2011-06
2011-06-30,634585,169730,464855,몰도바,2011-06
2011-06-30,602609,48108,554501,도미니카,2011-06
2011-06-30,521004,19272111,-18751107,버뮤다,2011-06
2011-06-30,520950,54533,466417,안도라,2011-06
2011-06-30,519262,3392,515870,안티가 바부다,2011-06
2011-06-30,513712,0,513712,그레나다,2011-06
2011-06-30,477948,121,477827,북마리아나 군도,2011-06
2011-06-30,470242,0,470242,바베이도스,2011-06
2011-06-30,394151,1228260,-834109,말라위,2011-06
2011-06-30,373928,0,373928,기네비소,2011-06
2011-06-30,373878,280628,93250,모나코,2011-06
2011-06-30,279324,1278034,-998710,리히텐슈타인,2011-06
2011-06-30,265921,19285567,-19019646,티모르,2011-06
2011-06-30,249769,12799,236970,몰디브,2011-06
2011-06-30,208111,0,208111,소말리아,2011-06
2011-06-30,182319,16662,165657,세인트 루시아,2011-06
2011-06-30,181518,0,181518,감비아,2011-06
2011-06-30,173729,34957,138772,르완다,2011-06
2011-06-30,172160,43977884,-43805724,적도 기니,2011-06
2011-06-30,171061,0,171061,에리트리아,2011-06
2011-06-30,167408,33223136,-33055728,나미비아,2011-06
2011-06-30,163034,1946,161088,몬테네그로,2011-06
2011-06-30,152653,2065515,-1912862,솔로몬 군도,2011-06
2011-06-30,143576,137619,5957,마세도니아,2011-06
2011-06-30,141067,0,141067,투발루,2011-06
2011-06-30,137588,198,137390,아메리칸 사모아,2011-06
2011-06-30,135651,2828,132823,산마리노,2011-06
2011-06-30,106767,15318,91449,팔라우,2011-06
2011-06-30,84388,168680,-84292,세인트 키츠 네비스,2011-06
2011-06-30,72828,0,72828,노폴크 아일랜드,2011-06
2011-06-30,67795,0,67795,세인트 빈센트 그레나딘,2011-06
2011-06-30,55750,115287,-59537,영령 버진군도,2011-06
2011-06-30,45762,0,45762,챠드,2011-06
2011-06-30,35273,0,35273,말리,2011-06
2011-06-30,30967,30350,617,쿡 아일랜드,2011-06
2011-06-30,22270,0,22270,카보 베르데,2011-06
2011-06-30,21365,27040,-5675,통가,2011-06
2011-06-30,20949,0,20949,부룬디,2011-06
2011-06-30,10875,281,10594,지브랄타,2011-06
2011-06-30,9859,0,9859,키리바티,2011-06
2011-06-30,5880,19,5861,앙귈라,2011-06
2011-06-30,3129,0,3129,투르크 & 카이코스 군도,2011-06
2011-06-30,2900,2536,364,영령 인도양,2011-06
2011-06-30,2475,23515,-21040,상토메 프린스페,2011-06
2011-06-30,2350,112693,-110343,그린랜드,2011-06
2011-06-30,1610,0,1610,나우루,2011-06
2011-06-30,810,0,810,코스 군도,2011-06
2011-06-30,0,71659,-71659,토켈라우,2011-06
2011-06-30,0,2382,-2382,미령 버진군도,2011-06
2011-06-30,0,63720,-63720,남조지아 & 남샌드위치 군도,2011-06
2011-07-31,11829362508,7103826884,4725535624,중국,2011-07
2011-07-31,4650593591,3610226224,1040367367,미국,2011-07
2011-07-31,3407616401,5867724465,-2460108064,일본,2011-07
2011-07-31,2864386328,222673532,2641712796,홍콩,2011-07
2011-07-31,1936287192,700198668,1236088524,싱가포르,2011-07
2011-07-31,1858044476,539241827,1318802649,브라질,2011-07
2011-07-31,1485488181,1292113546,193374635,대만,2011-07
2011-07-31,1407431770,503146014,904285756,태국,2011-07
2011-07-31,1159843825,1307,1159842518,마샬군도,2011-07
2011-07-31,1149577191,623303736,526273455,인도,2011-07
2011-07-31,1109885435,1217570541,-107685106,인도네시아,2011-07
2011-07-31,1012044849,468812567,543232282,베트남,2011-07
2011-07-31,885313722,752809410,132504312,러시아 연방,2011-07
2011-07-31,758165278,188216650,569948628,멕시코,2011-07
2011-07-31,686799224,1342297071,-655497847,아랍에미리트 연합,2011-07
2011-07-31,655247671,289033016,366214655,필리핀,2011-07
2011-07-31,649052064,3269011328,-2619959264,사우디아라비아,2011-07
2011-07-31,597232377,1515056327,-917823950,독일,2011-07
2011-07-31,587388053,70885,587317168,라이베리아,2011-07
2011-07-31,581569407,2108300689,-1526731282,호주,2011-07
2011-07-31,553493702,814346216,-260852514,말레이시아,2011-07
2011-07-31,550569921,468358557,82211364,네덜란드,2011-07
2011-07-31,541415073,973328404,-431913331,이란,2011-07
2011-07-31,444776600,681092910,-236316310,캐나다,2011-07
2011-07-31,401411767,61137923,340273844,튀르키예,2011-07
2011-07-31,392137499,62633051,329504448,몰타,2011-07
2011-07-31,332147153,27383399,304763754,폴란드,2011-07
2011-07-31,289420197,329285908,-39865711,영국,2011-07
2011-07-31,284986693,11911670,273075023,슬로바키아,2011-07
2011-07-31,267849939,399847740,-131997801,이탈리아,2011-07
2011-07-31,267076075,136562938,130513137,파나마,2011-07
2011-07-31,256559924,83150735,173409189,브루나이,2011-07
2011-07-31,246472557,119491307,126981250,벨기에,2011-07
2011-07-31,234350303,268306527,-33956224,남아프리카공화국,2011-07
2011-07-31,228242183,703129415,-474887232,프랑스,2011-07
2011-07-31,205806442,459967778,-254161336,칠레,2011-07
2011-07-31,199148179,50422369,148725810,체코공화국,2011-07
2011-07-31,190107268,68080,190039188,바하마,2011-07
2011-07-31,170826567,1113021,169713546,우즈베키스탄,2011-07
2011-07-31,151071001,44214578,106856423,콜롬비아,2011-07
2011-07-31,147421390,64685212,82736178,이스라엘,2011-07
2011-07-31,137172117,7974464,129197653,기타국,2011-07
2011-07-31,136037808,37637947,98399861,헝가리,2011-07
2011-07-31,133279510,24092810,109186700,이집트,2011-07
2011-07-31,129522966,6528910,122994056,슬로베니아,2011-07
2011-07-31,120734480,109077450,11657030,스페인,2011-07
2011-07-31,106769604,226903479,-120133875,페루,2011-07
2011-07-31,106525829,25868135,80657694,방글라데시,2011-07
2011-07-31,99082000,120324638,-21242638,스웨덴,2011-07
2011-07-31,96583188,38916848,57666340,나이지리아,2011-07
2011-07-31,92162598,160901066,-68738468,아르헨티나,2011-07
2011-07-31,86975851,16008093,70967758,요르단,2011-07
2011-07-31,85309928,473322414,-388012486,오만,2011-07
2011-07-31,82554387,110975689,-28421302,우크라이나,2011-07
2011-07-31,81791602,1459,81790143,알제리,2011-07
2011-07-31,81550909,35775013,45775896,카자흐스탄,2011-07
2011-07-31,75403211,769893964,-694490753,이라크,2011-07
2011-07-31,71803845,2224476,69579369,에쿠아도르,2011-07
2011-07-31,70568446,1578994995,-1508426549,쿠웨이트,2011-07
2011-07-31,70377648,6432923,63944725,그리스,2011-07
2011-07-31,66495370,118146254,-51650884,뉴질랜드,2011-07
2011-07-31,65389409,76404844,-11015435,파키스탄,2011-07
2011-07-31,64242909,0,64242909,지브랄타,2011-07
2011-07-31,62728725,519978,62208747,시리아,2011-07
2011-07-31,53903904,2805150,51098754,베네주엘라,2011-07
2011-07-31,49635571,107668625,-58033054,오스트리아,2011-07
2011-07-31,48511288,22203795,26307493,미얀마,2011-07
2011-07-31,43841477,87860841,-44019364,핀란드,2011-07
2011-07-31,40417769,1675635366,-1635217597,카타르,2011-07
2011-07-31,39899284,7089720,32809564,캄보디아,2011-07
2011-07-31,38892820,37163373,1729447,루마니아,2011-07
2011-07-31,38087220,202343633,-164256413,스위스,2011-07
2011-07-31,33767636,0,33767636,불령 폴리네시아,2011-07
2011-07-31,33321158,78711866,-45390708,덴마크,2011-07
2011-07-31,32520230,0,32520230,투르크멘,2011-07
2011-07-31,27854325,9091068,18763257,포루투갈,2011-07
2011-07-31,25535093,4244601,21290492,몽골,2011-07
2011-07-31,25390259,6909323,18480936,모로코,2011-07
2011-07-31,25307999,8067457,17240542,스리랑카,2011-07
2011-07-31,24856453,7758226,17098227,과테말라,2011-07
2011-07-31,24160160,1790393,22369767,레바논,2011-07
2011-07-31,23991910,2291910,21700000,가나,2011-07
2011-07-31,22788684,15937704,6850980,코스타리카,2011-07
2011-07-31,22240969,80288247,-58047278,바레인,2011-07
2011-07-31,20130269,837539,19292730,케냐,2011-07
2011-07-31,19918037,17,19918020,앙골라,2011-07
2011-07-31,19470905,72608088,-53137183,아일랜드,2011-07
2011-07-31,19128770,3166459,15962311,우루과이,2011-07
2011-07-31,18552960,4024699,14528261,튀니지,2011-07
2011-07-31,17641646,137305,17504341,아제르바이잔,2011-07
2011-07-31,17226310,1948113,15278197,라트비아,2011-07
2011-07-31,17105303,188889600,-171784297,노르웨이,2011-07
2011-07-31,16658801,1465832,15192969,니카라과,2011-07
2011-07-31,16596679,2000576,14596103,수단,2011-07
2011-07-31,15767291,15976008,-208717,푸에르토리코,2011-07
2011-07-31,14982854,1515047,13467807,리투아니아,2011-07
2011-07-31,14350804,1674706,12676098,에티오피아,2011-07
2011-07-31,14213035,523916,13689119,라오스,2011-07
2011-07-31,13845536,8754111,5091425,도미니카 공화국,2011-07
2011-07-31,13632700,163832,13468868,파라과이,2011-07
2011-07-31,12979239,17046271,-4067032,온두라스,2011-07
2011-07-31,12364265,537,12363728,키르기스스탄,2011-07
2011-07-31,9895834,4470,9891364,아프카니스탄,2011-07
2011-07-31,9580973,39806147,-30225174,트리니다드 토바고,2011-07
2011-07-31,9412435,12605980,-3193545,불가리아,2011-07
2011-07-31,8534960,5494957,3040003,에스토니아,2011-07
2011-07-31,8194293,2144690,6049603,조지아,2011-07
2011-07-31,7700901,58024,7642877,탄자니아,2011-07
2011-07-31,7658504,18,7658486,코트디봐르,2011-07
2011-07-31,7375536,1913605,5461931,파푸아 뉴기니,2011-07
2011-07-31,7203286,9829645,-2626359,뉴 칼레도니아,2011-07
2011-07-31,7027095,83134654,-76107559,예맨,2011-07
2011-07-31,6276657,95331,6181326,리비아,2011-07
2011-07-31,5847921,262804,5585117,모리셔스,2011-07
2011-07-31,5648605,4719173,929432,세네갈,2011-07
2011-07-31,5599134,3622432,1976702,크로아티아,2011-07
2011-07-31,5531549,48361,5483188,모잠비크,2011-07
2011-07-31,5269445,1942899,3326546,엘살바도르,2011-07
2011-07-31,5232702,662176,4570526,카메룬,2011-07
2011-07-31,5226262,188336,5037926,괌,2011-07
2011-07-31,4522994,27884361,-23361367,사이프러스,2011-07
2011-07-31,4243327,143776,4099551,쿠바,2011-07
2011-07-31,4104976,6099503,-1994527,타지크,2011-07
2011-07-31,3503903,0,3503903,베닝,2011-07
2011-07-31,3438713,365954,3072759,기니,2011-07
2011-07-31,3409883,13482106,-10072223,잠비아,2011-07
2011-07-31,3392741,22784581,-19391840,세르비아,2011-07
2011-07-31,3291731,166014,3125717,가이아나,2011-07
2011-07-31,3205166,145299,3059867,네팔,2011-07
2011-07-31,3203069,350630,2852439,짐바브웨,2011-07
2011-07-31,3132348,10506,3121842,토고,2011-07
2011-07-31,3093909,852698,2241211,벨라루스,2011-07
2011-07-31,3033342,387807,2645535,마카오,2011-07
2011-07-31,2866770,1398,2865372,지부티,2011-07
2011-07-31,2661214,3515366,-854152,룩셈부르그,2011-07
2011-07-31,2652097,7262961,-4610864,볼리비아,2011-07
2011-07-31,2498881,2106840,392041,피지,2011-07
2011-07-31,2477675,138297,2339378,팔레스타인 해방기구,2011-07
2011-07-31,2423191,74937,2348254,아이티,2011-07
2011-07-31,2378162,197,2377965,마티니크,2011-07
2011-07-31,2170028,97975,2072053,가봉,2011-07
2011-07-31,2115801,122180,1993621,마다카스카르,2011-07
2011-07-31,2088829,4487620,-2398791,콩고,2011-07
2011-07-31,2039193,40207,1998986,아루바,2011-07
2011-07-31,1995403,22129,1973274,아르메니아,2011-07
2011-07-31,1849313,1575061,274252,우간다,2011-07
2011-07-31,1738430,63399,1675031,세이쉘,2011-07
2011-07-31,1472752,0,1472752,부탄,2011-07
2011-07-31,1268822,2337818,-1068996,자마이카,2011-07
2011-07-31,1222629,222336,1000293,모리타니,2011-07
2011-07-31,1130930,720431,410499,아이슬란드,2011-07
2011-07-31,1112933,599,1112334,에리트리아,2011-07
2011-07-31,1106992,0,1106992,불령 리유니온 코모도 제도,2011-07
2011-07-31,984620,24634,959986,안도라,2011-07
2011-07-31,967481,5253,962228,수리남,2011-07
2011-07-31,957635,701221,256414,알바니아,2011-07
2011-07-31,869256,0,869256,부르키나 파소,2011-07
2011-07-31,853412,152758,700654,말라위,2011-07
2011-07-31,752266,48810,703456,네덜란드 열도,2011-07
2011-07-31,726071,28760,697311,니제르,2011-07
2011-07-31,678077,145,677932,과델로프,2011-07
2011-07-31,631500,126030,505470,보츠와나,2011-07
2011-07-31,604249,1646,602603,바베이도스,2011-07
2011-07-31,532243,0,532243,벨리제,2011-07
2011-07-31,519925,132568,387357,보스니아-헤르체고비나,2011-07
2011-07-31,513096,0,513096,몬테네그로,2011-07
2011-07-31,468326,119267,349059,시에라 리온,2011-07
2011-07-31,466219,7839688,-7373469,콩고민주공화국,2011-07
2011-07-31,463507,0,463507,영령 캐이맨 군도,2011-07
2011-07-31,460487,20053155,-19592668,티모르,2011-07
2011-07-31,451859,135404,316455,마이크로네시아,2011-07
2011-07-31,410995,18385,392610,말리,2011-07
2011-07-31,399263,0,399263,버뮤다,2011-07
2011-07-31,393997,0,393997,불령 가이아나,2011-07
2011-07-31,390006,716638,-326632,스와질랜드,2011-07
2011-07-31,378972,696,378276,북마리아나 군도,2011-07
2011-07-31,367049,16895,350154,사모아,2011-07
2011-07-31,341138,1093432,-752294,리히텐슈타인,2011-07
2011-07-31,334710,66485,268225,마세도니아,2011-07
2011-07-31,280450,185154,95296,도미니카,2011-07
2011-07-31,277698,14031,263667,몰디브,2011-07
2011-07-31,269564,0,269564,세인트 루시아,2011-07
2011-07-31,247468,27,247441,르완다,2011-07
2011-07-31,220361,121225,99136,바누아투,2011-07
2011-07-31,220111,0,220111,적도 기니,2011-07
2011-07-31,192710,949179,-756469,솔로몬 군도,2011-07
2011-07-31,190577,1009828,-819251,몰도바,2011-07
2011-07-31,174093,0,174093,투르크 & 카이코스 군도,2011-07
2011-07-31,164321,0,164321,팔라우,2011-07
2011-07-31,152537,607915,-455378,모나코,2011-07
2011-07-31,149882,966,148916,아메리칸 사모아,2011-07
2011-07-31,148605,0,148605,그레나다,2011-07
2011-07-31,137834,217,137617,감비아,2011-07
2011-07-31,128218,46609,81609,통가,2011-07
2011-07-31,124760,0,124760,쿡 아일랜드,2011-07
2011-07-31,120848,118786,2062,영령 버진군도,2011-07
2011-07-31,105102,0,105102,코모로스,2011-07
2011-07-31,89531,3742,85789,산마리노,2011-07
2011-07-31,84097,356,83741,나미비아,2011-07
2011-07-31,76811,0,76811,노폴크 아일랜드,2011-07
2011-07-31,73581,232,73349,세인트 키츠 네비스,2011-07
2011-07-31,73170,4402,68768,안티가 바부다,2011-07
2011-07-31,69054,0,69054,카보 베르데,2011-07
2011-07-31,48264,0,48264,세인트 빈센트 그레나딘,2011-07
2011-07-31,43652,22732,20920,중앙아프리카공화국,2011-07
2011-07-31,41100,0,41100,기네비소,2011-07
2011-07-31,17373,0,17373,투발루,2011-07
2011-07-31,11340,0,11340,앙귈라,2011-07
2011-07-31,8548,160,8388,키리바티,2011-07
2011-07-31,7957,353,7604,나우루,2011-07
2011-07-31,5339,0,5339,부룬디,2011-07
2011-07-31,3058,3736,-678,레소토,2011-07
2011-07-31,2500,9387,-6887,세인트 헬레나,2011-07
2011-07-31,1562,0,1562,파로에 군도,2011-07
2011-07-31,410,0,410,영령 인도양,2011-07
2011-07-31,0,34684,-34684,토켈라우,2011-07
2011-07-31,0,567,-567,코스 군도,2011-07
2011-07-31,0,79012,-79012,니우에,2011-07
2011-07-31,0,1105,-1105,미령 버진군도,2011-07
2011-07-31,0,751,-751,상토메 프린스페,2011-07
2011-07-31,0,20458,-20458,몬트세라트,2011-07
2011-07-31,0,21924,-21924,그린랜드,2011-07
2011-07-31,0,613,-613,남조지아 & 남샌드위치 군도,2011-07
2011-08-31,11615643560,7553298677,4062344883,중국,2011-08
2011-08-31,4322256349,4382666928,-60410579,미국,2011-08
2011-08-31,3425151059,6061221927,-2636070868,일본,2011-08
2011-08-31,2853164440,212827062,2640337378,홍콩,2011-08
2011-08-31,1706433146,1216653513,489779633,대만,2011-08
2011-08-31,1704009673,813893916,890115757,싱가포르,2011-08
2011-08-31,1167195552,453739617,713455935,베트남,2011-08
2011-08-31,1154615885,150,1154615735,마샬군도,2011-08
2011-08-31,1142098766,795110760,346988006,인도,2011-08
2011-08-31,974878591,1406179686,-431301095,인도네시아,2011-08
2011-08-31,885866681,59735,885806946,라이베리아,2011-08
2011-08-31,814018053,599873780,214144273,브라질,2011-08
2011-08-31,744849711,940976197,-196126486,러시아 연방,2011-08
2011-08-31,703586419,234253193,469333226,멕시코,2011-08
2011-08-31,650545188,477927812,172617376,태국,2011-08
2011-08-31,602922304,342464358,260457946,필리핀,2011-08
2011-08-31,576186989,1223444040,-647257051,아랍에미리트 연합,2011-08
2011-08-31,537914225,747857788,-209943563,프랑스,2011-08
2011-08-31,536981146,1493244991,-956263845,독일,2011-08
2011-08-31,511132997,768536238,-257403241,말레이시아,2011-08
2011-08-31,469452897,1022673111,-553220214,이란,2011-08
2011-08-31,457010868,2380552556,-1923541688,호주,2011-08
2011-08-31,426335213,2942902449,-2516567236,사우디아라비아,2011-08
2011-08-31,418584437,50159717,368424720,튀르키예,2011-08
2011-08-31,359853511,11626080,348227431,슬로바키아,2011-08
2011-08-31,351239946,593706821,-242466875,캐나다,2011-08
2011-08-31,321230943,271788939,49442004,네덜란드,2011-08
2011-08-31,316345772,40999,316304773,바하마,2011-08
2011-08-31,313352639,340474822,-27122183,영국,2011-08
2011-08-31,302379627,36315041,266064586,폴란드,2011-08
2011-08-31,226966479,392726233,-165759754,이탈리아,2011-08
2011-08-31,203604483,321459147,-117854664,칠레,2011-08
2011-08-31,194558655,5209962,189348693,몰타,2011-08
2011-08-31,181704546,144662648,37041898,스웨덴,2011-08
2011-08-31,181345747,267215174,-85869427,남아프리카공화국,2011-08
2011-08-31,170544638,108655619,61889019,벨기에,2011-08
2011-08-31,165119435,40294466,124824969,체코공화국,2011-08
2011-08-31,157564517,23320547,134243970,방글라데시,2011-08
2011-08-31,151111184,4710440,146400744,파나마,2011-08
2011-08-31,142787874,83223694,59564180,스페인,2011-08
2011-08-31,139968058,6439437,133528621,슬로베니아,2011-08
2011-08-31,128764145,0,128764145,버뮤다,2011-08
2011-08-31,128644258,99273253,29371005,페루,2011-08
2011-08-31,126790349,2131421,124658928,우즈베키스탄,2011-08
2011-08-31,119544656,0,119544656,영령 캐이맨 군도,2011-08
2011-08-31,118313917,15574410,102739507,콜롬비아,2011-08
2011-08-31,118308418,542186,117766232,사이프러스,2011-08
2011-08-31,105645015,40362217,65282798,헝가리,2011-08
2011-08-31,101958997,5127532,96831465,기타국,2011-08
2011-08-31,100351233,3191769,97159464,에쿠아도르,2011-08
2011-08-31,100010907,19873184,80137723,이집트,2011-08
2011-08-31,96464212,55659820,40804392,이스라엘,2011-08
2011-08-31,94031716,152696037,-58664321,아르헨티나,2011-08
2011-08-31,92041630,0,92041630,지브랄타,2011-08
2011-08-31,86609717,39112625,47497092,우크라이나,2011-08
2011-08-31,82981240,146077375,-63096135,뉴질랜드,2011-08
2011-08-31,81715309,4692033,77023276,요르단,2011-08
2011-08-31,79967628,75193411,4774217,나이지리아,2011-08
2011-08-31,74228673,275002,73953671,영령 버진군도,2011-08
2011-08-31,74042610,66431825,7610785,파키스탄,2011-08
2011-08-31,72736507,377946685,-305210178,오만,2011-08
2011-08-31,72481308,3046,72478262,알제리,2011-08
2011-08-31,69967984,817472686,-747504702,이라크,2011-08
2011-08-31,67979273,38701776,29277497,카자흐스탄,2011-08
2011-08-31,64900722,1574192606,-1509291884,쿠웨이트,2011-08
2011-08-31,64782034,120410036,-55628002,오스트리아,2011-08
2011-08-31,60919132,2977272,57941860,그리스,2011-08
2011-08-31,53385919,97419745,-44033826,핀란드,2011-08
2011-08-31,48235840,429338,47806502,시리아,2011-08
2011-08-31,48209492,59143748,-10934256,아일랜드,2011-08
2011-08-31,47366858,10421371,36945487,포루투갈,2011-08
2011-08-31,44848315,25653747,19194568,루마니아,2011-08
2011-08-31,41206682,2387625,38819057,베네주엘라,2011-08
2011-08-31,36630844,2308723,34322121,가나,2011-08
2011-08-31,36010969,34964657,1046312,미얀마,2011-08
2011-08-31,35270213,2590541,32679672,몽골,2011-08
2011-08-31,33764126,9711593,24052533,캄보디아,2011-08
2011-08-31,31325108,249622845,-218297737,스위스,2011-08
2011-08-31,30164876,14753100,15411776,코스타리카,2011-08
2011-08-31,27080508,2686916,24393592,과테말라,2011-08
2011-08-31,27067351,59789043,-32721692,덴마크,2011-08
2011-08-31,21854543,755425,21099118,케냐,2011-08
2011-08-31,21614604,1433052993,-1411438389,카타르,2011-08
2011-08-31,21603463,10886304,10717159,스리랑카,2011-08
2011-08-31,18790357,5896705,12893652,모로코,2011-08
2011-08-31,18187262,24443817,-6256555,푸에르토리코,2011-08
2011-08-31,17803949,252043,17551906,앙골라,2011-08
2011-08-31,17660301,3953254,13707047,우루과이,2011-08
2011-08-31,17467569,140331462,-122863893,노르웨이,2011-08
2011-08-31,15865749,3167718,12698031,레바논,2011-08
2011-08-31,15831488,4452913,11378575,튀니지,2011-08
2011-08-31,14757163,1356272,13400891,크로아티아,2011-08
2011-08-31,14618465,13674018,944447,도미니카 공화국,2011-08
2011-08-31,14427945,6907611,7520334,파라과이,2011-08
2011-08-31,14206573,1624,14204949,아프카니스탄,2011-08
2011-08-31,14180041,83292653,-69112612,파푸아 뉴기니,2011-08
2011-08-31,13314322,771050,12543272,니카라과,2011-08
2011-08-31,12622297,98711,12523586,키르기스스탄,2011-08
2011-08-31,12415178,3495,12411683,아제르바이잔,2011-08
2011-08-31,12219663,62395303,-50175640,바레인,2011-08
2011-08-31,12002716,3361,11999355,코트디봐르,2011-08
2011-08-31,11497395,92083,11405312,투르크멘,2011-08
2011-08-31,10117808,280779,9837029,라오스,2011-08
2011-08-31,9972835,2074100,7898735,수단,2011-08
2011-08-31,9367529,2605161,6762368,라트비아,2011-08
2011-08-31,9210656,485559,8725097,탄자니아,2011-08
2011-08-31,8670952,2061297,6609655,리투아니아,2011-08
2011-08-31,8577099,68409414,-59832315,예맨,2011-08
2011-08-31,8394256,10532831,-2138575,온두라스,2011-08
2011-08-31,8243568,2930595,5312973,조지아,2011-08
2011-08-31,8112136,69219415,-61107279,트리니다드 토바고,2011-08
2011-08-31,7836924,3787746,4049178,불가리아,2011-08
2011-08-31,7675101,3271595,4403506,에스토니아,2011-08
2011-08-31,7054789,3186741,3868048,엘살바도르,2011-08
2011-08-31,6238463,1717765,4520698,에티오피아,2011-08
2011-08-31,6031232,260274,5770958,모리셔스,2011-08
2011-08-31,5612910,12339,5600571,가봉,2011-08
2011-08-31,5360132,2412510,2947622,세네갈,2011-08
2011-08-31,5244690,130232,5114458,모잠비크,2011-08
2011-08-31,4982003,502524,4479479,벨라루스,2011-08
2011-08-31,4866274,1195353,3670921,쿠바,2011-08
2011-08-31,4605909,40909,4565000,말라위,2011-08
2011-08-31,4407042,1134701,3272341,기니,2011-08
2011-08-31,4404093,139624061,-135219968,브루나이,2011-08
2011-08-31,4307590,1403841,2903749,리비아,2011-08
2011-08-31,4005461,19893009,-15887548,뉴 칼레도니아,2011-08
2011-08-31,3849190,9096837,-5247647,콩고,2011-08
2011-08-31,3821021,367,3820654,네덜란드 열도,2011-08
2011-08-31,3176572,751896,2424676,카메룬,2011-08
2011-08-31,3145750,351702,2794048,마카오,2011-08
2011-08-31,3138374,530900,2607474,네팔,2011-08
2011-08-31,2985697,5913874,-2928177,타지크,2011-08
2011-08-31,2942647,161851,2780796,아이티,2011-08
2011-08-31,2841045,8162,2832883,아르메니아,2011-08
2011-08-31,2615474,24080620,-21465146,세르비아,2011-08
2011-08-31,2569575,71051178,-68481603,볼리비아,2011-08
2011-08-31,2463812,494928,1968884,베닝,2011-08
2011-08-31,2461821,1866757,595064,자마이카,2011-08
2011-08-31,2436952,0,2436952,지부티,2011-08
2011-08-31,2422879,3999178,-1576299,룩셈부르그,2011-08
2011-08-31,2372525,559082,1813443,괌,2011-08
2011-08-31,2347401,639258,1708143,짐바브웨,2011-08
2011-08-31,2143335,22922,2120413,가이아나,2011-08
2011-08-31,1802837,4749,1798088,부탄,2011-08
2011-08-31,1744373,51149,1693224,시에라 리온,2011-08
2011-08-31,1690434,0,1690434,불령 리유니온 코모도 제도,2011-08
2011-08-31,1685250,162,1685088,토고,2011-08
2011-08-31,1648581,2268131,-619550,아이슬란드,2011-08
2011-08-31,1522251,91039,1431212,마다카스카르,2011-08
2011-08-31,1505746,5714,1500032,부르키나 파소,2011-08
2011-08-31,1432945,51543108,-50110163,아루바,2011-08
2011-08-31,1407276,579386,827890,모리타니,2011-08
2011-08-31,1345647,88662,1256985,팔레스타인 해방기구,2011-08
2011-08-31,1334738,1456079,-121341,피지,2011-08
2011-08-31,1331918,6729,1325189,바베이도스,2011-08
2011-08-31,1299359,28,1299331,마티니크,2011-08
2011-08-31,1271624,10389416,-9117792,콩고민주공화국,2011-08
2011-08-31,1259965,53597,1206368,알바니아,2011-08
2011-08-31,1256851,8403,1248448,나미비아,2011-08
2011-08-31,1214123,1323761,-109638,우간다,2011-08
2011-08-31,1201452,0,1201452,보츠와나,2011-08
2011-08-31,1158072,12759,1145313,세이쉘,2011-08
2011-08-31,1099285,654786,444499,보스니아-헤르체고비나,2011-08
2011-08-31,1065653,0,1065653,불령 폴리네시아,2011-08
2011-08-31,1062579,48359383,-47296804,잠비아,2011-08
2011-08-31,931709,22523,909186,니제르,2011-08
2011-08-31,918906,0,918906,과델로프,2011-08
2011-08-31,907050,39277,867773,수리남,2011-08
2011-08-31,775228,0,775228,에리트리아,2011-08
2011-08-31,658002,331626,326376,몰도바,2011-08
2011-08-31,631539,0,631539,사모아,2011-08
2011-08-31,571675,335486,236189,스와질랜드,2011-08
2011-08-31,481886,2411799,-1929913,마세도니아,2011-08
2011-08-31,464068,387068,77000,마이크로네시아,2011-08
2011-08-31,447551,7471,440080,몰디브,2011-08
2011-08-31,438126,108,438018,말리,2011-08
2011-08-31,429090,334,428756,북마리아나 군도,2011-08
2011-08-31,423374,473,422901,벨리제,2011-08
2011-08-31,390137,178,389959,몬테네그로,2011-08
2011-08-31,366291,0,366291,불령 가이아나,2011-08
2011-08-31,362248,0,362248,감비아,2011-08
2011-08-31,334398,721252,-386854,리히텐슈타인,2011-08
2011-08-31,304324,35898,268426,도미니카,2011-08
2011-08-31,277007,0,277007,티모르,2011-08
2011-08-31,270845,0,270845,세인트 루시아,2011-08
2011-08-31,221605,0,221605,그레나다,2011-08
2011-08-31,209872,0,209872,소말리아,2011-08
2011-08-31,200435,90515,109920,바누아투,2011-08
2011-08-31,183603,289186,-105583,세인트 키츠 네비스,2011-08
2011-08-31,180206,82,180124,안도라,2011-08
2011-08-31,163039,184,162855,아메리칸 사모아,2011-08
2011-08-31,158816,0,158816,팔라우,2011-08
2011-08-31,141618,0,141618,적도 기니,2011-08
2011-08-31,124632,277138,-152506,솔로몬 군도,2011-08
2011-08-31,74029,14064,59965,안티가 바부다,2011-08
2011-08-31,64951,0,64951,카보 베르데,2011-08
2011-08-31,59400,0,59400,기네비소,2011-08
2011-08-31,49002,0,49002,미령 버진군도,2011-08
2011-08-31,47006,0,47006,챠드,2011-08
2011-08-31,37995,3977,34018,키리바티,2011-08
2011-08-31,37419,0,37419,중앙아프리카공화국,2011-08
2011-08-31,36754,7622,29132,르완다,2011-08
2011-08-31,33328,246708,-213380,모나코,2011-08
2011-08-31,31517,22831,8686,세인트 빈센트 그레나딘,2011-08
2011-08-31,16024,143,15881,통가,2011-08
2011-08-31,12403,0,12403,포클랜드 군도,2011-08
2011-08-31,5935,27900,-21965,몬트세라트,2011-08
2011-08-31,4464,80954,-76490,레소토,2011-08
2011-08-31,2534,0,2534,세인트 마틴,2011-08
2011-08-31,1643,0,1643,부룬디,2011-08
2011-08-31,1148,0,1148,상토메 프린스페,2011-08
2011-08-31,587,0,587,영령 인도양,2011-08
2011-08-31,528,14461,-13933,산마리노,2011-08
2011-08-31,329,160,169,쿡 아일랜드,2011-08
2011-08-31,240,0,240,투발루,2011-08
2011-08-31,0,2,-2,세인트 헬레나,2011-08
2011-08-31,0,2271,-2271,투르크 & 카이코스 군도,2011-08
2011-08-31,0,9212,-9212,코스 군도,2011-08
2011-08-31,0,4464268,-4464268,나우루,2011-08
2011-08-31,0,223118,-223118,그린랜드,2011-08
2011-08-31,0,34398,-34398,토켈라우,2011-08
2011-09-30,11664543504,7266648918,4397894586,중국,2011-09
2011-09-30,4794608984,3589833867,1204775117,미국,2011-09
2011-09-30,3414076198,5577654241,-2163578043,일본,2011-09
2011-09-30,2344299427,192081559,2152217868,홍콩,2011-09
2011-09-30,1690556188,740376724,950179464,싱가포르,2011-09
2011-09-30,1394300701,1258504379,135796322,대만,2011-09
2011-09-30,1306856539,500917509,805939030,베트남,2011-09
2011-09-30,1170763414,1926850647,-756087233,인도네시아,2011-09
2011-09-30,1111116468,697314670,413801798,인도,2011-09
2011-09-30,919233983,840403292,78830691,러시아 연방,2011-09
2011-09-30,904506188,151578237,752927951,멕시코,2011-09
2011-09-30,800325987,558908626,241417361,브라질,2011-09
2011-09-30,727966161,446520994,281445167,태국,2011-09
2011-09-30,629052836,286173193,342879643,필리핀,2011-09
2011-09-30,601386318,1196110533,-594724215,아랍에미리트 연합,2011-09
2011-09-30,584763314,780931173,-196167859,말레이시아,2011-09
2011-09-30,582129914,175093191,407036723,네덜란드,2011-09
2011-09-30,582006029,1480182331,-898176302,독일,2011-09
2011-09-30,581313700,2529368526,-1948054826,호주,2011-09
2011-09-30,555169971,1136559217,-581389246,이란,2011-09
2011-09-30,535676390,2677,535673713,마샬군도,2011-09
2011-09-30,503072628,3233371794,-2730299166,사우디아라비아,2011-09
2011-09-30,486305015,10887,486294128,바하마,2011-09
2011-09-30,468117405,192346,467925059,라이베리아,2011-09
2011-09-30,446871800,280460917,166410883,영국,2011-09
2011-09-30,401816716,13023724,388792992,슬로바키아,2011-09
2011-09-30,384974068,63793388,321180680,튀르키예,2011-09
2011-09-30,378698050,694545966,-315847916,캐나다,2011-09
2011-09-30,346082056,42506907,303575149,폴란드,2011-09
2011-09-30,342481181,608821582,-266340401,프랑스,2011-09
2011-09-30,291176950,369335521,-78158571,이탈리아,2011-09
2011-09-30,221608430,18405565,203202865,파나마,2011-09
2011-09-30,199583718,41228395,158355323,체코공화국,2011-09
2011-09-30,197785911,3412497,194373414,우즈베키스탄,2011-09
2011-09-30,191336595,175219208,16117387,남아프리카공화국,2011-09
2011-09-30,186221491,50810764,135410727,이스라엘,2011-09
2011-09-30,186149770,117292686,68857084,벨기에,2011-09
2011-09-30,160815669,390752341,-229936672,칠레,2011-09
2011-09-30,157681456,9902904,147778552,사이프러스,2011-09
2011-09-30,143206820,123676881,19529939,스페인,2011-09
2011-09-30,139705235,6501978,133203257,그리스,2011-09
2011-09-30,139123559,17420819,121702740,콜롬비아,2011-09
2011-09-30,137706893,6007454,131699439,슬로베니아,2011-09
2011-09-30,136763108,25863414,110899694,방글라데시,2011-09
2011-09-30,134412103,209175823,-74763720,페루,2011-09
2011-09-30,128999082,45866198,83132884,헝가리,2011-09
2011-09-30,126835344,8267142,118568202,이집트,2011-09
2011-09-30,120299290,110379586,9919704,뉴질랜드,2011-09
2011-09-30,113023689,10873,113012816,알제리,2011-09
2011-09-30,112917115,58077257,54839858,아르헨티나,2011-09
2011-09-30,102063264,0,102063264,맨섬,2011-09
2011-09-30,101913303,2924850,98988453,나이지리아,2011-09
2011-09-30,97847841,66543939,31303902,우크라이나,2011-09
2011-09-30,94314778,557544126,-463229348,오만,2011-09
2011-09-30,92340818,16218419,76122399,카자흐스탄,2011-09
2011-09-30,89145691,0,89145691,지브랄타,2011-09
2011-09-30,88393728,3408142,84985586,요르단,2011-09
2011-09-30,87423014,2780126,84642888,에쿠아도르,2011-09
2011-09-30,83706548,6697456,77009092,기타국,2011-09
2011-09-30,77329831,45058952,32270879,미얀마,2011-09
2011-09-30,76575256,99263097,-22687841,오스트리아,2011-09
2011-09-30,74795556,841645816,-766850260,이라크,2011-09
2011-09-30,68712417,1592497878,-1523785461,쿠웨이트,2011-09
2011-09-30,67124252,9189398,57934854,몰타,2011-09
2011-09-30,65036305,156175810,-91139505,스웨덴,2011-09
2011-09-30,62942418,707166,62235252,괌,2011-09
2011-09-30,61783743,51099935,10683808,핀란드,2011-09
2011-09-30,60630455,1035621,59594834,베네주엘라,2011-09
2011-09-30,56811039,102499367,-45688328,파키스탄,2011-09
2011-09-30,49656668,3766147,45890521,룩셈부르그,2011-09
2011-09-30,46122640,37105622,9017018,루마니아,2011-09
2011-09-30,41068323,12825698,28242625,캄보디아,2011-09
2011-09-30,40231004,50502148,-10271144,아일랜드,2011-09
2011-09-30,39363541,19102,39344439,불령 폴리네시아,2011-09
2011-09-30,33659714,441163,33218551,시리아,2011-09
2011-09-30,30232017,16309695,13922322,코스타리카,2011-09
2011-09-30,29943142,213041309,-183098167,스위스,2011-09
2011-09-30,29186509,7614445,21572064,스리랑카,2011-09
2011-09-30,28863354,3736525,25126829,몽골,2011-09
2011-09-30,27860030,1112190,26747840,가나,2011-09
2011-09-30,27508259,2188587257,-2161078998,카타르,2011-09
2011-09-30,26995029,221591618,-194596589,노르웨이,2011-09
2011-09-30,24610025,57716430,-33106405,덴마크,2011-09
2011-09-30,24573269,8907028,15666241,포루투갈,2011-09
2011-09-30,22762384,24871276,-2108892,푸에르토리코,2011-09
2011-09-30,22560612,3225621,19334991,수단,2011-09
2011-09-30,22449615,2382166,20067449,과테말라,2011-09
2011-09-30,21661118,3040100,18621018,레바논,2011-09
2011-09-30,21477440,6132,21471308,앙골라,2011-09
2011-09-30,21426417,85649188,-64222771,바레인,2011-09
2011-09-30,19532411,10927647,8604764,모로코,2011-09
2011-09-30,18534176,1238639,17295537,에티오피아,2011-09
2011-09-30,18411869,1286584,17125285,니카라과,2011-09
2011-09-30,18234387,77172,18157215,투르크멘,2011-09
2011-09-30,17909721,331020,17578701,케냐,2011-09
2011-09-30,17849955,17769289,80666,파라과이,2011-09
2011-09-30,17199334,1994,17197340,아프카니스탄,2011-09
2011-09-30,17121998,28848,17093150,아제르바이잔,2011-09
2011-09-30,15937754,3253109,12684645,우루과이,2011-09
2011-09-30,14116773,0,14116773,키리바티,2011-09
2011-09-30,13218065,269049,12949016,탄자니아,2011-09
2011-09-30,13134768,364959,12769809,코트디봐르,2011-09
2011-09-30,12314155,80085,12234070,키르기스스탄,2011-09
2011-09-30,11495144,7239733,4255411,도미니카 공화국,2011-09
2011-09-30,10768678,3913358,6855320,튀니지,2011-09
2011-09-30,9906971,2878741,7028230,엘살바도르,2011-09
2011-09-30,9777521,7297767,2479754,온두라스,2011-09
2011-09-30,9582318,667358,8914960,라오스,2011-09
2011-09-30,9424646,28245510,-18820864,불가리아,2011-09
2011-09-30,9275168,3036826,6238342,에스토니아,2011-09
2011-09-30,8894222,3278795,5615427,라트비아,2011-09
2011-09-30,8516790,1002161,7514629,크로아티아,2011-09
2011-09-30,7757714,751606,7006108,벨라루스,2011-09
2011-09-30,7710314,2369712,5340602,리투아니아,2011-09
2011-09-30,7446013,3857342,3588671,조지아,2011-09
2011-09-30,6838403,23447549,-16609146,세르비아,2011-09
2011-09-30,6573382,0,6573382,지부티,2011-09
2011-09-30,6245095,98377,6146718,쿠바,2011-09
2011-09-30,6033874,926128,5107746,기니,2011-09
2011-09-30,5873159,7637266,-1764107,콩고,2011-09
2011-09-30,5831973,72816,5759157,리비아,2011-09
2011-09-30,5603881,2302694,3301187,세네갈,2011-09
2011-09-30,5351044,20661219,-15310175,뉴 칼레도니아,2011-09
2011-09-30,5235398,5626146,-390748,파푸아 뉴기니,2011-09
2011-09-30,5227080,99392146,-94165066,예맨,2011-09
2011-09-30,5079218,304443,4774775,카메룬,2011-09
2011-09-30,4936205,127108962,-122172757,트리니다드 토바고,2011-09
2011-09-30,4723417,725047,3998370,모리셔스,2011-09
2011-09-30,4066137,193938871,-189872734,브루나이,2011-09
2011-09-30,3743396,2977542,765854,베닝,2011-09
2011-09-30,3727487,0,3727487,티모르,2011-09
2011-09-30,3205881,58,3205823,토고,2011-09
2011-09-30,3151054,72806,3078248,가이아나,2011-09
2011-09-30,3046561,92014,2954547,네팔,2011-09
2011-09-30,2945873,115647,2830226,모잠비크,2011-09
2011-09-30,2879462,104910,2774552,말리,2011-09
2011-09-30,2809837,1229512,1580325,알바니아,2011-09
2011-09-30,2804681,348779,2455902,마다카스카르,2011-09
2011-09-30,2531451,1964085,567366,타지크,2011-09
2011-09-30,2518486,371,2518115,르완다,2011-09
2011-09-30,2467345,6444093,-3976748,볼리비아,2011-09
2011-09-30,2458899,17464924,-15006025,콩고민주공화국,2011-09
2011-09-30,2393011,26980,2366031,네덜란드 열도,2011-09
2011-09-30,2358584,1834739,523845,자마이카,2011-09
2011-09-30,2348222,38280479,-35932257,잠비아,2011-09
2011-09-30,2289067,5504,2283563,아이티,2011-09
2011-09-30,2270956,1264194,1006762,아이슬란드,2011-09
2011-09-30,2151416,67962,2083454,짐바브웨,2011-09
2011-09-30,2016922,3177199,-1160277,피지,2011-09
2011-09-30,1995372,19989,1975383,세이쉘,2011-09
2011-09-30,1966569,56,1966513,부르키나 파소,2011-09
2011-09-30,1943547,440125,1503422,마카오,2011-09
2011-09-30,1888780,26584,1862196,말라위,2011-09
2011-09-30,1862922,217604,1645318,시에라 리온,2011-09
2011-09-30,1797566,4343,1793223,아르메니아,2011-09
2011-09-30,1701288,3027692,-1326404,가봉,2011-09
2011-09-30,1651623,5970,1645653,부탄,2011-09
2011-09-30,1589583,794039,795544,우간다,2011-09
2011-09-30,1481914,130439,1351475,수리남,2011-09
2011-09-30,1417426,65610,1351816,아루바,2011-09
2011-09-30,1371376,4706,1366670,불령 리유니온 코모도 제도,2011-09
2011-09-30,1185990,0,1185990,에리트리아,2011-09
2011-09-30,1092436,282412,810024,모리타니,2011-09
2011-09-30,913562,0,913562,마티니크,2011-09
2011-09-30,793457,466377,327080,마이크로네시아,2011-09
2011-09-30,768845,130617,638228,보츠와나,2011-09
2011-09-30,664627,40916,623711,팔레스타인 해방기구,2011-09
2011-09-30,649076,0,649076,벨리제,2011-09
2011-09-30,628617,615388,13229,보스니아-헤르체고비나,2011-09
2011-09-30,603325,0,603325,과델로프,2011-09
2011-09-30,584493,787355,-202862,스와질랜드,2011-09
2011-09-30,579760,0,579760,버뮤다,2011-09
2011-09-30,557209,79246,477963,마세도니아,2011-09
2011-09-30,432067,12241,419826,북마리아나 군도,2011-09
2011-09-30,387960,78677,309283,도미니카,2011-09
2011-09-30,372506,0,372506,불령 가이아나,2011-09
2011-09-30,361935,4222,357713,세인트 루시아,2011-09
2011-09-30,343860,0,343860,영령 캐이맨 군도,2011-09
2011-09-30,340959,51974,288985,몰디브,2011-09
2011-09-30,290037,13,290024,바베이도스,2011-09
2011-09-30,288129,759459,-471330,리히텐슈타인,2011-09
2011-09-30,286017,73879,212138,나미비아,2011-09
2011-09-30,285533,5465,280068,안티가 바부다,2011-09
2011-09-30,277942,5039,272903,니제르,2011-09
2011-09-30,277642,1218111,-940469,몰도바,2011-09
2011-09-30,207532,15683,191849,몬테네그로,2011-09
2011-09-30,200705,0,200705,팔라우,2011-09
2011-09-30,197443,383131,-185688,영령 버진군도,2011-09
2011-09-30,144319,0,144319,감비아,2011-09
2011-09-30,143700,0,143700,산마리노,2011-09
2011-09-30,133209,689021,-555812,바누아투,2011-09
2011-09-30,111072,427046,-315974,모나코,2011-09
2011-09-30,108479,131728,-23249,사모아,2011-09
2011-09-30,102383,11,102372,아메리칸 사모아,2011-09
2011-09-30,92584,0,92584,세인트 헬레나,2011-09
2011-09-30,64756,44375,20381,카보 베르데,2011-09
2011-09-30,62875,0,62875,코모로스,2011-09
2011-09-30,62771,0,62771,노폴크 아일랜드,2011-09
2011-09-30,51581,1902478,-1850897,솔로몬 군도,2011-09
2011-09-30,48769,48669890,-48621121,적도 기니,2011-09
2011-09-30,46636,20,46616,투르크 & 카이코스 군도,2011-09
2011-09-30,38573,580,37993,그레나다,2011-09
2011-09-30,34200,0,34200,크리스마스 아일랜드,2011-09
2011-09-30,23056,46,23010,세인트 빈센트 그레나딘,2011-09
2011-09-30,22327,2542,19785,안도라,2011-09
2011-09-30,21040,2471,18569,토켈라우,2011-09
2011-09-30,20079,0,20079,중앙아프리카공화국,2011-09
2011-09-30,19203,0,19203,상토메 프린스페,2011-09
2011-09-30,14722,32384,-17662,레소토,2011-09
2011-09-30,11949,0,11949,부룬디,2011-09
2011-09-30,9892,120,9772,미령 버진군도,2011-09
2011-09-30,2802,32,2770,쿡 아일랜드,2011-09
2011-09-30,640,0,640,앙귈라,2011-09
2011-09-30,628,316228,-315600,그린랜드,2011-09
2011-09-30,464,0,464,영령 인도양,2011-09
2011-09-30,0,628,-628,몬트세라트,2011-09
2011-09-30,0,5360880,-5360880,나우루,2011-09
2011-09-30,0,30596,-30596,니우에,2011-09
2011-09-30,0,601,-601,보빗군도,2011-09
2011-09-30,0,96650,-96650,세인트 키츠 네비스,2011-09
2011-09-30,0,32334,-32334,통가,2011-09
2011-09-30,0,329,-329,저어지,2011-09
2011-09-30,0,9447,-9447,남조지아 & 남샌드위치 군도,2011-09
2011-10-31,11842269115,7013690339,4828578776,중국,2011-10
2011-10-31,4604884789,3491612317,1113272472,미국,2011-10
2011-10-31,3291812320,5342217354,-2050405034,일본,2011-10
2011-10-31,3070063782,147821661,2922242121,홍콩,2011-10
2011-10-31,1433790630,839558731,594231899,싱가포르,2011-10
2011-10-31,1226446881,428813083,797633798,베트남,2011-10
2011-10-31,1223302727,1479557041,-256254314,인도네시아,2011-10
2011-10-31,1211632416,1184844812,26787604,대만,2011-10
2011-10-31,915473607,532457199,383016408,인도,2011-10
2011-10-31,817087017,237308197,579778820,멕시코,2011-10
2011-10-31,805930477,982173518,-176243041,러시아 연방,2011-10
2011-10-31,770304973,33045,770271928,마샬군도,2011-10
2011-10-31,749742584,300977893,448764691,필리핀,2011-10
2011-10-31,733808381,198,733808183,버뮤다,2011-10
2011-10-31,721188337,1434247735,-713059398,독일,2011-10
2011-10-31,689488021,476394438,213093583,브라질,2011-10
2011-10-31,663582045,2057414784,-1393832739,호주,2011-10
2011-10-31,647526732,479759686,167767046,태국,2011-10
2011-10-31,628112793,1167232490,-539119697,아랍에미리트 연합,2011-10
2011-10-31,596902976,944823549,-347920573,이란,2011-10
2011-10-31,520006374,3483679274,-2963672900,사우디아라비아,2011-10
2011-10-31,516013190,913,516012277,바하마,2011-10
2011-10-31,497199622,406716548,90483074,캐나다,2011-10
2011-10-31,496214195,790689118,-294474923,말레이시아,2011-10
2011-10-31,447774255,96528203,351246052,튀르키예,2011-10
2011-10-31,402502249,234814499,167687750,네덜란드,2011-10
2011-10-31,373323850,27935070,345388780,폴란드,2011-10
2011-10-31,364113211,16757509,347355702,슬로바키아,2011-10
2011-10-31,329756382,142698,329613684,라이베리아,2011-10
2011-10-31,319126403,55739803,263386600,파나마,2011-10
2011-10-31,292655631,338549451,-45893820,영국,2011-10
2011-10-31,272919739,1438019116,-1165099377,쿠웨이트,2011-10
2011-10-31,246397632,315761274,-69363642,이탈리아,2011-10
2011-10-31,204521766,245709219,-41187453,남아프리카공화국,2011-10
2011-10-31,204428443,353832591,-149404148,프랑스,2011-10
2011-10-31,195484548,401652204,-206167656,칠레,2011-10
2011-10-31,194545733,2606452,191939281,우즈베키스탄,2011-10
2011-10-31,175849979,645011123,-469161144,이라크,2011-10
2011-10-31,172299727,60913449,111386278,이스라엘,2011-10
2011-10-31,165683398,8646709,157036689,몰타,2011-10
2011-10-31,161285907,110342779,50943128,벨기에,2011-10
2011-10-31,160051738,37196474,122855264,체코공화국,2011-10
2011-10-31,149923047,10053690,139869357,이집트,2011-10
2011-10-31,146800969,73189122,73611847,스페인,2011-10
2011-10-31,132613692,19265153,113348539,콜롬비아,2011-10
2011-10-31,132072868,9947924,122124944,슬로베니아,2011-10
2011-10-31,125708525,145664292,-19955767,페루,2011-10
2011-10-31,116459048,34470847,81988201,헝가리,2011-10
2011-10-31,108439640,3143531,105296109,요르단,2011-10
2011-10-31,96774798,26692777,70082021,방글라데시,2011-10
2011-10-31,93204660,94597120,-1392460,아르헨티나,2011-10
2011-10-31,91507425,1417774,90089651,그리스,2011-10
2011-10-31,87635509,67823,87567686,중앙아프리카공화국,2011-10
2011-10-31,83552238,157229033,-73676795,나이지리아,2011-10
2011-10-31,81369703,772092,80597611,알제리,2011-10
2011-10-31,80230086,120692966,-40462880,뉴질랜드,2011-10
2011-10-31,80051330,130079951,-50028621,오스트리아,2011-10
2011-10-31,79576737,42982463,36594274,우크라이나,2011-10
2011-10-31,78471358,82200858,-3729500,파키스탄,2011-10
2011-10-31,77110249,558842298,-481732049,오만,2011-10
2011-10-31,64027810,135936139,-71908329,스웨덴,2011-10
2011-10-31,61579804,304265,61275539,시리아,2011-10
2011-10-31,59072898,36711403,22361495,카자흐스탄,2011-10
2011-10-31,56951655,4234501,52717154,베네주엘라,2011-10
2011-10-31,53144771,2640156,50504615,에쿠아도르,2011-10
2011-10-31,52899553,44591050,8308503,미얀마,2011-10
2011-10-31,50972189,63886659,-12914470,핀란드,2011-10
2011-10-31,41822910,2061894566,-2020071656,카타르,2011-10
2011-10-31,32918891,7644203,25274688,캄보디아,2011-10
2011-10-31,32793048,18394442,14398606,코스타리카,2011-10
2011-10-31,32336107,0,32336107,영령 캐이맨 군도,2011-10
2011-10-31,32107042,6467821,25639221,스리랑카,2011-10
2011-10-31,31138954,22848104,8290850,푸에르토리코,2011-10
2011-10-31,30822425,29758640,1063785,사이프러스,2011-10
2011-10-31,28582555,44893133,-16310578,루마니아,2011-10
2011-10-31,27779976,6589028,21190948,모로코,2011-10
2011-10-31,27274370,3759724,23514646,몽골,2011-10
2011-10-31,27187215,210007627,-182820412,스위스,2011-10
2011-10-31,25019119,3117116,21902003,가나,2011-10
2011-10-31,24025808,46753112,-22727304,바레인,2011-10
2011-10-31,23904888,59668930,-35764042,덴마크,2011-10
2011-10-31,23822216,70557,23751659,앙골라,2011-10
2011-10-31,23071460,3879083,19192377,과테말라,2011-10
2011-10-31,22341555,1826802,20514753,레바논,2011-10
2011-10-31,21689016,169098437,-147409421,노르웨이,2011-10
2011-10-31,21314623,2121969,19192654,케냐,2011-10
2011-10-31,21286622,66814715,-45528093,아일랜드,2011-10
2011-10-31,20679257,17101536,3577721,불가리아,2011-10
2011-10-31,19145362,166452,18978910,파라과이,2011-10
2011-10-31,17697507,7790158,9907349,포루투갈,2011-10
2011-10-31,15874276,2670614,13203662,튀니지,2011-10
2011-10-31,15697140,7860677,7836463,우루과이,2011-10
2011-10-31,15107820,0,15107820,아제르바이잔,2011-10
2011-10-31,14694001,1828841,12865160,니카라과,2011-10
2011-10-31,14272925,3501382,10771543,수단,2011-10
2011-10-31,13780632,9778240,4002392,도미니카 공화국,2011-10
2011-10-31,12660537,234564,12425973,라오스,2011-10
2011-10-31,12299809,251872,12047937,키르기스스탄,2011-10
2011-10-31,11495472,2964041,8531431,온두라스,2011-10
2011-10-31,11347132,1845515,9501617,파푸아 뉴기니,2011-10
2011-10-31,11011747,301860,10709887,투르크멘,2011-10
2011-10-31,10803320,4512877,6290443,가봉,2011-10
2011-10-31,10402193,2997851,7404342,콩고,2011-10
2011-10-31,9595190,49774,9545416,리비아,2011-10
2011-10-31,8961323,2137881,6823442,엘살바도르,2011-10
2011-10-31,8859932,2871614,5988318,라트비아,2011-10
2011-10-31,8610106,9450580,-840474,탄자니아,2011-10
2011-10-31,8533390,1824603,6708787,리투아니아,2011-10
2011-10-31,8399073,3655682,4743391,에스토니아,2011-10
2011-10-31,8395242,1435796,6959446,코트디봐르,2011-10
2011-10-31,8256495,37377187,-29120692,트리니다드 토바고,2011-10
2011-10-31,7845096,652410,7192686,벨라루스,2011-10
2011-10-31,7338912,59209133,-51870221,예맨,2011-10
2011-10-31,7114511,2612668,4501843,에티오피아,2011-10
2011-10-31,6940186,0,6940186,지부티,2011-10
2011-10-31,6522058,1121071,5400987,크로아티아,2011-10
2011-10-31,6375458,222742199,-216366741,브루나이,2011-10
2011-10-31,6065993,21356010,-15290017,뉴 칼레도니아,2011-10
2011-10-31,5519239,4636646,882593,조지아,2011-10
2011-10-31,5461310,1633,5459677,아프카니스탄,2011-10
2011-10-31,5362474,555766,4806708,카메룬,2011-10
2011-10-31,5322854,822604,4500250,모리셔스,2011-10
2011-10-31,4895447,2144929,2750518,세네갈,2011-10
2011-10-31,4877598,1319502,3558096,괌,2011-10
2011-10-31,4568237,11888486,-7320249,세르비아,2011-10
2011-10-31,3415587,138293,3277294,수리남,2011-10
2011-10-31,3414257,113524,3300733,토고,2011-10
2011-10-31,3402260,881,3401379,모잠비크,2011-10
2011-10-31,3358658,191149,3167509,쿠바,2011-10
2011-10-31,3260021,148468,3111553,아이티,2011-10
2011-10-31,3100535,1115602,1984933,기니,2011-10
2011-10-31,3047504,3004708,42796,룩셈부르그,2011-10
2011-10-31,2746604,18255901,-15509297,볼리비아,2011-10
2011-10-31,2745738,953078,1792660,베닝,2011-10
2011-10-31,2380099,504,2379595,부탄,2011-10
2011-10-31,2333287,159398,2173889,아르메니아,2011-10
2011-10-31,2307828,225076,2082752,가이아나,2011-10
2011-10-31,2142393,1413469,728924,짐바브웨,2011-10
2011-10-31,2094127,46262,2047865,네팔,2011-10
2011-10-31,2001473,150831,1850642,마다카스카르,2011-10
2011-10-31,1964699,1990592,-25893,피지,2011-10
2011-10-31,1899311,575376,1323935,우간다,2011-10
2011-10-31,1873341,32466,1840875,네덜란드 열도,2011-10
2011-10-31,1815314,1455331,359983,타지크,2011-10
2011-10-31,1787104,1295194,491910,아이슬란드,2011-10
2011-10-31,1739811,50152,1689659,알바니아,2011-10
2011-10-31,1650403,635709,1014694,자마이카,2011-10
2011-10-31,1641164,19581230,-17940066,잠비아,2011-10
2011-10-31,1623039,303761,1319278,마카오,2011-10
2011-10-31,1553619,17602788,-16049169,콩고민주공화국,2011-10
2011-10-31,1525246,108367,1416879,세이쉘,2011-10
2011-10-31,1521696,3401187,-1879491,기타국,2011-10
2011-10-31,1444365,33213,1411152,아루바,2011-10
2011-10-31,1438973,0,1438973,과델로프,2011-10
2011-10-31,1375512,45509,1330003,불령 폴리네시아,2011-10
2011-10-31,1335172,66858,1268314,팔레스타인 해방기구,2011-10
2011-10-31,1306502,0,1306502,불령 리유니온 코모도 제도,2011-10
2011-10-31,1107466,755846,351620,보스니아-헤르체고비나,2011-10
2011-10-31,1103857,2112,1101745,말라위,2011-10
2011-10-31,1082862,0,1082862,마티니크,2011-10
2011-10-31,885756,93054,792702,시에라 리온,2011-10
2011-10-31,838900,296781,542119,스와질랜드,2011-10
2011-10-31,791177,796,790381,니제르,2011-10
2011-10-31,759776,234694,525082,모리타니,2011-10
2011-10-31,730377,19029,711348,벨리제,2011-10
2011-10-31,617037,68282,548755,보츠와나,2011-10
2011-10-31,551254,0,551254,부르키나 파소,2011-10
2011-10-31,537256,126236,411020,사모아,2011-10
2011-10-31,469603,81044,388559,티모르,2011-10
2011-10-31,448323,286,448037,몰디브,2011-10
2011-10-31,435327,128561,306766,마이크로네시아,2011-10
2011-10-31,434742,2520336,-2085594,마세도니아,2011-10
2011-10-31,417686,221,417465,바베이도스,2011-10
2011-10-31,398605,398190,415,솔로몬 군도,2011-10
2011-10-31,392630,0,392630,팔라우,2011-10
2011-10-31,390716,16707,374009,북마리아나 군도,2011-10
2011-10-31,356750,1664,355086,카보 베르데,2011-10
2011-10-31,341681,634029,-292348,리히텐슈타인,2011-10
2011-10-31,336967,59,336908,말리,2011-10
2011-10-31,306198,155009,151189,바누아투,2011-10
2011-10-31,280935,0,280935,불령 가이아나,2011-10
2011-10-31,243501,15027,228474,감비아,2011-10
2011-10-31,201775,37,201738,아메리칸 사모아,2011-10
2011-10-31,198622,3043,195579,에리트리아,2011-10
2011-10-31,195843,788840,-592997,몰도바,2011-10
2011-10-31,176550,41922,134628,세인트 빈센트 그레나딘,2011-10
2011-10-31,168744,0,168744,적도 기니,2011-10
2011-10-31,156563,0,156563,그레나다,2011-10
2011-10-31,152818,0,152818,세인트 루시아,2011-10
2011-10-31,148393,4214,144179,나미비아,2011-10
2011-10-31,131514,1965,129549,르완다,2011-10
2011-10-31,126324,8063,118261,몬테네그로,2011-10
2011-10-31,123178,0,123178,지브랄타,2011-10
2011-10-31,87864,11,87853,부룬디,2011-10
2011-10-31,81334,56958,24376,도미니카,2011-10
2011-10-31,71984,0,71984,소말리아,2011-10
2011-10-31,71644,0,71644,기네비소,2011-10
2011-10-31,70099,12866,57233,안티가 바부다,2011-10
2011-10-31,34009,19571,14438,토켈라우,2011-10
2011-10-31,32137,0,32137,메요트,2011-10
2011-10-31,28023,92955,-64932,통가,2011-10
2011-10-31,20551,712717,-692166,모나코,2011-10
2011-10-31,3489,8766,-5277,상토메 프린스페,2011-10
2011-10-31,3084,0,3084,키리바티,2011-10
2011-10-31,2455,43,2412,앙귈라,2011-10
2011-10-31,1400,0,1400,남조지아 & 남샌드위치 군도,2011-10
2011-10-31,934,11904,-10970,안도라,2011-10
2011-10-31,682,0,682,영령 인도양,2011-10
2011-10-31,640,116312,-115672,영령 버진군도,2011-10
2011-10-31,514,51,463,쿡 아일랜드,2011-10
2011-10-31,403,0,403,챠드,2011-10
2011-10-31,51,0,51,세인트 마틴,2011-10
2011-10-31,0,24844,-24844,나우루,2011-10
2011-10-31,0,3782,-3782,니우에,2011-10
2011-10-31,0,78061,-78061,그린랜드,2011-10
2011-10-31,0,183,-183,투르크 & 카이코스 군도,2011-10
2011-10-31,0,25364,-25364,산마리노,2011-10
2011-10-31,0,38049,-38049,세인트 키츠 네비스,2011-10
2011-11-30,11194390060,7491389365,3703000695,중국,2011-11
2011-11-30,5401548478,3636085240,1765463238,미국,2011-11
2011-11-30,3488538645,5359717271,-1871178626,일본,2011-11
2011-11-30,2667430107,172448488,2494981619,홍콩,2011-11
2011-11-30,1832191083,677947027,1154244056,싱가포르,2011-11
2011-11-30,1423443852,1180921843,242522009,대만,2011-11
2011-11-30,1264671906,380330968,884340938,베트남,2011-11
2011-11-30,1196176711,1403810305,-207633594,인도네시아,2011-11
2011-11-30,993527958,578355043,415172915,인도,2011-11
2011-11-30,880332503,2405951349,-1525618846,호주,2011-11
2011-11-30,820234036,1444609269,-624375233,독일,2011-11
2011-11-30,750585599,1116776003,-366190404,러시아 연방,2011-11
2011-11-30,741330039,700413240,40916799,브라질,2011-11
2011-11-30,715179792,137982174,577197618,멕시코,2011-11
2011-11-30,680991009,224525683,456465326,필리핀,2011-11
2011-11-30,656971173,1151860440,-494889267,아랍에미리트 연합,2011-11
2011-11-30,621884914,1062846876,-440961962,이란,2011-11
2011-11-30,569854337,352872070,216982267,태국,2011-11
2011-11-30,542865207,2874607182,-2331741975,사우디아라비아,2011-11
2011-11-30,470592047,897592476,-427000429,말레이시아,2011-11
2011-11-30,424728500,57540358,367188142,튀르키예,2011-11
2011-11-30,400208505,566510269,-166301764,캐나다,2011-11
2011-11-30,394678792,80138722,314540070,파나마,2011-11
2011-11-30,387495939,31314991,356180948,폴란드,2011-11
2011-11-30,372691285,368697233,3994052,네덜란드,2011-11
2011-11-30,363952311,49940,363902371,라이베리아,2011-11
2011-11-30,347778818,560595694,-212816876,영국,2011-11
2011-11-30,326234538,390275244,-64040706,이탈리아,2011-11
2011-11-30,321526515,130486,321396029,마샬군도,2011-11
2011-11-30,313766762,12035511,301731251,슬로바키아,2011-11
2011-11-30,260277083,44375,260232708,바하마,2011-11
2011-11-30,245867086,799506793,-553639707,이라크,2011-11
2011-11-30,228091397,421582247,-193490850,칠레,2011-11
2011-11-30,207141911,196365326,10776585,남아프리카공화국,2011-11
2011-11-30,187332991,616025532,-428692541,프랑스,2011-11
2011-11-30,177302564,58237602,119064962,이집트,2011-11
2011-11-30,171069915,49423025,121646890,체코공화국,2011-11
2011-11-30,168008367,129246644,38761723,벨기에,2011-11
2011-11-30,155817560,141310055,14507505,스페인,2011-11
2011-11-30,134045523,1580010,132465513,요르단,2011-11
2011-11-30,131457043,48760679,82696364,이스라엘,2011-11
2011-11-30,130798400,18910314,111888086,우즈베키스탄,2011-11
2011-11-30,125696707,34396732,91299975,방글라데시,2011-11
2011-11-30,119302865,18090149,101212716,콜롬비아,2011-11
2011-11-30,106497973,10040541,96457432,그리스,2011-11
2011-11-30,104590363,46044119,58546244,헝가리,2011-11
2011-11-30,102735803,121037538,-18301735,페루,2011-11
2011-11-30,102464990,107083820,-4618830,뉴질랜드,2011-11
2011-11-30,102203962,0,102203962,맨섬,2011-11
2011-11-30,100899988,11222082,89677906,슬로베니아,2011-11
2011-11-30,99928756,1135324852,-1035396096,쿠웨이트,2011-11
2011-11-30,99784580,386305105,-286520525,오만,2011-11
2011-11-30,99543692,11477,99532215,알제리,2011-11
2011-11-30,91646917,62429959,29216958,아르헨티나,2011-11
2011-11-30,91340927,105781141,-14440214,오스트리아,2011-11
2011-11-30,78803186,106735061,-27931875,나이지리아,2011-11
2011-11-30,78772909,87611188,-8838279,우크라이나,2011-11
2011-11-30,76129931,26424154,49705777,카자흐스탄,2011-11
2011-11-30,73618333,3336479,70281854,에쿠아도르,2011-11
2011-11-30,72702529,159626060,-86923531,스웨덴,2011-11
2011-11-30,71650722,71396594,254128,핀란드,2011-11
2011-11-30,67178444,13057115,54121329,몰타,2011-11
2011-11-30,64045448,0,64045448,버뮤다,2011-11
2011-11-30,63061791,111556,62950235,시리아,2011-11
2011-11-30,62061973,57930782,4131191,파키스탄,2011-11
2011-11-30,55072637,233643644,-178571007,스위스,2011-11
2011-11-30,54499962,27599474,26900488,미얀마,2011-11
2011-11-30,48102555,7220750,40881805,캄보디아,2011-11
2011-11-30,41444093,1388015814,-1346571721,카타르,2011-11
2011-11-30,39907520,0,39907520,불령 폴리네시아,2011-11
2011-11-30,37110251,59900444,-22790193,덴마크,2011-11
2011-11-30,36415290,45319623,-8904333,루마니아,2011-11
2011-11-30,35052208,6640501,28411707,스리랑카,2011-11
2011-11-30,33175231,55,33175176,아제르바이잔,2011-11
2011-11-30,31917341,6741885,25175456,베네주엘라,2011-11
2011-11-30,31640728,17317634,14323094,코스타리카,2011-11
2011-11-30,29578735,1901392,27677343,레바논,2011-11
2011-11-30,29146089,3377327,25768762,가나,2011-11
2011-11-30,28559356,9073,28550283,앙골라,2011-11
2011-11-30,27387766,285518,27102248,파라과이,2011-11
2011-11-30,25554710,7037650,18517060,포루투갈,2011-11
2011-11-30,24669631,3037789,21631842,몽골,2011-11
2011-11-30,22982499,2505707,20476792,튀니지,2011-11
2011-11-30,22625829,1629803,20996026,케냐,2011-11
2011-11-30,22290932,476517,21814415,리비아,2011-11
2011-11-30,21548925,3139026,18409899,과테말라,2011-11
2011-11-30,19491875,13860429,5631446,모로코,2011-11
2011-11-30,18664320,183904628,-165240308,노르웨이,2011-11
2011-11-30,18630562,13442404,5188158,불가리아,2011-11
2011-11-30,18346812,15493216,2853596,바레인,2011-11
2011-11-30,16764457,21377541,-4613084,푸에르토리코,2011-11
2011-11-30,15487584,1512974,13974610,니카라과,2011-11
2011-11-30,15305385,8287085,7018300,우루과이,2011-11
2011-11-30,14939909,1616,14938293,아프카니스탄,2011-11
2011-11-30,14194986,6826472,7368514,도미니카 공화국,2011-11
2011-11-30,14146226,29366083,-15219857,파푸아 뉴기니,2011-11
2011-11-30,13668597,437201,13231396,라오스,2011-11
2011-11-30,13317038,63393551,-50076513,아일랜드,2011-11
2011-11-30,11963336,101949,11861387,키르기스스탄,2011-11
2011-11-30,11465462,3175870,8289592,온두라스,2011-11
2011-11-30,10939100,243,10938857,투르크멘,2011-11
2011-11-30,10902642,2875728,8026914,수단,2011-11
2011-11-30,9564534,3631345,5933189,에스토니아,2011-11
2011-11-30,9336773,2737603,6599170,리투아니아,2011-11
2011-11-30,9124663,1490406,7634257,엘살바도르,2011-11
2011-11-30,8939930,3191512,5748418,라트비아,2011-11
2011-11-30,8852789,2584926,6267863,세네갈,2011-11
2011-11-30,8767948,486438,8281510,카메룬,2011-11
2011-11-30,8695664,85153982,-76458318,브루나이,2011-11
2011-11-30,8692751,73752248,-65059497,트리니다드 토바고,2011-11
2011-11-30,8219453,4794354,3425099,조지아,2011-11
2011-11-30,8139764,59696,8080068,쿠바,2011-11
2011-11-30,7400906,442032,6958874,코트디봐르,2011-11
2011-11-30,7391700,6387055,1004645,세르비아,2011-11
2011-11-30,6641408,87717670,-81076262,예맨,2011-11
2011-11-30,6526773,154545,6372228,탄자니아,2011-11
2011-11-30,6369835,601380,5768455,모리셔스,2011-11
2011-11-30,6291292,487976,5803316,벨라루스,2011-11
2011-11-30,5954809,17056920,-11102111,뉴 칼레도니아,2011-11
2011-11-30,5824180,2217544,3606636,크로아티아,2011-11
2011-11-30,5651261,1121415,4529846,마카오,2011-11
2011-11-30,5571082,6169,5564913,지부티,2011-11
2011-11-30,4786796,1447705,3339091,에티오피아,2011-11
2011-11-30,4082816,560265,3522551,괌,2011-11
2011-11-30,3923723,1923210,2000513,베닝,2011-11
2011-11-30,3802692,59132509,-55329817,사이프러스,2011-11
2011-11-30,3537816,177384,3360432,짐바브웨,2011-11
2011-11-30,3050118,35565,3014553,모잠비크,2011-11
2011-11-30,3044159,762076,2282083,기니,2011-11
2011-11-30,2958652,8689875,-5731223,가봉,2011-11
2011-11-30,2905607,13536421,-10630814,콩고민주공화국,2011-11
2011-11-30,2761633,26810,2734823,시에라 리온,2011-11
2011-11-30,2669336,46101,2623235,수리남,2011-11
2011-11-30,2607618,374274,2233344,우간다,2011-11
2011-11-30,2602806,49083,2553723,알바니아,2011-11
2011-11-30,2578614,4812840,-2234226,기타국,2011-11
2011-11-30,2518872,19127878,-16609006,볼리비아,2011-11
2011-11-30,2508500,0,2508500,토고,2011-11
2011-11-30,2394690,2419494,-24804,룩셈부르그,2011-11
2011-11-30,2338309,36180282,-33841973,잠비아,2011-11
2011-11-30,2315102,1988830,326272,아이슬란드,2011-11
2011-11-30,2313808,143701,2170107,아루바,2011-11
2011-11-30,2214842,45361,2169481,세이쉘,2011-11
2011-11-30,2145108,440060,1705048,타지크,2011-11
2011-11-30,2141362,2908077,-766715,콩고,2011-11
2011-11-30,2109900,67919,2041981,네덜란드 열도,2011-11
2011-11-30,2091387,76337,2015050,마다카스카르,2011-11
2011-11-30,1895694,99995,1795699,가이아나,2011-11
2011-11-30,1821678,0,1821678,불령 리유니온 코모도 제도,2011-11
2011-11-30,1691576,0,1691576,모리타니,2011-11
2011-11-30,1665765,729304,936461,자마이카,2011-11
2011-11-30,1576363,0,1576363,부르키나 파소,2011-11
2011-11-30,1524778,2341,1522437,몬테네그로,2011-11
2011-11-30,1341602,236883,1104719,아르메니아,2011-11
2011-11-30,1319895,138831,1181064,아이티,2011-11
2011-11-30,1252889,151,1252738,과델로프,2011-11
2011-11-30,1213803,228294,985509,티모르,2011-11
2011-11-30,1176672,63010,1113662,네팔,2011-11
2011-11-30,1172379,2126447,-954068,피지,2011-11
2011-11-30,1130967,0,1130967,마티니크,2011-11
2011-11-30,1094539,662,1093877,르완다,2011-11
2011-11-30,1052691,187721,864970,팔레스타인 해방기구,2011-11
2011-11-30,1022922,12494,1010428,마이크로네시아,2011-11
2011-11-30,940734,742228,198506,몰도바,2011-11
2011-11-30,908002,66679,841323,보츠와나,2011-11
2011-11-30,795295,0,795295,도미니카,2011-11
2011-11-30,768852,0,768852,부탄,2011-11
2011-11-30,741451,695,740756,말라위,2011-11
2011-11-30,673942,180697,493245,사모아,2011-11
2011-11-30,579293,122005,457288,벨리제,2011-11
2011-11-30,579030,497447,81583,보스니아-헤르체고비나,2011-11
2011-11-30,490093,12298,477795,세인트 루시아,2011-11
2011-11-30,489736,19,489717,북마리아나 군도,2011-11
2011-11-30,472303,2335161,-1862858,마세도니아,2011-11
2011-11-30,455116,0,455116,안티가 바부다,2011-11
2011-11-30,450909,8387,442522,레소토,2011-11
2011-11-30,428292,2158432,-1730140,나미비아,2011-11
2011-11-30,419275,30045,389230,말리,2011-11
2011-11-30,391148,0,391148,에리트리아,2011-11
2011-11-30,360561,0,360561,불령 가이아나,2011-11
2011-11-30,350124,269161,80963,스와질랜드,2011-11
2011-11-30,345416,60090,285326,바베이도스,2011-11
2011-11-30,330315,593517,-263202,리히텐슈타인,2011-11
2011-11-30,228398,302593,-74195,모나코,2011-11
2011-11-30,217483,0,217483,키리바티,2011-11
2011-11-30,214013,3872,210141,몰디브,2011-11
2011-11-30,208498,0,208498,영령 캐이맨 군도,2011-11
2011-11-30,192140,25500,166640,팔라우,2011-11
2011-11-30,166024,163142,2882,바누아투,2011-11
2011-11-30,159562,21066,138496,안도라,2011-11
2011-11-30,155593,64050,91543,감비아,2011-11
2011-11-30,149701,0,149701,그레나다,2011-11
2011-11-30,145878,6433,139445,투르크 & 카이코스 군도,2011-11
2011-11-30,143703,2490,141213,니제르,2011-11
2011-11-30,138968,0,138968,소말리아,2011-11
2011-11-30,128002,428,127574,아메리칸 사모아,2011-11
2011-11-30,102007,0,102007,쿡 아일랜드,2011-11
2011-11-30,73846,0,73846,부룬디,2011-11
2011-11-30,67452,1257732,-1190280,솔로몬 군도,2011-11
2011-11-30,50697,8730,41967,산마리노,2011-11
2011-11-30,48731,0,48731,투발루,2011-11
2011-11-30,27014,3000,24014,카보 베르데,2011-11
2011-11-30,21223,0,21223,적도 기니,2011-11
2011-11-30,20983,38144,-17161,세인트 빈센트 그레나딘,2011-11
2011-11-30,18566,405042,-386476,통가,2011-11
2011-11-30,17445,0,17445,세인트 키츠 네비스,2011-11
2011-11-30,14724,0,14724,남수단,2011-11
2011-11-30,7650,1831,5819,지브랄타,2011-11
2011-11-30,5493,0,5493,챠드,2011-11
2011-11-30,982,4218871,-4217889,나우루,2011-11
2011-11-30,24,590272,-590248,영령 버진군도,2011-11
2011-11-30,0,35703,-35703,몬트세라트,2011-11
2011-11-30,0,47,-47,마이너 아우틀링 합중국 군도,2011-11
2011-11-30,0,59796,-59796,토켈라우,2011-11
2011-11-30,0,3092,-3092,니우에,2011-11
2011-11-30,0,2414,-2414,교황청,2011-11
2011-11-30,0,818,-818,남조지아 & 남샌드위치 군도,2011-11
2011-11-30,0,111,-111,안타티카,2011-11
2011-11-30,0,137837,-137837,그린랜드,2011-11
2011-11-30,0,1449,-1449,세인트 헬레나,2011-11
2011-12-31,11684611820,6848639070,4835972750,중국,2011-12
2011-12-31,4600334466,3655449691,944884775,미국,2011-12
2011-12-31,3719723337,5873652407,-2153929070,일본,2011-12
2011-12-31,2466363303,163048117,2303315186,홍콩,2011-12
2011-12-31,1833165741,768177783,1064987958,싱가포르,2011-12
2011-12-31,1357511960,1114240110,243271850,대만,2011-12
2011-12-31,1317295005,366571587,950723418,베트남,2011-12
2011-12-31,1314348031,2444979763,-1130631732,호주,2011-12
2011-12-31,1286130360,1580250990,-294120630,인도네시아,2011-12
2011-12-31,1077511452,566095308,511416144,인도,2011-12
2011-12-31,1056030218,1365232221,-309202003,독일,2011-12
2011-12-31,1041092524,3349965,1037742559,파나마,2011-12
2011-12-31,824307708,968237448,-143929740,러시아 연방,2011-12
2011-12-31,703213858,3362568974,-2659355116,사우디아라비아,2011-12
2011-12-31,693478167,196656116,496822051,스위스,2011-12
2011-12-31,686703076,544325186,142377890,브라질,2011-12
2011-12-31,685267918,336320449,348947469,태국,2011-12
2011-12-31,658814409,1079251871,-420437462,아랍에미리트 연합,2011-12
2011-12-31,632307008,262382843,369924165,필리핀,2011-12
2011-12-31,603181908,137370794,465811114,멕시코,2011-12
2011-12-31,574726665,714239744,-139513079,이란,2011-12
2011-12-31,497149923,1025746007,-528596084,말레이시아,2011-12
2011-12-31,357859701,478425645,-120565944,캐나다,2011-12
2011-12-31,343494833,48216897,295277936,폴란드,2011-12
2011-12-31,338054966,45706794,292348172,튀르키예,2011-12
2011-12-31,337141574,261254,336880320,라이베리아,2011-12
2011-12-31,335844358,12351063,323493295,슬로바키아,2011-12
2011-12-31,327829927,1053996298,-726166371,이라크,2011-12
2011-12-31,320831616,290137631,30693985,영국,2011-12
2011-12-31,291924201,437611671,-145687470,이탈리아,2011-12
2011-12-31,280951327,564627401,-283676074,네덜란드,2011-12
2011-12-31,280374490,58566912,221807578,마샬군도,2011-12
2011-12-31,244258753,296479455,-52220702,남아프리카공화국,2011-12
2011-12-31,208354296,152739918,55614378,벨기에,2011-12
2011-12-31,204678851,14453184,190225667,방글라데시,2011-12
2011-12-31,199164310,277197172,-78032862,칠레,2011-12
2011-12-31,177206987,374831016,-197624029,프랑스,2011-12
2011-12-31,171266725,47813931,123452794,체코공화국,2011-12
2011-12-31,170497130,134079695,36417435,이집트,2011-12
2011-12-31,148365311,2161689,146203622,우즈베키스탄,2011-12
2011-12-31,144382683,80993563,63389120,스페인,2011-12
2011-12-31,144207242,5791322,138415920,몰타,2011-12
2011-12-31,134793544,15368517,119425027,콜롬비아,2011-12
2011-12-31,134426426,3069817,131356609,요르단,2011-12
2011-12-31,120613601,12278917,108334684,슬로베니아,2011-12
2011-12-31,116486475,73052596,43433879,페루,2011-12
2011-12-31,111382199,54232993,57149206,이스라엘,2011-12
2011-12-31,108690650,1910526350,-1801835700,쿠웨이트,2011-12
2011-12-31,105535984,648302,104887682,알제리,2011-12
2011-12-31,97425344,126964746,-29539402,우크라이나,2011-12
2011-12-31,89319978,206,89319772,중앙아프리카공화국,2011-12
2011-12-31,89229189,2963779,86265410,그리스,2011-12
2011-12-31,87560731,56301478,31259253,헝가리,2011-12
2011-12-31,84162972,106754503,-22591531,아르헨티나,2011-12
2011-12-31,82902672,5360956,77541716,베네주엘라,2011-12
2011-12-31,82818816,486669492,-403850676,오만,2011-12
2011-12-31,78960141,244487,78715654,시리아,2011-12
2011-12-31,76903867,3408019,73495848,에쿠아도르,2011-12
2011-12-31,75360723,152364166,-77003443,노르웨이,2011-12
2011-12-31,75083324,224135911,-149052587,나이지리아,2011-12
2011-12-31,73238976,61553703,11685273,파키스탄,2011-12
2011-12-31,72992852,124405383,-51412531,뉴질랜드,2011-12
2011-12-31,72651061,2414802652,-2342151591,카타르,2011-12
2011-12-31,70375821,35784620,34591201,카자흐스탄,2011-12
2011-12-31,67540978,102511977,-34970999,오스트리아,2011-12
2011-12-31,65702426,91729320,-26026894,핀란드,2011-12
2011-12-31,60189448,156738139,-96548691,스웨덴,2011-12
2011-12-31,58962544,23708722,35253822,미얀마,2011-12
2011-12-31,56721289,23983321,32737968,코스타리카,2011-12
2011-12-31,52862234,4433478,48428756,모로코,2011-12
2011-12-31,46834518,8357490,38477028,캄보디아,2011-12
2011-12-31,44633065,61261787,-16628722,아일랜드,2011-12
2011-12-31,42676379,17210,42659169,불령 폴리네시아,2011-12
2011-12-31,34612712,36752983,-2140271,루마니아,2011-12
2011-12-31,34219579,59635593,-25416014,덴마크,2011-12
2011-12-31,33908429,5930887,27977542,스리랑카,2011-12
2011-12-31,28477737,3601,28474136,아프카니스탄,2011-12
2011-12-31,28318400,50051244,-21732844,바레인,2011-12
2011-12-31,27552570,3788390,23764180,과테말라,2011-12
2011-12-31,27491973,3636414,23855559,가나,2011-12
2011-12-31,26822162,3000648,23821514,몽골,2011-12
2011-12-31,26432347,1252258,25180089,레바논,2011-12
2011-12-31,22684270,87,22684183,아제르바이잔,2011-12
2011-12-31,20871721,3764498,17107223,튀니지,2011-12
2011-12-31,20444399,210391300,-189946901,리비아,2011-12
2011-12-31,18387902,1237312,17150590,케냐,2011-12
2011-12-31,18013107,4640508,13372599,도미니카 공화국,2011-12
2011-12-31,17881052,25276400,-7395348,파라과이,2011-12
2011-12-31,17516682,18941893,-1425211,우루과이,2011-12
2011-12-31,16866484,3489048,13377436,불가리아,2011-12
2011-12-31,16515724,9320683,7195041,포루투갈,2011-12
2011-12-31,16349075,3759368,12589707,수단,2011-12
2011-12-31,15410044,53830,15356214,시에라 리온,2011-12
2011-12-31,15125291,344486051,-329360760,브루나이,2011-12
2011-12-31,15016279,977652,14038627,앙골라,2011-12
2011-12-31,14932327,1444354,13487973,니카라과,2011-12
2011-12-31,13837224,111087,13726137,키르기스스탄,2011-12
2011-12-31,13499312,24587468,-11088156,푸에르토리코,2011-12
2011-12-31,13453843,54094702,-40640859,파푸아 뉴기니,2011-12
2011-12-31,13208588,489792,12718796,라오스,2011-12
2011-12-31,11253470,0,11253470,키리바티,2011-12
2011-12-31,11113243,17579462,-6466219,에스토니아,2011-12
2011-12-31,10259650,178487,10081163,코트디봐르,2011-12
2011-12-31,10057916,6814,10051102,아이티,2011-12
2011-12-31,9975819,1577001,8398818,엘살바도르,2011-12
2011-12-31,9684981,8614321,1070660,온두라스,2011-12
2011-12-31,9438503,116,9438387,투르크멘,2011-12
2011-12-31,9438146,890335,8547811,에티오피아,2011-12
2011-12-31,9187066,85659987,-76472921,예맨,2011-12
2011-12-31,9129123,22091035,-12961912,뉴 칼레도니아,2011-12
2011-12-31,9050199,2110543,6939656,리투아니아,2011-12
2011-12-31,8917139,1267556,7649583,크로아티아,2011-12
2011-12-31,8537722,539948,7997774,카메룬,2011-12
2011-12-31,8488676,2651986,5836690,조지아,2011-12
2011-12-31,8140685,2179985,5960700,라트비아,2011-12
2011-12-31,7053156,13945844,-6892688,탄자니아,2011-12
2011-12-31,5994133,178097617,-172103484,트리니다드 토바고,2011-12
2011-12-31,5911737,8609958,-2698221,세르비아,2011-12
2011-12-31,5845110,1253904,4591206,기니,2011-12
2011-12-31,5379912,0,5379912,지부티,2011-12
2011-12-31,5185866,0,5185866,적도 기니,2011-12
2011-12-31,5104146,49634,5054512,네팔,2011-12
2011-12-31,4682354,30836763,-26154409,잠비아,2011-12
2011-12-31,4657265,1124417,3532848,세네갈,2011-12
2011-12-31,4401695,206718,4194977,쿠바,2011-12
2011-12-31,4175616,167557,4008059,모리셔스,2011-12
2011-12-31,4077545,95927,3981618,가이아나,2011-12
2011-12-31,3977661,1793283,2184378,콩고,2011-12
2011-12-31,3962320,1631809,2330511,베닝,2011-12
2011-12-31,3847130,63779,3783351,팔레스타인 해방기구,2011-12
2011-12-31,3681023,615389,3065634,벨라루스,2011-12
2011-12-31,3662390,960660,2701730,마카오,2011-12
2011-12-31,2934109,0,2934109,모잠비크,2011-12
2011-12-31,2860026,50962853,-48102827,사이프러스,2011-12
2011-12-31,2762563,892613,1869950,우간다,2011-12
2011-12-31,2750424,100,2750324,토고,2011-12
2011-12-31,2633723,8786430,-6152707,가봉,2011-12
2011-12-31,2506178,1503051,1003127,짐바브웨,2011-12
2011-12-31,2476126,0,2476126,타지크,2011-12
2011-12-31,2473332,57892,2415440,아르메니아,2011-12
2011-12-31,2416402,49239,2367163,아루바,2011-12
2011-12-31,2248344,64797,2183547,말라위,2011-12
2011-12-31,2189747,164019,2025728,마다카스카르,2011-12
2011-12-31,2120689,1684765,435924,피지,2011-12
2011-12-31,2102739,189433,1913306,괌,2011-12
2011-12-31,1980510,10869369,-8888859,콩고민주공화국,2011-12
2011-12-31,1972851,18473,1954378,바하마,2011-12
2011-12-31,1852721,2900360,-1047639,룩셈부르그,2011-12
2011-12-31,1807471,18576,1788895,네덜란드 열도,2011-12
2011-12-31,1801865,258213,1543652,보스니아-헤르체고비나,2011-12
2011-12-31,1770676,30092,1740584,세이쉘,2011-12
2011-12-31,1710634,31700,1678934,몰디브,2011-12
2011-12-31,1699279,1056934,642345,모리타니,2011-12
2011-12-31,1622726,0,1622726,마티니크,2011-12
2011-12-31,1568823,495910,1072913,자마이카,2011-12
2011-12-31,1487159,95103,1392056,수리남,2011-12
2011-12-31,1425054,9382,1415672,알바니아,2011-12
2011-12-31,1266755,9363,1257392,부르키나 파소,2011-12
2011-12-31,1224807,2995561,-1770754,아이슬란드,2011-12
2011-12-31,1217310,22738236,-21520926,볼리비아,2011-12
2011-12-31,1217253,0,1217253,불령 리유니온 코모도 제도,2011-12
2011-12-31,1121943,0,1121943,부탄,2011-12
2011-12-31,1116224,81773,1034451,마이크로네시아,2011-12
2011-12-31,1053245,79352,973893,보츠와나,2011-12
2011-12-31,881020,570296,310724,르완다,2011-12
2011-12-31,832820,14070,818750,티모르,2011-12
2011-12-31,829030,6368813,-5539783,기타국,2011-12
2011-12-31,772899,5765,767134,바베이도스,2011-12
2011-12-31,759178,40915,718263,말리,2011-12
2011-12-31,737824,0,737824,과델로프,2011-12
2011-12-31,662770,45528,617242,영령 캐이맨 군도,2011-12
2011-12-31,591042,0,591042,안도라,2011-12
2011-12-31,553488,120,553368,북마리아나 군도,2011-12
2011-12-31,526184,492434,33750,몰도바,2011-12
2011-12-31,513759,214340,299419,바누아투,2011-12
2011-12-31,494589,302514,192075,사모아,2011-12
2011-12-31,438559,442,438117,버뮤다,2011-12
2011-12-31,416801,8065476,-7648675,마세도니아,2011-12
2011-12-31,378966,963835,-584869,스와질랜드,2011-12
2011-12-31,365696,1307727,-942031,리히텐슈타인,2011-12
2011-12-31,354085,661915,-307830,나미비아,2011-12
2011-12-31,281877,259077,22800,벨리제,2011-12
2011-12-31,259539,238,259301,세인트 루시아,2011-12
2011-12-31,247350,0,247350,감비아,2011-12
2011-12-31,240604,271836,-31232,솔로몬 군도,2011-12
2011-12-31,186518,71,186447,팔라우,2011-12
2011-12-31,155240,2397009,-2241769,안티가 바부다,2011-12
2011-12-31,138285,0,138285,미령 버진군도,2011-12
2011-12-31,128673,27069,101604,영령 버진군도,2011-12
2011-12-31,127321,0,127321,그레나다,2011-12
2011-12-31,126504,0,126504,불령 가이아나,2011-12
2011-12-31,108087,51,108036,니제르,2011-12
2011-12-31,102041,30290,71751,아메리칸 사모아,2011-12
2011-12-31,91798,0,91798,지브랄타,2011-12
2011-12-31,91600,1090,90510,몬테네그로,2011-12
2011-12-31,90266,0,90266,카보 베르데,2011-12
2011-12-31,83099,23853,59246,산마리노,2011-12
2011-12-31,73820,0,73820,세인트 키츠 네비스,2011-12
2011-12-31,71754,0,71754,메요트,2011-12
2011-12-31,69540,0,69540,에리트리아,2011-12
2011-12-31,67032,403354,-336322,모나코,2011-12
2011-12-31,66309,10625,55684,도미니카,2011-12
2011-12-31,54112,1129935,-1075823,통가,2011-12
2011-12-31,46589,0,46589,상토메 프린스페,2011-12
2011-12-31,40070,0,40070,불령 남부지역,2011-12
2011-12-31,29417,36,29381,쿡 아일랜드,2011-12
2011-12-31,27678,0,27678,기네비소,2011-12
2011-12-31,23895,0,23895,챠드,2011-12
2011-12-31,22378,19989,2389,세인트 빈센트 그레나딘,2011-12
2011-12-31,20111,70,20041,코모로스,2011-12
2011-12-31,19393,0,19393,부룬디,2011-12
2011-12-31,6810,0,6810,투르크 & 카이코스 군도,2011-12
2011-12-31,4694,0,4694,세인트 헬레나,2011-12
2011-12-31,4400,217,4183,몬트세라트,2011-12
2011-12-31,680,0,680,세인트 마틴,2011-12
2011-12-31,500,119075,-118575,그린랜드,2011-12
2011-12-31,0,5851473,-5851473,나우루,2011-12
2011-12-31,0,11203,-11203,레소토,2011-12
2011-12-31,0,30250,-30250,토켈라우,2011-12
2011-12-31,0,2497,-2497,니우에,2011-12
2011-12-31,0,2964,-2964,코스 군도,2011-12
2011-12-31,0,190,-190,마이너 아우틀링 합중국 군도,2011-12
2011-12-31,0,50,-50,영령 인도양,2011-12
2012-01-31,9793924454,6834749422,2959175032,중국,2012-01
2012-01-31,4123411437,3694734104,428677333,미국,2012-01
2012-01-31,3270842174,5243684814,-1972842640,일본,2012-01
2012-01-31,2540872940,132704327,2408168613,홍콩,2012-01
2012-01-31,1406383272,776789987,629593285,싱가포르,2012-01
2012-01-31,1220001296,1270136166,-50134870,인도네시아,2012-01
2012-01-31,1213911160,1196067899,17843261,대만,2012-01
2012-01-31,1061188915,453440592,607748323,베트남,2012-01
2012-01-31,971667951,551228735,420439216,인도,2012-01
2012-01-31,734644913,4268316,730376597,파나마,2012-01
2012-01-31,716561638,996811697,-280250059,러시아 연방,2012-01
2012-01-31,655344047,290423467,364920580,필리핀,2012-01
2012-01-31,652143165,202996718,449146447,멕시코,2012-01
2012-01-31,639417931,690158449,-50740518,브라질,2012-01
2012-01-31,637788967,2231193548,-1593404581,호주,2012-01
2012-01-31,582002716,3445914752,-2863912036,사우디아라비아,2012-01
2012-01-31,581941190,1373048165,-791106975,독일,2012-01
2012-01-31,573541019,887564856,-314023837,말레이시아,2012-01
2012-01-31,565234355,978902383,-413668028,이란,2012-01
2012-01-31,543495561,367312970,176182591,태국,2012-01
2012-01-31,521311625,1624878613,-1103566988,아랍에미리트 연합,2012-01
2012-01-31,496045648,1713,496043935,마샬군도,2012-01
2012-01-31,412771668,6843180,405928488,몰타,2012-01
2012-01-31,329718337,43532893,286185444,폴란드,2012-01
2012-01-31,320639410,630401988,-309762578,이라크,2012-01
2012-01-31,316413885,73860411,242553474,튀르키예,2012-01
2012-01-31,310022183,290639608,19382575,영국,2012-01
2012-01-31,309442152,361268730,-51826578,이탈리아,2012-01
2012-01-31,303497556,525415350,-221917794,캐나다,2012-01
2012-01-31,298918232,11694862,287223370,슬로바키아,2012-01
2012-01-31,267510823,175372,267335451,바하마,2012-01
2012-01-31,235923947,300388898,-64464951,남아프리카공화국,2012-01
2012-01-31,225433375,3193497,222239878,그리스,2012-01
2012-01-31,220270070,1594,220268476,라이베리아,2012-01
2012-01-31,210788808,91808832,118979976,스페인,2012-01
2012-01-31,201196232,441429535,-240233303,네덜란드,2012-01
2012-01-31,178104595,428066840,-249962245,칠레,2012-01
2012-01-31,176482542,364027394,-187544852,프랑스,2012-01
2012-01-31,173634320,103076181,70558139,벨기에,2012-01
2012-01-31,170048993,92251047,77797946,이스라엘,2012-01
2012-01-31,168714574,1684985417,-1516270843,쿠웨이트,2012-01
2012-01-31,151014073,38702643,112311430,체코공화국,2012-01
2012-01-31,129413085,148589668,-19176583,이집트,2012-01
2012-01-31,122471898,18500167,103971731,콜롬비아,2012-01
2012-01-31,114555408,4621319,109934089,요르단,2012-01
2012-01-31,96658629,110968009,-14309380,뉴질랜드,2012-01
2012-01-31,96317720,149796042,-53478322,페루,2012-01
2012-01-31,93228245,7348001,85880244,슬로베니아,2012-01
2012-01-31,91560357,80204804,11355553,아르헨티나,2012-01
2012-01-31,89056196,53550727,35505469,헝가리,2012-01
2012-01-31,83650842,7555356,76095486,우즈베키스탄,2012-01
2012-01-31,80041188,169806360,-89765172,노르웨이,2012-01
2012-01-31,73705348,13464253,60241095,방글라데시,2012-01
2012-01-31,67108494,29828986,37279508,우크라이나,2012-01
2012-01-31,66383219,57775510,8607709,나이지리아,2012-01
2012-01-31,60422800,2970936,57451864,에쿠아도르,2012-01
2012-01-31,60349984,51991,60297993,알제리,2012-01
2012-01-31,58568228,100666281,-42098053,오스트리아,2012-01
2012-01-31,58316548,336431455,-278114907,오만,2012-01
2012-01-31,58211916,77679898,-19467982,파키스탄,2012-01
2012-01-31,56561096,145930048,-89368952,스웨덴,2012-01
2012-01-31,54553981,25785737,28768244,카자흐스탄,2012-01
2012-01-31,51144814,66824480,-15679666,핀란드,2012-01
2012-01-31,46831715,251371,46580344,시리아,2012-01
2012-01-31,39426466,5424726,34001740,스리랑카,2012-01
2012-01-31,37423007,25683856,11739151,코스타리카,2012-01
2012-01-31,36374774,26504395,9870379,미얀마,2012-01
2012-01-31,35373206,153425532,-118052326,사이프러스,2012-01
2012-01-31,35083021,10622135,24460886,캄보디아,2012-01
2012-01-31,33514114,18128463,15385651,모로코,2012-01
2012-01-31,32203535,85674476,-53470941,바레인,2012-01
2012-01-31,32099741,2741143,29358598,베네주엘라,2012-01
2012-01-31,29536123,53852675,-24316552,루마니아,2012-01
2012-01-31,28140643,534155,27606488,앙골라,2012-01
2012-01-31,28045372,1201,28044171,아제르바이잔,2012-01
2012-01-31,26442661,43064714,-16622053,파라과이,2012-01
2012-01-31,25696898,50495017,-24798119,덴마크,2012-01
2012-01-31,25215316,4916,25210400,리비아,2012-01
2012-01-31,25190786,29290837,-4100051,과테말라,2012-01
2012-01-31,24694744,1856168538,-1831473794,카타르,2012-01
2012-01-31,23414761,1297564,22117197,레바논,2012-01
2012-01-31,22605959,4639990,17965969,몽골,2012-01
2012-01-31,21053337,2191861,18861476,가나,2012-01
2012-01-31,20458067,223027910,-202569843,스위스,2012-01
2012-01-31,18698052,9558802,9139250,포루투갈,2012-01
2012-01-31,16386456,67827344,-51440888,아일랜드,2012-01
2012-01-31,16065621,1624606,14441015,케냐,2012-01
2012-01-31,15869214,242124,15627090,라오스,2012-01
2012-01-31,15035148,68,15035080,투르크멘,2012-01
2012-01-31,14792183,21961556,-7169373,푸에르토리코,2012-01
2012-01-31,12840522,1261384,11579138,니카라과,2012-01
2012-01-31,12629518,0,12629518,지부티,2012-01
2012-01-31,12356495,10143742,2212753,도미니카 공화국,2012-01
2012-01-31,11345605,182,11345423,코트디봐르,2012-01
2012-01-31,11273219,2671774,8601445,우루과이,2012-01
2012-01-31,10717034,4159747,6557287,온두라스,2012-01
2012-01-31,10545510,2719,10542791,키르기스스탄,2012-01
2012-01-31,10465313,3033402,7431911,튀니지,2012-01
2012-01-31,9388514,11661579,-2273065,파푸아 뉴기니,2012-01
2012-01-31,9210233,6021562,3188671,에스토니아,2012-01
2012-01-31,8886467,3023855,5862612,리투아니아,2012-01
2012-01-31,8763259,2724397,6038862,수단,2012-01
2012-01-31,8664720,41672559,-33007839,브루나이,2012-01
2012-01-31,8436320,2560303,5876017,라트비아,2012-01
2012-01-31,7995772,14508062,-6512290,불가리아,2012-01
2012-01-31,7386052,2376381,5009671,조지아,2012-01
2012-01-31,7253446,1238426,6015020,알바니아,2012-01
2012-01-31,7108758,2038888,5069870,엘살바도르,2012-01
2012-01-31,6726005,97125468,-90399463,트리니다드 토바고,2012-01
2012-01-31,6541501,1831405,4710096,크로아티아,2012-01
2012-01-31,6383811,2500037,3883774,탄자니아,2012-01
2012-01-31,6382837,771483,5611354,기니,2012-01
2012-01-31,6220366,1456781,4763585,카메룬,2012-01
2012-01-31,5585300,4379091,1206209,뉴 칼레도니아,2012-01
2012-01-31,5462062,66137688,-60675626,예맨,2012-01
2012-01-31,5097416,1949077,3148339,에티오피아,2012-01
2012-01-31,5009386,717542,4291844,콩고,2012-01
2012-01-31,4852422,23470353,-18617931,세르비아,2012-01
2012-01-31,4834864,899777,3935087,모리셔스,2012-01
2012-01-31,4224580,308206,3916374,모잠비크,2012-01
2012-01-31,4174348,2768584,1405764,콩고민주공화국,2012-01
2012-01-31,4062502,169179,3893323,가이아나,2012-01
2012-01-31,3684098,819176,2864922,벨라루스,2012-01
2012-01-31,3395907,889028,2506879,마카오,2012-01
2012-01-31,3265173,25858466,-22593293,잠비아,2012-01
2012-01-31,3191475,949979,2241496,세네갈,2012-01
2012-01-31,3166003,364951,2801052,괌,2012-01
2012-01-31,3141951,7597,3134354,아프카니스탄,2012-01
2012-01-31,2938737,66794,2871943,아이티,2012-01
2012-01-31,2886495,13783879,-10897384,볼리비아,2012-01
2012-01-31,2481673,72017,2409656,팔레스타인 해방기구,2012-01
2012-01-31,2173068,259967,1913101,짐바브웨,2012-01
2012-01-31,2074902,151571,1923331,쿠바,2012-01
2012-01-31,1999565,0,1999565,토고,2012-01
2012-01-31,1997171,1487762,509409,타지크,2012-01
2012-01-31,1923418,820381,1103037,베닝,2012-01
2012-01-31,1838268,123916,1714352,마다카스카르,2012-01
2012-01-31,1831015,1054956,776059,피지,2012-01
2012-01-31,1827531,152,1827379,불령 폴리네시아,2012-01
2012-01-31,1812749,341169,1471580,보스니아-헤르체고비나,2012-01
2012-01-31,1786937,78239,1708698,아루바,2012-01
2012-01-31,1741696,48867,1692829,수리남,2012-01
2012-01-31,1664398,20,1664378,부르키나 파소,2012-01
2012-01-31,1599835,9008,1590827,나미비아,2012-01
2012-01-31,1426253,310732,1115521,세이쉘,2012-01
2012-01-31,1385932,2289586,-903654,아이슬란드,2012-01
2012-01-31,1292251,78366219,-77073968,가봉,2012-01
2012-01-31,1218131,574140,643991,모리타니,2012-01
2012-01-31,1166544,0,1166544,부탄,2012-01
2012-01-31,1166347,82849,1083498,아르메니아,2012-01
2012-01-31,1160193,5096,1155097,불령 리유니온 코모도 제도,2012-01
2012-01-31,1060980,2298364,-1237384,룩셈부르그,2012-01
2012-01-31,1010621,155359,855262,자마이카,2012-01
2012-01-31,990285,114669,875616,네팔,2012-01
2012-01-31,889493,0,889493,니제르,2012-01
2012-01-31,883680,18805,864875,네덜란드 열도,2012-01
2012-01-31,809508,6072,803436,말리,2012-01
2012-01-31,783044,727851,55193,말라위,2012-01
2012-01-31,766816,322913,443903,벨리제,2012-01
2012-01-31,710390,6346140,-5635750,기타국,2012-01
2012-01-31,704125,63496,640629,사모아,2012-01
2012-01-31,685931,921003,-235072,우간다,2012-01
2012-01-31,660139,0,660139,과델로프,2012-01
2012-01-31,623617,28396,595221,시에라 리온,2012-01
2012-01-31,565024,0,565024,마티니크,2012-01
2012-01-31,553268,112,553156,바베이도스,2012-01
2012-01-31,475072,6105,468967,북마리아나 군도,2012-01
2012-01-31,461101,6346744,-5885643,마세도니아,2012-01
2012-01-31,382400,67,382333,에리트리아,2012-01
2012-01-31,357754,980612,-622858,리히텐슈타인,2012-01
2012-01-31,347319,91,347228,영령 캐이맨 군도,2012-01
2012-01-31,342993,82278,260715,바누아투,2012-01
2012-01-31,341351,32119,309232,몰디브,2012-01
2012-01-31,288030,56245,231785,안티가 바부다,2012-01
2012-01-31,283661,0,283661,버뮤다,2012-01
2012-01-31,272485,323493,-51008,마이크로네시아,2012-01
2012-01-31,253260,176562,76698,도미니카,2012-01
2012-01-31,248200,49760,198440,토켈라우,2012-01
2012-01-31,219117,270019,-50902,몰도바,2012-01
2012-01-31,189642,3746873,-3557231,스와질랜드,2012-01
2012-01-31,159830,9140,150690,보츠와나,2012-01
2012-01-31,158250,3040,155210,영령 버진군도,2012-01
2012-01-31,155884,1484935,-1329051,솔로몬 군도,2012-01
2012-01-31,132703,0,132703,부룬디,2012-01
2012-01-31,128353,0,128353,산마리노,2012-01
2012-01-31,123806,17,123789,아메리칸 사모아,2012-01
2012-01-31,121466,134128,-12662,그레나다,2012-01
2012-01-31,114506,999,113507,르완다,2012-01
2012-01-31,106440,19405,87035,팔라우,2012-01
2012-01-31,104676,0,104676,불령 가이아나,2012-01
2012-01-31,88794,0,88794,감비아,2012-01
2012-01-31,81887,0,81887,세인트 루시아,2012-01
2012-01-31,74984,0,74984,키리바티,2012-01
2012-01-31,59923,41218,18705,적도 기니,2012-01
2012-01-31,45576,0,45576,티모르,2012-01
2012-01-31,42037,68842,-26805,안도라,2012-01
2012-01-31,40525,0,40525,카보 베르데,2012-01
2012-01-31,37652,0,37652,기네비소,2012-01
2012-01-31,35400,0,35400,중앙아프리카공화국,2012-01
2012-01-31,29269,276165,-246896,통가,2012-01
2012-01-31,27542,0,27542,남수단,2012-01
2012-01-31,21101,0,21101,챠드,2012-01
2012-01-31,18565,478201,-459636,모나코,2012-01
2012-01-31,10070,0,10070,파로에 군도,2012-01
2012-01-31,9182,2254,6928,몬테네그로,2012-01
2012-01-31,7995,35260,-27265,세인트 빈센트 그레나딘,2012-01
2012-01-31,7812,7548,264,코모로스,2012-01
2012-01-31,6190,0,6190,쿡 아일랜드,2012-01
2012-01-31,5395,126516,-121121,세인트 키츠 네비스,2012-01
2012-01-31,4093,0,4093,포클랜드 군도,2012-01
2012-01-31,2175,0,2175,영령 인도양,2012-01
2012-01-31,975,8503,-7528,레소토,2012-01
2012-01-31,340,0,340,지브랄타,2012-01
2012-01-31,300,6228,-5928,몬트세라트,2012-01
2012-01-31,0,3559,-3559,노폴크 아일랜드,2012-01
2012-01-31,0,518674,-518674,투발루,2012-01
2012-01-31,0,7004752,-7004752,미령 버진군도,2012-01
2012-01-31,0,8468,-8468,피트카이른,2012-01
2012-01-31,0,73,-73,코스 군도,2012-01
2012-01-31,0,95543,-95543,나우루,2012-01
2012-01-31,0,90423,-90423,그린랜드,2012-01
2012-01-31,0,26460,-26460,세인트 헬레나,2012-01
2012-02-29,10500481337,6109233925,4391247412,중국,2012-02
2012-02-29,5619301450,4143403828,1475897622,미국,2012-02
2012-02-29,3503411607,5708287975,-2204876368,일본,2012-02
2012-02-29,2775074973,192811786,2582263187,홍콩,2012-02
2012-02-29,1964089042,767118249,1196970793,싱가포르,2012-02
2012-02-29,1335238033,699546100,635691933,브라질,2012-02
2012-02-29,1286340783,1124228795,162111988,대만,2012-02
2012-02-29,1259403126,326464711,932938415,베트남,2012-02
2012-02-29,1150438620,1656317100,-505878480,인도네시아,2012-02
2012-02-29,962727123,511866477,450860646,인도,2012-02
2012-02-29,873106912,912166881,-39059969,러시아 연방,2012-02
2012-02-29,745377959,267208312,478169647,멕시코,2012-02
2012-02-29,726481134,1924232609,-1197751475,호주,2012-02
2012-02-29,664922710,1300302849,-635380139,독일,2012-02
2012-02-29,638055564,380699887,257355677,태국,2012-02
2012-02-29,630596516,141275,630455241,라이베리아,2012-02
2012-02-29,628518193,1042414552,-413896359,이란,2012-02
2012-02-29,596784234,296572768,300211466,필리핀,2012-02
2012-02-29,587567189,3348445538,-2760878349,사우디아라비아,2012-02
2012-02-29,560342657,1298350385,-738007728,아랍에미리트 연합,2012-02
2012-02-29,466148775,973732795,-507584020,말레이시아,2012-02
2012-02-29,439774508,66625738,373148770,튀르키예,2012-02
2012-02-29,425620411,445989048,-20368637,캐나다,2012-02
2012-02-29,362566134,9454306,353111828,슬로바키아,2012-02
2012-02-29,356515784,740629814,-384114030,영국,2012-02
2012-02-29,350250487,13297281,336953206,몰타,2012-02
2012-02-29,344566126,95188428,249377698,벨기에,2012-02
2012-02-29,335620188,401834326,-66214138,네덜란드,2012-02
2012-02-29,312713669,41134105,271579564,폴란드,2012-02
2012-02-29,303407247,409838079,-106430832,이탈리아,2012-02
2012-02-29,265756258,6602638,259153620,그리스,2012-02
2012-02-29,250243392,14477594,235765798,방글라데시,2012-02
2012-02-29,248762722,354374447,-105611725,프랑스,2012-02
2012-02-29,242955915,5022,242950893,마샬군도,2012-02
2012-02-29,199702732,422678199,-222975467,칠레,2012-02
2012-02-29,197164899,196236081,928818,남아프리카공화국,2012-02
2012-02-29,190355385,42024893,148330492,체코공화국,2012-02
2012-02-29,170861507,52438204,118423303,우크라이나,2012-02
2012-02-29,154834276,89008026,65826250,스페인,2012-02
2012-02-29,149470468,15438046,134032422,콜롬비아,2012-02
2012-02-29,134281584,90198726,44082858,이집트,2012-02
2012-02-29,128365932,3986891,124379041,요르단,2012-02
2012-02-29,125374402,6695258,118679144,슬로베니아,2012-02
2012-02-29,125126361,6506206,118620155,우즈베키스탄,2012-02
2012-02-29,117617666,55148070,62469596,이스라엘,2012-02
2012-02-29,117079461,643835669,-526756208,이라크,2012-02
2012-02-29,110980430,186902737,-75922307,페루,2012-02
2012-02-29,110933216,262932874,-151999658,노르웨이,2012-02
2012-02-29,110576817,103828510,6748307,알제리,2012-02
2012-02-29,110374198,111395757,-1021559,뉴질랜드,2012-02
2012-02-29,88401246,32793449,55607797,헝가리,2012-02
2012-02-29,87936647,1439531263,-1351594616,쿠웨이트,2012-02
2012-02-29,78178118,78628623,-450505,파나마,2012-02
2012-02-29,76948092,151869,76796223,바하마,2012-02
2012-02-29,76357739,116098625,-39740886,아르헨티나,2012-02
2012-02-29,75407452,36887868,38519584,카자흐스탄,2012-02
2012-02-29,71783497,142306586,-70523089,사이프러스,2012-02
2012-02-29,71501558,3069431,68432127,에쿠아도르,2012-02
2012-02-29,71116084,538734859,-467618775,오만,2012-02
2012-02-29,68458927,3049955,65408972,라트비아,2012-02
2012-02-29,67990791,235601504,-167610713,나이지리아,2012-02
2012-02-29,64283613,96514605,-32230992,오스트리아,2012-02
2012-02-29,62317947,115204222,-52886275,스웨덴,2012-02
2012-02-29,59957829,62046748,-2088919,파키스탄,2012-02
2012-02-29,52650428,554506,52095922,베네주엘라,2012-02
2012-02-29,50870648,28230784,22639864,미얀마,2012-02
2012-02-29,50275960,0,50275960,불령 폴리네시아,2012-02
2012-02-29,48128394,83932822,-35804428,리비아,2012-02
2012-02-29,47483007,87858351,-40375344,핀란드,2012-02
2012-02-29,46192453,8848560,37343893,캄보디아,2012-02
2012-02-29,43680455,2715461240,-2671780785,카타르,2012-02
2012-02-29,41908882,16319,41892563,시리아,2012-02
2012-02-29,39551344,6544757,33006587,모로코,2012-02
2012-02-29,35434850,65865546,-30430696,루마니아,2012-02
2012-02-29,34970975,23817038,11153937,코스타리카,2012-02
2012-02-29,33012798,5157667,27855131,몽골,2012-02
2012-02-29,31745033,27238961,4506072,과테말라,2012-02
2012-02-29,31375047,352609,31022438,괌,2012-02
2012-02-29,30064256,210831613,-180767357,스위스,2012-02
2012-02-29,28811484,62725412,-33913928,바레인,2012-02
2012-02-29,28143457,55488528,-27345071,덴마크,2012-02
2012-02-29,27363094,2462382,24900712,케냐,2012-02
2012-02-29,26577392,587344,25990048,레바논,2012-02
2012-02-29,26375643,7559186,18816457,스리랑카,2012-02
2012-02-29,25747181,21474217,4272964,푸에르토리코,2012-02
2012-02-29,25724118,13868166,11855952,포루투갈,2012-02
2012-02-29,24557454,1142910,23414544,가나,2012-02
2012-02-29,24144029,240,24143789,아제르바이잔,2012-02
2012-02-29,22557884,28828907,-6271023,파라과이,2012-02
2012-02-29,19537149,7852936,11684213,도미니카 공화국,2012-02
2012-02-29,19524422,63492868,-43968446,아일랜드,2012-02
2012-02-29,19036089,39177448,-20141359,앙골라,2012-02
2012-02-29,17943299,4505606,13437693,튀니지,2012-02
2012-02-29,15240296,1358406,13881890,온두라스,2012-02
2012-02-29,14647959,17921084,-3273125,불가리아,2012-02
2012-02-29,14594823,1628712,12966111,니카라과,2012-02
2012-02-29,14018233,24536,13993697,키르기스스탄,2012-02
2012-02-29,13972845,490371,13482474,라오스,2012-02
2012-02-29,13141555,2611128,10530427,조지아,2012-02
2012-02-29,12868691,7812008,5056683,우루과이,2012-02
2012-02-29,11337314,1562672,9774642,엘살바도르,2012-02
2012-02-29,11153559,122271797,-111118238,예맨,2012-02
2012-02-29,10965000,643469,10321531,코트디봐르,2012-02
2012-02-29,10568056,2524256,8043800,파푸아 뉴기니,2012-02
2012-02-29,10444088,2446673,7997415,수단,2012-02
2012-02-29,10341676,1076,10340600,투르크멘,2012-02
2012-02-29,10111959,1373465,8738494,크로아티아,2012-02
2012-02-29,9828349,2435434,7392915,리투아니아,2012-02
2012-02-29,9427279,152730,9274549,콩고,2012-02
2012-02-29,9253784,494299,8759485,카메룬,2012-02
2012-02-29,8982118,1527083,7455035,탄자니아,2012-02
2012-02-29,8981710,6617099,2364611,에스토니아,2012-02
2012-02-29,8729033,2431,8726602,아프카니스탄,2012-02
2012-02-29,8694748,155202842,-146508094,트리니다드 토바고,2012-02
2012-02-29,8055451,213794048,-205738597,브루나이,2012-02
2012-02-29,7580833,2015498,5565335,에티오피아,2012-02
2012-02-29,6374275,0,6374275,지부티,2012-02
2012-02-29,5657166,721806,4935360,모리셔스,2012-02
2012-02-29,4882881,6420203,-1537322,세르비아,2012-02
2012-02-29,4615470,1143291,3472179,세네갈,2012-02
2012-02-29,4233162,20801589,-16568427,뉴 칼레도니아,2012-02
2012-02-29,4085618,1113004,2972614,아이슬란드,2012-02
2012-02-29,3796095,191272,3604823,모잠비크,2012-02
2012-02-29,3723874,1189802,2534072,마카오,2012-02
2012-02-29,3408563,3908,3404655,부르키나 파소,2012-02
2012-02-29,3400225,673734,2726491,베닝,2012-02
2012-02-29,3366496,0,3366496,팔레스타인 해방기구,2012-02
2012-02-29,3291741,778815,2512926,벨라루스,2012-02
2012-02-29,3069168,2734,3066434,네덜란드 열도,2012-02
2012-02-29,2971960,0,2971960,아메리칸 사모아,2012-02
2012-02-29,2907735,867297,2040438,타지크,2012-02
2012-02-29,2791989,937336,1854653,기니,2012-02
2012-02-29,2572679,331146,2241533,자마이카,2012-02
2012-02-29,2499939,0,2499939,토고,2012-02
2012-02-29,2397644,276046,2121598,마다카스카르,2012-02
2012-02-29,2353705,812,2352893,가이아나,2012-02
2012-02-29,2318988,68270,2250718,짐바브웨,2012-02
2012-02-29,2305675,13911912,-11606237,볼리비아,2012-02
2012-02-29,2150707,1669466,481241,피지,2012-02
2012-02-29,1914314,95704,1818610,세이쉘,2012-02
2012-02-29,1843111,95251,1747860,쿠바,2012-02
2012-02-29,1795630,2079544,-283914,말라위,2012-02
2012-02-29,1720590,71563,1649027,아루바,2012-02
2012-02-29,1702338,10863,1691475,불령 리유니온 코모도 제도,2012-02
2012-02-29,1607814,158922,1448892,아르메니아,2012-02
2012-02-29,1594843,110444,1484399,네팔,2012-02
2012-02-29,1577508,166869,1410639,수리남,2012-02
2012-02-29,1537422,2703438,-1166016,가봉,2012-02
2012-02-29,1510507,2414879,-904372,룩셈부르그,2012-02
2012-02-29,1414520,108,1414412,말리,2012-02
2012-02-29,1408402,3160,1405242,아이티,2012-02
2012-02-29,1351212,83852838,-82501626,적도 기니,2012-02
2012-02-29,1283354,32924687,-31641333,잠비아,2012-02
2012-02-29,1277988,0,1277988,부탄,2012-02
2012-02-29,1233003,350988,882015,모리타니,2012-02
2012-02-29,1166981,11087365,-9920384,콩고민주공화국,2012-02
2012-02-29,1159929,274727,885202,보스니아-헤르체고비나,2012-02
2012-02-29,1115543,44341,1071202,바베이도스,2012-02
2012-02-29,1041443,460641,580802,스와질랜드,2012-02
2012-02-29,915613,1704,913909,나미비아,2012-02
2012-02-29,811858,21140,790718,과델로프,2012-02
2012-02-29,741868,0,741868,마티니크,2012-02
2012-02-29,708245,0,708245,티모르,2012-02
2012-02-29,641538,26398,615140,시에라 리온,2012-02
2012-02-29,596837,1620,595217,알바니아,2012-02
2012-02-29,529068,1364869,-835801,우간다,2012-02
2012-02-29,517912,36329,481583,르완다,2012-02
2012-02-29,504680,312,504368,북마리아나 군도,2012-02
2012-02-29,499242,1530246,-1031004,마이크로네시아,2012-02
2012-02-29,491856,20605,471251,몰디브,2012-02
2012-02-29,483560,0,483560,불령 가이아나,2012-02
2012-02-29,476050,30997,445053,안티가 바부다,2012-02
2012-02-29,422935,6607844,-6184909,기타국,2012-02
2012-02-29,409666,0,409666,에리트리아,2012-02
2012-02-29,389151,131406,257745,사모아,2012-02
2012-02-29,379411,171225,208186,바누아투,2012-02
2012-02-29,372100,44561,327539,안도라,2012-02
2012-02-29,342573,79224,263349,영령 캐이맨 군도,2012-02
2012-02-29,327613,0,327613,세인트 루시아,2012-02
2012-02-29,326074,1744888,-1418814,몰도바,2012-02
2012-02-29,322285,26781,295504,도미니카,2012-02
2012-02-29,306380,628666,-322286,리히텐슈타인,2012-02
2012-02-29,259612,0,259612,키리바티,2012-02
2012-02-29,259573,0,259573,감비아,2012-02
2012-02-29,246902,0,246902,버뮤다,2012-02
2012-02-29,245469,0,245469,니제르,2012-02
2012-02-29,230854,244095,-13241,벨리제,2012-02
2012-02-29,214557,0,214557,몬테네그로,2012-02
2012-02-29,211355,6859769,-6648414,마세도니아,2012-02
2012-02-29,205196,18283,186913,세인트 빈센트 그레나딘,2012-02
2012-02-29,138189,0,138189,소말리아,2012-02
2012-02-29,126867,27512,99355,통가,2012-02
2012-02-29,119317,0,119317,팔라우,2012-02
2012-02-29,116782,30962,85820,보츠와나,2012-02
2012-02-29,110386,0,110386,노폴크 아일랜드,2012-02
2012-02-29,98036,0,98036,영령 버진군도,2012-02
2012-02-29,84953,277631,-192678,모나코,2012-02
2012-02-29,81267,0,81267,그레나다,2012-02
2012-02-29,55767,0,55767,부룬디,2012-02
2012-02-29,55753,59307,-3554,솔로몬 군도,2012-02
2012-02-29,40327,3400,36927,산마리노,2012-02
2012-02-29,27245,0,27245,투발루,2012-02
2012-02-29,23680,1952,21728,세인트 키츠 네비스,2012-02
2012-02-29,16262,0,16262,투르크 & 카이코스 군도,2012-02
2012-02-29,15376,0,15376,카보 베르데,2012-02
2012-02-29,9125,0,9125,지브랄타,2012-02
2012-02-29,3309,1141,2168,토켈라우,2012-02
2012-02-29,3030,1595,1435,남조지아 & 남샌드위치 군도,2012-02
2012-02-29,2280,0,2280,기네비소,2012-02
2012-02-29,1925,0,1925,앙귈라,2012-02
2012-02-29,1624,40116,-38492,나우루,2012-02
2012-02-29,1181,0,1181,포클랜드 군도,2012-02
2012-02-29,1051,0,1051,쿡 아일랜드,2012-02
2012-02-29,1030,207619,-206589,그린랜드,2012-02
2012-02-29,400,44037,-43637,세인트 헬레나,2012-02
2012-02-29,0,19311,-19311,레소토,2012-02
2012-02-29,0,1193,-1193,교황청,2012-02
2012-02-29,0,5157,-5157,니우에,2012-02
2012-02-29,0,40,-40,코스 군도,2012-02
2012-02-29,0,4168,-4168,상토메 프린스페,2012-02
2012-03-31,11043089650,7091192230,3951897420,중국,2012-03
2012-03-31,5934643568,3979382885,1955260683,미국,2012-03
2012-03-31,3329166847,5883403962,-2554237115,일본,2012-03
2012-03-31,2978444630,176103369,2802341261,홍콩,2012-03
2012-03-31,2129266716,909128185,1220138531,싱가포르,2012-03
2012-03-31,1331343642,1220118643,111224999,대만,2012-03
2012-03-31,1251894087,420280124,831613963,베트남,2012-03
2012-03-31,1199037162,1512543293,-313506131,인도네시아,2012-03
2012-03-31,1093013223,623299294,469713929,인도,2012-03
2012-03-31,909020207,807949858,101070349,러시아 연방,2012-03
2012-03-31,843004916,1871796955,-1028792039,호주,2012-03
2012-03-31,837919739,412518716,425401023,브라질,2012-03
2012-03-31,771318849,147109777,624209072,멕시코,2012-03
2012-03-31,749504542,3613755528,-2864250986,사우디아라비아,2012-03
2012-03-31,700918410,481343790,219574620,태국,2012-03
2012-03-31,672300610,1555990184,-883689574,독일,2012-03
2012-03-31,663761167,265866472,397894695,필리핀,2012-03
2012-03-31,623424751,876832800,-253408049,말레이시아,2012-03
2012-03-31,597443204,1149639363,-552196159,아랍에미리트 연합,2012-03
2012-03-31,505354081,872251136,-366897055,이란,2012-03
2012-03-31,499256945,64011556,435245389,튀르키예,2012-03
2012-03-31,490208758,554442104,-64233346,캐나다,2012-03
2012-03-31,420588064,48542960,372045104,마샬군도,2012-03
2012-03-31,419192893,450993600,-31800707,영국,2012-03
2012-03-31,388000062,15326665,372673397,슬로바키아,2012-03
2012-03-31,384674070,9565557,375108513,몰타,2012-03
2012-03-31,320680472,288208329,32472143,네덜란드,2012-03
2012-03-31,303992069,47180186,256811883,폴란드,2012-03
2012-03-31,282067251,65506,282001745,라이베리아,2012-03
2012-03-31,269442017,15915678,253526339,파나마,2012-03
2012-03-31,262032901,382672321,-120639420,이탈리아,2012-03
2012-03-31,241175097,399923184,-158748087,프랑스,2012-03
2012-03-31,217164956,90575603,126589353,스페인,2012-03
2012-03-31,209748199,94559670,115188529,우크라이나,2012-03
2012-03-31,205513673,154835806,50677867,벨기에,2012-03
2012-03-31,198445182,386547996,-188102814,칠레,2012-03
2012-03-31,196742688,46282178,150460510,체코공화국,2012-03
2012-03-31,172152807,232547068,-60394261,남아프리카공화국,2012-03
2012-03-31,153869706,5921954,147947752,우즈베키스탄,2012-03
2012-03-31,150924262,49009037,101915225,이집트,2012-03
2012-03-31,147050164,1439735458,-1292685294,쿠웨이트,2012-03
2012-03-31,130331870,27186636,103145234,콜롬비아,2012-03
2012-03-31,128075346,6138088,121937258,슬로베니아,2012-03
2012-03-31,123597658,90620817,32976841,페루,2012-03
2012-03-31,112443240,2296040,110147200,그리스,2012-03
2012-03-31,110451627,861126841,-750675214,이라크,2012-03
2012-03-31,110171500,8828285,101343215,요르단,2012-03
2012-03-31,108385379,17493643,90891736,방글라데시,2012-03
2012-03-31,106074715,54223784,51850931,이스라엘,2012-03
2012-03-31,97758264,27161089,70597175,알제리,2012-03
2012-03-31,83059248,98261245,-15201997,아르헨티나,2012-03
2012-03-31,81871366,133023263,-51151897,나이지리아,2012-03
2012-03-31,81480984,130850574,-49369590,리비아,2012-03
2012-03-31,78910859,1886063,77024796,에쿠아도르,2012-03
2012-03-31,78740410,110816003,-32075593,뉴질랜드,2012-03
2012-03-31,76392791,31798337,44594454,헝가리,2012-03
2012-03-31,76178293,90753262,-14574969,오스트리아,2012-03
2012-03-31,71837396,27996785,43840611,카자흐스탄,2012-03
2012-03-31,67915696,88989575,-21073879,아일랜드,2012-03
2012-03-31,63843764,1257546,62586218,베네주엘라,2012-03
2012-03-31,60252655,115191218,-54938563,스웨덴,2012-03
2012-03-31,60074630,59125169,949461,파키스탄,2012-03
2012-03-31,57079386,356736892,-299657506,오만,2012-03
2012-03-31,50486869,6922751,43564118,모로코,2012-03
2012-03-31,49585311,5285974,44299337,몽골,2012-03
2012-03-31,49478617,1797309246,-1747830629,카타르,2012-03
2012-03-31,48606067,10437461,38168606,캄보디아,2012-03
2012-03-31,44583060,3071518,41511542,룩셈부르그,2012-03
2012-03-31,44243255,24106407,20136848,미얀마,2012-03
2012-03-31,44078978,99375247,-55296269,핀란드,2012-03
2012-03-31,42400636,130889,42269747,시리아,2012-03
2012-03-31,39065463,42,39065421,버뮤다,2012-03
2012-03-31,35576415,3117943,32458472,레바논,2012-03
2012-03-31,33692249,38753428,-5061179,루마니아,2012-03
2012-03-31,33308908,201473132,-168164224,스위스,2012-03
2012-03-31,32453787,3707,32450080,투르크멘,2012-03
2012-03-31,31644219,6499632,25144587,스리랑카,2012-03
2012-03-31,29396206,27646446,1749760,코스타리카,2012-03
2012-03-31,29225596,61353622,-32128026,덴마크,2012-03
2012-03-31,27457208,2035940,25421268,케냐,2012-03
2012-03-31,26629805,12304439,14325366,포루투갈,2012-03
2012-03-31,26064952,67759264,-41694312,바레인,2012-03
2012-03-31,24634167,2317716,22316451,가나,2012-03
2012-03-31,24279697,3366918,20912779,과테말라,2012-03
2012-03-31,22988308,3063094,19925214,앙골라,2012-03
2012-03-31,22594538,26871986,-4277448,푸에르토리코,2012-03
2012-03-31,19720009,27352,19692657,아제르바이잔,2012-03
2012-03-31,18053329,463,18052866,키르기스스탄,2012-03
2012-03-31,16997812,544288,16453524,라오스,2012-03
2012-03-31,16944462,1611,16942851,아프카니스탄,2012-03
2012-03-31,14759641,6926544,7833097,도미니카 공화국,2012-03
2012-03-31,14734524,86920468,-72185944,예맨,2012-03
2012-03-31,14525753,569487214,-554961461,노르웨이,2012-03
2012-03-31,14268214,1494151,12774063,엘살바도르,2012-03
2012-03-31,13344526,327829615,-314485089,브루나이,2012-03
2012-03-31,13278482,4382947,8895535,온두라스,2012-03
2012-03-31,12982494,7732826,5249668,우루과이,2012-03
2012-03-31,12661118,1044346,11616772,니카라과,2012-03
2012-03-31,12341062,2890091,9450971,라트비아,2012-03
2012-03-31,11685190,58,11685132,지부티,2012-03
2012-03-31,11422813,1910280,9512533,파라과이,2012-03
2012-03-31,10895388,19050019,-8154631,튀니지,2012-03
2012-03-31,10122258,187819,9934439,코트디봐르,2012-03
2012-03-31,9414252,2136562,7277690,수단,2012-03
2012-03-31,8946539,411807,8534732,탄자니아,2012-03
2012-03-31,8899449,4317259,4582190,에스토니아,2012-03
2012-03-31,8229268,2387406,5841862,에티오피아,2012-03
2012-03-31,8176770,4704040,3472730,불가리아,2012-03
2012-03-31,8018602,129231150,-121212548,트리니다드 토바고,2012-03
2012-03-31,7855408,179752,7675656,카메룬,2012-03
2012-03-31,7844013,116639,7727374,쿠바,2012-03
2012-03-31,7821748,2786506,5035242,리투아니아,2012-03
2012-03-31,7700959,56757573,-49056614,파푸아 뉴기니,2012-03
2012-03-31,5899494,84200,5815294,팔레스타인 해방기구,2012-03
2012-03-31,5841720,587900,5253820,조지아,2012-03
2012-03-31,5430720,609782,4820938,모리셔스,2012-03
2012-03-31,4640464,1108796,3531668,콩고,2012-03
2012-03-31,4565409,25879947,-21314538,세르비아,2012-03
2012-03-31,4367295,1367152,3000143,세네갈,2012-03
2012-03-31,4191238,0,4191238,토고,2012-03
2012-03-31,4178417,177429,4000988,타지크,2012-03
2012-03-31,4047846,166488,3881358,모잠비크,2012-03
2012-03-31,3802558,17304782,-13502224,뉴 칼레도니아,2012-03
2012-03-31,3620330,2571300,1049030,아이슬란드,2012-03
2012-03-31,3444661,344494,3100167,괌,2012-03
2012-03-31,3369326,1105692,2263634,마카오,2012-03
2012-03-31,3116872,64038736,-60921864,볼리비아,2012-03
2012-03-31,3003400,954786,2048614,크로아티아,2012-03
2012-03-31,2991536,3866,2987670,아르메니아,2012-03
2012-03-31,2933966,0,2933966,적도 기니,2012-03
2012-03-31,2855823,734839,2120984,베닝,2012-03
2012-03-31,2616299,98582753,-95966454,사이프러스,2012-03
2012-03-31,2604704,125565359,-122960655,가봉,2012-03
2012-03-31,2478442,61262,2417180,가이아나,2012-03
2012-03-31,2432258,3505386,-1073128,벨라루스,2012-03
2012-03-31,2422057,1009307,1412750,기니,2012-03
2012-03-31,2340297,166142,2174155,수리남,2012-03
2012-03-31,2164763,67310,2097453,아루바,2012-03
2012-03-31,2085082,95318,1989764,바하마,2012-03
2012-03-31,1942491,315824,1626667,아이티,2012-03
2012-03-31,1920135,1610,1918525,부르키나 파소,2012-03
2012-03-31,1772031,391202,1380829,마다카스카르,2012-03
2012-03-31,1619431,105742,1513689,짐바브웨,2012-03
2012-03-31,1602204,817787,784417,피지,2012-03
2012-03-31,1576695,0,1576695,아메리칸 사모아,2012-03
2012-03-31,1521820,5372,1516448,불령 리유니온 코모도 제도,2012-03
2012-03-31,1487167,102718,1384449,도미니카,2012-03
2012-03-31,1464433,187554,1276879,세이쉘,2012-03
2012-03-31,1445317,1344752,100565,말라위,2012-03
2012-03-31,1368190,0,1368190,과델로프,2012-03
2012-03-31,1361406,460471,900935,자마이카,2012-03
2012-03-31,1265544,16700010,-15434466,콩고민주공화국,2012-03
2012-03-31,1257581,35571223,-34313642,잠비아,2012-03
2012-03-31,1130677,0,1130677,부탄,2012-03
2012-03-31,1128485,290023,838462,시에라 리온,2012-03
2012-03-31,1114224,269438,844786,네팔,2012-03
2012-03-31,1078477,64862,1013615,네덜란드 열도,2012-03
2012-03-31,1077626,261731,815895,모리타니,2012-03
2012-03-31,1030032,49,1029983,말리,2012-03
2012-03-31,920920,689218,231702,보스니아-헤르체고비나,2012-03
2012-03-31,899509,23878,875631,알바니아,2012-03
2012-03-31,893543,406,893137,나미비아,2012-03
2012-03-31,871160,61669,809491,불령 폴리네시아,2012-03
2012-03-31,679194,37968,641226,영령 캐이맨 군도,2012-03
2012-03-31,665418,0,665418,북마리아나 군도,2012-03
2012-03-31,625913,124758,501155,마이크로네시아,2012-03
2012-03-31,592715,144040,448675,벨리제,2012-03
2012-03-31,578992,209198,369794,우간다,2012-03
2012-03-31,577940,1244914,-666974,리히텐슈타인,2012-03
2012-03-31,552056,0,552056,에리트리아,2012-03
2012-03-31,528559,4982248,-4453689,기타국,2012-03
2012-03-31,524089,0,524089,세인트 루시아,2012-03
2012-03-31,504698,18057,486641,바베이도스,2012-03
2012-03-31,451625,18939,432686,보츠와나,2012-03
2012-03-31,446810,172169,274641,르완다,2012-03
2012-03-31,331925,27,331898,몬테네그로,2012-03
2012-03-31,312265,0,312265,불령 가이아나,2012-03
2012-03-31,296643,222082,74561,안티가 바부다,2012-03
2012-03-31,273749,0,273749,마티니크,2012-03
2012-03-31,270424,89542,180882,사모아,2012-03
2012-03-31,234807,209595,25212,영령 버진군도,2012-03
2012-03-31,211494,42450,169044,몰디브,2012-03
2012-03-31,207317,78556,128761,세인트 키츠 네비스,2012-03
2012-03-31,205204,0,205204,감비아,2012-03
2012-03-31,190236,1325,188911,팔라우,2012-03
2012-03-31,161097,293983,-132886,스와질랜드,2012-03
2012-03-31,151814,846327,-694513,몰도바,2012-03
2012-03-31,149728,0,149728,니제르,2012-03
2012-03-31,137528,12,137516,투르크 & 카이코스 군도,2012-03
2012-03-31,111721,3443723,-3332002,마세도니아,2012-03
2012-03-31,107308,358245,-250937,모나코,2012-03
2012-03-31,94527,556,93971,그레나다,2012-03
2012-03-31,87594,2640,84954,티모르,2012-03
2012-03-31,86961,149586,-62625,바누아투,2012-03
2012-03-31,76760,61,76699,쿡 아일랜드,2012-03
2012-03-31,66701,0,66701,미령 버진군도,2012-03
2012-03-31,54127,0,54127,카보 베르데,2012-03
2012-03-31,45554,7805,37749,지브랄타,2012-03
2012-03-31,42912,18110,24802,통가,2012-03
2012-03-31,42168,0,42168,챠드,2012-03
2012-03-31,38398,35532,2866,세인트 빈센트 그레나딘,2012-03
2012-03-31,35176,170194,-135018,중앙아프리카공화국,2012-03
2012-03-31,8937,3155,5782,코모로스,2012-03
2012-03-31,8574,153,8421,키리바티,2012-03
2012-03-31,5937,0,5937,포클랜드 군도,2012-03
2012-03-31,4319,16053,-11734,토켈라우,2012-03
2012-03-31,2793,0,2793,앙귈라,2012-03
2012-03-31,1400,0,1400,남조지아 & 남샌드위치 군도,2012-03
2012-03-31,680,0,680,세인트 마틴,2012-03
2012-03-31,0,2393,-2393,니우에,2012-03
2012-03-31,0,237,-237,교황청,2012-03
2012-03-31,0,10271759,-10271759,나우루,2012-03
2012-03-31,0,32,-32,부룬디,2012-03
2012-03-31,0,1138,-1138,노폴크 아일랜드,2012-03
2012-03-31,0,470,-470,세인트 헬레나,2012-03
2012-03-31,0,199101,-199101,솔로몬 군도,2012-03
2012-03-31,0,29602,-29602,파로에 군도,2012-03
2012-03-31,0,17163,-17163,레소토,2012-03
2012-03-31,0,108605,-108605,그린랜드,2012-03
2012-03-31,0,29730,-29730,안도라,2012-03
2012-03-31,0,248175,-248175,투발루,2012-03
2012-03-31,0,933,-933,산마리노,2012-03
2012-04-30,10463536254,6916436425,3547099829,중국,2012-04
2012-04-30,5307363135,3950596478,1356766657,미국,2012-04
2012-04-30,2751439767,5496773241,-2745333474,일본,2012-04
2012-04-30,2684699609,167153417,2517546192,홍콩,2012-04
2012-04-30,1586667616,879995709,706671907,싱가포르,2012-04
2012-04-30,1237804270,450702096,787102174,베트남,2012-04
2012-04-30,1163842508,1178948396,-15105888,대만,2012-04
2012-04-30,1122959750,51,1122959699,버뮤다,2012-04
2012-04-30,1075679544,668425523,407254021,인도,2012-04
2012-04-30,1065952352,1429803025,-363850673,인도네시아,2012-04
2012-04-30,973517660,684406714,289110946,러시아 연방,2012-04
2012-04-30,819819999,1699078495,-879258496,호주,2012-04
2012-04-30,810478233,326886319,483591914,필리핀,2012-04
2012-04-30,783524893,3428887294,-2645362401,사우디아라비아,2012-04
2012-04-30,756251131,224366805,531884326,멕시코,2012-04
2012-04-30,717363756,408726374,308637382,브라질,2012-04
2012-04-30,682903810,477367028,205536782,태국,2012-04
2012-04-30,671433859,1433397407,-761963548,독일,2012-04
2012-04-30,579161312,620273080,-41111768,말레이시아,2012-04
2012-04-30,574816957,1118174161,-543357204,이란,2012-04
2012-04-30,551933388,1039933756,-488000368,아랍에미리트 연합,2012-04
2012-04-30,518134824,61918900,456215924,마샬군도,2012-04
2012-04-30,444723135,368819281,75903854,캐나다,2012-04
2012-04-30,418755818,63443863,355311955,튀르키예,2012-04
2012-04-30,386626630,11946261,374680369,슬로바키아,2012-04
2012-04-30,372613845,364083730,8530115,이탈리아,2012-04
2012-04-30,337084097,1342128164,-1005044067,쿠웨이트,2012-04
2012-04-30,327226094,449875628,-122649534,영국,2012-04
2012-04-30,326615292,400784313,-74169021,네덜란드,2012-04
2012-04-30,304188704,8943184,295245520,파나마,2012-04
2012-04-30,298208261,8754650,289453611,몰타,2012-04
2012-04-30,292677145,42270958,250406187,폴란드,2012-04
2012-04-30,271548207,167266,271380941,라이베리아,2012-04
2012-04-30,255952157,430289641,-174337484,칠레,2012-04
2012-04-30,237955056,4271949,233683107,그리스,2012-04
2012-04-30,217034494,113952805,103081689,벨기에,2012-04
2012-04-30,215928396,201548525,14379871,남아프리카공화국,2012-04
2012-04-30,214643958,17079197,197564761,방글라데시,2012-04
2012-04-30,208703123,370065343,-161362220,프랑스,2012-04
2012-04-30,158624654,35975980,122648674,콜롬비아,2012-04
2012-04-30,153682774,56814435,96868339,이집트,2012-04
2012-04-30,151073480,61507588,89565892,체코공화국,2012-04
2012-04-30,146805593,121246155,25559438,스페인,2012-04
2012-04-30,136876882,112146864,24730018,뉴질랜드,2012-04
2012-04-30,132733954,86795021,45938933,이스라엘,2012-04
2012-04-30,129962450,3163475,126798975,우즈베키스탄,2012-04
2012-04-30,126497930,125305,126372625,바하마,2012-04
2012-04-30,120134789,6221251,113913538,요르단,2012-04
2012-04-30,119818131,126349076,-6530945,페루,2012-04
2012-04-30,115509789,7697831,107811958,슬로베니아,2012-04
2012-04-30,113455088,585145614,-471690526,노르웨이,2012-04
2012-04-30,111607126,74208710,37398416,우크라이나,2012-04
2012-04-30,107108805,62472445,44636360,리비아,2012-04
2012-04-30,103972297,1009662012,-905689715,이라크,2012-04
2012-04-30,99335691,43709969,55625722,헝가리,2012-04
2012-04-30,92837998,69617,92768381,알제리,2012-04
2012-04-30,90947660,578920651,-487972991,오만,2012-04
2012-04-30,75164941,85072807,-9907866,파키스탄,2012-04
2012-04-30,74777428,151144222,-76366794,나이지리아,2012-04
2012-04-30,72478665,66143064,6335601,아르헨티나,2012-04
2012-04-30,65919365,2242809,63676556,베네주엘라,2012-04
2012-04-30,64988494,121586824,-56598330,스웨덴,2012-04
2012-04-30,62275743,60283480,1992263,모로코,2012-04
2012-04-30,60204726,67942792,-7738066,아일랜드,2012-04
2012-04-30,58677669,99683278,-41005609,오스트리아,2012-04
2012-04-30,55221699,52569,55169130,시리아,2012-04
2012-04-30,54357749,2878250,51479499,에쿠아도르,2012-04
2012-04-30,53674384,13117831,40556553,캄보디아,2012-04
2012-04-30,53303618,28775213,24528405,카자흐스탄,2012-04
2012-04-30,43980257,759,43979498,중앙아프리카공화국,2012-04
2012-04-30,43777091,2261056227,-2217279136,카타르,2012-04
2012-04-30,43627139,4225071,39402068,몽골,2012-04
2012-04-30,39126394,45514992,-6388598,루마니아,2012-04
2012-04-30,38905827,0,38905827,불령 폴리네시아,2012-04
2012-04-30,37620577,22703785,14916792,미얀마,2012-04
2012-04-30,35092470,70559958,-35467488,핀란드,2012-04
2012-04-30,33854894,26835173,7019721,푸에르토리코,2012-04
2012-04-30,32882044,53114,32828930,영령 캐이맨 군도,2012-04
2012-04-30,30407663,3821582,26586081,레바논,2012-04
2012-04-30,28510246,56027017,-27516771,덴마크,2012-04
2012-04-30,25569449,19821386,5748063,과테말라,2012-04
2012-04-30,25371358,29816703,-4445345,코스타리카,2012-04
2012-04-30,24577477,198749764,-174172287,스위스,2012-04
2012-04-30,24250127,69904150,-45654023,바레인,2012-04
2012-04-30,23771952,1582100,22189852,가나,2012-04
2012-04-30,23575358,59255997,-35680639,앙골라,2012-04
2012-04-30,23368888,72,23368816,아제르바이잔,2012-04
2012-04-30,22108438,10325066,11783372,포루투갈,2012-04
2012-04-30,21999993,5093432,16906561,스리랑카,2012-04
2012-04-30,21899986,10805573,11094413,파푸아 뉴기니,2012-04
2012-04-30,21842366,148960,21693406,투르크멘,2012-04
2012-04-30,20452480,5244849,15207631,튀니지,2012-04
2012-04-30,18130404,2223121,15907283,케냐,2012-04
2012-04-30,17099081,3536340,13562741,에스토니아,2012-04
2012-04-30,16663788,17563827,-900039,우루과이,2012-04
2012-04-30,15568087,522775,15045312,파라과이,2012-04
2012-04-30,15297298,9203935,6093363,온두라스,2012-04
2012-04-30,15047649,135,15047514,키르기스스탄,2012-04
2012-04-30,14443872,10204183,4239689,니카라과,2012-04
2012-04-30,14079637,2798486,11281151,라트비아,2012-04
2012-04-30,11594973,3365517,8229456,엘살바도르,2012-04
2012-04-30,11474094,14883497,-3409403,도미니카 공화국,2012-04
2012-04-30,11186454,675385,10511069,탄자니아,2012-04
2012-04-30,11184917,3341264,7843653,수단,2012-04
2012-04-30,10972843,70039756,-59066913,예맨,2012-04
2012-04-30,10317699,22324453,-12006754,불가리아,2012-04
2012-04-30,10250857,1703,10249154,아프카니스탄,2012-04
2012-04-30,9580534,521464,9059070,조지아,2012-04
2012-04-30,9405333,2688186,6717147,리투아니아,2012-04
2012-04-30,8489784,177823615,-169333831,브루나이,2012-04
2012-04-30,7789039,15317879,-7528840,콩고민주공화국,2012-04
2012-04-30,7754823,652767,7102056,라오스,2012-04
2012-04-30,7445448,1056,7444392,코트디봐르,2012-04
2012-04-30,7167413,949365,6218048,트리니다드 토바고,2012-04
2012-04-30,6793127,27955788,-21162661,사이프러스,2012-04
2012-04-30,6756013,1424045,5331968,크로아티아,2012-04
2012-04-30,6542937,7207952,-665015,뉴 칼레도니아,2012-04
2012-04-30,6460611,965514,5495097,기니,2012-04
2012-04-30,5168994,184225,4984769,타지크,2012-04
2012-04-30,4398306,78172,4320134,팔레스타인 해방기구,2012-04
2012-04-30,4373050,492641,3880409,모리셔스,2012-04
2012-04-30,4360029,151561,4208468,괌,2012-04
2012-04-30,4271156,6116,4265040,지부티,2012-04
2012-04-30,4031786,1024238,3007548,베닝,2012-04
2012-04-30,3948054,3190662,757392,벨라루스,2012-04
2012-04-30,3916831,4441589,-524758,가봉,2012-04
2012-04-30,3826776,2731333,1095443,세네갈,2012-04
2012-04-30,3726930,169528,3557402,토고,2012-04
2012-04-30,3589047,7111578,-3522531,모잠비크,2012-04
2012-04-30,3491784,0,3491784,티모르,2012-04
2012-04-30,3096843,1277876,1818967,콩고,2012-04
2012-04-30,2931119,252920,2678199,마카오,2012-04
2012-04-30,2922555,0,2922555,아메리칸 사모아,2012-04
2012-04-30,2860731,25196,2835535,아르메니아,2012-04
2012-04-30,2849967,9691105,-6841138,볼리비아,2012-04
2012-04-30,2727200,1735871,991329,에티오피아,2012-04
2012-04-30,2540334,919240,1621094,카메룬,2012-04
2012-04-30,2426084,2738971,-312887,아이슬란드,2012-04
2012-04-30,2386992,693,2386299,바베이도스,2012-04
2012-04-30,2163908,119280,2044628,세이쉘,2012-04
2012-04-30,2138967,27182788,-25043821,잠비아,2012-04
2012-04-30,2116499,16627315,-14510816,세르비아,2012-04
2012-04-30,1980572,444426,1536146,모리타니,2012-04
2012-04-30,1974969,211473,1763496,가이아나,2012-04
2012-04-30,1938017,0,1938017,아루바,2012-04
2012-04-30,1936636,0,1936636,부르키나 파소,2012-04
2012-04-30,1878121,225170,1652951,수리남,2012-04
2012-04-30,1837216,809063,1028153,피지,2012-04
2012-04-30,1784410,323540,1460870,아이티,2012-04
2012-04-30,1768409,720761,1047648,자마이카,2012-04
2012-04-30,1697825,138899,1558926,나미비아,2012-04
2012-04-30,1642528,59904,1582624,네덜란드 열도,2012-04
2012-04-30,1587027,55592,1531435,네팔,2012-04
2012-04-30,1573851,273488,1300363,마다카스카르,2012-04
2012-04-30,1565449,92711,1472738,쿠바,2012-04
2012-04-30,1550934,1476340,74594,룩셈부르그,2012-04
2012-04-30,1525074,6548528,-5023454,말라위,2012-04
2012-04-30,1348182,104752,1243430,말리,2012-04
2012-04-30,1336504,12199,1324305,짐바브웨,2012-04
2012-04-30,1303679,53853,1249826,불령 리유니온 코모도 제도,2012-04
2012-04-30,1061736,0,1061736,부탄,2012-04
2012-04-30,956239,271538,684701,시에라 리온,2012-04
2012-04-30,951549,95097,856452,니제르,2012-04
2012-04-30,894673,10353,884320,북마리아나 군도,2012-04
2012-04-30,893300,7609664,-6716364,기타국,2012-04
2012-04-30,881754,735802,145952,우간다,2012-04
2012-04-30,787387,127312,660075,벨리제,2012-04
2012-04-30,726561,0,726561,영령 버진군도,2012-04
2012-04-30,674183,818024,-143841,리히텐슈타인,2012-04
2012-04-30,669308,0,669308,마티니크,2012-04
2012-04-30,658802,6883,651919,몰디브,2012-04
2012-04-30,657215,98060,559155,사모아,2012-04
2012-04-30,618791,25595,593196,보츠와나,2012-04
2012-04-30,590971,92996,497975,알바니아,2012-04
2012-04-30,559239,1213168,-653929,마이크로네시아,2012-04
2012-04-30,551195,2655192,-2103997,안티가 바부다,2012-04
2012-04-30,527052,3218192,-2691140,마세도니아,2012-04
2012-04-30,508571,0,508571,키리바티,2012-04
2012-04-30,498210,340,497870,과델로프,2012-04
2012-04-30,420000,0,420000,불령 가이아나,2012-04
2012-04-30,386408,0,386408,감비아,2012-04
2012-04-30,382472,690538,-308066,보스니아-헤르체고비나,2012-04
2012-04-30,378777,0,378777,세인트 루시아,2012-04
2012-04-30,364930,0,364930,에리트리아,2012-04
2012-04-30,277536,1522806,-1245270,몰도바,2012-04
2012-04-30,238134,0,238134,그레나다,2012-04
2012-04-30,225960,0,225960,보빗군도,2012-04
2012-04-30,209872,0,209872,적도 기니,2012-04
2012-04-30,204628,7600,197028,팔라우,2012-04
2012-04-30,194539,83980,110559,바누아투,2012-04
2012-04-30,157354,1070319,-912965,솔로몬 군도,2012-04
2012-04-30,156525,8405615,-8249090,스와질랜드,2012-04
2012-04-30,140371,52664,87707,산마리노,2012-04
2012-04-30,138484,0,138484,챠드,2012-04
2012-04-30,126094,236546,-110452,도미니카,2012-04
2012-04-30,102277,300416,-198139,모나코,2012-04
2012-04-30,98456,0,98456,지브랄타,2012-04
2012-04-30,93313,42615,50698,몬테네그로,2012-04
2012-04-30,81786,0,81786,기네비소,2012-04
2012-04-30,68836,18538,50298,르완다,2012-04
2012-04-30,56572,14758,41814,세인트 빈센트 그레나딘,2012-04
2012-04-30,54965,2757,52208,노폴크 아일랜드,2012-04
2012-04-30,51550,1580,49970,미령 버진군도,2012-04
2012-04-30,39960,4537,35423,통가,2012-04
2012-04-30,31677,0,31677,메요트,2012-04
2012-04-30,29538,0,29538,카보 베르데,2012-04
2012-04-30,12902,0,12902,파로에 군도,2012-04
2012-04-30,1345,0,1345,앙귈라,2012-04
2012-04-30,982,0,982,세인트 헬레나,2012-04
2012-04-30,0,11302,-11302,토켈라우,2012-04
2012-04-30,0,41498,-41498,세인트 키츠 네비스,2012-04
2012-04-30,0,6,-6,쿡 아일랜드,2012-04
2012-04-30,0,141161,-141161,투발루,2012-04
2012-04-30,0,425,-425,몬트세라트,2012-04
2012-04-30,0,6012638,-6012638,나우루,2012-04
2012-04-30,0,13449,-13449,부룬디,2012-04
2012-04-30,0,2374,-2374,허드 앤 맥도날드 군도,2012-04
2012-04-30,0,142386,-142386,그린랜드,2012-04
2012-04-30,0,6327,-6327,남조지아 & 남샌드위치 군도,2012-04
2012-04-30,0,7998,-7998,안도라,2012-04
2012-04-30,0,90530,-90530,니우에,2012-04
2012-05-31,10716030491,7091267073,3624763418,중국,2012-05
2012-05-31,4726885740,3826340564,900545176,미국,2012-05
2012-05-31,3093617482,5290957142,-2197339660,일본,2012-05
2012-05-31,3024354148,212949215,2811404933,홍콩,2012-05
2012-05-31,1960345350,742374968,1217970382,싱가포르,2012-05
2012-05-31,1354118913,1230381524,123737389,대만,2012-05
2012-05-31,1286975266,366434258,920541008,베트남,2012-05
2012-05-31,1279046117,465013848,814032269,브라질,2012-05
2012-05-31,1150301937,1238664567,-88362630,인도네시아,2012-05
2012-05-31,1022361794,553677722,468684072,인도,2012-05
2012-05-31,995288980,1089197570,-93908590,러시아 연방,2012-05
2012-05-31,786896757,445132273,341764484,네덜란드,2012-05
2012-05-31,783592445,3650223071,-2866630626,사우디아라비아,2012-05
2012-05-31,776533634,267631754,508901880,필리핀,2012-05
2012-05-31,751021806,205304728,545717078,멕시코,2012-05
2012-05-31,734137483,1489098826,-754961343,독일,2012-05
2012-05-31,727918353,1717928640,-990010287,호주,2012-05
2012-05-31,701437248,471732729,229704519,태국,2012-05
2012-05-31,625779692,655319269,-29539577,이란,2012-05
2012-05-31,594622439,1648196459,-1053574020,아랍에미리트 연합,2012-05
2012-05-31,584620552,1059,584619493,라이베리아,2012-05
2012-05-31,579126778,801116874,-221990096,말레이시아,2012-05
2012-05-31,482615735,439989629,42626106,캐나다,2012-05
2012-05-31,401908146,4191157,397716989,마샬군도,2012-05
2012-05-31,394930098,13975694,380954404,슬로바키아,2012-05
2012-05-31,366375872,46451159,319924713,튀르키예,2012-05
2012-05-31,329074087,40718962,288355125,파나마,2012-05
2012-05-31,321333962,41922752,279411210,폴란드,2012-05
2012-05-31,306148064,787407938,-481259874,영국,2012-05
2012-05-31,274173819,4742722,269431097,튀니지,2012-05
2012-05-31,242049016,389581208,-147532192,이탈리아,2012-05
2012-05-31,208459467,384451902,-175992435,프랑스,2012-05
2012-05-31,198732886,467077772,-268344886,칠레,2012-05
2012-05-31,189703025,183388106,6314919,남아프리카공화국,2012-05
2012-05-31,183412044,141257573,42154471,벨기에,2012-05
2012-05-31,180901670,3907172,176994498,우즈베키스탄,2012-05
2012-05-31,153259613,4734952,148524661,그리스,2012-05
2012-05-31,151385154,101180847,50204307,스페인,2012-05
2012-05-31,150863440,10495563,140367877,이집트,2012-05
2012-05-31,150697196,120306989,30390207,뉴질랜드,2012-05
2012-05-31,148970540,51346277,97624263,체코공화국,2012-05
2012-05-31,142700569,47453189,95247380,몰타,2012-05
2012-05-31,138433580,6869344,131564236,슬로베니아,2012-05
2012-05-31,137941432,172409510,-34468078,페루,2012-05
2012-05-31,134531040,68030585,66500455,핀란드,2012-05
2012-05-31,130628927,3125402,127503525,요르단,2012-05
2012-05-31,122939182,19911499,103027683,콜롬비아,2012-05
2012-05-31,117997779,654768032,-536770253,이라크,2012-05
2012-05-31,117011505,50545643,66465862,지브랄타,2012-05
2012-05-31,114375513,1867715308,-1753339795,쿠웨이트,2012-05
2012-05-31,112076242,37383911,74692331,우크라이나,2012-05
2012-05-31,111426993,17334644,94092349,방글라데시,2012-05
2012-05-31,109464506,74957535,34506971,이스라엘,2012-05
2012-05-31,107232598,89380694,17851904,알제리,2012-05
2012-05-31,103670612,42041244,61629368,헝가리,2012-05
2012-05-31,81891109,308456951,-226565842,오만,2012-05
2012-05-31,80383001,112309945,-31926944,스웨덴,2012-05
2012-05-31,80279358,128588267,-48308909,리비아,2012-05
2012-05-31,79311438,124715703,-45404265,오스트리아,2012-05
2012-05-31,78107013,126055925,-47948912,아르헨티나,2012-05
2012-05-31,75189068,2684440,72504628,에쿠아도르,2012-05
2012-05-31,74239509,118024222,-43784713,나이지리아,2012-05
2012-05-31,73229647,27892183,45337464,사이프러스,2012-05
2012-05-31,71512203,36135069,35377134,파키스탄,2012-05
2012-05-31,66907561,25479235,41428326,카자흐스탄,2012-05
2012-05-31,61478597,209204503,-147725906,스위스,2012-05
2012-05-31,54745563,10812043,43933520,캄보디아,2012-05
2012-05-31,51170260,11736748,39433512,미얀마,2012-05
2012-05-31,49598286,4583952,45014334,몽골,2012-05
2012-05-31,49419864,2190265251,-2140845387,카타르,2012-05
2012-05-31,49267388,17115798,32151590,모로코,2012-05
2012-05-31,48139164,3892799,44246365,베네주엘라,2012-05
2012-05-31,43321892,3795312,39526580,룩셈부르그,2012-05
2012-05-31,42867111,49601,42817510,시리아,2012-05
2012-05-31,37758512,920649,36837863,괌,2012-05
2012-05-31,35720321,27437145,8283176,코스타리카,2012-05
2012-05-31,35293756,0,35293756,불령 폴리네시아,2012-05
2012-05-31,35010839,100265872,-65255033,루마니아,2012-05
2012-05-31,33942444,73371490,-39429046,덴마크,2012-05
2012-05-31,29909443,9774833,20134610,과테말라,2012-05
2012-05-31,29827190,4099305,25727885,레바논,2012-05
2012-05-31,27284883,48800166,-21515283,바레인,2012-05
2012-05-31,26059861,3820587,22239274,케냐,2012-05
2012-05-31,25922383,2721594,23200789,가나,2012-05
2012-05-31,25793451,9831,25783620,아제르바이잔,2012-05
2012-05-31,24195878,5357479,18838399,스리랑카,2012-05
2012-05-31,23612103,27430279,-3818176,푸에르토리코,2012-05
2012-05-31,20632683,9302562,11330121,포루투갈,2012-05
2012-05-31,19238004,2109327,17128677,앙골라,2012-05
2012-05-31,16916432,15188975,1727457,니카라과,2012-05
2012-05-31,16065924,493362,15572562,라오스,2012-05
2012-05-31,14419007,2584,14416423,투르크멘,2012-05
2012-05-31,13706946,12295762,1411184,우루과이,2012-05
2012-05-31,13654982,2775890,10879092,라트비아,2012-05
2012-05-31,13528633,2928961,10599672,수단,2012-05
2012-05-31,13360453,1462642,11897811,예맨,2012-05
2012-05-31,13313482,2122907,11190575,에티오피아,2012-05
2012-05-31,13241853,13613761,-371908,온두라스,2012-05
2012-05-31,13159899,3914994,9244905,에스토니아,2012-05
2012-05-31,12820861,10492134,2328727,도미니카 공화국,2012-05
2012-05-31,12455018,478945897,-466490879,노르웨이,2012-05
2012-05-31,12423618,2766,12420852,키르기스스탄,2012-05
2012-05-31,11969670,52507924,-40538254,아일랜드,2012-05
2012-05-31,11399487,39957003,-28557516,브루나이,2012-05
2012-05-31,10282761,146622,10136139,코트디봐르,2012-05
2012-05-31,10009110,2605624,7403486,엘살바도르,2012-05
2012-05-31,9414193,1237762,8176431,조지아,2012-05
2012-05-31,9398932,5904979,3493953,탄자니아,2012-05
2012-05-31,9208469,971613,8236856,파라과이,2012-05
2012-05-31,9049089,2203405,6845684,리투아니아,2012-05
2012-05-31,8967563,0,8967563,지부티,2012-05
2012-05-31,7185960,2685150,4500810,파푸아 뉴기니,2012-05
2012-05-31,6825131,20277396,-13452265,불가리아,2012-05
2012-05-31,6491420,1222,6490198,아프카니스탄,2012-05
2012-05-31,6074353,14362989,-8288636,뉴 칼레도니아,2012-05
2012-05-31,6002688,20009198,-14006510,볼리비아,2012-05
2012-05-31,5591403,6065291,-473888,트리니다드 토바고,2012-05
2012-05-31,5475262,4985708,489554,세네갈,2012-05
2012-05-31,5328657,880347,4448310,모리셔스,2012-05
2012-05-31,5219551,167963,5051588,토고,2012-05
2012-05-31,5110974,5339815,-228841,기타국,2012-05
2012-05-31,4783915,287754,4496161,베닝,2012-05
2012-05-31,4612271,2117088,2495183,벨라루스,2012-05
2012-05-31,4255884,2776242,1479642,콩고,2012-05
2012-05-31,3814563,1422171,2392392,크로아티아,2012-05
2012-05-31,3564513,1482023,2082490,피지,2012-05
2012-05-31,3470594,99199,3371395,수리남,2012-05
2012-05-31,3341331,1803600,1537731,아이슬란드,2012-05
2012-05-31,3334794,20556000,-17221206,콩고민주공화국,2012-05
2012-05-31,3263338,1821509,1441829,기니,2012-05
2012-05-31,3254467,365847,2888620,카메룬,2012-05
2012-05-31,3132057,327245,2804812,가이아나,2012-05
2012-05-31,2985838,24189653,-21203815,세르비아,2012-05
2012-05-31,2958075,151577,2806498,쿠바,2012-05
2012-05-31,2662697,91400,2571297,팔레스타인 해방기구,2012-05
2012-05-31,2650680,0,2650680,적도 기니,2012-05
2012-05-31,2510985,201167,2309818,타지크,2012-05
2012-05-31,2454430,485975,1968455,마카오,2012-05
2012-05-31,2413629,280441,2133188,짐바브웨,2012-05
2012-05-31,2407243,59531,2347712,네팔,2012-05
2012-05-31,2362317,570064,1792253,모리타니,2012-05
2012-05-31,2150491,278205,1872286,세이쉘,2012-05
2012-05-31,2057643,2416460,-358817,모잠비크,2012-05
2012-05-31,1988736,19480660,-17491924,잠비아,2012-05
2012-05-31,1955396,318149,1637247,자마이카,2012-05
2012-05-31,1918368,4618,1913750,아메리칸 사모아,2012-05
2012-05-31,1863467,184454,1679013,마다카스카르,2012-05
2012-05-31,1858408,125155,1733253,부르키나 파소,2012-05
2012-05-31,1799855,583680,1216175,아이티,2012-05
2012-05-31,1792648,0,1792648,불령 리유니온 코모도 제도,2012-05
2012-05-31,1659337,95484,1563853,바하마,2012-05
2012-05-31,1550182,9921160,-8370978,말라위,2012-05
2012-05-31,1525142,156183,1368959,마이크로네시아,2012-05
2012-05-31,1474206,1269,1472937,가봉,2012-05
2012-05-31,1426195,0,1426195,과델로프,2012-05
2012-05-31,1414845,16674,1398171,바베이도스,2012-05
2012-05-31,1324281,1835,1322446,니제르,2012-05
2012-05-31,1145259,6233,1139026,아르메니아,2012-05
2012-05-31,912790,67429,845361,아루바,2012-05
2012-05-31,883223,0,883223,마티니크,2012-05
2012-05-31,840557,53872,786685,영령 캐이맨 군도,2012-05
2012-05-31,823966,119989,703977,르완다,2012-05
2012-05-31,805660,0,805660,보츠와나,2012-05
2012-05-31,774620,168491,606129,사모아,2012-05
2012-05-31,732882,95852,637030,말리,2012-05
2012-05-31,708528,484253,224275,시에라 리온,2012-05
2012-05-31,707519,45316,662203,북마리아나 군도,2012-05
2012-05-31,696722,82580,614142,네덜란드 열도,2012-05
2012-05-31,685284,621015,64269,우간다,2012-05
2012-05-31,625028,819603,-194575,스와질랜드,2012-05
2012-05-31,579189,99793,479396,도미니카,2012-05
2012-05-31,569157,539249,29908,보스니아-헤르체고비나,2012-05
2012-05-31,547895,200,547695,부탄,2012-05
2012-05-31,541442,6461,534981,부룬디,2012-05
2012-05-31,531464,4576,526888,에리트리아,2012-05
2012-05-31,510421,0,510421,영령 버진군도,2012-05
2012-05-31,504077,0,504077,안티가 바부다,2012-05
2012-05-31,465473,156,465317,몬테네그로,2012-05
2012-05-31,421059,0,421059,세인트 루시아,2012-05
2012-05-31,409903,738183,-328280,리히텐슈타인,2012-05
2012-05-31,406277,631721,-225444,몰도바,2012-05
2012-05-31,404978,7033,397945,알바니아,2012-05
2012-05-31,398745,0,398745,키리바티,2012-05
2012-05-31,371889,0,371889,불령 가이아나,2012-05
2012-05-31,370874,0,370874,팔라우,2012-05
2012-05-31,342422,42,342380,감비아,2012-05
2012-05-31,308622,0,308622,티모르,2012-05
2012-05-31,292058,10412915,-10120857,마세도니아,2012-05
2012-05-31,239120,1090964,-851844,솔로몬 군도,2012-05
2012-05-31,219288,5248,214040,몰디브,2012-05
2012-05-31,209902,372429,-162527,모나코,2012-05
2012-05-31,192897,381205,-188308,바누아투,2012-05
2012-05-31,192828,0,192828,그레나다,2012-05
2012-05-31,168537,0,168537,버뮤다,2012-05
2012-05-31,163671,19649989,-19486318,나미비아,2012-05
2012-05-31,163195,162254,941,벨리제,2012-05
2012-05-31,133388,17647,115741,교황청,2012-05
2012-05-31,100598,0,100598,노폴크 아일랜드,2012-05
2012-05-31,88318,0,88318,카보 베르데,2012-05
2012-05-31,77353,4110,73243,세인트 키츠 네비스,2012-05
2012-05-31,71852,0,71852,소말리아,2012-05
2012-05-31,44043,2495,41548,산마리노,2012-05
2012-05-31,40873,0,40873,불령 남부지역,2012-05
2012-05-31,36500,228,36272,앙귈라,2012-05
2012-05-31,33739,42536,-8797,통가,2012-05
2012-05-31,31634,6196,25438,쿡 아일랜드,2012-05
2012-05-31,22747,153862,-131115,안도라,2012-05
2012-05-31,16262,0,16262,투르크 & 카이코스 군도,2012-05
2012-05-31,10758,3731,7027,기네비소,2012-05
2012-05-31,9458,0,9458,코모로스,2012-05
2012-05-31,5736,0,5736,챠드,2012-05
2012-05-31,3298,194717,-191419,포클랜드 군도,2012-05
2012-05-31,938,0,938,중앙아프리카공화국,2012-05
2012-05-31,77,0,77,세인트 마틴,2012-05
2012-05-31,0,2078,-2078,레소토,2012-05
2012-05-31,0,4197,-4197,코스 군도,2012-05
2012-05-31,0,22698,-22698,토켈라우,2012-05
2012-05-31,0,85959,-85959,나우루,2012-05
2012-05-31,0,646,-646,미령 버진군도,2012-05
2012-05-31,0,419474,-419474,투발루,2012-05
2012-05-31,0,246622,-246622,그린랜드,2012-05
2012-05-31,0,19135,-19135,세인트 빈센트 그레나딘,2012-05
2012-05-31,0,1393,-1393,상토메 프린스페,2012-05
2012-05-31,0,2595,-2595,니우에,2012-05
2012-06-30,10828777757,6450084447,4378693310,중국,2012-06
2012-06-30,4977490336,3764716314,1212774022,미국,2012-06
2012-06-30,3402562013,5093984087,-1691422074,일본,2012-06
2012-06-30,2539827120,153735578,2386091542,홍콩,2012-06
2012-06-30,2297073867,787833284,1509240583,싱가포르,2012-06
2012-06-30,1369072255,469049247,900023008,베트남,2012-06
2012-06-30,1258938612,1528093428,-269154816,인도네시아,2012-06
2012-06-30,1209479226,1141478412,68000814,대만,2012-06
2012-06-30,1044660582,747049395,297611187,러시아 연방,2012-06
2012-06-30,943075876,621196070,321879806,인도,2012-06
2012-06-30,934907046,450722165,484184881,브라질,2012-06
2012-06-30,868899981,2918146933,-2049246952,사우디아라비아,2012-06
2012-06-30,783808629,1634486823,-850678194,호주,2012-06
2012-06-30,720023639,1402313532,-682289893,독일,2012-06
2012-06-30,713173457,261310939,451862518,멕시코,2012-06
2012-06-30,681328368,1152578949,-471250581,아랍에미리트 연합,2012-06
2012-06-30,673842291,481752116,192090175,태국,2012-06
2012-06-30,654887352,42512,654844840,라이베리아,2012-06
2012-06-30,645199044,297441050,347757994,필리핀,2012-06
2012-06-30,618028011,843857678,-225829667,말레이시아,2012-06
2012-06-30,558466097,11115,558454982,마샬군도,2012-06
2012-06-30,534692084,0,534692084,영령 버진군도,2012-06
2012-06-30,497989359,847257199,-349267840,이란,2012-06
2012-06-30,487733903,496212017,-8478114,캐나다,2012-06
2012-06-30,475432492,343621583,131810909,네덜란드,2012-06
2012-06-30,365951687,72327627,293624060,튀르키예,2012-06
2012-06-30,358394012,13348469,345045543,슬로바키아,2012-06
2012-06-30,296701536,50300899,246400637,파나마,2012-06
2012-06-30,296292231,30938208,265354023,몰타,2012-06
2012-06-30,292206123,36797224,255408899,폴란드,2012-06
2012-06-30,289709945,485051838,-195341893,영국,2012-06
2012-06-30,269706751,384099880,-114393129,이탈리아,2012-06
2012-06-30,197120889,2624896,194495993,우즈베키스탄,2012-06
2012-06-30,187875129,160331508,27543621,남아프리카공화국,2012-06
2012-06-30,185003975,367290506,-182286531,프랑스,2012-06
2012-06-30,183406528,74708763,108697765,이스라엘,2012-06
2012-06-30,178433770,351652953,-173219183,칠레,2012-06
2012-06-30,164168424,2993368,161175056,그리스,2012-06
2012-06-30,157221214,97295413,59925801,벨기에,2012-06
2012-06-30,153881041,45753428,108127613,페루,2012-06
2012-06-30,151737451,117176532,34560919,이집트,2012-06
2012-06-30,141140574,858921967,-717781393,이라크,2012-06
2012-06-30,140374269,7333633,133040636,요르단,2012-06
2012-06-30,133854852,120962291,12892561,뉴질랜드,2012-06
2012-06-30,132238192,54228874,78009318,체코공화국,2012-06
2012-06-30,129549470,98870888,30678582,콜롬비아,2012-06
2012-06-30,121426213,85974839,35451374,핀란드,2012-06
2012-06-30,114485963,236769,114249194,알제리,2012-06
2012-06-30,110892929,1598970953,-1488078024,쿠웨이트,2012-06
2012-06-30,104961032,91789800,13171232,우크라이나,2012-06
2012-06-30,104865996,8507494,96358502,슬로베니아,2012-06
2012-06-30,101236728,116261424,-15024696,스페인,2012-06
2012-06-30,99605643,249268628,-149662985,리비아,2012-06
2012-06-30,97718936,17747816,79971120,방글라데시,2012-06
2012-06-30,97370336,259018,97111318,바하마,2012-06
2012-06-30,92671071,37262298,55408773,헝가리,2012-06
2012-06-30,88073796,321216643,-233142847,오만,2012-06
2012-06-30,85482241,307154314,-221672073,노르웨이,2012-06
2012-06-30,83829406,151458699,-67629293,나이지리아,2012-06
2012-06-30,82021673,110383214,-28361541,아르헨티나,2012-06
2012-06-30,70312973,22870002,47442971,카자흐스탄,2012-06
2012-06-30,70258952,14677105,55581847,모로코,2012-06
2012-06-30,69618072,69242577,375495,파키스탄,2012-06
2012-06-30,64864869,37,64864832,버뮤다,2012-06
2012-06-30,63830209,2694451,61135758,에쿠아도르,2012-06
2012-06-30,63467976,37141546,26326430,루마니아,2012-06
2012-06-30,61747788,109851231,-48103443,스웨덴,2012-06
2012-06-30,60637705,120995669,-60357964,오스트리아,2012-06
2012-06-30,57884681,240861150,-182976469,스위스,2012-06
2012-06-30,56590849,17247962,39342887,미얀마,2012-06
2012-06-30,48914877,8026108,40888769,캄보디아,2012-06
2012-06-30,47481017,2023014625,-1975533608,카타르,2012-06
2012-06-30,44676683,59959614,-15282931,아일랜드,2012-06
2012-06-30,43440465,2706513,40733952,몽골,2012-06
2012-06-30,37423899,380849,37043050,괌,2012-06
2012-06-30,34323419,48455,34274964,베네주엘라,2012-06
2012-06-30,32042352,1790935,30251417,레바논,2012-06
2012-06-30,30745333,56605394,-25860061,덴마크,2012-06
2012-06-30,30334542,5597401,24737141,스리랑카,2012-06
2012-06-30,28711485,16194,28695291,앙골라,2012-06
2012-06-30,26575936,14385,26561551,아제르바이잔,2012-06
2012-06-30,25444815,37059598,-11614783,바레인,2012-06
2012-06-30,25374695,60046,25314649,시리아,2012-06
2012-06-30,25018291,24337075,681216,코스타리카,2012-06
2012-06-30,24764987,3286199,21478788,과테말라,2012-06
2012-06-30,24044441,3104585,20939856,가나,2012-06
2012-06-30,23346247,2626750,20719497,케냐,2012-06
2012-06-30,20012129,4499799,15512330,튀니지,2012-06
2012-06-30,19161971,10165519,8996452,포루투갈,2012-06
2012-06-30,18824301,21452076,-2627775,푸에르토리코,2012-06
2012-06-30,18013074,3298512,14714562,수단,2012-06
2012-06-30,16120581,2427352,13693229,우루과이,2012-06
2012-06-30,15493309,11059534,4433775,온두라스,2012-06
2012-06-30,15242336,45547,15196789,투르크멘,2012-06
2012-06-30,14618156,1670139,12948017,엘살바도르,2012-06
2012-06-30,14117367,490032,13627335,라오스,2012-06
2012-06-30,14056931,5619537,8437394,도미니카 공화국,2012-06
2012-06-30,13961673,3891373,10070300,파푸아 뉴기니,2012-06
2012-06-30,13921215,1861636,12059579,니카라과,2012-06
2012-06-30,13018451,2031474,10986977,라트비아,2012-06
2012-06-30,12375426,2456,12372970,아프카니스탄,2012-06
2012-06-30,11442756,62429324,-50986568,예맨,2012-06
2012-06-30,11351328,350,11350978,키르기스스탄,2012-06
2012-06-30,11020203,6141326,4878877,에스토니아,2012-06
2012-06-30,10774780,2192437,8582343,조지아,2012-06
2012-06-30,10510341,228179532,-217669191,브루나이,2012-06
2012-06-30,9732073,2182245,7549828,에티오피아,2012-06
2012-06-30,7832003,8006612,-174609,탄자니아,2012-06
2012-06-30,7741354,155281,7586073,코트디봐르,2012-06
2012-06-30,7591852,0,7591852,아메리칸 사모아,2012-06
2012-06-30,7004644,4157740,2846904,불가리아,2012-06
2012-06-30,6987116,396113,6591003,파라과이,2012-06
2012-06-30,6804718,2532553,4272165,리투아니아,2012-06
2012-06-30,6430044,0,6430044,지부티,2012-06
2012-06-30,5609185,4667489,941696,세네갈,2012-06
2012-06-30,5315025,13368315,-8053290,트리니다드 토바고,2012-06
2012-06-30,4975678,449569,4526109,모리셔스,2012-06
2012-06-30,4887659,1852822,3034837,벨라루스,2012-06
2012-06-30,4431644,0,4431644,팔레스타인 해방기구,2012-06
2012-06-30,3943242,13928988,-9985746,세르비아,2012-06
2012-06-30,3589144,270503,3318641,수리남,2012-06
2012-06-30,3406844,0,3406844,토고,2012-06
2012-06-30,3292104,1269116,2022988,카메룬,2012-06
2012-06-30,3273569,5767485,-2493916,기타국,2012-06
2012-06-30,3247494,73,3247421,부르키나 파소,2012-06
2012-06-30,3112852,857535,2255317,기니,2012-06
2012-06-30,3089877,26278160,-23188283,잠비아,2012-06
2012-06-30,3044910,1325040,1719870,크로아티아,2012-06
2012-06-30,2940267,198382,2741885,마다카스카르,2012-06
2012-06-30,2799120,24460169,-21661049,뉴 칼레도니아,2012-06
2012-06-30,2786290,1709985,1076305,베닝,2012-06
2012-06-30,2709194,68694,2640500,아르메니아,2012-06
2012-06-30,2638848,82716722,-80077874,사이프러스,2012-06
2012-06-30,2628732,76215734,-73587002,가봉,2012-06
2012-06-30,2587110,150202,2436908,쿠바,2012-06
2012-06-30,2467062,653985,1813077,자마이카,2012-06
2012-06-30,2278075,210745,2067330,짐바브웨,2012-06
2012-06-30,2273072,634793,1638279,마카오,2012-06
2012-06-30,2093343,11789847,-9696504,볼리비아,2012-06
2012-06-30,1989455,562675,1426780,아이티,2012-06
2012-06-30,1985754,0,1985754,타지크,2012-06
2012-06-30,1832373,1440405,391968,아이슬란드,2012-06
2012-06-30,1820245,275206,1545039,모잠비크,2012-06
2012-06-30,1809533,20815,1788718,아루바,2012-06
2012-06-30,1771682,0,1771682,불령 리유니온 코모도 제도,2012-06
2012-06-30,1771524,285562,1485962,나미비아,2012-06
2012-06-30,1626998,20339739,-18712741,콩고민주공화국,2012-06
2012-06-30,1590829,761926,828903,콩고,2012-06
2012-06-30,1511587,0,1511587,바베이도스,2012-06
2012-06-30,1506649,732739,773910,시에라 리온,2012-06
2012-06-30,1493072,913456,579616,말라위,2012-06
2012-06-30,1474759,276702,1198057,가이아나,2012-06
2012-06-30,1359392,1516721,-157329,피지,2012-06
2012-06-30,1303893,632,1303261,네덜란드 열도,2012-06
2012-06-30,1167773,0,1167773,적도 기니,2012-06
2012-06-30,1061237,79702,981535,네팔,2012-06
2012-06-30,933939,7534045,-6600106,룩셈부르그,2012-06
2012-06-30,873180,9896,863284,알바니아,2012-06
2012-06-30,826330,87176,739154,세이쉘,2012-06
2012-06-30,752759,91936,660823,벨리제,2012-06
2012-06-30,752657,325779,426878,모리타니,2012-06
2012-06-30,655129,282,654847,말리,2012-06
2012-06-30,644383,0,644383,파로에 군도,2012-06
2012-06-30,644080,0,644080,부탄,2012-06
2012-06-30,642388,5565652,-4923264,스와질랜드,2012-06
2012-06-30,603763,0,603763,세인트 루시아,2012-06
2012-06-30,573790,0,573790,북마리아나 군도,2012-06
2012-06-30,522392,0,522392,티모르,2012-06
2012-06-30,502538,448047,54491,마이크로네시아,2012-06
2012-06-30,486616,494811,-8195,우간다,2012-06
2012-06-30,482617,197045,285572,몰도바,2012-06
2012-06-30,482559,0,482559,영령 캐이맨 군도,2012-06
2012-06-30,448079,789577,-341498,리히텐슈타인,2012-06
2012-06-30,439041,42468,396573,니제르,2012-06
2012-06-30,424525,0,424525,보츠와나,2012-06
2012-06-30,399928,0,399928,마티니크,2012-06
2012-06-30,320984,2168667,-1847683,바누아투,2012-06
2012-06-30,266962,0,266962,불령 폴리네시아,2012-06
2012-06-30,264996,809101,-544105,솔로몬 군도,2012-06
2012-06-30,247085,17,247068,불령 가이아나,2012-06
2012-06-30,233000,3344850,-3111850,마세도니아,2012-06
2012-06-30,232454,112,232342,르완다,2012-06
2012-06-30,221872,1042,220830,그레나다,2012-06
2012-06-30,205471,7702,197769,안도라,2012-06
2012-06-30,201824,226,201598,세인트 키츠 네비스,2012-06
2012-06-30,199191,105384,93807,사모아,2012-06
2012-06-30,191780,189199,2581,도미니카,2012-06
2012-06-30,187901,13332,174569,몰디브,2012-06
2012-06-30,181158,0,181158,과델로프,2012-06
2012-06-30,178475,0,178475,키리바티,2012-06
2012-06-30,162894,576022,-413128,보스니아-헤르체고비나,2012-06
2012-06-30,161740,0,161740,지브랄타,2012-06
2012-06-30,156401,205243,-48842,모나코,2012-06
2012-06-30,148524,85,148439,몬테네그로,2012-06
2012-06-30,134378,0,134378,팔라우,2012-06
2012-06-30,133726,17904,115822,소말리아,2012-06
2012-06-30,128841,0,128841,세인트 빈센트 그레나딘,2012-06
2012-06-30,126038,0,126038,챠드,2012-06
2012-06-30,111015,0,111015,감비아,2012-06
2012-06-30,108712,0,108712,기네비소,2012-06
2012-06-30,105055,0,105055,투르크 & 카이코스 군도,2012-06
2012-06-30,102750,3253550,-3150800,안티가 바부다,2012-06
2012-06-30,100130,0,100130,에리트리아,2012-06
2012-06-30,58734,0,58734,카보 베르데,2012-06
2012-06-30,54441,28666,25775,노폴크 아일랜드,2012-06
2012-06-30,35500,0,35500,쿡 아일랜드,2012-06
2012-06-30,13424,0,13424,큐라소,2012-06
2012-06-30,10236,15433,-5197,중앙아프리카공화국,2012-06
2012-06-30,4200,126794,-122594,부룬디,2012-06
2012-06-30,4036,114799,-110763,통가,2012-06
2012-06-30,3275,327,2948,앙귈라,2012-06
2012-06-30,2890,2691,199,코스 군도,2012-06
2012-06-30,0,698,-698,니우에,2012-06
2012-06-30,0,4816615,-4816615,나우루,2012-06
2012-06-30,0,24867,-24867,세인트 헬레나,2012-06
2012-06-30,0,95237,-95237,레소토,2012-06
2012-06-30,0,25947,-25947,토켈라우,2012-06
2012-06-30,0,145895,-145895,투발루,2012-06
2012-06-30,0,7479,-7479,상토메 프린스페,2012-06
2012-06-30,0,264804,-264804,그린랜드,2012-06
2012-06-30,0,48284,-48284,산마리노,2012-06
2012-07-31,11247341363,6643524138,4603817225,중국,2012-07
2012-07-31,4692004268,3604758193,1087246075,미국,2012-07
2012-07-31,3337717682,5267517558,-1929799876,일본,2012-07
2012-07-31,2226851858,178156711,2048695147,홍콩,2012-07
2012-07-31,2210876678,825843093,1385033585,싱가포르,2012-07
2012-07-31,1351975837,388329176,963646661,베트남,2012-07
2012-07-31,1119238388,1138456164,-19217776,대만,2012-07
2012-07-31,1076147065,413834355,662312710,인도,2012-07
2012-07-31,1055517470,755169918,300347552,러시아 연방,2012-07
2012-07-31,928465258,1211540522,-283075264,인도네시아,2012-07
2012-07-31,885925786,2833814060,-1947888274,사우디아라비아,2012-07
2012-07-31,816841751,375007496,441834255,브라질,2012-07
2012-07-31,784256181,185766869,598489312,멕시코,2012-07
2012-07-31,764898074,2101941757,-1337043683,호주,2012-07
2012-07-31,763073704,253242013,509831691,필리핀,2012-07
2012-07-31,691474706,765511563,-74036857,말레이시아,2012-07
2012-07-31,668939363,420362831,248576532,태국,2012-07
2012-07-31,635061140,1062004990,-426943850,아랍에미리트 연합,2012-07
2012-07-31,599992349,347784664,252207685,네덜란드,2012-07
2012-07-31,538749824,557503758,-18753934,이란,2012-07
2012-07-31,500867471,1516419649,-1015552178,독일,2012-07
2012-07-31,428306636,453108454,-24801818,캐나다,2012-07
2012-07-31,403356190,15071862,388284328,슬로바키아,2012-07
2012-07-31,378621125,631533578,-252912453,영국,2012-07
2012-07-31,364820980,60467107,304353873,튀르키예,2012-07
2012-07-31,276737465,35561964,241175501,폴란드,2012-07
2012-07-31,225817642,481206713,-255389071,이탈리아,2012-07
2012-07-31,218357718,79117497,139240221,파나마,2012-07
2012-07-31,200579438,4867731,195711707,마샬군도,2012-07
2012-07-31,181843597,373288164,-191444567,칠레,2012-07
2012-07-31,169722933,404596167,-234873234,프랑스,2012-07
2012-07-31,162006942,494959179,-332952237,이라크,2012-07
2012-07-31,159145279,112687452,46457827,남아프리카공화국,2012-07
2012-07-31,157356116,35626482,121729634,이집트,2012-07
2012-07-31,157048299,53596734,103451565,그리스,2012-07
2012-07-31,153348041,121950191,31397850,벨기에,2012-07
2012-07-31,146140770,3426628,142714142,우즈베키스탄,2012-07
2012-07-31,134589126,8703521,125885605,슬로베니아,2012-07
2012-07-31,130910903,54763145,76147758,콜롬비아,2012-07
2012-07-31,127543971,43038466,84505505,체코공화국,2012-07
2012-07-31,126403103,25987220,100415883,방글라데시,2012-07
2012-07-31,122346205,207054720,-84708515,페루,2012-07
2012-07-31,121961229,13878737,108082492,몰타,2012-07
2012-07-31,120821728,99015,120722713,리비아,2012-07
2012-07-31,117282067,76483318,40798749,이스라엘,2012-07
2012-07-31,114836799,27900127,86936672,헝가리,2012-07
2012-07-31,110056575,1382231287,-1272174712,쿠웨이트,2012-07
2012-07-31,109747962,231245,109516717,라이베리아,2012-07
2012-07-31,108571658,817111436,-708539778,노르웨이,2012-07
2012-07-31,103127431,1128952,101998479,앙골라,2012-07
2012-07-31,101528487,7157930,94370557,요르단,2012-07
2012-07-31,98025149,477977,97547172,알제리,2012-07
2012-07-31,97351747,125972857,-28621110,뉴질랜드,2012-07
2012-07-31,96826164,6766,96819398,바하마,2012-07
2012-07-31,95390416,125028616,-29638200,스페인,2012-07
2012-07-31,94770227,66452914,28317313,아르헨티나,2012-07
2012-07-31,94066091,26743919,67322172,카자흐스탄,2012-07
2012-07-31,87554159,53262660,34291499,우크라이나,2012-07
2012-07-31,84189819,570383753,-486193934,오만,2012-07
2012-07-31,80508106,36300454,44207652,파키스탄,2012-07
2012-07-31,76524719,172599165,-96074446,나이지리아,2012-07
2012-07-31,72066008,3340518,68725490,에쿠아도르,2012-07
2012-07-31,65868665,107279256,-41410591,핀란드,2012-07
2012-07-31,62411162,165838244,-103427082,스웨덴,2012-07
2012-07-31,53354843,26611180,26743663,미얀마,2012-07
2012-07-31,49714087,2078721161,-2029007074,카타르,2012-07
2012-07-31,49414564,14797319,34617245,캄보디아,2012-07
2012-07-31,48104472,8879119,39225353,모로코,2012-07
2012-07-31,46316211,119459240,-73143029,오스트리아,2012-07
2012-07-31,37708321,410938,37297383,모나코,2012-07
2012-07-31,36365476,4861378,31504098,몽골,2012-07
2012-07-31,32084247,45212,32039035,불령 폴리네시아,2012-07
2012-07-31,31785662,8516172,23269490,과테말라,2012-07
2012-07-31,30435839,74617198,-44181359,덴마크,2012-07
2012-07-31,29369243,1794378,27574865,안티가 바부다,2012-07
2012-07-31,28342714,12088,28330626,아제르바이잔,2012-07
2012-07-31,28166594,17273356,10893238,코스타리카,2012-07
2012-07-31,28152289,236747108,-208594819,스위스,2012-07
2012-07-31,27930128,59460211,-31530083,바레인,2012-07
2012-07-31,27353938,6252628,21101310,스리랑카,2012-07
2012-07-31,26794679,14143896,12650783,베네주엘라,2012-07
2012-07-31,25860856,735055,25125801,레바논,2012-07
2012-07-31,25159069,3119197,22039872,가나,2012-07
2012-07-31,23761071,72180343,-48419272,루마니아,2012-07
2012-07-31,22361361,67780690,-45419329,아일랜드,2012-07
2012-07-31,21664035,39861732,-18197697,푸에르토리코,2012-07
2012-07-31,21017083,452238,20564845,투르크멘,2012-07
2012-07-31,19496756,3117579,16379177,케냐,2012-07
2012-07-31,17482886,2518824,14964062,니카라과,2012-07
2012-07-31,17244792,570187,16674605,라오스,2012-07
2012-07-31,15579893,8125526,7454367,온두라스,2012-07
2012-07-31,15324742,205893265,-190568523,예맨,2012-07
2012-07-31,15066003,14429038,636965,포루투갈,2012-07
2012-07-31,14608645,218224,14390421,시리아,2012-07
2012-07-31,14051573,4477,14047096,키르기스스탄,2012-07
2012-07-31,13695376,6784686,6910690,에스토니아,2012-07
2012-07-31,13658750,1749,13657001,아프카니스탄,2012-07
2012-07-31,13290021,1308164,11981857,우루과이,2012-07
2012-07-31,12571348,69336,12502012,파라과이,2012-07
2012-07-31,12214886,170538,12044348,코트디봐르,2012-07
2012-07-31,11853946,566964,11286982,조지아,2012-07
2012-07-31,11563225,1234724,10328501,기니,2012-07
2012-07-31,11482488,8889010,2593478,도미니카 공화국,2012-07
2012-07-31,11358111,4343233,7014878,튀니지,2012-07
2012-07-31,11346211,4027859,7318352,수단,2012-07
2012-07-31,11229940,3778836,7451104,리투아니아,2012-07
2012-07-31,11134604,535731,10598873,탄자니아,2012-07
2012-07-31,9963405,2833056,7130349,라트비아,2012-07
2012-07-31,9450767,94778,9355989,쿠바,2012-07
2012-07-31,9172112,2494274,6677838,에티오피아,2012-07
2012-07-31,9096194,0,9096194,지부티,2012-07
2012-07-31,8655855,101805969,-93150114,브루나이,2012-07
2012-07-31,7239501,10159715,-2920214,엘살바도르,2012-07
2012-07-31,7031486,6733413,298073,세네갈,2012-07
2012-07-31,6779217,51319358,-44540141,파푸아 뉴기니,2012-07
2012-07-31,6760618,32347366,-25586748,불가리아,2012-07
2012-07-31,5531430,458282,5073148,모리셔스,2012-07
2012-07-31,5519600,17156396,-11636796,세르비아,2012-07
2012-07-31,5422464,8597017,-3174553,기타국,2012-07
2012-07-31,5259697,1277529,3982168,괌,2012-07
2012-07-31,4579766,39307,4540459,벨리제,2012-07
2012-07-31,4382162,4745991,-363829,트리니다드 토바고,2012-07
2012-07-31,4333375,163,4333212,팔레스타인 해방기구,2012-07
2012-07-31,4308362,16200454,-11892092,모잠비크,2012-07
2012-07-31,4085432,471095,3614337,카메룬,2012-07
2012-07-31,3721629,91508,3630121,짐바브웨,2012-07
2012-07-31,3674802,98694862,-95020060,사이프러스,2012-07
2012-07-31,3615357,11648927,-8033570,뉴 칼레도니아,2012-07
2012-07-31,3557727,1515272,2042455,베닝,2012-07
2012-07-31,3259723,9638701,-6378978,벨라루스,2012-07
2012-07-31,3072303,4811064,-1738761,말라위,2012-07
2012-07-31,3018965,107918,2911047,세이쉘,2012-07
2012-07-31,2798560,1490609,1307951,크로아티아,2012-07
2012-07-31,2773841,19346439,-16572598,콩고민주공화국,2012-07
2012-07-31,2687269,813524,1873745,콩고,2012-07
2012-07-31,2525087,16047,2509040,수리남,2012-07
2012-07-31,2504785,1289963,1214822,피지,2012-07
2012-07-31,2497921,139611,2358310,마다카스카르,2012-07
2012-07-31,2348899,8991,2339908,타지크,2012-07
2012-07-31,2334349,2292093,42256,모리타니,2012-07
2012-07-31,2236702,21405761,-19169059,잠비아,2012-07
2012-07-31,2143357,175120,1968237,자마이카,2012-07
2012-07-31,2052715,16749775,-14697060,나미비아,2012-07
2012-07-31,1984579,244526,1740053,마카오,2012-07
2012-07-31,1977334,27987952,-26010618,볼리비아,2012-07
2012-07-31,1971960,20725,1951235,말리,2012-07
2012-07-31,1962761,25925,1936836,아르메니아,2012-07
2012-07-31,1953848,525412,1428436,아이티,2012-07
2012-07-31,1739036,171812,1567224,토고,2012-07
2012-07-31,1732019,51151,1680868,아루바,2012-07
2012-07-31,1441411,135012,1306399,네덜란드 열도,2012-07
2012-07-31,1432658,24958,1407700,부르키나 파소,2012-07
2012-07-31,1352498,4990,1347508,불령 리유니온 코모도 제도,2012-07
2012-07-31,1348969,0,1348969,아메리칸 사모아,2012-07
2012-07-31,1169052,63854,1105198,가이아나,2012-07
2012-07-31,1152589,5777619,-4625030,가봉,2012-07
2012-07-31,1137617,173392,964225,네팔,2012-07
2012-07-31,1066814,4087,1062727,니제르,2012-07
2012-07-31,1037715,3576973,-2539258,아이슬란드,2012-07
2012-07-31,996001,11362383,-10366382,룩셈부르그,2012-07
2012-07-31,870292,49000,821292,영령 버진군도,2012-07
2012-07-31,739856,33889,705967,몰디브,2012-07
2012-07-31,665928,0,665928,에리트리아,2012-07
2012-07-31,557658,408178,149480,몰도바,2012-07
2012-07-31,532030,0,532030,티모르,2012-07
2012-07-31,497964,707718,-209754,리히텐슈타인,2012-07
2012-07-31,493574,34340,459234,보츠와나,2012-07
2012-07-31,486981,8772,478209,알바니아,2012-07
2012-07-31,472831,867930,-395099,시에라 리온,2012-07
2012-07-31,456242,167,456075,부탄,2012-07
2012-07-31,422582,2565,420017,우간다,2012-07
2012-07-31,408300,0,408300,키리바티,2012-07
2012-07-31,408168,219866,188302,보스니아-헤르체고비나,2012-07
2012-07-31,391244,0,391244,마티니크,2012-07
2012-07-31,379317,11669,367648,북마리아나 군도,2012-07
2012-07-31,365782,114695,251087,사모아,2012-07
2012-07-31,347639,869,346770,르완다,2012-07
2012-07-31,344150,60653,283497,영령 캐이맨 군도,2012-07
2012-07-31,337774,6566789,-6229015,마세도니아,2012-07
2012-07-31,332032,0,332032,과델로프,2012-07
2012-07-31,331962,27098,304864,적도 기니,2012-07
2012-07-31,327424,0,327424,그레나다,2012-07
2012-07-31,326708,200,326508,버뮤다,2012-07
2012-07-31,323228,229,322999,바베이도스,2012-07
2012-07-31,321771,1456631,-1134860,마이크로네시아,2012-07
2012-07-31,320273,5445148,-5124875,스와질랜드,2012-07
2012-07-31,300854,0,300854,팔라우,2012-07
2012-07-31,276772,147617,129155,바누아투,2012-07
2012-07-31,255174,2235,252939,세인트 루시아,2012-07
2012-07-31,247316,833923,-586607,도미니카,2012-07
2012-07-31,233598,736666,-503068,솔로몬 군도,2012-07
2012-07-31,142628,0,142628,감비아,2012-07
2012-07-31,114088,2900,111188,산마리노,2012-07
2012-07-31,96832,22816,74016,몬테네그로,2012-07
2012-07-31,66970,0,66970,소말리아,2012-07
2012-07-31,65215,0,65215,세인트 키츠 네비스,2012-07
2012-07-31,64698,0,64698,레소토,2012-07
2012-07-31,54503,12690,41813,노폴크 아일랜드,2012-07
2012-07-31,41650,38524,3126,세인트 헬레나,2012-07
2012-07-31,41105,127767,-86662,통가,2012-07
2012-07-31,24175,0,24175,영령 인도양,2012-07
2012-07-31,23970,25612,-1642,중앙아프리카공화국,2012-07
2012-07-31,22812,0,22812,챠드,2012-07
2012-07-31,21796,0,21796,지브랄타,2012-07
2012-07-31,17191,0,17191,불령 가이아나,2012-07
2012-07-31,17097,0,17097,카보 베르데,2012-07
2012-07-31,16332,0,16332,투르크 & 카이코스 군도,2012-07
2012-07-31,14370,8198,6172,부룬디,2012-07
2012-07-31,13656,0,13656,큐라소,2012-07
2012-07-31,7247,17237,-9990,세인트 빈센트 그레나딘,2012-07
2012-07-31,5200,0,5200,상토메 프린스페,2012-07
2012-07-31,3900,77,3823,안도라,2012-07
2012-07-31,782,120,662,피트카이른,2012-07
2012-07-31,680,0,680,앙귈라,2012-07
2012-07-31,441,0,441,쿡 아일랜드,2012-07
2012-07-31,230,1938,-1708,미령 버진군도,2012-07
2012-07-31,100,245,-145,몬트세라트,2012-07
2012-07-31,0,10975172,-10975172,나우루,2012-07
2012-07-31,0,104360,-104360,그린랜드,2012-07
2012-07-31,0,4597,-4597,코모로스,2012-07
2012-07-31,0,3108,-3108,불령 남부지역,2012-07
2012-07-31,0,17620,-17620,교황청,2012-07
2012-07-31,0,319223,-319223,투발루,2012-07
2012-07-31,0,6976,-6976,토켈라우,2012-07
2012-07-31,0,21565,-21565,코스 군도,2012-07
2012-08-31,11061860561,6542001490,4519859071,중국,2012-08
2012-08-31,4221897982,3232144608,989753374,미국,2012-08
2012-08-31,3179793894,5100299203,-1920505309,일본,2012-08
2012-08-31,2487766109,166975643,2320790466,홍콩,2012-08
2012-08-31,1543570481,769663473,773907008,싱가포르,2012-08
2012-08-31,1380809715,596093151,784716564,베트남,2012-08
2012-08-31,1276124715,1096533199,179591516,대만,2012-08
2012-08-31,1134900937,1150478572,-15577635,인도네시아,2012-08
2012-08-31,958092070,1001156089,-43064019,러시아 연방,2012-08
2012-08-31,889476556,517404238,372072318,인도,2012-08
2012-08-31,752103883,243653719,508450164,멕시코,2012-08
2012-08-31,722829721,532090660,190739061,브라질,2012-08
2012-08-31,720180418,1949322839,-1229142421,호주,2012-08
2012-08-31,704226956,3319553090,-2615326134,사우디아라비아,2012-08
2012-08-31,675407991,454927838,220480153,태국,2012-08
2012-08-31,668257309,302036711,366220598,네덜란드,2012-08
2012-08-31,567080106,234660059,332420047,필리핀,2012-08
2012-08-31,534330436,49675,534280761,영령 버진군도,2012-08
2012-08-31,500688785,489445427,11243358,영국,2012-08
2012-08-31,492377749,703047854,-210670105,말레이시아,2012-08
2012-08-31,482251394,992906728,-510655334,아랍에미리트 연합,2012-08
2012-08-31,462956113,52547133,410408980,이란,2012-08
2012-08-31,459890232,1425862206,-965971974,독일,2012-08
2012-08-31,393419737,11668713,381751024,슬로바키아,2012-08
2012-08-31,349484319,405790142,-56305823,캐나다,2012-08
2012-08-31,326332805,37657083,288675722,폴란드,2012-08
2012-08-31,320960958,48786365,272174593,튀르키예,2012-08
2012-08-31,280026526,396354544,-116328018,이탈리아,2012-08
2012-08-31,247095129,7035,247088094,마샬군도,2012-08
2012-08-31,236428282,74892222,161536060,그리스,2012-08
2012-08-31,187084615,2295529,184789086,파나마,2012-08
2012-08-31,178819049,374506632,-195687583,프랑스,2012-08
2012-08-31,170929633,7793408,163136225,몰타,2012-08
2012-08-31,164356044,375153402,-210797358,칠레,2012-08
2012-08-31,154531504,331119272,-176587768,노르웨이,2012-08
2012-08-31,143632076,800,143631276,라이베리아,2012-08
2012-08-31,143309457,102021507,41287950,뉴질랜드,2012-08
2012-08-31,139830096,96190754,43639342,이스라엘,2012-08
2012-08-31,136288551,193324791,-57036240,남아프리카공화국,2012-08
2012-08-31,136012981,9108959,126904022,슬로베니아,2012-08
2012-08-31,132127296,57994954,74132342,체코공화국,2012-08
2012-08-31,124278162,77235641,47042521,핀란드,2012-08
2012-08-31,122629442,116692686,5936756,벨기에,2012-08
2012-08-31,118609445,1657612,116951833,우즈베키스탄,2012-08
2012-08-31,113299664,34974785,78324879,헝가리,2012-08
2012-08-31,112682491,296098,112386393,모나코,2012-08
2012-08-31,108896415,1362419577,-1253523162,이라크,2012-08
2012-08-31,107884917,141148850,-33263933,페루,2012-08
2012-08-31,99017013,96915538,2101475,스페인,2012-08
2012-08-31,97779135,110378907,-12599772,이집트,2012-08
2012-08-31,94022495,1377139938,-1283117443,쿠웨이트,2012-08
2012-08-31,89860451,79843829,10016622,콜롬비아,2012-08
2012-08-31,84896708,619227,84277481,알제리,2012-08
2012-08-31,83595909,8679487,74916422,요르단,2012-08
2012-08-31,79731520,87866386,-8134866,아르헨티나,2012-08
2012-08-31,79111378,23485441,55625937,카자흐스탄,2012-08
2012-08-31,75350919,110137084,-34786165,오스트리아,2012-08
2012-08-31,75149451,37471378,37678073,방글라데시,2012-08
2012-08-31,71157894,1989696474,-1918538580,카타르,2012-08
2012-08-31,71153151,0,71153151,버뮤다,2012-08
2012-08-31,69663674,2935373,66728301,에쿠아도르,2012-08
2012-08-31,66620101,128579,66491522,리비아,2012-08
2012-08-31,65136734,58117974,7018760,사이프러스,2012-08
2012-08-31,61689212,80478627,-18789415,파키스탄,2012-08
2012-08-31,59222021,44520537,14701484,나이지리아,2012-08
2012-08-31,58636647,44552712,14083935,우크라이나,2012-08
2012-08-31,57385435,468860507,-411475072,오만,2012-08
2012-08-31,57176526,110844440,-53667914,스웨덴,2012-08
2012-08-31,50979196,46741287,4237909,아일랜드,2012-08
2012-08-31,45341126,35252619,10088507,미얀마,2012-08
2012-08-31,45019798,10868975,34150823,캄보디아,2012-08
2012-08-31,40821588,877149,39944439,앙골라,2012-08
2012-08-31,40749782,14068123,26681659,모로코,2012-08
2012-08-31,40609866,57588093,-16978227,덴마크,2012-08
2012-08-31,38602896,21928,38580968,바하마,2012-08
2012-08-31,33134208,50574076,-17439868,루마니아,2012-08
2012-08-31,32266384,4624349,27642035,몽골,2012-08
2012-08-31,28755545,59085443,-30329898,바레인,2012-08
2012-08-31,26163305,1208656,24954649,레바논,2012-08
2012-08-31,23812120,204621126,-180809006,스위스,2012-08
2012-08-31,23240485,271119,22969366,쿠바,2012-08
2012-08-31,21534317,16623173,4911144,포루투갈,2012-08
2012-08-31,20595028,6449107,14145921,스리랑카,2012-08
2012-08-31,19675434,2168906,17506528,가나,2012-08
2012-08-31,19495656,35712268,-16216612,베네주엘라,2012-08
2012-08-31,19316529,45174,19271355,투르크멘,2012-08
2012-08-31,18930482,24169111,-5238629,코스타리카,2012-08
2012-08-31,18615503,7746574,10868929,과테말라,2012-08
2012-08-31,17519284,16236800,1282484,푸에르토리코,2012-08
2012-08-31,16962328,0,16962328,적도 기니,2012-08
2012-08-31,15885818,2090517,13795301,케냐,2012-08
2012-08-31,13405393,5919325,7486068,우루과이,2012-08
2012-08-31,13380471,3656,13376815,키르기스스탄,2012-08
2012-08-31,13204463,1431264,11773199,니카라과,2012-08
2012-08-31,12850736,2584983,10265753,리투아니아,2012-08
2012-08-31,11738969,4980372,6758597,튀니지,2012-08
2012-08-31,11592696,3833468,7759228,수단,2012-08
2012-08-31,10939472,0,10939472,지부티,2012-08
2012-08-31,10866279,2155,10864124,아프카니스탄,2012-08
2012-08-31,10832358,31,10832327,아제르바이잔,2012-08
2012-08-31,10819670,144052,10675618,시리아,2012-08
2012-08-31,9779180,889954,8889226,에티오피아,2012-08
2012-08-31,9735215,7040510,2694705,에스토니아,2012-08
2012-08-31,9543301,3512,9539789,코트디봐르,2012-08
2012-08-31,9250973,11531424,-2280451,도미니카 공화국,2012-08
2012-08-31,8779597,264125,8515472,탄자니아,2012-08
2012-08-31,8593457,8513612,79845,온두라스,2012-08
2012-08-31,8211884,64063273,-55851389,예맨,2012-08
2012-08-31,8200981,384522,7816459,파라과이,2012-08
2012-08-31,8033804,462569,7571235,라오스,2012-08
2012-08-31,7840879,3244815,4596064,라트비아,2012-08
2012-08-31,7473026,148331,7324695,세이쉘,2012-08
2012-08-31,6156033,9012199,-2856166,파푸아 뉴기니,2012-08
2012-08-31,5952694,519895,5432799,조지아,2012-08
2012-08-31,5234869,6724399,-1489530,엘살바도르,2012-08
2012-08-31,5189545,305025,4884520,괌,2012-08
2012-08-31,5149603,0,5149603,토고,2012-08
2012-08-31,5129595,215320320,-210190725,브루나이,2012-08
2012-08-31,5007291,15431958,-10424667,불가리아,2012-08
2012-08-31,4731033,21576107,-16845074,뉴 칼레도니아,2012-08
2012-08-31,4520597,684143,3836454,모리셔스,2012-08
2012-08-31,4247749,4727732,-479983,세네갈,2012-08
2012-08-31,4160930,0,4160930,부르키나 파소,2012-08
2012-08-31,3886075,9570,3876505,팔레스타인 해방기구,2012-08
2012-08-31,3874844,564088,3310756,마카오,2012-08
2012-08-31,3835674,306556,3529118,콩고,2012-08
2012-08-31,3767124,18355349,-14588225,모잠비크,2012-08
2012-08-31,3668455,42106929,-38438474,트리니다드 토바고,2012-08
2012-08-31,3302406,801010,2501396,카메룬,2012-08
2012-08-31,3054380,23436246,-20381866,콩고민주공화국,2012-08
2012-08-31,2951062,0,2951062,타지크,2012-08
2012-08-31,2942264,1149298,1792966,기니,2012-08
2012-08-31,2916388,20411608,-17495220,잠비아,2012-08
2012-08-31,2871766,15921787,-13050021,세르비아,2012-08
2012-08-31,2797540,239623,2557917,마다카스카르,2012-08
2012-08-31,2793284,46080,2747204,짐바브웨,2012-08
2012-08-31,2765907,576115,2189792,벨라루스,2012-08
2012-08-31,2559152,1409031,1150121,크로아티아,2012-08
2012-08-31,2395403,1277222,1118181,베닝,2012-08
2012-08-31,2167535,4390805,-2223270,기타국,2012-08
2012-08-31,2110654,310066,1800588,아이티,2012-08
2012-08-31,2043391,45154829,-43111438,볼리비아,2012-08
2012-08-31,2013311,1654701,358610,아이슬란드,2012-08
2012-08-31,1952289,39925,1912364,아르메니아,2012-08
2012-08-31,1894556,34,1894522,불령 리유니온 코모도 제도,2012-08
2012-08-31,1788536,0,1788536,아메리칸 사모아,2012-08
2012-08-31,1725617,28516,1697101,말라위,2012-08
2012-08-31,1657041,1553,1655488,말리,2012-08
2012-08-31,1572114,55369,1516745,가이아나,2012-08
2012-08-31,1520618,280929,1239689,자마이카,2012-08
2012-08-31,1358760,4165684,-2806924,가봉,2012-08
2012-08-31,1139540,1770037,-630497,피지,2012-08
2012-08-31,1131642,0,1131642,바베이도스,2012-08
2012-08-31,1097685,29317,1068368,네덜란드 열도,2012-08
2012-08-31,1091930,73908,1018022,사모아,2012-08
2012-08-31,1055728,808207,247521,보스니아-헤르체고비나,2012-08
2012-08-31,978512,301191,677321,네팔,2012-08
2012-08-31,941128,12876,928252,북마리아나 군도,2012-08
2012-08-31,804687,8056591,-7251904,룩셈부르그,2012-08
2012-08-31,778555,19841,758714,아루바,2012-08
2012-08-31,754208,138245,615963,수리남,2012-08
2012-08-31,752804,0,752804,마티니크,2012-08
2012-08-31,629893,1284612,-654719,모리타니,2012-08
2012-08-31,584383,394564,189819,알바니아,2012-08
2012-08-31,578274,42,578232,니제르,2012-08
2012-08-31,572212,59778,512434,영령 캐이맨 군도,2012-08
2012-08-31,550657,2139,548518,나미비아,2012-08
2012-08-31,539821,54490733,-53950912,티모르,2012-08
2012-08-31,529595,851,528744,보츠와나,2012-08
2012-08-31,518756,590762,-72006,마이크로네시아,2012-08
2012-08-31,488019,284,487735,벨리제,2012-08
2012-08-31,453845,216,453629,과델로프,2012-08
2012-08-31,443435,139973,303462,시에라 리온,2012-08
2012-08-31,438917,34,438883,불령 폴리네시아,2012-08
2012-08-31,419388,0,419388,소말리아,2012-08
2012-08-31,387748,2190053,-1802305,몰도바,2012-08
2012-08-31,375489,9523,365966,바누아투,2012-08
2012-08-31,347722,1248082,-900360,키리바티,2012-08
2012-08-31,318975,573606,-254631,우간다,2012-08
2012-08-31,315107,0,315107,에리트리아,2012-08
2012-08-31,301074,487461,-186387,리히텐슈타인,2012-08
2012-08-31,278773,4110578,-3831805,마세도니아,2012-08
2012-08-31,236904,0,236904,부탄,2012-08
2012-08-31,234509,0,234509,안도라,2012-08
2012-08-31,218583,462701,-244118,스와질랜드,2012-08
2012-08-31,193294,448810,-255516,도미니카,2012-08
2012-08-31,175152,41,175111,몰디브,2012-08
2012-08-31,169669,0,169669,팔라우,2012-08
2012-08-31,146323,263,146060,세인트 빈센트 그레나딘,2012-08
2012-08-31,144152,1061,143091,카보 베르데,2012-08
2012-08-31,141713,0,141713,세인트 키츠 네비스,2012-08
2012-08-31,140617,768202,-627585,솔로몬 군도,2012-08
2012-08-31,138537,0,138537,감비아,2012-08
2012-08-31,138011,9642,128369,르완다,2012-08
2012-08-31,105591,0,105591,세인트 루시아,2012-08
2012-08-31,89602,0,89602,산마리노,2012-08
2012-08-31,50655,0,50655,노폴크 아일랜드,2012-08
2012-08-31,42942,35,42907,투르크 & 카이코스 군도,2012-08
2012-08-31,40433,0,40433,지브랄타,2012-08
2012-08-31,40024,0,40024,그레나다,2012-08
2012-08-31,35110,14914,20196,중앙아프리카공화국,2012-08
2012-08-31,26919,155410,-128491,통가,2012-08
2012-08-31,25377,0,25377,파로에 군도,2012-08
2012-08-31,24372,0,24372,앙귈라,2012-08
2012-08-31,20894,0,20894,불령 가이아나,2012-08
2012-08-31,14489,6357,8132,레소토,2012-08
2012-08-31,11630,0,11630,안타티카,2012-08
2012-08-31,10475,0,10475,남조지아 & 남샌드위치 군도,2012-08
2012-08-31,7256,190096,-182840,기네비소,2012-08
2012-08-31,5949,2212098,-2206149,안티가 바부다,2012-08
2012-08-31,4200,8220,-4020,부룬디,2012-08
2012-08-31,3122,0,3122,상토메 프린스페,2012-08
2012-08-31,594,823,-229,코스 군도,2012-08
2012-08-31,0,4586,-4586,마이너 아우틀링 합중국 군도,2012-08
2012-08-31,0,295651,-295651,투발루,2012-08
2012-08-31,0,83338,-83338,그린랜드,2012-08
2012-08-31,0,7283,-7283,몬테네그로,2012-08
2012-08-31,0,6110,-6110,토켈라우,2012-08
2012-08-31,0,29698,-29698,몬트세라트,2012-08
2012-08-31,0,58165,-58165,세인트 헬레나,2012-08
2012-08-31,0,583,-583,크리스마스 아일랜드,2012-08
2012-08-31,0,2361,-2361,미령 버진군도,2012-08
2012-08-31,0,12420,-12420,나우루,2012-08
2012-08-31,0,20,-20,교황청,2012-08
2012-09-30,11783075626,6677076767,5105998859,중국,2012-09
2012-09-30,4813841920,3276136233,1537705687,미국,2012-09
2012-09-30,3038832724,177578331,2861254393,홍콩,2012-09
2012-09-30,2967153292,5326948366,-2359795074,일본,2012-09
2012-09-30,1904446319,885012538,1019433781,싱가포르,2012-09
2012-09-30,1340309229,585030754,755278475,베트남,2012-09
2012-09-30,1155684472,645159731,510524741,인도,2012-09
2012-09-30,1118496570,1127983879,-9487309,대만,2012-09
2012-09-30,972891176,1111620230,-138729054,러시아 연방,2012-09
2012-09-30,858460241,961002685,-102542444,인도네시아,2012-09
2012-09-30,845705674,255664158,590041516,멕시코,2012-09
2012-09-30,822025790,2107373248,-1285347458,호주,2012-09
2012-09-30,798005293,424970438,373034855,브라질,2012-09
2012-09-30,741024942,2939250423,-2198225481,사우디아라비아,2012-09
2012-09-30,722301717,1491497968,-769196251,독일,2012-09
2012-09-30,689819354,500237502,189581852,태국,2012-09
2012-09-30,644214606,855808306,-211593700,말레이시아,2012-09
2012-09-30,640692047,251237246,389454801,필리핀,2012-09
2012-09-30,596635647,767787289,-171151642,영국,2012-09
2012-09-30,589065471,1126932772,-537867301,아랍에미리트 연합,2012-09
2012-09-30,530191140,106627526,423563614,이란,2012-09
2012-09-30,459727874,250882153,208845721,네덜란드,2012-09
2012-09-30,409656206,14460040,395196166,슬로바키아,2012-09
2012-09-30,387293063,395439737,-8146674,캐나다,2012-09
2012-09-30,354253343,53662174,300591169,폴란드,2012-09
2012-09-30,339298427,48104502,291193925,튀르키예,2012-09
2012-09-30,289806931,413817126,-124010195,이탈리아,2012-09
2012-09-30,227447442,302287,227145155,라이베리아,2012-09
2012-09-30,225513165,316948817,-91435652,칠레,2012-09
2012-09-30,220560410,357191616,-136631206,프랑스,2012-09
2012-09-30,216010006,2264,216007742,마샬군도,2012-09
2012-09-30,204616600,1261305930,-1056689330,이라크,2012-09
2012-09-30,203454338,163696285,39758053,남아프리카공화국,2012-09
2012-09-30,188629435,80153195,108476240,벨기에,2012-09
2012-09-30,178543242,1065777,177477465,우즈베키스탄,2012-09
2012-09-30,151376930,26147266,125229664,이집트,2012-09
2012-09-30,140173083,28583151,111589932,몰타,2012-09
2012-09-30,139615517,93694025,45921492,뉴질랜드,2012-09
2012-09-30,136434725,89428432,47006293,페루,2012-09
2012-09-30,133848285,46109842,87738443,체코공화국,2012-09
2012-09-30,128597623,6049039,122548584,슬로베니아,2012-09
2012-09-30,124585200,52825846,71759354,이스라엘,2012-09
2012-09-30,114499468,1519816529,-1405317061,쿠웨이트,2012-09
2012-09-30,109644245,14676908,94967337,콜롬비아,2012-09
2012-09-30,108561609,114863536,-6301927,스페인,2012-09
2012-09-30,108063275,40618162,67445113,헝가리,2012-09
2012-09-30,105731907,3196525,102535382,요르단,2012-09
2012-09-30,99613619,98540309,1073310,오스트리아,2012-09
2012-09-30,95516933,29139125,66377808,방글라데시,2012-09
2012-09-30,91794258,79876806,11917452,알제리,2012-09
2012-09-30,90134644,166426539,-76291895,아르헨티나,2012-09
2012-09-30,86324137,352503597,-266179460,오만,2012-09
2012-09-30,85778582,21287501,64491081,카자흐스탄,2012-09
2012-09-30,83403168,2718712,80684456,그리스,2012-09
2012-09-30,82759148,259645,82499503,리비아,2012-09
2012-09-30,75931110,47782891,28148219,파키스탄,2012-09
2012-09-30,72780155,3618490,69161665,에쿠아도르,2012-09
2012-09-30,69066247,107775334,-38709087,스웨덴,2012-09
2012-09-30,66856752,6407656,60449096,나이지리아,2012-09
2012-09-30,65331200,492682706,-427351506,노르웨이,2012-09
2012-09-30,65262135,137019169,-71757034,파나마,2012-09
2012-09-30,58344788,2510364448,-2452019660,카타르,2012-09
2012-09-30,56436377,59244008,-2807631,우크라이나,2012-09
2012-09-30,54863351,51069181,3794170,루마니아,2012-09
2012-09-30,52704021,164512,52539509,앙골라,2012-09
2012-09-30,48501289,15579940,32921349,캄보디아,2012-09
2012-09-30,46460111,51908898,-5448787,미얀마,2012-09
2012-09-30,37707127,199648,37507479,모나코,2012-09
2012-09-30,36226629,122389,36104240,불령 폴리네시아,2012-09
2012-09-30,35676316,42418880,-6742564,모로코,2012-09
2012-09-30,30913610,5363022,25550588,몽골,2012-09
2012-09-30,30629771,104029538,-73399767,핀란드,2012-09
2012-09-30,30052282,84121927,-54069645,바레인,2012-09
2012-09-30,28154336,24403761,3750575,코스타리카,2012-09
2012-09-30,27768869,8702,27760167,시리아,2012-09
2012-09-30,27072078,5496272,21575806,베네주엘라,2012-09
2012-09-30,26308570,3007668,23300902,레바논,2012-09
2012-09-30,26130154,19373586,6756568,과테말라,2012-09
2012-09-30,24959968,0,24959968,바하마,2012-09
2012-09-30,24265026,0,24265026,아제르바이잔,2012-09
2012-09-30,24258474,6533142,17725332,스리랑카,2012-09
2012-09-30,23001854,65533823,-42531969,덴마크,2012-09
2012-09-30,22657341,3553,22653788,아프카니스탄,2012-09
2012-09-30,22643447,1771279,20872168,케냐,2012-09
2012-09-30,21761638,2255029,19506609,가나,2012-09
2012-09-30,21732685,196692197,-174959512,스위스,2012-09
2012-09-30,19207692,32555880,-13348188,푸에르토리코,2012-09
2012-09-30,19008441,13782986,5225455,포루투갈,2012-09
2012-09-30,18831566,76585,18754981,투르크멘,2012-09
2012-09-30,16325179,10893596,5431583,우루과이,2012-09
2012-09-30,15519890,1307580,14212310,니카라과,2012-09
2012-09-30,15302438,1947283,13355155,에티오피아,2012-09
2012-09-30,15221525,6668,15214857,키르기스스탄,2012-09
2012-09-30,14750179,14547766,202413,도미니카 공화국,2012-09
2012-09-30,14350959,71197616,-56846657,아일랜드,2012-09
2012-09-30,11908557,9980485,1928072,불가리아,2012-09
2012-09-30,11853313,34669911,-22816598,예맨,2012-09
2012-09-30,11598665,10543283,1055382,에스토니아,2012-09
2012-09-30,11546613,23855053,-12308440,파라과이,2012-09
2012-09-30,11035953,2312188,8723765,리투아니아,2012-09
2012-09-30,10931695,4192444,6739251,수단,2012-09
2012-09-30,10558994,2659124,7899870,튀니지,2012-09
2012-09-30,9937368,125005,9812363,쿠바,2012-09
2012-09-30,9409633,13887372,-4477739,온두라스,2012-09
2012-09-30,8952135,601113,8351022,조지아,2012-09
2012-09-30,8930057,112664,8817393,탄자니아,2012-09
2012-09-30,8274184,4284876,3989308,라트비아,2012-09
2012-09-30,7622798,103839305,-96216507,브루나이,2012-09
2012-09-30,7239059,0,7239059,지부티,2012-09
2012-09-30,7210074,1809460,5400614,엘살바도르,2012-09
2012-09-30,6863887,219326,6644561,라오스,2012-09
2012-09-30,6410898,158887,6252011,코트디봐르,2012-09
2012-09-30,6240713,49898612,-43657899,트리니다드 토바고,2012-09
2012-09-30,5900986,397392,5503594,모리셔스,2012-09
2012-09-30,5751461,554464,5196997,마이크로네시아,2012-09
2012-09-30,4843792,9886461,-5042669,파푸아 뉴기니,2012-09
2012-09-30,4622015,3913999,708016,세네갈,2012-09
2012-09-30,4316417,30630637,-26314220,세르비아,2012-09
2012-09-30,4135343,11721960,-7586617,뉴 칼레도니아,2012-09
2012-09-30,3979047,5778,3973269,말라위,2012-09
2012-09-30,3959077,216989,3742088,자마이카,2012-09
2012-09-30,3905564,28456440,-24550876,잠비아,2012-09
2012-09-30,3806893,270370,3536523,괌,2012-09
2012-09-30,3422570,738550,2684020,벨라루스,2012-09
2012-09-30,3336866,126731,3210135,팔레스타인 해방기구,2012-09
2012-09-30,3334191,3763493,-429302,나미비아,2012-09
2012-09-30,3207794,474,3207320,아메리칸 사모아,2012-09
2012-09-30,3174289,111666236,-108491947,사이프러스,2012-09
2012-09-30,3054277,845197,2209080,타지크,2012-09
2012-09-30,3031845,1347976,1683869,카메룬,2012-09
2012-09-30,3022519,72219395,-69196876,적도 기니,2012-09
2012-09-30,2903940,1340778,1563162,크로아티아,2012-09
2012-09-30,2659680,7270101,-4610421,기타국,2012-09
2012-09-30,2656090,487030,2169060,기니,2012-09
2012-09-30,2630596,0,2630596,시에라 리온,2012-09
2012-09-30,2615202,16821,2598381,모잠비크,2012-09
2012-09-30,2553597,1701413,852184,베닝,2012-09
2012-09-30,2490007,281374,2208633,마다카스카르,2012-09
2012-09-30,2434508,53440,2381068,짐바브웨,2012-09
2012-09-30,2371843,196,2371647,말리,2012-09
2012-09-30,2347037,233100,2113937,마카오,2012-09
2012-09-30,2329754,33703844,-31374090,콩고민주공화국,2012-09
2012-09-30,2325115,9739597,-7414482,볼리비아,2012-09
2012-09-30,2288240,305278,1982962,수리남,2012-09
2012-09-30,2061009,12,2060997,네덜란드 열도,2012-09
2012-09-30,2028642,932465,1096177,피지,2012-09
2012-09-30,2012370,839,2011531,니제르,2012-09
2012-09-30,1874166,63223,1810943,아루바,2012-09
2012-09-30,1842924,531726,1311198,보스니아-헤르체고비나,2012-09
2012-09-30,1740388,150001,1590387,네팔,2012-09
2012-09-30,1621793,4640,1617153,불령 리유니온 코모도 제도,2012-09
2012-09-30,1596482,0,1596482,과델로프,2012-09
2012-09-30,1555977,3946023,-2390046,아이슬란드,2012-09
2012-09-30,1537485,0,1537485,영령 캐이맨 군도,2012-09
2012-09-30,1518476,718865,799611,아르메니아,2012-09
2012-09-30,1512491,2,1512489,토고,2012-09
2012-09-30,1479170,2,1479168,부르키나 파소,2012-09
2012-09-30,1440482,2595481,-1154999,가봉,2012-09
2012-09-30,1408211,109899,1298312,가이아나,2012-09
2012-09-30,1329560,8099,1321461,세이쉘,2012-09
2012-09-30,1171771,2360584,-1188813,콩고,2012-09
2012-09-30,1145075,1055,1144020,북마리아나 군도,2012-09
2012-09-30,1034047,1708759,-674712,룩셈부르그,2012-09
2012-09-30,963984,69700,894284,티모르,2012-09
2012-09-30,899995,188074,711921,아이티,2012-09
2012-09-30,880881,0,880881,마티니크,2012-09
2012-09-30,818334,0,818334,세인트 루시아,2012-09
2012-09-30,810265,445501,364764,우간다,2012-09
2012-09-30,790957,0,790957,버뮤다,2012-09
2012-09-30,719236,322,718914,바베이도스,2012-09
2012-09-30,702065,0,702065,키리바티,2012-09
2012-09-30,539939,0,539939,불령 가이아나,2012-09
2012-09-30,517641,0,517641,사모아,2012-09
2012-09-30,472473,147562,324911,알바니아,2012-09
2012-09-30,458456,0,458456,소말리아,2012-09
2012-09-30,437006,941392,-504386,리히텐슈타인,2012-09
2012-09-30,427299,7570450,-7143151,마세도니아,2012-09
2012-09-30,414910,1345057,-930147,도미니카,2012-09
2012-09-30,414340,31665,382675,안도라,2012-09
2012-09-30,400052,3028,397024,벨리제,2012-09
2012-09-30,393824,0,393824,보츠와나,2012-09
2012-09-30,388068,3828,384240,몰디브,2012-09
2012-09-30,340960,0,340960,에리트리아,2012-09
2012-09-30,314818,1167389,-852571,몰도바,2012-09
2012-09-30,313539,6477,307062,부탄,2012-09
2012-09-30,304955,0,304955,팔라우,2012-09
2012-09-30,299445,0,299445,감비아,2012-09
2012-09-30,266965,0,266965,세인트 빈센트 그레나딘,2012-09
2012-09-30,243875,991441,-747566,모리타니,2012-09
2012-09-30,189799,1780,188019,영령 버진군도,2012-09
2012-09-30,187713,420637,-232924,스와질랜드,2012-09
2012-09-30,177148,13391,163757,안티가 바부다,2012-09
2012-09-30,165229,12587,152642,르완다,2012-09
2012-09-30,161653,218,161435,세인트 키츠 네비스,2012-09
2012-09-30,157896,0,157896,지브랄타,2012-09
2012-09-30,124274,0,124274,카보 베르데,2012-09
2012-09-30,113271,79432,33839,바누아투,2012-09
2012-09-30,99201,1716321,-1617120,솔로몬 군도,2012-09
2012-09-30,96747,0,96747,몬테네그로,2012-09
2012-09-30,87726,0,87726,그레나다,2012-09
2012-09-30,78057,4482,73575,레소토,2012-09
2012-09-30,69346,0,69346,투르크 & 카이코스 군도,2012-09
2012-09-30,62376,16220,46156,중앙아프리카공화국,2012-09
2012-09-30,62120,110,62010,앙귈라,2012-09
2012-09-30,37887,0,37887,쿡 아일랜드,2012-09
2012-09-30,34484,0,34484,국제통화기금,2012-09
2012-09-30,31600,686,30914,교황청,2012-09
2012-09-30,27817,0,27817,산마리노,2012-09
2012-09-30,24385,2256,22129,통가,2012-09
2012-09-30,24300,0,24300,챠드,2012-09
2012-09-30,15633,0,15633,피트카이른,2012-09
2012-09-30,8276,0,8276,파로에 군도,2012-09
2012-09-30,4478,651,3827,세인트 마틴,2012-09
2012-09-30,624,0,624,서사하라,2012-09
2012-09-30,350,4125,-3775,부룬디,2012-09
2012-09-30,0,313,-313,노폴크 아일랜드,2012-09
2012-09-30,0,73553,-73553,그린랜드,2012-09
2012-09-30,0,3368,-3368,영령 인도양,2012-09
2012-09-30,0,12556,-12556,몬트세라트,2012-09
2012-09-30,0,63701,-63701,기네비소,2012-09
2012-09-30,0,3036,-3036,크리스마스 아일랜드,2012-09
2012-09-30,0,5941,-5941,토켈라우,2012-09
2012-09-30,0,14228,-14228,니우에,2012-09
2012-10-31,12461125903,7094929415,5366196488,중국,2012-10
2012-10-31,4438501425,3657163066,781338359,미국,2012-10
2012-10-31,3291482280,5368786920,-2077304640,일본,2012-10
2012-10-31,2893857628,179540090,2714317538,홍콩,2012-10
2012-10-31,2073689556,801849901,1271839655,싱가포르,2012-10
2012-10-31,1378261202,657058585,721202617,베트남,2012-10
2012-10-31,1279868954,1295468290,-15599336,인도네시아,2012-10
2012-10-31,1186420532,1238469750,-52049218,대만,2012-10
2012-10-31,958411146,16990044,941421102,파나마,2012-10
2012-10-31,888268779,1260518227,-372249448,러시아 연방,2012-10
2012-10-31,877714851,622857502,254857349,인도,2012-10
2012-10-31,867138544,172039069,695099475,멕시코,2012-10
2012-10-31,835124485,838309961,-3185476,말레이시아,2012-10
2012-10-31,818540993,3594356241,-2775815248,사우디아라비아,2012-10
2012-10-31,786016668,601415118,184601550,브라질,2012-10
2012-10-31,784931359,1882831054,-1097899695,호주,2012-10
2012-10-31,744453413,447778631,296674782,태국,2012-10
2012-10-31,722523010,1437971621,-715448611,독일,2012-10
2012-10-31,717796353,319757086,398039267,필리핀,2012-10
2012-10-31,609206044,402794827,206411217,영국,2012-10
2012-10-31,558126600,1260804590,-702677990,아랍에미리트 연합,2012-10
2012-10-31,521630316,790725745,-269095429,이란,2012-10
2012-10-31,443403777,13802340,429601437,슬로바키아,2012-10
2012-10-31,419926602,25928239,393998363,튀르키예,2012-10
2012-10-31,346325074,351323670,-4998596,캐나다,2012-10
2012-10-31,292935943,54407917,238528026,폴란드,2012-10
2012-10-31,255869750,412310701,-156440951,프랑스,2012-10
2012-10-31,248810497,418742999,-169932502,이탈리아,2012-10
2012-10-31,246153915,5551,246148364,마샬군도,2012-10
2012-10-31,234005037,401596134,-167591097,칠레,2012-10
2012-10-31,192975046,221412737,-28437691,네덜란드,2012-10
2012-10-31,181911554,164156036,17755518,남아프리카공화국,2012-10
2012-10-31,177809106,103935766,73873340,벨기에,2012-10
2012-10-31,174742645,7276074,167466571,몰타,2012-10
2012-10-31,163057752,3475708,159582044,이집트,2012-10
2012-10-31,149158161,302317633,-153159472,노르웨이,2012-10
2012-10-31,143735322,102490188,41245134,뉴질랜드,2012-10
2012-10-31,142521250,659927928,-517406678,이라크,2012-10
2012-10-31,141027241,6400894,134626347,그리스,2012-10
2012-10-31,130499513,116463932,14035581,스페인,2012-10
2012-10-31,126139396,105298195,20841201,페루,2012-10
2012-10-31,125975424,44408391,81567033,체코공화국,2012-10
2012-10-31,122725841,6322261,116403580,요르단,2012-10
2012-10-31,121060573,57332529,63728044,이스라엘,2012-10
2012-10-31,119846422,2075035,117771387,우즈베키스탄,2012-10
2012-10-31,105923617,38364730,67558887,헝가리,2012-10
2012-10-31,105846783,441283,105405500,리비아,2012-10
2012-10-31,99876954,106563726,-6686772,오스트리아,2012-10
2012-10-31,95197017,20125241,75071776,콜롬비아,2012-10
2012-10-31,94560574,52553692,42006882,방글라데시,2012-10
2012-10-31,89749381,4504439,85244942,에쿠아도르,2012-10
2012-10-31,87646870,25082295,62564575,카자흐스탄,2012-10
2012-10-31,85615415,50294,85565121,알제리,2012-10
2012-10-31,85538174,6720403,78817771,슬로베니아,2012-10
2012-10-31,79426343,1211156438,-1131730095,쿠웨이트,2012-10
2012-10-31,78331703,422470566,-344138863,오만,2012-10
2012-10-31,76861978,1244,76860734,바하마,2012-10
2012-10-31,75697106,81198056,-5500950,파키스탄,2012-10
2012-10-31,72727165,169884035,-97156870,아르헨티나,2012-10
2012-10-31,71435142,0,71435142,버뮤다,2012-10
2012-10-31,66566759,109685441,-43118682,스웨덴,2012-10
2012-10-31,60273588,1904268548,-1843994960,카타르,2012-10
2012-10-31,56887113,85510585,-28623472,우크라이나,2012-10
2012-10-31,55628471,124825789,-69197318,나이지리아,2012-10
2012-10-31,54622399,241620021,-186997622,스위스,2012-10
2012-10-31,51185438,10907471,40277967,캄보디아,2012-10
2012-10-31,50192067,539000,49653067,베네주엘라,2012-10
2012-10-31,41315323,427412,40887911,시리아,2012-10
2012-10-31,40563153,50590663,-10027510,미얀마,2012-10
2012-10-31,38127437,116997,38010440,라이베리아,2012-10
2012-10-31,33300757,48713,33252044,앙골라,2012-10
2012-10-31,30194406,4385017,25809389,몽골,2012-10
2012-10-31,29432499,52408973,-22976474,루마니아,2012-10
2012-10-31,28778216,118700449,-89922233,바레인,2012-10
2012-10-31,27145248,120358130,-93212882,핀란드,2012-10
2012-10-31,26275499,3847509,22427990,레바논,2012-10
2012-10-31,25628251,8313817,17314434,모로코,2012-10
2012-10-31,24483161,23121668,1361493,코스타리카,2012-10
2012-10-31,24397654,3728177,20669477,가나,2012-10
2012-10-31,24145309,57395934,-33250625,덴마크,2012-10
2012-10-31,24082272,26973470,-2891198,푸에르토리코,2012-10
2012-10-31,23122904,5930371,17192533,스리랑카,2012-10
2012-10-31,23044762,6861754,16183008,과테말라,2012-10
2012-10-31,22210235,16593,22193642,아제르바이잔,2012-10
2012-10-31,21583600,16364644,5218956,포루투갈,2012-10
2012-10-31,19780405,2360170,17420235,니카라과,2012-10
2012-10-31,18619437,1065376,17554061,케냐,2012-10
2012-10-31,17945518,4218962,13726556,기타국,2012-10
2012-10-31,16840814,720,16840094,아프카니스탄,2012-10
2012-10-31,16566323,6717006,9849317,온두라스,2012-10
2012-10-31,15710854,60266275,-44555421,아일랜드,2012-10
2012-10-31,15279087,14792750,486337,우루과이,2012-10
2012-10-31,15112419,11422498,3689921,도미니카 공화국,2012-10
2012-10-31,13976120,35244,13940876,키르기스스탄,2012-10
2012-10-31,13602376,4132348,9470028,라트비아,2012-10
2012-10-31,12320505,4400767,7919738,파라과이,2012-10
2012-10-31,11693502,2511717,9181785,리투아니아,2012-10
2012-10-31,11632210,561656,11070554,조지아,2012-10
2012-10-31,11518279,110380016,-98861737,예맨,2012-10
2012-10-31,10726793,4028049,6698744,수단,2012-10
2012-10-31,10667380,3468675,7198705,튀니지,2012-10
2012-10-31,10275060,652954,9622106,탄자니아,2012-10
2012-10-31,9825680,0,9825680,코트디봐르,2012-10
2012-10-31,9471586,15846868,-6375282,에스토니아,2012-10
2012-10-31,8707036,26799934,-18092898,불가리아,2012-10
2012-10-31,8669543,26726704,-18057161,파푸아 뉴기니,2012-10
2012-10-31,8486332,2781652,5704680,엘살바도르,2012-10
2012-10-31,8338666,45346204,-37007538,트리니다드 토바고,2012-10
2012-10-31,8197077,27097,8169980,적도 기니,2012-10
2012-10-31,7894955,4408754,3486201,라오스,2012-10
2012-10-31,7734306,1973691,5760615,에티오피아,2012-10
2012-10-31,7144177,0,7144177,안타티카,2012-10
2012-10-31,6505589,134501098,-127995509,브루나이,2012-10
2012-10-31,6032869,348527,5684342,괌,2012-10
2012-10-31,5662458,0,5662458,아메리칸 사모아,2012-10
2012-10-31,5218075,6864831,-1646756,벨라루스,2012-10
2012-10-31,5054161,61457,4992704,불령 폴리네시아,2012-10
2012-10-31,5021009,9688409,-4667400,세르비아,2012-10
2012-10-31,4837155,0,4837155,지부티,2012-10
2012-10-31,4737482,5729401,-991919,모잠비크,2012-10
2012-10-31,4713976,3789607,924369,세네갈,2012-10
2012-10-31,4345275,58634,4286641,투르크멘,2012-10
2012-10-31,4215459,846861,3368598,모리셔스,2012-10
2012-10-31,3920466,588205,3332261,카메룬,2012-10
2012-10-31,3846111,0,3846111,말리,2012-10
2012-10-31,3470873,306373,3164500,자마이카,2012-10
2012-10-31,3280759,249761,3030998,콩고,2012-10
2012-10-31,3076348,0,3076348,타지크,2012-10
2012-10-31,3045680,17375663,-14329983,뉴 칼레도니아,2012-10
2012-10-31,2908924,6446255,-3537331,사이프러스,2012-10
2012-10-31,2892878,37797,2855081,팔레스타인 해방기구,2012-10
2012-10-31,2870248,31289360,-28419112,볼리비아,2012-10
2012-10-31,2779930,2796672,-16742,가봉,2012-10
2012-10-31,2749144,114677,2634467,짐바브웨,2012-10
2012-10-31,2659357,37586595,-34927238,잠비아,2012-10
2012-10-31,2638519,0,2638519,세인트 루시아,2012-10
2012-10-31,2602029,252618,2349411,기니,2012-10
2012-10-31,2492194,1899467,592727,아이슬란드,2012-10
2012-10-31,2392649,0,2392649,아루바,2012-10
2012-10-31,2331282,3591568,-1260286,크로아티아,2012-10
2012-10-31,2327129,420655,1906474,아이티,2012-10
2012-10-31,2257803,243012,2014791,수리남,2012-10
2012-10-31,2181801,1376351,805450,베닝,2012-10
2012-10-31,2157898,0,2157898,토고,2012-10
2012-10-31,2127892,1041194,1086698,피지,2012-10
2012-10-31,2067823,7785710,-5717887,나미비아,2012-10
2012-10-31,2040286,626335,1413951,모리타니,2012-10
2012-10-31,2026720,206029,1820691,마다카스카르,2012-10
2012-10-31,1982629,317392,1665237,세이쉘,2012-10
2012-10-31,1977267,517144,1460123,마카오,2012-10
2012-10-31,1652162,6,1652156,네덜란드 열도,2012-10
2012-10-31,1597293,581922,1015371,쿠바,2012-10
2012-10-31,1549358,250378,1298980,가이아나,2012-10
2012-10-31,1506770,437619,1069151,시에라 리온,2012-10
2012-10-31,1491659,2190,1489469,불령 리유니온 코모도 제도,2012-10
2012-10-31,1472268,604492,867776,보스니아-헤르체고비나,2012-10
2012-10-31,1366101,0,1366101,북마리아나 군도,2012-10
2012-10-31,1343695,43365,1300330,영령 캐이맨 군도,2012-10
2012-10-31,1335132,0,1335132,부르키나 파소,2012-10
2012-10-31,1281534,22572580,-21291046,콩고민주공화국,2012-10
2012-10-31,1271522,0,1271522,마이크로네시아,2012-10
2012-10-31,1219819,85245,1134574,알바니아,2012-10
2012-10-31,1216220,724831,491389,우간다,2012-10
2012-10-31,1204918,129941,1074977,네팔,2012-10
2012-10-31,1029200,0,1029200,에리트리아,2012-10
2012-10-31,904268,285619,618649,말라위,2012-10
2012-10-31,848151,59727315,-58879164,티모르,2012-10
2012-10-31,780138,0,780138,과델로프,2012-10
2012-10-31,734714,9599,725115,바베이도스,2012-10
2012-10-31,666102,5927150,-5261048,룩셈부르그,2012-10
2012-10-31,643315,281686,361629,아르메니아,2012-10
2012-10-31,623374,23003,600371,보츠와나,2012-10
2012-10-31,594303,717665,-123362,도미니카,2012-10
2012-10-31,487718,10874,476844,사모아,2012-10
2012-10-31,461427,2940345,-2478918,마세도니아,2012-10
2012-10-31,438277,0,438277,마티니크,2012-10
2012-10-31,332910,1816178,-1483268,몰도바,2012-10
2012-10-31,304923,4858,300065,벨리제,2012-10
2012-10-31,300100,3021,297079,몰디브,2012-10
2012-10-31,286172,289434,-3262,모나코,2012-10
2012-10-31,282627,0,282627,불령 가이아나,2012-10
2012-10-31,260934,3348,257586,니제르,2012-10
2012-10-31,256255,853132,-596877,리히텐슈타인,2012-10
2012-10-31,254339,65643,188696,바누아투,2012-10
2012-10-31,216441,1862599,-1646158,솔로몬 군도,2012-10
2012-10-31,170917,1856908,-1685991,안티가 바부다,2012-10
2012-10-31,168663,576,168087,부탄,2012-10
2012-10-31,165108,0,165108,감비아,2012-10
2012-10-31,141259,106222,35037,스와질랜드,2012-10
2012-10-31,136476,118599,17877,르완다,2012-10
2012-10-31,126079,148,125931,소말리아,2012-10
2012-10-31,124304,0,124304,지브랄타,2012-10
2012-10-31,123580,0,123580,키리바티,2012-10
2012-10-31,106652,0,106652,그레나다,2012-10
2012-10-31,100579,10981,89598,팔라우,2012-10
2012-10-31,79621,14,79607,세인트 키츠 네비스,2012-10
2012-10-31,78362,0,78362,카보 베르데,2012-10
2012-10-31,73387,305,73082,세인트 빈센트 그레나딘,2012-10
2012-10-31,73162,801,72361,노폴크 아일랜드,2012-10
2012-10-31,59566,42488,17078,안도라,2012-10
2012-10-31,56182,296590,-240408,통가,2012-10
2012-10-31,41600,0,41600,교황청,2012-10
2012-10-31,34421,1261,33160,몬테네그로,2012-10
2012-10-31,31085,0,31085,메요트,2012-10
2012-10-31,30271,37,30234,쿡 아일랜드,2012-10
2012-10-31,28452,0,28452,국제통화기금,2012-10
2012-10-31,27005,0,27005,피트카이른,2012-10
2012-10-31,19260,483760,-464500,투발루,2012-10
2012-10-31,11459,166820,-155361,영령 버진군도,2012-10
2012-10-31,10850,0,10850,챠드,2012-10
2012-10-31,6425,0,6425,세인트 마틴,2012-10
2012-10-31,5411,0,5411,중앙아프리카공화국,2012-10
2012-10-31,2200,0,2200,포클랜드 군도,2012-10
2012-10-31,1841,0,1841,앙귈라,2012-10
2012-10-31,478,8700,-8222,부룬디,2012-10
2012-10-31,0,115068,-115068,그린랜드,2012-10
2012-10-31,0,6851,-6851,레소토,2012-10
2012-10-31,0,4567491,-4567491,나우루,2012-10
2012-10-31,0,1114,-1114,크리스마스 아일랜드,2012-10
2012-10-31,0,854,-854,남수단,2012-10
2012-10-31,0,5160,-5160,몬트세라트,2012-10
2012-10-31,0,37058,-37058,니우에,2012-10
2012-10-31,0,472,-472,세인트 헬레나,2012-10
2012-10-31,0,9584,-9584,산마리노,2012-10
2012-10-31,0,27058,-27058,토켈라우,2012-10
2012-11-30,12429057074,6914174816,5514882258,중국,2012-11
2012-11-30,5113742215,3161155713,1952586502,미국,2012-11
2012-11-30,3622014649,5339050448,-1717035799,일본,2012-11
2012-11-30,2814775645,168495978,2646279667,홍콩,2012-11
2012-11-30,1837162042,773651552,1063510490,싱가포르,2012-11
2012-11-30,1529012572,539595885,989416687,베트남,2012-11
2012-11-30,1479830011,1170415067,309414944,인도네시아,2012-11
2012-11-30,1288853939,1190527579,98326360,대만,2012-11
2012-11-30,999999781,599575213,400424568,인도,2012-11
2012-11-30,981923281,1143017805,-161094524,러시아 연방,2012-11
2012-11-30,807022258,35652371,771369887,미얀마,2012-11
2012-11-30,792311552,3436003367,-2643691815,사우디아라비아,2012-11
2012-11-30,779504433,1922470319,-1142965886,호주,2012-11
2012-11-30,764250809,911984851,-147734042,말레이시아,2012-11
2012-11-30,734131880,231560528,502571352,멕시코,2012-11
2012-11-30,723495647,510137180,213358467,브라질,2012-11
2012-11-30,697858889,447544013,250314876,태국,2012-11
2012-11-30,697471670,259331090,438140580,필리핀,2012-11
2012-11-30,554938699,1429722634,-874783935,아랍에미리트 연합,2012-11
2012-11-30,543871714,90686,543781028,라이베리아,2012-11
2012-11-30,542797054,1490246374,-947449320,독일,2012-11
2012-11-30,416146524,836238069,-420091545,이란,2012-11
2012-11-30,407377801,293336427,114041374,영국,2012-11
2012-11-30,403228311,17215898,386012413,슬로바키아,2012-11
2012-11-30,345661493,43074948,302586545,튀르키예,2012-11
2012-11-30,337929775,530454968,-192525193,캐나다,2012-11
2012-11-30,325900156,50005792,275894364,폴란드,2012-11
2012-11-30,279076074,83460,278992614,마샬군도,2012-11
2012-11-30,260762162,427685930,-166923768,프랑스,2012-11
2012-11-30,234457530,381542237,-147084707,칠레,2012-11
2012-11-30,218334672,240753663,-22418991,네덜란드,2012-11
2012-11-30,215737839,402253654,-186515815,이탈리아,2012-11
2012-11-30,196239605,37646898,158592707,이집트,2012-11
2012-11-30,195151305,853936455,-658785150,이라크,2012-11
2012-11-30,189091104,106017209,83073895,벨기에,2012-11
2012-11-30,161756886,3262671,158494215,우즈베키스탄,2012-11
2012-11-30,161204051,40471195,120732856,체코공화국,2012-11
2012-11-30,141769044,126975261,14793783,남아프리카공화국,2012-11
2012-11-30,137320995,132670378,4650617,스페인,2012-11
2012-11-30,131821790,5522658,126299132,요르단,2012-11
2012-11-30,128440298,95774067,32666231,리비아,2012-11
2012-11-30,124047569,4951086,119096483,슬로베니아,2012-11
2012-11-30,123429065,75106916,48322149,이스라엘,2012-11
2012-11-30,117769519,182053786,-64284267,페루,2012-11
2012-11-30,107153741,315758149,-208604408,노르웨이,2012-11
2012-11-30,106533632,14911772,91621860,콜롬비아,2012-11
2012-11-30,102736052,1776421756,-1673685704,쿠웨이트,2012-11
2012-11-30,95709308,108912442,-13203134,뉴질랜드,2012-11
2012-11-30,93070740,1788755499,-1695684759,카타르,2012-11
2012-11-30,91337749,10400,91327349,알제리,2012-11
2012-11-30,86384388,20404282,65980106,방글라데시,2012-11
2012-11-30,85432891,121580362,-36147471,파나마,2012-11
2012-11-30,85249174,530679344,-445430170,오만,2012-11
2012-11-30,83735308,43523040,40212268,헝가리,2012-11
2012-11-30,80029914,130937215,-50907301,스웨덴,2012-11
2012-11-30,76924709,2713140,74211569,과테말라,2012-11
2012-11-30,74910058,95089630,-20179572,오스트리아,2012-11
2012-11-30,74326248,19820602,54505646,카자흐스탄,2012-11
2012-11-30,72824889,4240314,68584575,에쿠아도르,2012-11
2012-11-30,70793124,184309532,-113516408,아르헨티나,2012-11
2012-11-30,69723043,50741092,18981951,나이지리아,2012-11
2012-11-30,61262206,75310167,-14047961,파키스탄,2012-11
2012-11-30,60396888,35924492,24472396,베네주엘라,2012-11
2012-11-30,59958738,5844346,54114392,캄보디아,2012-11
2012-11-30,44601229,58269,44542960,시리아,2012-11
2012-11-30,44489209,189508,44299701,괌,2012-11
2012-11-30,44337226,39878720,4458506,우크라이나,2012-11
2012-11-30,41039736,63521279,-22481543,그리스,2012-11
2012-11-30,39519855,1766,39518089,불령 폴리네시아,2012-11
2012-11-30,35472798,6327636,29145162,레바논,2012-11
2012-11-30,33598400,19836297,13762103,푸에르토리코,2012-11
2012-11-30,32575252,44717080,-12141828,루마니아,2012-11
2012-11-30,31986611,73800384,-41813773,핀란드,2012-11
2012-11-30,29120000,1165,29118835,맨섬,2012-11
2012-11-30,27482284,5411850,22070434,스리랑카,2012-11
2012-11-30,27470940,72028871,-44557931,덴마크,2012-11
2012-11-30,27469540,5105,27464435,아제르바이잔,2012-11
2012-11-30,27457484,70628367,-43170883,바레인,2012-11
2012-11-30,27435083,12739854,14695229,포루투갈,2012-11
2012-11-30,26414958,209373040,-182958082,스위스,2012-11
2012-11-30,26392857,4163237,22229620,가나,2012-11
2012-11-30,26343871,3927924,22415947,몽골,2012-11
2012-11-30,26025367,49827056,-23801689,아일랜드,2012-11
2012-11-30,24620393,9340821,15279572,모로코,2012-11
2012-11-30,24084556,21039729,3044827,코스타리카,2012-11
2012-11-30,23130396,2334524,20795872,케냐,2012-11
2012-11-30,22321078,12386143,9934935,우루과이,2012-11
2012-11-30,21726341,328,21726013,앙골라,2012-11
2012-11-30,19347093,12688084,6659009,도미니카 공화국,2012-11
2012-11-30,16962699,1215684,15747015,라오스,2012-11
2012-11-30,16514186,1774248,14739938,니카라과,2012-11
2012-11-30,15143940,10048,15133892,아프카니스탄,2012-11
2012-11-30,15113342,115858211,-100744869,예맨,2012-11
2012-11-30,15062190,498,15061692,투르크멘,2012-11
2012-11-30,14145497,165238485,-151092988,브루나이,2012-11
2012-11-30,14028457,73948,13954509,키르기스스탄,2012-11
2012-11-30,13669405,844,13668561,코트디봐르,2012-11
2012-11-30,12874144,8075266,4798878,에스토니아,2012-11
2012-11-30,12764281,3490612,9273669,튀니지,2012-11
2012-11-30,12532556,2794995,9737561,리투아니아,2012-11
2012-11-30,12224536,3365030,8859506,라트비아,2012-11
2012-11-30,11783257,1755030,10028227,온두라스,2012-11
2012-11-30,11455585,5229927,6225658,수단,2012-11
2012-11-30,11316303,342166,10974137,조지아,2012-11
2012-11-30,10760567,183043,10577524,탄자니아,2012-11
2012-11-30,10206700,772004,9434696,파라과이,2012-11
2012-11-30,8461272,1914466,6546806,에티오피아,2012-11
2012-11-30,8433400,2868517,5564883,트리니다드 토바고,2012-11
2012-11-30,8343151,3257121,5086030,불가리아,2012-11
2012-11-30,7747297,2611366,5135931,파푸아 뉴기니,2012-11
2012-11-30,7256468,2003578,5252890,엘살바도르,2012-11
2012-11-30,6506374,26186,6480188,쿠바,2012-11
2012-11-30,6276546,94745387,-88468841,몰타,2012-11
2012-11-30,5613406,1317021,4296385,베닝,2012-11
2012-11-30,4965054,24111969,-19146915,세르비아,2012-11
2012-11-30,4816408,18072068,-13255660,볼리비아,2012-11
2012-11-30,4749451,31875337,-27125886,콩고민주공화국,2012-11
2012-11-30,4672551,405023,4267528,모리셔스,2012-11
2012-11-30,4625744,94349,4531395,아르메니아,2012-11
2012-11-30,4597106,404287,4192819,타지크,2012-11
2012-11-30,4401978,27650379,-23248401,뉴 칼레도니아,2012-11
2012-11-30,4299804,54062,4245742,팔레스타인 해방기구,2012-11
2012-11-30,4298571,888558,3410013,카메룬,2012-11
2012-11-30,4210544,5832391,-1621847,모잠비크,2012-11
2012-11-30,3931397,3070965,860432,세네갈,2012-11
2012-11-30,3821068,0,3821068,지부티,2012-11
2012-11-30,3569703,171307,3398396,네팔,2012-11
2012-11-30,3316702,339365,2977337,수리남,2012-11
2012-11-30,3220492,617,3219875,말리,2012-11
2012-11-30,3202194,41516919,-38314725,적도 기니,2012-11
2012-11-30,3088928,705317,2383611,기니,2012-11
2012-11-30,3053082,984344,2068738,말라위,2012-11
2012-11-30,2947591,0,2947591,부르키나 파소,2012-11
2012-11-30,2887185,4847413,-1960228,벨라루스,2012-11
2012-11-30,2656235,3166927,-510692,가봉,2012-11
2012-11-30,2655642,681874,1973768,아이티,2012-11
2012-11-30,2581280,526131,2055149,자마이카,2012-11
2012-11-30,2503898,89369756,-86865858,사이프러스,2012-11
2012-11-30,2472322,2413305,59017,크로아티아,2012-11
2012-11-30,2414409,1405,2413004,토고,2012-11
2012-11-30,2396385,145837,2250548,가이아나,2012-11
2012-11-30,2323879,154822,2169057,마다카스카르,2012-11
2012-11-30,2262335,463505,1798830,콩고,2012-11
2012-11-30,2244433,230654,2013779,짐바브웨,2012-11
2012-11-30,2060061,168048,1892013,세이쉘,2012-11
2012-11-30,1939013,0,1939013,아루바,2012-11
2012-11-30,1934750,90340,1844410,네덜란드 열도,2012-11
2012-11-30,1933975,112537,1821438,마카오,2012-11
2012-11-30,1808571,35404532,-33595961,잠비아,2012-11
2012-11-30,1672277,0,1672277,불령 리유니온 코모도 제도,2012-11
2012-11-30,1608149,125672,1482477,우간다,2012-11
2012-11-30,1566047,2349092,-783045,아이슬란드,2012-11
2012-11-30,1507793,107014,1400779,피지,2012-11
2012-11-30,1285531,70922,1214609,알바니아,2012-11
2012-11-30,1268946,28345,1240601,니제르,2012-11
2012-11-30,1138472,139437,999035,티모르,2012-11
2012-11-30,1054194,15110,1039084,아메리칸 사모아,2012-11
2012-11-30,996309,0,996309,바하마,2012-11
2012-11-30,945805,5847,939958,시에라 리온,2012-11
2012-11-30,872941,281847,591094,보스니아-헤르체고비나,2012-11
2012-11-30,752855,759,752096,북마리아나 군도,2012-11
2012-11-30,732849,1994638,-1261789,모리타니,2012-11
2012-11-30,723714,93,723621,바베이도스,2012-11
2012-11-30,698173,42895,655278,영령 캐이맨 군도,2012-11
2012-11-30,677967,2618533,-1940566,룩셈부르그,2012-11
2012-11-30,673774,1812,671962,키리바티,2012-11
2012-11-30,644792,100789,544003,벨리제,2012-11
2012-11-30,636110,0,636110,과델로프,2012-11
2012-11-30,613181,14,613167,마티니크,2012-11
2012-11-30,570914,0,570914,에리트리아,2012-11
2012-11-30,521997,4314069,-3792072,기타국,2012-11
2012-11-30,496110,1132345,-636235,안티가 바부다,2012-11
2012-11-30,473298,39435,433863,보츠와나,2012-11
2012-11-30,470852,238109,232743,모나코,2012-11
2012-11-30,460728,1295942,-835214,몰도바,2012-11
2012-11-30,390329,0,390329,세인트 루시아,2012-11
2012-11-30,371929,314654,57275,마이크로네시아,2012-11
2012-11-30,337760,378,337382,영령 버진군도,2012-11
2012-11-30,296202,0,296202,버뮤다,2012-11
2012-11-30,262696,60,262636,르완다,2012-11
2012-11-30,252287,14310,237977,사모아,2012-11
2012-11-30,234290,130655,103635,도미니카,2012-11
2012-11-30,221183,1131227,-910044,마세도니아,2012-11
2012-11-30,214242,800873,-586631,리히텐슈타인,2012-11
2012-11-30,212454,0,212454,팔라우,2012-11
2012-11-30,203264,2473526,-2270262,스와질랜드,2012-11
2012-11-30,174891,15274,159617,바누아투,2012-11
2012-11-30,160382,0,160382,그레나다,2012-11
2012-11-30,138035,0,138035,불령 가이아나,2012-11
2012-11-30,105842,55465,50377,몰디브,2012-11
2012-11-30,91826,19600362,-19508536,나미비아,2012-11
2012-11-30,88190,14,88176,지브랄타,2012-11
2012-11-30,80311,0,80311,남수단,2012-11
2012-11-30,78120,3691,74429,투발루,2012-11
2012-11-30,75305,0,75305,산마리노,2012-11
2012-11-30,67700,0,67700,부룬디,2012-11
2012-11-30,67425,885,66540,몬테네그로,2012-11
2012-11-30,60195,432056,-371861,솔로몬 군도,2012-11
2012-11-30,49990,44140,5850,중앙아프리카공화국,2012-11
2012-11-30,45900,0,45900,교황청,2012-11
2012-11-30,38332,0,38332,메요트,2012-11
2012-11-30,26427,1314,25113,안도라,2012-11
2012-11-30,18099,6177282,-6159183,나우루,2012-11
2012-11-30,17381,0,17381,감비아,2012-11
2012-11-30,14520,0,14520,코모로스,2012-11
2012-11-30,14249,0,14249,세인트 빈센트 그레나딘,2012-11
2012-11-30,12535,27,12508,상토메 프린스페,2012-11
2012-11-30,12325,0,12325,미령 버진군도,2012-11
2012-11-30,10782,0,10782,건지,2012-11
2012-11-30,10394,876939,-866545,통가,2012-11
2012-11-30,9375,0,9375,챠드,2012-11
2012-11-30,4927,0,4927,부탄,2012-11
2012-11-30,4810,0,4810,파로에 군도,2012-11
2012-11-30,4480,5152,-672,레소토,2012-11
2012-11-30,4008,0,4008,소말리아,2012-11
2012-11-30,2910,0,2910,세인트 마틴,2012-11
2012-11-30,2660,3586,-926,세인트 키츠 네비스,2012-11
2012-11-30,0,40656,-40656,토켈라우,2012-11
2012-11-30,0,263,-263,노폴크 아일랜드,2012-11
2012-11-30,0,5354,-5354,니우에,2012-11
2012-11-30,0,1388,-1388,세인트 헬레나,2012-11
2012-11-30,0,74409,-74409,그린랜드,2012-11
2012-11-30,0,337,-337,쿡 아일랜드,2012-11
2012-12-31,11994263599,6419924953,5574338646,중국,2012-12
2012-12-31,4555475076,3050429552,1505045524,미국,2012-12
2012-12-31,3046855254,5243386023,-2196530769,일본,2012-12
2012-12-31,2600831372,152214253,2448617119,홍콩,2012-12
2012-12-31,1974348135,757146814,1217201321,싱가포르,2012-12
2012-12-31,1499268932,466767220,1032501712,베트남,2012-12
2012-12-31,1266685650,1128765477,137920173,대만,2012-12
2012-12-31,1228834150,1251809445,-22975295,인도네시아,2012-12
2012-12-31,856621255,718370306,138250949,말레이시아,2012-12
2012-12-31,854488457,592301360,262187097,인도,2012-12
2012-12-31,840122842,1945260532,-1105137690,호주,2012-12
2012-12-31,814919454,3178700559,-2363781105,사우디아라비아,2012-12
2012-12-31,803950602,422185376,381765226,태국,2012-12
2012-12-31,728289561,845253795,-116964234,러시아 연방,2012-12
2012-12-31,694983197,515057505,179925692,브라질,2012-12
2012-12-31,676499777,220886133,455613644,필리핀,2012-12
2012-12-31,669737033,194584841,475152192,멕시코,2012-12
2012-12-31,535291149,1329337950,-794046801,아랍에미리트 연합,2012-12
2012-12-31,516552328,1729224905,-1212672577,독일,2012-12
2012-12-31,473052944,310212053,162840891,네덜란드,2012-12
2012-12-31,450525465,39069390,411456075,파나마,2012-12
2012-12-31,395535055,577274136,-181739081,영국,2012-12
2012-12-31,389157993,686468163,-297310170,이란,2012-12
2012-12-31,381996394,22099271,359897123,슬로바키아,2012-12
2012-12-31,354421264,59229480,295191784,튀르키예,2012-12
2012-12-31,344377605,280387048,63990557,캐나다,2012-12
2012-12-31,248495596,50913304,197582292,폴란드,2012-12
2012-12-31,244457342,707584049,-463126707,프랑스,2012-12
2012-12-31,242212070,424283888,-182071818,이탈리아,2012-12
2012-12-31,219790030,341621086,-121831056,칠레,2012-12
2012-12-31,180201708,26396107,153805601,몰타,2012-12
2012-12-31,170987201,1194865,169792336,우즈베키스탄,2012-12
2012-12-31,170257769,116551536,53706233,이집트,2012-12
2012-12-31,166956085,93666633,73289452,남아프리카공화국,2012-12
2012-12-31,144560856,151579994,-7019138,벨기에,2012-12
2012-12-31,141883684,935840779,-793957095,이라크,2012-12
2012-12-31,138875357,168162492,-29287135,사이프러스,2012-12
2012-12-31,138833501,2389593692,-2250760191,카타르,2012-12
2012-12-31,138142412,119488785,18653627,뉴질랜드,2012-12
2012-12-31,134436323,46324374,88111949,체코공화국,2012-12
2012-12-31,130383052,118401,130264651,리비아,2012-12
2012-12-31,124752999,31896109,92856890,방글라데시,2012-12
2012-12-31,122167087,14565536,107601551,콜롬비아,2012-12
2012-12-31,119506098,142590988,-23084890,페루,2012-12
2012-12-31,117368721,1657316495,-1539947774,쿠웨이트,2012-12
2012-12-31,115332592,97223215,18109377,스페인,2012-12
2012-12-31,107162605,0,107162605,마샬군도,2012-12
2012-12-31,105911074,4161697,101749377,요르단,2012-12
2012-12-31,97567812,65645767,31922045,파키스탄,2012-12
2012-12-31,97038596,2523437,94515159,탄자니아,2012-12
2012-12-31,96833905,19092,96814813,라이베리아,2012-12
2012-12-31,95798378,270054,95528324,알제리,2012-12
2012-12-31,94100999,6767582,87333417,슬로베니아,2012-12
2012-12-31,90697282,22604535,68092747,그리스,2012-12
2012-12-31,86763798,65262785,21501013,이스라엘,2012-12
2012-12-31,84684868,520288271,-435603403,오만,2012-12
2012-12-31,82100400,48364877,33735523,헝가리,2012-12
2012-12-31,81164867,155770405,-74605538,아르헨티나,2012-12
2012-12-31,76693225,219485294,-142792069,나이지리아,2012-12
2012-12-31,75471838,4684473,70787365,에쿠아도르,2012-12
2012-12-31,72135220,23984917,48150303,카자흐스탄,2012-12
2012-12-31,69253882,95183460,-25929578,우크라이나,2012-12
2012-12-31,67266008,110568512,-43302504,스웨덴,2012-12
2012-12-31,61280309,20618215,40662094,미얀마,2012-12
2012-12-31,59871721,461905167,-402033446,노르웨이,2012-12
2012-12-31,51998595,6496842,45501753,캄보디아,2012-12
2012-12-31,44756491,98770893,-54014402,오스트리아,2012-12
2012-12-31,42017370,12111855,29905515,베네주엘라,2012-12
2012-12-31,41556314,40,41556274,불령 폴리네시아,2012-12
2012-12-31,39655937,101667,39554270,시리아,2012-12
2012-12-31,38700607,16851800,21848807,포루투갈,2012-12
2012-12-31,35657218,3747331,31909887,레바논,2012-12
2012-12-31,35502805,3837317,31665488,몽골,2012-12
2012-12-31,30904369,91909480,-61005111,핀란드,2012-12
2012-12-31,28678486,47978706,-19300220,루마니아,2012-12
2012-12-31,28358218,11427265,16930953,모로코,2012-12
2012-12-31,27908342,68138304,-40229962,덴마크,2012-12
2012-12-31,27534537,69149864,-41615327,아일랜드,2012-12
2012-12-31,26798955,24867405,1931550,푸에르토리코,2012-12
2012-12-31,25653951,2628111,23025840,과테말라,2012-12
2012-12-31,25571849,24293416,1278433,코스타리카,2012-12
2012-12-31,24767755,2636166,22131589,케냐,2012-12
2012-12-31,23523272,5439078,18084194,스리랑카,2012-12
2012-12-31,23261645,1556038,21705607,라오스,2012-12
2012-12-31,22507820,3053218,19454602,가나,2012-12
2012-12-31,21929920,37865131,-15935211,바레인,2012-12
2012-12-31,21503212,33166025,-11662813,앙골라,2012-12
2012-12-31,21299390,399,21298991,아제르바이잔,2012-12
2012-12-31,19755704,2438821,17316883,우루과이,2012-12
2012-12-31,19259128,207894746,-188635618,스위스,2012-12
2012-12-31,17760488,1071104,16689384,니카라과,2012-12
2012-12-31,13262201,561849,12700352,파라과이,2012-12
2012-12-31,12320516,8862912,3457604,튀니지,2012-12
2012-12-31,12095590,7871737,4223853,도미니카 공화국,2012-12
2012-12-31,11780523,19104428,-7323905,파푸아 뉴기니,2012-12
2012-12-31,11655429,2586695,9068734,라트비아,2012-12
2012-12-31,11202898,1282793,9920105,온두라스,2012-12
2012-12-31,11088896,253528,10835368,코트디봐르,2012-12
2012-12-31,11049738,3827819,7221919,에스토니아,2012-12
2012-12-31,10941119,1851438,9089681,리투아니아,2012-12
2012-12-31,10781918,3049296,7732622,에티오피아,2012-12
2012-12-31,10515450,1728230,8787220,엘살바도르,2012-12
2012-12-31,10500485,161713141,-151212656,예맨,2012-12
2012-12-31,9847547,5025437,4822110,수단,2012-12
2012-12-31,9828861,55950,9772911,키르기스스탄,2012-12
2012-12-31,9644156,38766465,-29122309,트리니다드 토바고,2012-12
2012-12-31,9203431,232941368,-223737937,브루나이,2012-12
2012-12-31,9091368,12747158,-3655790,불가리아,2012-12
2012-12-31,7668206,24747053,-17078847,조지아,2012-12
2012-12-31,7490231,0,7490231,지부티,2012-12
2012-12-31,6066270,12902,6053368,아프카니스탄,2012-12
2012-12-31,5648832,1548720,4100112,세네갈,2012-12
2012-12-31,5601596,1957,5599639,투르크멘,2012-12
2012-12-31,5181716,4053240,1128476,가봉,2012-12
2012-12-31,4850857,9769272,-4918415,모잠비크,2012-12
2012-12-31,4672430,9115850,-4443420,볼리비아,2012-12
2012-12-31,4607497,16747149,-12139652,세르비아,2012-12
2012-12-31,4597885,315362,4282523,쿠바,2012-12
2012-12-31,4265844,60480,4205364,팔레스타인 해방기구,2012-12
2012-12-31,4233227,1044881,3188346,베닝,2012-12
2012-12-31,4227822,338082,3889740,모리셔스,2012-12
2012-12-31,4043129,96798,3946331,괌,2012-12
2012-12-31,3934345,26041588,-22107243,잠비아,2012-12
2012-12-31,3748440,10310293,-6561853,뉴 칼레도니아,2012-12
2012-12-31,3527114,3156804,370310,벨라루스,2012-12
2012-12-31,3445980,2125620,1320360,크로아티아,2012-12
2012-12-31,3426469,285870,3140599,가이아나,2012-12
2012-12-31,3330878,443520,2887358,타지크,2012-12
2012-12-31,3046161,1896372,1149789,카메룬,2012-12
2012-12-31,2743165,102966,2640199,콩고,2012-12
2012-12-31,2676640,193798,2482842,수리남,2012-12
2012-12-31,2555249,1882971,672278,피지,2012-12
2012-12-31,2468849,74527,2394322,짐바브웨,2012-12
2012-12-31,2416445,1129889,1286556,마다카스카르,2012-12
2012-12-31,2353183,116308,2236875,토고,2012-12
2012-12-31,2260982,0,2260982,아루바,2012-12
2012-12-31,2201297,58035,2143262,세이쉘,2012-12
2012-12-31,2175028,611017,1564011,기니,2012-12
2012-12-31,2074737,261,2074476,아메리칸 사모아,2012-12
2012-12-31,2028798,65454,1963344,아르메니아,2012-12
2012-12-31,1987572,570,1987002,말리,2012-12
2012-12-31,1961205,0,1961205,네덜란드 열도,2012-12
2012-12-31,1938381,360,1938021,바하마,2012-12
2012-12-31,1879236,394575,1484661,자마이카,2012-12
2012-12-31,1833153,44541,1788612,마카오,2012-12
2012-12-31,1658559,123116,1535443,네팔,2012-12
2012-12-31,1596861,2582985,-986124,아이슬란드,2012-12
2012-12-31,1545489,100,1545389,부르키나 파소,2012-12
2012-12-31,1455336,18880243,-17424907,콩고민주공화국,2012-12
2012-12-31,1392563,174,1392389,불령 리유니온 코모도 제도,2012-12
2012-12-31,1387136,12365,1374771,알바니아,2012-12
2012-12-31,1294510,959485,335025,아이티,2012-12
2012-12-31,1125886,605511,520375,우간다,2012-12
2012-12-31,1098800,208915,889885,보스니아-헤르체고비나,2012-12
2012-12-31,1081009,1175580,-94571,말라위,2012-12
2012-12-31,1019362,9858,1009504,사모아,2012-12
2012-12-31,1018937,140671741,-139652804,적도 기니,2012-12
2012-12-31,950903,5943342,-4992439,기타국,2012-12
2012-12-31,926251,500,925751,영령 캐이맨 군도,2012-12
2012-12-31,884181,200429,683752,시에라 리온,2012-12
2012-12-31,868462,2442813,-1574351,룩셈부르그,2012-12
2012-12-31,822421,916971,-94550,스와질랜드,2012-12
2012-12-31,785242,14298,770944,보츠와나,2012-12
2012-12-31,737958,127,737831,버뮤다,2012-12
2012-12-31,719858,0,719858,티모르,2012-12
2012-12-31,707874,28584,679290,마이크로네시아,2012-12
2012-12-31,652736,1172337,-519601,모리타니,2012-12
2012-12-31,629749,0,629749,북마리아나 군도,2012-12
2012-12-31,535982,0,535982,마티니크,2012-12
2012-12-31,486419,246,486173,바베이도스,2012-12
2012-12-31,427703,147572,280131,모나코,2012-12
2012-12-31,426560,0,426560,키리바티,2012-12
2012-12-31,389227,242,388985,팔라우,2012-12
2012-12-31,377816,36,377780,부탄,2012-12
2012-12-31,375117,2741,372376,교황청,2012-12
2012-12-31,324088,19644,304444,과델로프,2012-12
2012-12-31,323268,275446,47822,도미니카,2012-12
2012-12-31,298548,151019,147529,몰도바,2012-12
2012-12-31,296773,0,296773,챠드,2012-12
2012-12-31,295794,305346,-9552,마세도니아,2012-12
2012-12-31,274992,12983,262009,안티가 바부다,2012-12
2012-12-31,251540,149546,101994,바누아투,2012-12
2012-12-31,212024,820348,-608324,리히텐슈타인,2012-12
2012-12-31,204471,0,204471,불령 가이아나,2012-12
2012-12-31,170137,0,170137,감비아,2012-12
2012-12-31,167289,794648,-627359,솔로몬 군도,2012-12
2012-12-31,155038,1789,153249,벨리제,2012-12
2012-12-31,151944,0,151944,에리트리아,2012-12
2012-12-31,120843,0,120843,세인트 빈센트 그레나딘,2012-12
2012-12-31,120269,802,119467,몬테네그로,2012-12
2012-12-31,110537,0,110537,그레나다,2012-12
2012-12-31,109390,10665627,-10556237,나미비아,2012-12
2012-12-31,108979,5832,103147,니제르,2012-12
2012-12-31,97488,3448,94040,르완다,2012-12
2012-12-31,95035,66902,28133,몰디브,2012-12
2012-12-31,86582,0,86582,세인트 키츠 네비스,2012-12
2012-12-31,85105,0,85105,영령 버진군도,2012-12
2012-12-31,80820,0,80820,레소토,2012-12
2012-12-31,79290,47402,31888,부룬디,2012-12
2012-12-31,77988,0,77988,카보 베르데,2012-12
2012-12-31,72015,0,72015,기네비소,2012-12
2012-12-31,59437,0,59437,국제통화기금,2012-12
2012-12-31,54431,0,54431,메요트,2012-12
2012-12-31,49530,0,49530,앙귈라,2012-12
2012-12-31,37741,0,37741,세인트 루시아,2012-12
2012-12-31,28878,1208428,-1179550,통가,2012-12
2012-12-31,23841,0,23841,파로에 군도,2012-12
2012-12-31,10916,0,10916,쿡 아일랜드,2012-12
2012-12-31,4763,2378,2385,지브랄타,2012-12
2012-12-31,4214,67853,-63639,중앙아프리카공화국,2012-12
2012-12-31,3074,4820,-1746,안도라,2012-12
2012-12-31,1200,152,1048,토켈라우,2012-12
2012-12-31,964,0,964,세인트 마틴,2012-12
2012-12-31,0,25200,-25200,남조지아 & 남샌드위치 군도,2012-12
2012-12-31,0,80,-80,크리스마스 아일랜드,2012-12
2012-12-31,0,42580,-42580,나우루,2012-12
2012-12-31,0,746,-746,피트카이른,2012-12
2012-12-31,0,3311,-3311,맨섬,2012-12
2012-12-31,0,235018,-235018,투발루,2012-12
2012-12-31,0,2033,-2033,미령 버진군도,2012-12
2012-12-31,0,127,-127,영령 인도양,2012-12
2012-12-31,0,508,-508,상토메 프린스페,2012-12
2012-12-31,0,278820,-278820,그린랜드,2012-12
2013-01-31,11425208289,7321008962,4104199327,중국,2013-01
2013-01-31,4960891720,3570689283,1390202437,미국,2013-01
2013-01-31,3518915044,5033518925,-1514603881,일본,2013-01
2013-01-31,2213281582,231845122,1981436460,홍콩,2013-01
2013-01-31,1702213404,943937463,758275941,싱가포르,2013-01
2013-01-31,1489705029,600031060,889673969,베트남,2013-01
2013-01-31,1371709477,1264140438,107569039,대만,2013-01
2013-01-31,1168179904,1172798296,-4618392,인도네시아,2013-01
2013-01-31,976367239,3313293389,-2336926150,사우디아라비아,2013-01
2013-01-31,921155909,1044491212,-123335303,러시아 연방,2013-01
2013-01-31,919687086,682073803,237613283,인도,2013-01
2013-01-31,800859497,1804551422,-1003691925,호주,2013-01
2013-01-31,781352137,155598977,625753160,멕시코,2013-01
2013-01-31,728548104,328439547,400108557,필리핀,2013-01
2013-01-31,708818083,408504517,300313566,태국,2013-01
2013-01-31,695208807,460995334,234213473,브라질,2013-01
2013-01-31,601843749,181145,601662604,마샬군도,2013-01
2013-01-31,574386158,1589274708,-1014888550,독일,2013-01
2013-01-31,514565837,775156664,-260590827,말레이시아,2013-01
2013-01-31,465666599,416691700,48974899,캐나다,2013-01
2013-01-31,442498749,1323643802,-881145053,아랍에미리트 연합,2013-01
2013-01-31,402880287,14678867,388201420,슬로바키아,2013-01
2013-01-31,395824272,596322162,-200497890,영국,2013-01
2013-01-31,380646682,44157,380602525,라이베리아,2013-01
2013-01-31,373953159,715976581,-342023422,이란,2013-01
2013-01-31,372334846,252689932,119644914,네덜란드,2013-01
2013-01-31,348739457,56257806,292481651,폴란드,2013-01
2013-01-31,313983102,48388168,265594934,튀르키예,2013-01
2013-01-31,270738026,125322561,145415465,파나마,2013-01
2013-01-31,254884783,0,254884783,바하마,2013-01
2013-01-31,252619024,45,252618979,버뮤다,2013-01
2013-01-31,230691970,491845764,-261153794,프랑스,2013-01
2013-01-31,228968252,486067346,-257099094,칠레,2013-01
2013-01-31,209768740,166056371,43712369,남아프리카공화국,2013-01
2013-01-31,201933484,444975073,-243041589,이탈리아,2013-01
2013-01-31,184390950,62473173,121917777,이집트,2013-01
2013-01-31,168787069,218522543,-49735474,벨기에,2013-01
2013-01-31,163940298,126194838,37745460,몰타,2013-01
2013-01-31,161310490,65096820,96213670,이스라엘,2013-01
2013-01-31,160691682,46672921,114018761,체코공화국,2013-01
2013-01-31,152488463,964544036,-812055573,이라크,2013-01
2013-01-31,126747860,17304666,109443194,방글라데시,2013-01
2013-01-31,126219812,202368409,-76148597,페루,2013-01
2013-01-31,124246967,140011161,-15764194,스페인,2013-01
2013-01-31,119086204,8119384,110966820,슬로베니아,2013-01
2013-01-31,115917413,17199346,98718067,콜롬비아,2013-01
2013-01-31,113401997,6036329,107365668,요르단,2013-01
2013-01-31,104467025,538998758,-434531733,노르웨이,2013-01
2013-01-31,101748740,127284952,-25536212,뉴질랜드,2013-01
2013-01-31,101647402,35349846,66297556,헝가리,2013-01
2013-01-31,100059636,517735786,-417676150,오만,2013-01
2013-01-31,99636486,1481152821,-1381516335,쿠웨이트,2013-01
2013-01-31,93890423,15438,93874985,중앙아프리카공화국,2013-01
2013-01-31,89466689,3478260,85988429,우즈베키스탄,2013-01
2013-01-31,86003348,77503453,8499895,알제리,2013-01
2013-01-31,81238847,402755038,-321516191,나이지리아,2013-01
2013-01-31,78943256,916611,78026645,리비아,2013-01
2013-01-31,77917466,21551554,56365912,카자흐스탄,2013-01
2013-01-31,68672425,33729004,34943421,파키스탄,2013-01
2013-01-31,68145457,4944942,63200515,에쿠아도르,2013-01
2013-01-31,61851625,2425669910,-2363818285,카타르,2013-01
2013-01-31,60307629,133023069,-72715440,아르헨티나,2013-01
2013-01-31,59263463,155986217,-96722754,스웨덴,2013-01
2013-01-31,56054613,118965253,-62910640,오스트리아,2013-01
2013-01-31,53232760,36172239,17060521,그리스,2013-01
2013-01-31,53224256,12192315,41031941,캄보디아,2013-01
2013-01-31,50706716,35991362,14715354,미얀마,2013-01
2013-01-31,46316122,221308657,-174992535,스위스,2013-01
2013-01-31,45189186,43822736,1366450,루마니아,2013-01
2013-01-31,43840570,35504069,8336501,우크라이나,2013-01
2013-01-31,43396686,7104803,36291883,레바논,2013-01
2013-01-31,41801879,160765,41641114,시리아,2013-01
2013-01-31,40481481,1510483,38970998,룩셈부르그,2013-01
2013-01-31,37205821,439782,36766039,모나코,2013-01
2013-01-31,35460202,24053,35436149,불령 폴리네시아,2013-01
2013-01-31,34871843,152493,34719350,앙골라,2013-01
2013-01-31,32702085,2781514,29920571,과테말라,2013-01
2013-01-31,31244508,5704194,25540314,수단,2013-01
2013-01-31,30876167,120199040,-89322873,핀란드,2013-01
2013-01-31,29513144,12735577,16777567,포루투갈,2013-01
2013-01-31,29210000,0,29210000,맨섬,2013-01
2013-01-31,26890250,77133755,-50243505,덴마크,2013-01
2013-01-31,25915293,16032,25899261,아제르바이잔,2013-01
2013-01-31,25571534,3172845,22398689,몽골,2013-01
2013-01-31,25332125,5612264,19719861,스리랑카,2013-01
2013-01-31,24980621,11535944,13444677,모로코,2013-01
2013-01-31,24849272,6631888,18217384,베네주엘라,2013-01
2013-01-31,21680251,3077737,18602514,가나,2013-01
2013-01-31,21518740,23306331,-1787591,푸에르토리코,2013-01
2013-01-31,20894650,39328268,-18433618,바레인,2013-01
2013-01-31,19498491,2425219,17073272,케냐,2013-01
2013-01-31,18521760,22950506,-4428746,코스타리카,2013-01
2013-01-31,17548114,2349674,15198440,니카라과,2013-01
2013-01-31,17493078,2784056,14709022,라오스,2013-01
2013-01-31,16680112,16828851,-148739,우루과이,2013-01
2013-01-31,16306084,91323303,-75017219,예맨,2013-01
2013-01-31,14962673,72312604,-57349931,아일랜드,2013-01
2013-01-31,13688866,605323,13083543,코트디봐르,2013-01
2013-01-31,12381189,14208777,-1827588,파라과이,2013-01
2013-01-31,12260927,2992187,9268740,리투아니아,2013-01
2013-01-31,11859782,57515,11802267,키르기스스탄,2013-01
2013-01-31,11439619,4311686,7127933,튀니지,2013-01
2013-01-31,10901437,9433065,1468372,탄자니아,2013-01
2013-01-31,10444367,6802429,3641938,도미니카 공화국,2013-01
2013-01-31,9927883,0,9927883,지부티,2013-01
2013-01-31,9486160,1493090,7993070,엘살바도르,2013-01
2013-01-31,9273789,1263719,8010070,온두라스,2013-01
2013-01-31,9223029,20394356,-11171327,불가리아,2013-01
2013-01-31,8850033,9006006,-155973,에스토니아,2013-01
2013-01-31,8846770,20210,8826560,아메리칸 사모아,2013-01
2013-01-31,8776583,9814,8766769,아프카니스탄,2013-01
2013-01-31,8378213,267707493,-259329280,브루나이,2013-01
2013-01-31,8336368,1443959,6892409,조지아,2013-01
2013-01-31,8061204,2772190,5289014,라트비아,2013-01
2013-01-31,7175539,41039962,-33864423,트리니다드 토바고,2013-01
2013-01-31,6340334,55738,6284596,팔레스타인 해방기구,2013-01
2013-01-31,6324705,511683,5813022,카메룬,2013-01
2013-01-31,5674523,1552607,4121916,세네갈,2013-01
2013-01-31,5559563,62065653,-56506090,파푸아 뉴기니,2013-01
2013-01-31,5142930,2798412,2344518,기니,2013-01
2013-01-31,4767121,32210,4734911,투르크멘,2013-01
2013-01-31,4432205,0,4432205,부르키나 파소,2013-01
2013-01-31,4217382,3019734,1197648,세르비아,2013-01
2013-01-31,3899783,4308363,-408580,마다카스카르,2013-01
2013-01-31,3880684,16040,3864644,가이아나,2013-01
2013-01-31,3810155,1548349,2261806,에티오피아,2013-01
2013-01-31,3696838,426214,3270624,괌,2013-01
2013-01-31,3646070,6597184,-2951114,모잠비크,2013-01
2013-01-31,3611190,544760,3066430,마카오,2013-01
2013-01-31,3589055,292423,3296632,쿠바,2013-01
2013-01-31,3422545,29533657,-26111112,볼리비아,2013-01
2013-01-31,3420319,3079055,341264,베닝,2013-01
2013-01-31,3332662,1172018,2160644,크로아티아,2013-01
2013-01-31,3302598,1224545,2078053,피지,2013-01
2013-01-31,3251824,4431441,-1179617,벨라루스,2013-01
2013-01-31,3055926,435069,2620857,사이프러스,2013-01
2013-01-31,2914764,13,2914751,네덜란드 열도,2013-01
2013-01-31,2873259,1093776,1779483,모리셔스,2013-01
2013-01-31,2852368,16812079,-13959711,뉴 칼레도니아,2013-01
2013-01-31,2771291,463283,2308008,자마이카,2013-01
2013-01-31,2471153,192,2470961,불령 리유니온 코모도 제도,2013-01
2013-01-31,2467016,412395,2054621,짐바브웨,2013-01
2013-01-31,2439706,78448,2361258,아르메니아,2013-01
2013-01-31,2404985,178400,2226585,타지크,2013-01
2013-01-31,2235499,1880941,354558,알바니아,2013-01
2013-01-31,2198250,9728655,-7530405,아이티,2013-01
2013-01-31,2084244,16812019,-14727775,잠비아,2013-01
2013-01-31,1968924,36221,1932703,수리남,2013-01
2013-01-31,1919394,130358,1789036,토고,2013-01
2013-01-31,1772059,39032,1733027,아루바,2013-01
2013-01-31,1669492,1986473,-316981,가봉,2013-01
2013-01-31,1660119,72841,1587278,네팔,2013-01
2013-01-31,1608977,1729824,-120847,콩고,2013-01
2013-01-31,1396643,0,1396643,에리트리아,2013-01
2013-01-31,1270157,10884156,-9613999,콩고민주공화국,2013-01
2013-01-31,1237715,1175236,62479,말라위,2013-01
2013-01-31,1204762,0,1204762,말리,2013-01
2013-01-31,1199797,7498,1192299,세이쉘,2013-01
2013-01-31,1066411,836133,230278,보스니아-헤르체고비나,2013-01
2013-01-31,1058065,4154,1053911,우간다,2013-01
2013-01-31,987193,0,987193,마이크로네시아,2013-01
2013-01-31,758476,62828,695648,티모르,2013-01
2013-01-31,704681,2790186,-2085505,아이슬란드,2013-01
2013-01-31,687555,0,687555,사모아,2013-01
2013-01-31,644124,5617400,-4973276,기타국,2013-01
2013-01-31,633043,0,633043,적도 기니,2013-01
2013-01-31,618951,2135,616816,안티가 바부다,2013-01
2013-01-31,603628,13,603615,니제르,2013-01
2013-01-31,565443,1707,563736,몰디브,2013-01
2013-01-31,559255,44611,514644,통가,2013-01
2013-01-31,551852,69,551783,바베이도스,2013-01
2013-01-31,547080,533,546547,북마리아나 군도,2013-01
2013-01-31,501322,1890757,-1389435,모리타니,2013-01
2013-01-31,477884,415394,62490,시에라 리온,2013-01
2013-01-31,433579,73782,359797,보츠와나,2013-01
2013-01-31,403747,2420,401327,과델로프,2013-01
2013-01-31,402992,200,402792,영령 캐이맨 군도,2013-01
2013-01-31,401156,35856,365300,벨리제,2013-01
2013-01-31,354706,72793,281913,마티니크,2013-01
2013-01-31,322146,0,322146,세인트 루시아,2013-01
2013-01-31,320073,0,320073,챠드,2013-01
2013-01-31,312358,297859,14499,몰도바,2013-01
2013-01-31,293126,455646,-162520,스와질랜드,2013-01
2013-01-31,284335,160869,123466,르완다,2013-01
2013-01-31,240254,0,240254,소말리아,2013-01
2013-01-31,233555,147616,85939,마세도니아,2013-01
2013-01-31,223557,13693,209864,도미니카,2013-01
2013-01-31,203951,7024,196927,바누아투,2013-01
2013-01-31,191619,0,191619,코모로스,2013-01
2013-01-31,155208,944253,-789045,리히텐슈타인,2013-01
2013-01-31,138545,59850,78695,나미비아,2013-01
2013-01-31,137322,3012,134310,불령 가이아나,2013-01
2013-01-31,136570,0,136570,팔라우,2013-01
2013-01-31,112850,2296341,-2183491,솔로몬 군도,2013-01
2013-01-31,108692,524,108168,세인트 키츠 네비스,2013-01
2013-01-31,105527,0,105527,그레나다,2013-01
2013-01-31,94650,0,94650,투르크 & 카이코스 군도,2013-01
2013-01-31,91204,68,91136,영령 버진군도,2013-01
2013-01-31,89507,0,89507,키리바티,2013-01
2013-01-31,89293,32275,57018,감비아,2013-01
2013-01-31,78591,0,78591,기네비소,2013-01
2013-01-31,67424,972,66452,몬테네그로,2013-01
2013-01-31,59388,0,59388,나우루,2013-01
2013-01-31,53426,0,53426,노폴크 아일랜드,2013-01
2013-01-31,42114,0,42114,쿡 아일랜드,2013-01
2013-01-31,28869,8066,20803,산마리노,2013-01
2013-01-31,28560,0,28560,큐라소,2013-01
2013-01-31,21139,0,21139,파로에 군도,2013-01
2013-01-31,17544,0,17544,영령 인도양,2013-01
2013-01-31,12916,18598,-5682,부룬디,2013-01
2013-01-31,12120,0,12120,지브랄타,2013-01
2013-01-31,10965,2597,8368,카보 베르데,2013-01
2013-01-31,9259,0,9259,투발루,2013-01
2013-01-31,8532,0,8532,세인트 빈센트 그레나딘,2013-01
2013-01-31,6671,0,6671,부탄,2013-01
2013-01-31,3742,0,3742,세인트 마틴,2013-01
2013-01-31,1350,0,1350,레소토,2013-01
2013-01-31,1039,0,1039,건지,2013-01
2013-01-31,315,195416,-195101,그린랜드,2013-01
2013-01-31,103,0,103,미령 버진군도,2013-01
2013-01-31,0,10991,-10991,토켈라우,2013-01
2013-01-31,0,1424,-1424,보빗군도,2013-01
2013-01-31,0,675,-675,니우에,2013-01
2013-01-31,0,6,-6,상토메 프린스페,2013-01
2013-01-31,0,16320,-16320,메요트,2013-01
2013-01-31,0,3,-3,마이너 아우틀링 합중국 군도,2013-01
2013-01-31,0,49,-49,안도라,2013-01
2013-02-28,10387585991,5519950962,4867635029,중국,2013-02
2013-02-28,5002517619,3165202580,1837315039,미국,2013-02
2013-02-28,2900960556,4975625171,-2074664615,일본,2013-02
2013-02-28,1909950723,152261705,1757689018,홍콩,2013-02
2013-02-28,1557485265,855316490,702168775,싱가포르,2013-02
2013-02-28,1445586525,550327320,895259205,베트남,2013-02
2013-02-28,1143835395,1040692498,103142897,대만,2013-02
2013-02-28,1051774500,1014081292,37693208,인도네시아,2013-02
2013-02-28,998169221,596687659,401481562,인도,2013-02
2013-02-28,917459682,734161804,183297878,러시아 연방,2013-02
2013-02-28,875177543,1643208789,-768031246,호주,2013-02
2013-02-28,803657962,394918204,408739758,태국,2013-02
2013-02-28,763948429,200831917,563116512,멕시코,2013-02
2013-02-28,763632922,3208000500,-2444367578,사우디아라비아,2013-02
2013-02-28,722220313,269774801,452445512,필리핀,2013-02
2013-02-28,704667899,1368769524,-664101625,독일,2013-02
2013-02-28,655851563,396599872,259251691,브라질,2013-02
2013-02-28,530622427,789035933,-258413506,말레이시아,2013-02
2013-02-28,435975715,1527419131,-1091443416,아랍에미리트 연합,2013-02
2013-02-28,430847273,8599474,422247799,슬로바키아,2013-02
2013-02-28,409918869,455188960,-45270091,이란,2013-02
2013-02-28,408815724,371339266,37476458,이탈리아,2013-02
2013-02-28,394326461,298645078,95681383,캐나다,2013-02
2013-02-28,377193195,137102792,240090403,남아프리카공화국,2013-02
2013-02-28,346963015,50200763,296762252,튀르키예,2013-02
2013-02-28,301700642,88973,301611669,라이베리아,2013-02
2013-02-28,293585769,40703543,252882226,폴란드,2013-02
2013-02-28,273500086,418124759,-144624673,프랑스,2013-02
2013-02-28,272891665,232695160,40196505,네덜란드,2013-02
2013-02-28,272676926,159423706,113253220,벨기에,2013-02
2013-02-28,263036732,573263676,-310226944,영국,2013-02
2013-02-28,243971486,27070133,216901353,파나마,2013-02
2013-02-28,233874768,5382,233869386,마샬군도,2013-02
2013-02-28,169167807,21515757,147652050,방글라데시,2013-02
2013-02-28,166902613,358690228,-191787615,칠레,2013-02
2013-02-28,158954360,186928343,-27973983,이집트,2013-02
2013-02-28,150383258,36686886,113696372,체코공화국,2013-02
2013-02-28,133225749,7296330,125929419,우즈베키스탄,2013-02
2013-02-28,129051242,106399412,22651830,스페인,2013-02
2013-02-28,128597985,38308609,90289376,몰타,2013-02
2013-02-28,123084244,825825569,-702741325,이라크,2013-02
2013-02-28,120998842,102566398,18432444,페루,2013-02
2013-02-28,114850283,5143565,109706718,슬로베니아,2013-02
2013-02-28,112014474,10641007,101373467,콜롬비아,2013-02
2013-02-28,110973282,56708409,54264873,이스라엘,2013-02
2013-02-28,110236245,51,110236194,바하마,2013-02
2013-02-28,95432623,444842734,-349410111,오만,2013-02
2013-02-28,95259147,31674078,63585069,헝가리,2013-02
2013-02-28,94957860,122211162,-27253302,뉴질랜드,2013-02
2013-02-28,94647202,21329919,73317283,리비아,2013-02
2013-02-28,92432134,5880230,86551904,에쿠아도르,2013-02
2013-02-28,89552600,12093601,77458999,과테말라,2013-02
2013-02-28,87647567,89452545,-1804978,알제리,2013-02
2013-02-28,86353583,2842500,83511083,요르단,2013-02
2013-02-28,85719766,1689820443,-1604100677,쿠웨이트,2013-02
2013-02-28,79353368,31457216,47896152,아르헨티나,2013-02
2013-02-28,75572442,274453843,-198881401,나이지리아,2013-02
2013-02-28,74630409,15051624,59578785,카자흐스탄,2013-02
2013-02-28,72234078,27247993,44986085,우크라이나,2013-02
2013-02-28,68626623,108599482,-39972859,오스트리아,2013-02
2013-02-28,61972867,46888929,15083938,파키스탄,2013-02
2013-02-28,60484501,339247000,-278762499,노르웨이,2013-02
2013-02-28,57612555,94753993,-37141438,스웨덴,2013-02
2013-02-28,55937526,8227826,47709700,캄보디아,2013-02
2013-02-28,51539595,197761331,-146221736,스위스,2013-02
2013-02-28,51003803,29770195,21233608,미얀마,2013-02
2013-02-28,47660386,2662226845,-2614566459,카타르,2013-02
2013-02-28,46704881,4759270,41945611,베네주엘라,2013-02
2013-02-28,42357944,172818,42185126,앙골라,2013-02
2013-02-28,35224655,1097198,34127457,괌,2013-02
2013-02-28,34613913,2100024,32513889,몽골,2013-02
2013-02-28,33958116,5552,33952564,시리아,2013-02
2013-02-28,30635199,137049720,-106414521,덴마크,2013-02
2013-02-28,30069816,55827631,-25757815,루마니아,2013-02
2013-02-28,28829724,83293504,-54463780,핀란드,2013-02
2013-02-28,26279146,2345894,23933252,가나,2013-02
2013-02-28,25768488,14098555,11669933,포루투갈,2013-02
2013-02-28,25701222,7471005,18230217,레바논,2013-02
2013-02-28,25397033,45060681,-19663648,아일랜드,2013-02
2013-02-28,23287679,5488539,17799140,모로코,2013-02
2013-02-28,22102560,6362,22096198,아제르바이잔,2013-02
2013-02-28,21771214,10047568,11723646,바레인,2013-02
2013-02-28,21650877,1412124,20238753,케냐,2013-02
2013-02-28,21477709,6974429,14503280,스리랑카,2013-02
2013-02-28,19494743,421526,19073217,라오스,2013-02
2013-02-28,19029890,18502536,527354,푸에르토리코,2013-02
2013-02-28,17171386,20724244,-3552858,코스타리카,2013-02
2013-02-28,15168823,636400,14532423,엘살바도르,2013-02
2013-02-28,15150943,4074921,11076022,그리스,2013-02
2013-02-28,14766594,236482015,-221715421,예맨,2013-02
2013-02-28,14713123,4394240,10318883,우루과이,2013-02
2013-02-28,13255764,482599,12773165,파라과이,2013-02
2013-02-28,12695852,36034,12659818,키르기스스탄,2013-02
2013-02-28,12682081,1890846,10791235,리투아니아,2013-02
2013-02-28,11704785,906402,10798383,니카라과,2013-02
2013-02-28,11595439,262,11595177,코트디봐르,2013-02
2013-02-28,11356061,3520,11352541,투르크멘,2013-02
2013-02-28,11026843,3538550,7488293,수단,2013-02
2013-02-28,10654776,4430503,6224273,불가리아,2013-02
2013-02-28,9917736,8199873,1717863,도미니카 공화국,2013-02
2013-02-28,9602249,778272,8823977,탄자니아,2013-02
2013-02-28,9582615,802907,8779708,조지아,2013-02
2013-02-28,9439118,8586439,852679,온두라스,2013-02
2013-02-28,8407141,1884912,6522229,세네갈,2013-02
2013-02-28,8328422,7092358,1236064,에스토니아,2013-02
2013-02-28,7792149,2915459,4876690,라트비아,2013-02
2013-02-28,7569985,359389,7210596,트리니다드 토바고,2013-02
2013-02-28,7323717,3720241,3603476,튀니지,2013-02
2013-02-28,6333336,0,6333336,모잠비크,2013-02
2013-02-28,5324607,0,5324607,지부티,2013-02
2013-02-28,5302921,3120483,2182438,벨라루스,2013-02
2013-02-28,4887840,976684,3911156,에티오피아,2013-02
2013-02-28,4848656,75915,4772741,팔레스타인 해방기구,2013-02
2013-02-28,4820562,4492866,327696,세르비아,2013-02
2013-02-28,4507994,6233507,-1725513,파푸아 뉴기니,2013-02
2013-02-28,3990386,0,3990386,부르키나 파소,2013-02
2013-02-28,3558609,240951,3317658,쿠바,2013-02
2013-02-28,3379025,1057777,2321248,기니,2013-02
2013-02-28,3373208,4737,3368471,아프카니스탄,2013-02
2013-02-28,3260548,109812304,-106551756,사이프러스,2013-02
2013-02-28,3200142,645471,2554671,우간다,2013-02
2013-02-28,3152336,141229927,-138077591,브루나이,2013-02
2013-02-28,3122316,226,3122090,짐바브웨,2013-02
2013-02-28,3065748,2474045,591703,아이슬란드,2013-02
2013-02-28,3020097,7266732,-4246635,토고,2013-02
2013-02-28,2966109,0,2966109,타지크,2013-02
2013-02-28,2764133,713525,2050608,크로아티아,2013-02
2013-02-28,2760045,1516019,1244026,피지,2013-02
2013-02-28,2758562,419411,2339151,모리셔스,2013-02
2013-02-28,2718340,391832,2326508,자마이카,2013-02
2013-02-28,2662097,146669,2515428,베닝,2013-02
2013-02-28,2391139,46224523,-43833384,볼리비아,2013-02
2013-02-28,2370210,18599093,-16228883,뉴 칼레도니아,2013-02
2013-02-28,2359881,121762,2238119,콩고,2013-02
2013-02-28,2323732,3725336,-1401604,마다카스카르,2013-02
2013-02-28,2227668,412196,1815472,카메룬,2013-02
2013-02-28,2164549,212052,1952497,마카오,2013-02
2013-02-28,2118941,158184,1960757,마이크로네시아,2013-02
2013-02-28,1959411,145543,1813868,세이쉘,2013-02
2013-02-28,1922999,67177,1855822,아르메니아,2013-02
2013-02-28,1920075,0,1920075,아루바,2013-02
2013-02-28,1905727,0,1905727,네덜란드 열도,2013-02
2013-02-28,1851533,24447,1827086,가이아나,2013-02
2013-02-28,1773015,1137172,635843,알바니아,2013-02
2013-02-28,1737306,40414287,-38676981,콩고민주공화국,2013-02
2013-02-28,1721844,17918267,-16196423,잠비아,2013-02
2013-02-28,1645236,11530,1633706,아메리칸 사모아,2013-02
2013-02-28,1464119,196577,1267542,수리남,2013-02
2013-02-28,1463647,54593543,-53129896,적도 기니,2013-02
2013-02-28,1153153,572078,581075,사모아,2013-02
2013-02-28,1113827,22,1113805,불령 폴리네시아,2013-02
2013-02-28,1104963,149995,954968,네팔,2013-02
2013-02-28,1085413,0,1085413,불령 리유니온 코모도 제도,2013-02
2013-02-28,1050985,310382,740603,아이티,2013-02
2013-02-28,1044341,4103069,-3058728,기타국,2013-02
2013-02-28,994920,0,994920,영령 캐이맨 군도,2013-02
2013-02-28,973336,1395,971941,바베이도스,2013-02
2013-02-28,927023,2914894,-1987871,가봉,2013-02
2013-02-28,812131,0,812131,마티니크,2013-02
2013-02-28,811847,223,811624,말리,2013-02
2013-02-28,748173,58957275,-58209102,티모르,2013-02
2013-02-28,704526,1250368,-545842,몰도바,2013-02
2013-02-28,677934,9,677925,니제르,2013-02
2013-02-28,661932,0,661932,키리바티,2013-02
2013-02-28,660355,13400248,-12739893,말라위,2013-02
2013-02-28,644149,400728,243421,모리타니,2013-02
2013-02-28,535120,2118845,-1583725,룩셈부르그,2013-02
2013-02-28,508060,0,508060,과델로프,2013-02
2013-02-28,507545,16,507529,감비아,2013-02
2013-02-28,495495,63147,432348,마세도니아,2013-02
2013-02-28,485815,253781,232034,보스니아-헤르체고비나,2013-02
2013-02-28,482608,23163,459445,안티가 바부다,2013-02
2013-02-28,475494,32,475462,북마리아나 군도,2013-02
2013-02-28,434633,6487,428146,보츠와나,2013-02
2013-02-28,429875,369158,60717,시에라 리온,2013-02
2013-02-28,422925,248875,174050,모나코,2013-02
2013-02-28,409682,0,409682,챠드,2013-02
2013-02-28,367834,217820,150014,르완다,2013-02
2013-02-28,366705,764923,-398218,리히텐슈타인,2013-02
2013-02-28,287200,87926,199274,카보 베르데,2013-02
2013-02-28,269135,51992,217143,바누아투,2013-02
2013-02-28,268511,0,268511,그레나다,2013-02
2013-02-28,265173,751922,-486749,솔로몬 군도,2013-02
2013-02-28,250227,0,250227,에리트리아,2013-02
2013-02-28,247372,34,247338,버뮤다,2013-02
2013-02-28,223627,0,223627,소말리아,2013-02
2013-02-28,188721,37338,151383,도미니카,2013-02
2013-02-28,184499,1261,183238,몰디브,2013-02
2013-02-28,172762,455,172307,팔라우,2013-02
2013-02-28,164533,4969560,-4805027,스와질랜드,2013-02
2013-02-28,153725,263,153462,지브랄타,2013-02
2013-02-28,144631,48,144583,세인트 키츠 네비스,2013-02
2013-02-28,142092,32412,109680,벨리제,2013-02
2013-02-28,136887,0,136887,투르크 & 카이코스 군도,2013-02
2013-02-28,136598,0,136598,불령 가이아나,2013-02
2013-02-28,105134,0,105134,세인트 루시아,2013-02
2013-02-28,102162,209,101953,노폴크 아일랜드,2013-02
2013-02-28,92118,0,92118,부탄,2013-02
2013-02-28,77610,2283,75327,산마리노,2013-02
2013-02-28,76800,0,76800,세인트 빈센트 그레나딘,2013-02
2013-02-28,46419,0,46419,세인트 마틴,2013-02
2013-02-28,46212,96,46116,앙귈라,2013-02
2013-02-28,33162,7931,25231,나미비아,2013-02
2013-02-28,32400,20,32380,중앙아프리카공화국,2013-02
2013-02-28,32379,42275,-9896,통가,2013-02
2013-02-28,17263,0,17263,남조지아 & 남샌드위치 군도,2013-02
2013-02-28,11609,13174,-1565,몬테네그로,2013-02
2013-02-28,11318,0,11318,포클랜드 군도,2013-02
2013-02-28,5304,60492,-55188,토켈라우,2013-02
2013-02-28,3408,17432,-14024,안도라,2013-02
2013-02-28,2389,0,2389,파로에 군도,2013-02
2013-02-28,844,0,844,쿡 아일랜드,2013-02
2013-02-28,705,136045,-135340,부룬디,2013-02
2013-02-28,0,4857924,-4857924,나우루,2013-02
2013-02-28,0,4772,-4772,니우에,2013-02
2013-02-28,0,321329,-321329,투발루,2013-02
2013-02-28,0,6100,-6100,코모로스,2013-02
2013-02-28,0,207811,-207811,그린랜드,2013-02
2013-02-28,0,5593,-5593,레소토,2013-02
2013-02-28,0,9936,-9936,상토메 프린스페,2013-02
2013-03-31,11685542722,6927548326,4757994396,중국,2013-03
2013-03-31,4978892498,3731576973,1247315525,미국,2013-03
2013-03-31,2703276679,5334627331,-2631350652,일본,2013-03
2013-03-31,2564802898,152153193,2412649705,홍콩,2013-03
2013-03-31,2564517609,800081214,1764436395,싱가포르,2013-03
2013-03-31,1827242882,580330236,1246912646,베트남,2013-03
2013-03-31,1461026435,1282516593,178509842,대만,2013-03
2013-03-31,1068371665,1237301140,-168929475,인도네시아,2013-03
2013-03-31,1017629040,432500393,585128647,인도,2013-03
2013-03-31,938984190,957206445,-18222255,러시아 연방,2013-03
2013-03-31,891167068,549400571,341766497,브라질,2013-03
2013-03-31,803039205,1635587061,-832547856,독일,2013-03
2013-03-31,780625288,817753630,-37128342,말레이시아,2013-03
2013-03-31,771034588,490380658,280653930,태국,2013-03
2013-03-31,716590119,340865626,375724493,필리핀,2013-03
2013-03-31,711693522,2944896982,-2233203460,사우디아라비아,2013-03
2013-03-31,696999585,170720120,526279465,멕시코,2013-03
2013-03-31,696991840,1474725851,-777734011,호주,2013-03
2013-03-31,604635763,35949,604599814,마샬군도,2013-03
2013-03-31,575473307,97445,575375862,라이베리아,2013-03
2013-03-31,535441130,906488820,-371047690,영국,2013-03
2013-03-31,497375135,519433475,-22058340,이란,2013-03
2013-03-31,491815702,1474477970,-982662268,아랍에미리트 연합,2013-03
2013-03-31,491105248,51096028,440009220,튀르키예,2013-03
2013-03-31,445951019,375718368,70232651,캐나다,2013-03
2013-03-31,398402808,14362827,384039981,슬로바키아,2013-03
2013-03-31,345621879,266676496,78945383,네덜란드,2013-03
2013-03-31,345566727,46333060,299233667,폴란드,2013-03
2013-03-31,297071325,545023849,-247952524,프랑스,2013-03
2013-03-31,262035059,417671279,-155636220,이탈리아,2013-03
2013-03-31,244109530,410281689,-166172159,칠레,2013-03
2013-03-31,201216281,129483303,71732978,남아프리카공화국,2013-03
2013-03-31,191799470,868375316,-676575846,이라크,2013-03
2013-03-31,188047708,0,188047708,버뮤다,2013-03
2013-03-31,170380070,24275816,146104254,방글라데시,2013-03
2013-03-31,170051773,131060415,38991358,벨기에,2013-03
2013-03-31,169163327,6234794,162928533,우즈베키스탄,2013-03
2013-03-31,161687714,126491717,35195997,스페인,2013-03
2013-03-31,148381924,123615527,24766397,뉴질랜드,2013-03
2013-03-31,131160943,1812096,129348847,파나마,2013-03
2013-03-31,130699449,192376891,-61677442,페루,2013-03
2013-03-31,129938118,38811958,91126160,체코공화국,2013-03
2013-03-31,127684557,185031833,-57347276,이집트,2013-03
2013-03-31,120030324,1418036637,-1298006313,쿠웨이트,2013-03
2013-03-31,115819619,15133052,100686567,콜롬비아,2013-03
2013-03-31,108592924,70865291,37727633,이스라엘,2013-03
2013-03-31,105922470,6707553,99214917,슬로베니아,2013-03
2013-03-31,100328338,454930551,-354602213,오만,2013-03
2013-03-31,96404353,6861388,89542965,요르단,2013-03
2013-03-31,94194858,6319715,87875143,마다카스카르,2013-03
2013-03-31,93105799,13373831,79731968,우루과이,2013-03
2013-03-31,91106419,136239596,-45133177,알제리,2013-03
2013-03-31,90209011,36267470,53941541,아르헨티나,2013-03
2013-03-31,89510063,13846106,75663957,카자흐스탄,2013-03
2013-03-31,89282718,40266873,49015845,리비아,2013-03
2013-03-31,85565079,50870036,34695043,파키스탄,2013-03
2013-03-31,78730201,2732694,75997507,에쿠아도르,2013-03
2013-03-31,78205087,26418073,51787014,헝가리,2013-03
2013-03-31,73389539,48010224,25379315,나이지리아,2013-03
2013-03-31,72534637,159216699,-86682062,스웨덴,2013-03
2013-03-31,63574820,114680440,-51105620,오스트리아,2013-03
2013-03-31,62953120,34340116,28613004,미얀마,2013-03
2013-03-31,59197473,264225986,-205028513,노르웨이,2013-03
2013-03-31,55582336,12943530,42638806,캄보디아,2013-03
2013-03-31,49766201,2611929999,-2562163798,카타르,2013-03
2013-03-31,47504478,28580006,18924472,우크라이나,2013-03
2013-03-31,40587733,36718966,3868767,루마니아,2013-03
2013-03-31,39145609,173975,38971634,불령 폴리네시아,2013-03
2013-03-31,37944720,11813532,26131188,베네주엘라,2013-03
2013-03-31,35668705,2836281,32832424,몽골,2013-03
2013-03-31,35223749,108770510,-73546761,핀란드,2013-03
2013-03-31,33426812,58239569,-24812757,덴마크,2013-03
2013-03-31,31268125,198061981,-166793856,스위스,2013-03
2013-03-31,29594332,4806,29589526,안티가 바부다,2013-03
2013-03-31,29275529,2512,29273017,시리아,2013-03
2013-03-31,28704842,3485246,25219596,가나,2013-03
2013-03-31,28677755,16616297,12061458,포루투갈,2013-03
2013-03-31,28442248,31108542,-2666294,과테말라,2013-03
2013-03-31,25706242,2142733,23563509,케냐,2013-03
2013-03-31,25548475,6343979,19204496,레바논,2013-03
2013-03-31,25307668,7916033,17391635,스리랑카,2013-03
2013-03-31,24295622,1143663,23151959,라오스,2013-03
2013-03-31,23590771,21846975,1743796,푸에르토리코,2013-03
2013-03-31,21374062,62434919,-41060857,아일랜드,2013-03
2013-03-31,20774461,1459,20773002,아제르바이잔,2013-03
2013-03-31,19972906,8796562,11176344,모로코,2013-03
2013-03-31,18016989,143105939,-125088950,예맨,2013-03
2013-03-31,17775688,17441,17758247,키르기스스탄,2013-03
2013-03-31,17533564,492027,17041537,앙골라,2013-03
2013-03-31,17219632,1002056,16217576,파라과이,2013-03
2013-03-31,15873947,31214876,-15340929,튀니지,2013-03
2013-03-31,15132535,3665102,11467433,그리스,2013-03
2013-03-31,14945341,11492445,3452896,에스토니아,2013-03
2013-03-31,14925982,29200748,-14274766,코스타리카,2013-03
2013-03-31,14461883,69674311,-55212428,바레인,2013-03
2013-03-31,13635746,13175792,459954,도미니카 공화국,2013-03
2013-03-31,13415238,11555406,1859832,수단,2013-03
2013-03-31,13293941,1299381,11994560,엘살바도르,2013-03
2013-03-31,12935126,3109575,9825551,리투아니아,2013-03
2013-03-31,12523055,1847610,10675445,라트비아,2013-03
2013-03-31,12414649,2003385,10411264,조지아,2013-03
2013-03-31,12227107,1146618,11080489,니카라과,2013-03
2013-03-31,11696095,162281,11533814,코트디봐르,2013-03
2013-03-31,11315200,4700,11310500,투르크멘,2013-03
2013-03-31,10484130,68312017,-57827887,트리니다드 토바고,2013-03
2013-03-31,10042970,3879782,6163188,탄자니아,2013-03
2013-03-31,9761705,9534991,226714,온두라스,2013-03
2013-03-31,9491765,1784568,7707197,세네갈,2013-03
2013-03-31,8345377,20025124,-11679747,불가리아,2013-03
2013-03-31,8025090,66090812,-58065722,몰타,2013-03
2013-03-31,7641963,122258765,-114616802,브루나이,2013-03
2013-03-31,5724508,2823325,2901183,콩고,2013-03
2013-03-31,5511553,1025108,4486445,벨라루스,2013-03
2013-03-31,5203676,2002236,3201440,에티오피아,2013-03
2013-03-31,5125638,6969246,-1843608,파푸아 뉴기니,2013-03
2013-03-31,4772700,469733,4302967,토고,2013-03
2013-03-31,4761134,134775,4626359,모잠비크,2013-03
2013-03-31,4662606,8381,4654225,아프카니스탄,2013-03
2013-03-31,4587003,0,4587003,타지크,2013-03
2013-03-31,4535964,28700,4507264,팔레스타인 해방기구,2013-03
2013-03-31,4219577,2054592,2164985,아이슬란드,2013-03
2013-03-31,4022530,916870,3105660,쿠바,2013-03
2013-03-31,3866180,922473,2943707,피지,2013-03
2013-03-31,3864575,6525592,-2661017,세르비아,2013-03
2013-03-31,3684315,240014,3444301,괌,2013-03
2013-03-31,3481774,0,3481774,지부티,2013-03
2013-03-31,3357620,2035274,1322346,베닝,2013-03
2013-03-31,3346054,945003,2401051,카메룬,2013-03
2013-03-31,3115683,435563,2680120,모리셔스,2013-03
2013-03-31,2924999,7506451,-4581452,볼리비아,2013-03
2013-03-31,2825089,44662,2780427,수리남,2013-03
2013-03-31,2787729,26791917,-24004188,잠비아,2013-03
2013-03-31,2731923,235806,2496117,모나코,2013-03
2013-03-31,2663666,1192757,1470909,기니,2013-03
2013-03-31,2445049,263916,2181133,아이티,2013-03
2013-03-31,2407833,38416145,-36008312,콩고민주공화국,2013-03
2013-03-31,2396047,321600,2074447,가이아나,2013-03
2013-03-31,2387796,121549,2266247,아르메니아,2013-03
2013-03-31,2387635,265897,2121738,자마이카,2013-03
2013-03-31,2376125,70395,2305730,네덜란드 열도,2013-03
2013-03-31,2353047,451171,1901876,우간다,2013-03
2013-03-31,2226818,337105836,-334879018,사이프러스,2013-03
2013-03-31,1979144,14144758,-12165614,뉴 칼레도니아,2013-03
2013-03-31,1934507,257556,1676951,마카오,2013-03
2013-03-31,1917262,3077682,-1160420,가봉,2013-03
2013-03-31,1913885,301,1913584,불령 리유니온 코모도 제도,2013-03
2013-03-31,1878117,273308,1604809,짐바브웨,2013-03
2013-03-31,1602854,70597,1532257,세이쉘,2013-03
2013-03-31,1546811,1745601,-198790,크로아티아,2013-03
2013-03-31,1467332,0,1467332,말리,2013-03
2013-03-31,1462578,0,1462578,부르키나 파소,2013-03
2013-03-31,1448600,34,1448566,아메리칸 사모아,2013-03
2013-03-31,1384927,273312,1111615,보스니아-헤르체고비나,2013-03
2013-03-31,1330210,0,1330210,아루바,2013-03
2013-03-31,1284972,44640,1240332,알바니아,2013-03
2013-03-31,1212943,313497,899446,시에라 리온,2013-03
2013-03-31,1194420,148495,1045925,네팔,2013-03
2013-03-31,1056120,3870621,-2814501,말라위,2013-03
2013-03-31,764146,72,764074,영령 캐이맨 군도,2013-03
2013-03-31,703949,4215333,-3511384,룩셈부르그,2013-03
2013-03-31,693614,0,693614,티모르,2013-03
2013-03-31,678578,33075,645503,북마리아나 군도,2013-03
2013-03-31,655165,147,655018,바베이도스,2013-03
2013-03-31,626639,0,626639,에리트리아,2013-03
2013-03-31,603835,41079,562756,적도 기니,2013-03
2013-03-31,588196,6114806,-5526610,기타국,2013-03
2013-03-31,563963,1613626,-1049663,모리타니,2013-03
2013-03-31,554946,1098407,-543461,몰도바,2013-03
2013-03-31,514145,79609,434536,마세도니아,2013-03
2013-03-31,506333,0,506333,키리바티,2013-03
2013-03-31,476033,41726,434307,벨리제,2013-03
2013-03-31,459900,6904,452996,몰디브,2013-03
2013-03-31,447286,29336,417950,보츠와나,2013-03
2013-03-31,445980,0,445980,마티니크,2013-03
2013-03-31,417680,894,416786,과델로프,2013-03
2013-03-31,407221,72000,335221,마이크로네시아,2013-03
2013-03-31,388586,46369,342217,바하마,2013-03
2013-03-31,372426,40128,332298,사모아,2013-03
2013-03-31,346539,34075,312464,도미니카,2013-03
2013-03-31,285192,37,285155,세인트 루시아,2013-03
2013-03-31,277845,84,277761,르완다,2013-03
2013-03-31,259661,1266230,-1006569,리히텐슈타인,2013-03
2013-03-31,233915,0,233915,팔라우,2013-03
2013-03-31,197874,0,197874,감비아,2013-03
2013-03-31,184912,329805,-144893,스와질랜드,2013-03
2013-03-31,179988,0,179988,세인트 빈센트 그레나딘,2013-03
2013-03-31,137923,103,137820,세인트 키츠 네비스,2013-03
2013-03-31,136022,0,136022,메요트,2013-03
2013-03-31,133801,11869237,-11735436,나미비아,2013-03
2013-03-31,131231,2033,129198,미령 버진군도,2013-03
2013-03-31,127039,0,127039,소말리아,2013-03
2013-03-31,124950,0,124950,지브랄타,2013-03
2013-03-31,120320,22164,98156,안도라,2013-03
2013-03-31,117478,336,117142,부탄,2013-03
2013-03-31,115200,0,115200,코모로스,2013-03
2013-03-31,97667,7364,90303,부룬디,2013-03
2013-03-31,93231,0,93231,그레나다,2013-03
2013-03-31,92391,25032,67359,통가,2013-03
2013-03-31,83461,9633,73828,몬테네그로,2013-03
2013-03-31,76265,17716,58549,투르크 & 카이코스 군도,2013-03
2013-03-31,74776,15850,58926,레소토,2013-03
2013-03-31,66999,15857,51142,산마리노,2013-03
2013-03-31,57937,47794,10143,불령 가이아나,2013-03
2013-03-31,46031,1815426,-1769395,솔로몬 군도,2013-03
2013-03-31,40659,51498,-10839,상토메 프린스페,2013-03
2013-03-31,34772,117,34655,니제르,2013-03
2013-03-31,30547,59995,-29448,바누아투,2013-03
2013-03-31,29888,619,29269,쿡 아일랜드,2013-03
2013-03-31,29226,42275,-13049,영령 버진군도,2013-03
2013-03-31,26950,81170,-54220,투발루,2013-03
2013-03-31,15186,0,15186,국제통화기금,2013-03
2013-03-31,10672,0,10672,나우루,2013-03
2013-03-31,7915,0,7915,건지,2013-03
2013-03-31,5965,0,5965,챠드,2013-03
2013-03-31,5355,0,5355,카보 베르데,2013-03
2013-03-31,3147,0,3147,파로에 군도,2013-03
2013-03-31,2167,46359,-44192,코스 군도,2013-03
2013-03-31,2000,16149,-14149,토켈라우,2013-03
2013-03-31,640,0,640,앙귈라,2013-03
2013-03-31,390,878,-488,남조지아 & 남샌드위치 군도,2013-03
2013-03-31,324,0,324,세인트 마틴,2013-03
2013-03-31,300,0,300,세인트 피레 미켈론,2013-03
2013-03-31,0,109,-109,몬트세라트,2013-03
2013-03-31,0,18926,-18926,마이너 아우틀링 합중국 군도,2013-03
2013-03-31,0,7430,-7430,세인트 헬레나,2013-03
2013-03-31,0,51674,-51674,중앙아프리카공화국,2013-03
2013-03-31,0,154621,-154621,그린랜드,2013-03
2013-04-30,12136960810,7498963164,4637997646,중국,2013-04
2013-04-30,5347295434,3571762387,1775533047,미국,2013-04
2013-04-30,2430303577,5580422895,-3150119318,일본,2013-04
2013-04-30,2163472777,183904354,1979568423,홍콩,2013-04
2013-04-30,1973716260,820060990,1153655270,싱가포르,2013-04
2013-04-30,1741362024,534467851,1206894173,베트남,2013-04
2013-04-30,1555299536,1269343091,285956445,대만,2013-04
2013-04-30,954241018,527532254,426708764,인도,2013-04
2013-04-30,932378321,948324109,-15945788,러시아 연방,2013-04
2013-04-30,894977365,1946670124,-1051692759,호주,2013-04
2013-04-30,852481048,539911696,312569352,브라질,2013-04
2013-04-30,847464375,882446852,-34982477,말레이시아,2013-04
2013-04-30,844999017,153675721,691323296,멕시코,2013-04
2013-04-30,803009539,1128043376,-325033837,인도네시아,2013-04
2013-04-30,801352010,2617276448,-1815924438,사우디아라비아,2013-04
2013-04-30,746147899,309839939,436307960,필리핀,2013-04
2013-04-30,685056211,457164032,227892179,태국,2013-04
2013-04-30,619501750,27904627,591597123,헝가리,2013-04
2013-04-30,581414251,1534645700,-953231449,독일,2013-04
2013-04-30,539055654,432288856,106766798,프랑스,2013-04
2013-04-30,506805114,76919381,429885733,튀르키예,2013-04
2013-04-30,482223262,429552920,52670342,캐나다,2013-04
2013-04-30,459835241,1248763806,-788928565,아랍에미리트 연합,2013-04
2013-04-30,450051301,460578101,-10526800,이란,2013-04
2013-04-30,422824034,281202734,141621300,네덜란드,2013-04
2013-04-30,363982850,13925519,350057331,슬로바키아,2013-04
2013-04-30,343998179,62710893,281287286,폴란드,2013-04
2013-04-30,330407422,535191057,-204783635,영국,2013-04
2013-04-30,273260950,10980114,262280836,마샬군도,2013-04
2013-04-30,249338647,448777170,-199438523,이탈리아,2013-04
2013-04-30,200566259,102451055,98115204,벨기에,2013-04
2013-04-30,194755346,341987904,-147232558,칠레,2013-04
2013-04-30,174722327,93957029,80765298,이스라엘,2013-04
2013-04-30,173570814,81566,173489248,라이베리아,2013-04
2013-04-30,165587823,134834744,30753079,남아프리카공화국,2013-04
2013-04-30,163329240,831077471,-667748231,이라크,2013-04
2013-04-30,151690862,127893117,23797745,스페인,2013-04
2013-04-30,151388288,13970474,137417814,우즈베키스탄,2013-04
2013-04-30,132638559,111390482,21248077,이집트,2013-04
2013-04-30,130367160,85021439,45345721,몰타,2013-04
2013-04-30,126774826,58962073,67812753,체코공화국,2013-04
2013-04-30,114652137,9765683,104886454,요르단,2013-04
2013-04-30,113309468,107692144,5617324,뉴질랜드,2013-04
2013-04-30,111410386,27077422,84332964,방글라데시,2013-04
2013-04-30,111089718,2726212,108363506,에쿠아도르,2013-04
2013-04-30,106252493,74074252,32178241,알제리,2013-04
2013-04-30,105268379,234084998,-128816619,페루,2013-04
2013-04-30,103328894,7842229,95486665,슬로베니아,2013-04
2013-04-30,100857620,14426027,86431593,콜롬비아,2013-04
2013-04-30,98869501,1568264699,-1469395198,쿠웨이트,2013-04
2013-04-30,97818882,38490778,59328104,아르헨티나,2013-04
2013-04-30,96931532,38961669,57969863,리비아,2013-04
2013-04-30,95500587,204252052,-108751465,나이지리아,2013-04
2013-04-30,84622991,374730907,-290107916,오만,2013-04
2013-04-30,82455364,16642183,65813181,카자흐스탄,2013-04
2013-04-30,73672986,62796261,10876725,파키스탄,2013-04
2013-04-30,64104761,32667718,31437043,미얀마,2013-04
2013-04-30,61283927,117931753,-56647826,스웨덴,2013-04
2013-04-30,58619934,118416385,-59796451,오스트리아,2013-04
2013-04-30,56609997,13337398,43272599,캄보디아,2013-04
2013-04-30,53226626,15225927,38000699,우크라이나,2013-04
2013-04-30,51913029,70788343,-18875314,그리스,2013-04
2013-04-30,50454901,2154790036,-2104335135,카타르,2013-04
2013-04-30,49578966,246291707,-196712741,스위스,2013-04
2013-04-30,46893507,8899745,37993762,파나마,2013-04
2013-04-30,39648677,50112968,-10464291,루마니아,2013-04
2013-04-30,37484625,1462957,36021668,몽골,2013-04
2013-04-30,36405857,114719730,-78313873,핀란드,2013-04
2013-04-30,36404648,4408623,31996025,가나,2013-04
2013-04-30,36362317,502800,35859517,앙골라,2013-04
2013-04-30,35579927,176397,35403530,모나코,2013-04
2013-04-30,34678876,292742,34386134,베네주엘라,2013-04
2013-04-30,34372724,83386037,-49013313,아일랜드,2013-04
2013-04-30,32258607,6196179,26062428,레바논,2013-04
2013-04-30,29890893,59590818,-29699925,덴마크,2013-04
2013-04-30,27500819,15413083,12087736,포루투갈,2013-04
2013-04-30,26562735,133982,26428753,시리아,2013-04
2013-04-30,26079334,20309184,5770150,푸에르토리코,2013-04
2013-04-30,25960874,8686,25952188,아제르바이잔,2013-04
2013-04-30,25507287,9645206,15862081,모로코,2013-04
2013-04-30,25167595,34708943,-9541348,과테말라,2013-04
2013-04-30,23288186,2947218,20340968,케냐,2013-04
2013-04-30,19945715,9013566,10932149,스리랑카,2013-04
2013-04-30,19138872,4811273,14327599,에스토니아,2013-04
2013-04-30,17575344,1166332,16409012,라오스,2013-04
2013-04-30,16670134,58870337,-42200203,바레인,2013-04
2013-04-30,16438536,1628249,14810287,파라과이,2013-04
2013-04-30,16265772,40318864,-24053092,튀니지,2013-04
2013-04-30,14928955,23678299,-8749344,코스타리카,2013-04
2013-04-30,14874523,1654636,13219887,니카라과,2013-04
2013-04-30,14813813,83487,14730326,키르기스스탄,2013-04
2013-04-30,14670061,12567762,2102299,수단,2013-04
2013-04-30,14420899,249390532,-234969633,노르웨이,2013-04
2013-04-30,14158888,167,14158721,코트디봐르,2013-04
2013-04-30,14067791,416149,13651642,모잠비크,2013-04
2013-04-30,14008401,1305996,12702405,엘살바도르,2013-04
2013-04-30,13730602,2953140,10777462,리투아니아,2013-04
2013-04-30,13270223,159276038,-146005815,예맨,2013-04
2013-04-30,13100260,41041,13059219,투르크멘,2013-04
2013-04-30,12804398,8451762,4352636,온두라스,2013-04
2013-04-30,12560831,12435581,125250,도미니카 공화국,2013-04
2013-04-30,11510517,3116899,8393618,라트비아,2013-04
2013-04-30,11453852,5628167,5825685,탄자니아,2013-04
2013-04-30,10725982,9717274,1008708,우루과이,2013-04
2013-04-30,10110831,1114082,8996749,에티오피아,2013-04
2013-04-30,9337688,10087442,-749754,불가리아,2013-04
2013-04-30,9266560,3915613,5350947,세네갈,2013-04
2013-04-30,9092647,140437364,-131344717,브루나이,2013-04
2013-04-30,8570203,1459739,7110464,트리니다드 토바고,2013-04
2013-04-30,7697455,0,7697455,지부티,2013-04
2013-04-30,7135559,738053,6397506,조지아,2013-04
2013-04-30,6660326,47223892,-40563566,파푸아 뉴기니,2013-04
2013-04-30,5491498,36220,5455278,팔레스타인 해방기구,2013-04
2013-04-30,5417302,224,5417078,타지크,2013-04
2013-04-30,5154591,2366,5152225,아프카니스탄,2013-04
2013-04-30,5141826,1143873,3997953,카메룬,2013-04
2013-04-30,4974560,1993743,2980817,기니,2013-04
2013-04-30,4511322,2011568,2499754,크로아티아,2013-04
2013-04-30,4385092,261086,4124006,괌,2013-04
2013-04-30,4383167,425057,3958110,모리셔스,2013-04
2013-04-30,4247568,9670725,-5423157,세르비아,2013-04
2013-04-30,4119429,493260,3626169,수리남,2013-04
2013-04-30,3911133,24968826,-21057693,콩고민주공화국,2013-04
2013-04-30,3661809,1080273,2581536,벨라루스,2013-04
2013-04-30,3603860,16480750,-12876890,뉴 칼레도니아,2013-04
2013-04-30,3420296,177793,3242503,쿠바,2013-04
2013-04-30,3408971,2902068,506903,베닝,2013-04
2013-04-30,3356473,40411638,-37055165,볼리비아,2013-04
2013-04-30,3338846,20488351,-17149505,잠비아,2013-04
2013-04-30,3287415,0,3287415,부르키나 파소,2013-04
2013-04-30,2874936,195123,2679813,아이티,2013-04
2013-04-30,2871488,118743915,-115872427,사이프러스,2013-04
2013-04-30,2854280,1635831,1218449,피지,2013-04
2013-04-30,2601789,252230,2349559,짐바브웨,2013-04
2013-04-30,2424314,420308,2004006,콩고,2013-04
2013-04-30,2402583,345234,2057349,토고,2013-04
2013-04-30,2389367,127825,2261542,가이아나,2013-04
2013-04-30,2271478,5071155,-2799677,마다카스카르,2013-04
2013-04-30,2160873,96529,2064344,네덜란드 열도,2013-04
2013-04-30,2146449,313008,1833441,네팔,2013-04
2013-04-30,2145262,0,2145262,키리바티,2013-04
2013-04-30,2061400,386257,1675143,자마이카,2013-04
2013-04-30,2058289,54169827,-52111538,적도 기니,2013-04
2013-04-30,2019999,415387,1604612,우간다,2013-04
2013-04-30,1912856,53148,1859708,말리,2013-04
2013-04-30,1895213,2975061,-1079848,말라위,2013-04
2013-04-30,1872375,92457,1779918,아르메니아,2013-04
2013-04-30,1830269,788341,1041928,마카오,2013-04
2013-04-30,1783335,149830,1633505,르완다,2013-04
2013-04-30,1734742,7982,1726760,불령 리유니온 코모도 제도,2013-04
2013-04-30,1566086,3596466,-2030380,룩셈부르그,2013-04
2013-04-30,1520397,2259742,-739345,아이슬란드,2013-04
2013-04-30,1448676,84558316,-83109640,가봉,2013-04
2013-04-30,1306097,305437,1000660,세이쉘,2013-04
2013-04-30,1087487,679566,407921,모리타니,2013-04
2013-04-30,1084040,242085,841955,보스니아-헤르체고비나,2013-04
2013-04-30,1082560,0,1082560,티모르,2013-04
2013-04-30,1038005,0,1038005,불령 폴리네시아,2013-04
2013-04-30,1033843,30281,1003562,바베이도스,2013-04
2013-04-30,968589,4276207,-3307618,기타국,2013-04
2013-04-30,960348,1311760,-351412,몰도바,2013-04
2013-04-30,927614,0,927614,아루바,2013-04
2013-04-30,864577,164493,700084,마이크로네시아,2013-04
2013-04-30,849220,188,849032,영령 캐이맨 군도,2013-04
2013-04-30,847318,6299234,-5451916,바하마,2013-04
2013-04-30,831400,53258,778142,알바니아,2013-04
2013-04-30,707049,49,707000,버뮤다,2013-04
2013-04-30,668854,65,668789,아메리칸 사모아,2013-04
2013-04-30,631760,85834,545926,북마리아나 군도,2013-04
2013-04-30,612197,45472,566725,벨리제,2013-04
2013-04-30,586285,0,586285,사모아,2013-04
2013-04-30,558042,55730,502312,바누아투,2013-04
2013-04-30,542646,2699,539947,몬테네그로,2013-04
2013-04-30,517352,441848,75504,시에라 리온,2013-04
2013-04-30,484335,556,483779,과델로프,2013-04
2013-04-30,434995,22306,412689,보츠와나,2013-04
2013-04-30,420689,2291,418398,안티가 바부다,2013-04
2013-04-30,416195,119014,297181,마티니크,2013-04
2013-04-30,411678,1321,410357,세인트 루시아,2013-04
2013-04-30,323174,21703,301471,안도라,2013-04
2013-04-30,286183,52777,233406,불령 가이아나,2013-04
2013-04-30,277006,12908,264098,마세도니아,2013-04
2013-04-30,267348,5242,262106,몰디브,2013-04
2013-04-30,262046,1034640,-772594,리히텐슈타인,2013-04
2013-04-30,256492,0,256492,에리트리아,2013-04
2013-04-30,241599,122,241477,영령 버진군도,2013-04
2013-04-30,227426,0,227426,그레나다,2013-04
2013-04-30,221367,379881,-158514,스와질랜드,2013-04
2013-04-30,199923,1487,198436,팔라우,2013-04
2013-04-30,191347,1739939,-1548592,솔로몬 군도,2013-04
2013-04-30,187864,8373704,-8185840,나미비아,2013-04
2013-04-30,135541,0,135541,세인트 빈센트 그레나딘,2013-04
2013-04-30,131594,0,131594,지브랄타,2013-04
2013-04-30,123358,833623,-710265,도미니카,2013-04
2013-04-30,113778,1432,112346,코모로스,2013-04
2013-04-30,74679,0,74679,감비아,2013-04
2013-04-30,67535,79078,-11543,통가,2013-04
2013-04-30,49883,56,49827,세인트 키츠 네비스,2013-04
2013-04-30,47810,0,47810,중앙아프리카공화국,2013-04
2013-04-30,40291,0,40291,메요트,2013-04
2013-04-30,32675,63567,-30892,니제르,2013-04
2013-04-30,29674,0,29674,기네비소,2013-04
2013-04-30,25417,0,25417,국제통화기금,2013-04
2013-04-30,24142,0,24142,부탄,2013-04
2013-04-30,23912,0,23912,소말리아,2013-04
2013-04-30,21066,725,20341,카보 베르데,2013-04
2013-04-30,3960,0,3960,앙귈라,2013-04
2013-04-30,3389,0,3389,쿡 아일랜드,2013-04
2013-04-30,3303,37541,-34238,부룬디,2013-04
2013-04-30,2319,0,2319,세인트 마틴,2013-04
2013-04-30,500,139,361,챠드,2013-04
2013-04-30,168,1691,-1523,몬트세라트,2013-04
2013-04-30,31,0,31,건지,2013-04
2013-04-30,17,0,17,세인트 바르탤르미,2013-04
2013-04-30,16,1220,-1204,미령 버진군도,2013-04
2013-04-30,0,3225756,-3225756,나우루,2013-04
2013-04-30,0,808,-808,토켈라우,2013-04
2013-04-30,0,198933,-198933,투발루,2013-04
2013-04-30,0,209,-209,세인트 헬레나,2013-04
2013-04-30,0,863,-863,투르크 & 카이코스 군도,2013-04
2013-04-30,0,29855,-29855,포클랜드 군도,2013-04
2013-04-30,0,15898,-15898,교황청,2013-04
2013-04-30,0,2099,-2099,산마리노,2013-04
2013-04-30,0,156134,-156134,그린랜드,2013-04
2013-04-30,0,8055119,-8055119,안타티카,2013-04
2013-04-30,0,762,-762,상토메 프린스페,2013-04
2013-05-31,12481015335,7288539042,5192476293,중국,2013-05
2013-05-31,5744405046,3539270743,2205134303,미국,2013-05
2013-05-31,2732790263,4917768287,-2184978024,일본,2013-05
2013-05-31,2380306187,160572206,2219733981,홍콩,2013-05
2013-05-31,2146651484,875811565,1270839919,싱가포르,2013-05
2013-05-31,1862563085,576083379,1286479706,베트남,2013-05
2013-05-31,1291936224,1337499871,-45563647,대만,2013-05
2013-05-31,1033258324,1272850755,-239592431,인도네시아,2013-05
2013-05-31,1003969703,550102452,453867251,인도,2013-05
2013-05-31,949165754,1246345138,-297179384,러시아 연방,2013-05
2013-05-31,946505772,382356602,564149170,브라질,2013-05
2013-05-31,868318967,198957186,669361781,멕시코,2013-05
2013-05-31,824463807,3019970250,-2195506443,사우디아라비아,2013-05
2013-05-31,769162429,490578130,278584299,태국,2013-05
2013-05-31,733258299,330990681,402267618,필리핀,2013-05
2013-05-31,716366501,1686382201,-970015700,호주,2013-05
2013-05-31,714451877,1473425058,-758973181,독일,2013-05
2013-05-31,665687348,840852445,-175165097,말레이시아,2013-05
2013-05-31,633528081,334472,633193609,바하마,2013-05
2013-05-31,580296852,392233323,188063529,이란,2013-05
2013-05-31,564845970,359055330,205790640,캐나다,2013-05
2013-05-31,497548088,47413473,450134615,튀르키예,2013-05
2013-05-31,477946995,379006839,98940156,네덜란드,2013-05
2013-05-31,434524767,551139543,-116614776,영국,2013-05
2013-05-31,428906385,1349814547,-920908162,아랍에미리트 연합,2013-05
2013-05-31,367518427,20769623,346748804,마샬군도,2013-05
2013-05-31,313758182,15695833,298062349,슬로바키아,2013-05
2013-05-31,286985404,439928039,-152942635,프랑스,2013-05
2013-05-31,272342051,407323655,-134981604,칠레,2013-05
2013-05-31,269203965,69899387,199304578,폴란드,2013-05
2013-05-31,264881564,91972433,172909131,파나마,2013-05
2013-05-31,237776447,471777019,-234000572,이탈리아,2013-05
2013-05-31,191386058,3988309,187397749,우즈베키스탄,2013-05
2013-05-31,191243472,7171,191236301,버뮤다,2013-05
2013-05-31,177390212,3017,177387195,라이베리아,2013-05
2013-05-31,175337807,754400172,-579062365,이라크,2013-05
2013-05-31,173958917,103265793,70693124,벨기에,2013-05
2013-05-31,154072480,153651746,420734,남아프리카공화국,2013-05
2013-05-31,149791414,49049278,100742136,체코공화국,2013-05
2013-05-31,138485536,135610747,2874789,뉴질랜드,2013-05
2013-05-31,133844568,7701002,126143566,슬로베니아,2013-05
2013-05-31,122487020,125489867,-3002847,스페인,2013-05
2013-05-31,112628359,41449492,71178867,페루,2013-05
2013-05-31,111958603,5330037,106628566,룩셈부르그,2013-05
2013-05-31,110813736,4612852,106200884,이집트,2013-05
2013-05-31,109226123,1093149949,-983923826,쿠웨이트,2013-05
2013-05-31,104761352,491555843,-386794491,오만,2013-05
2013-05-31,103095124,4835446,98259678,요르단,2013-05
2013-05-31,102375554,65888485,36487069,이스라엘,2013-05
2013-05-31,102369452,13382884,88986568,카자흐스탄,2013-05
2013-05-31,99883808,144383811,-44500003,아르헨티나,2013-05
2013-05-31,99680207,450205,99230002,알제리,2013-05
2013-05-31,99596360,15850760,83745600,콜롬비아,2013-05
2013-05-31,97258306,28549020,68709286,방글라데시,2013-05
2013-05-31,84095238,832418,83262820,리비아,2013-05
2013-05-31,81785911,36815654,44970257,헝가리,2013-05
2013-05-31,77120492,51627750,25492742,나이지리아,2013-05
2013-05-31,71586066,36214719,35371347,파키스탄,2013-05
2013-05-31,70408348,16032825,54375523,미얀마,2013-05
2013-05-31,65296196,3203578,62092618,에쿠아도르,2013-05
2013-05-31,61326496,124750737,-63424241,스웨덴,2013-05
2013-05-31,60299455,169647930,-109348475,몰타,2013-05
2013-05-31,58741862,372819038,-314077176,노르웨이,2013-05
2013-05-31,51916941,1852943873,-1801026932,카타르,2013-05
2013-05-31,51648650,116775675,-65127025,오스트리아,2013-05
2013-05-31,51602603,9313432,42289171,캄보디아,2013-05
2013-05-31,45641322,47662635,-2021313,루마니아,2013-05
2013-05-31,43675215,2356375,41318840,그리스,2013-05
2013-05-31,41441931,8933437,32508494,우크라이나,2013-05
2013-05-31,39329783,2477201,36852582,몽골,2013-05
2013-05-31,38852001,617,38851384,아제르바이잔,2013-05
2013-05-31,36926983,4679580,32247403,레바논,2013-05
2013-05-31,36671169,15933,36655236,불령 폴리네시아,2013-05
2013-05-31,32728632,73056920,-40328288,덴마크,2013-05
2013-05-31,31227551,0,31227551,시리아,2013-05
2013-05-31,30089562,4354397,25735165,가나,2013-05
2013-05-31,29612144,16359808,13252336,포루투갈,2013-05
2013-05-31,29041455,101412012,-72370557,핀란드,2013-05
2013-05-31,28903250,306,28902944,맨섬,2013-05
2013-05-31,28203887,0,28203887,영령 인도양,2013-05
2013-05-31,27580705,6616490,20964215,스리랑카,2013-05
2013-05-31,26809332,11216,26798116,베네주엘라,2013-05
2013-05-31,24638577,11130871,13507706,과테말라,2013-05
2013-05-31,22185815,5274580,16911235,모로코,2013-05
2013-05-31,20577186,1745490,18831696,케냐,2013-05
2013-05-31,20516195,56768806,-36252611,아일랜드,2013-05
2013-05-31,19847746,20710953,-863207,코스타리카,2013-05
2013-05-31,19072017,39561057,-20489040,우루과이,2013-05
2013-05-31,19038313,16347543,2690770,앙골라,2013-05
2013-05-31,18805938,595398,18210540,파라과이,2013-05
2013-05-31,18637847,212849138,-194211291,스위스,2013-05
2013-05-31,18608076,22341789,-3733713,푸에르토리코,2013-05
2013-05-31,18187305,81730239,-63542934,바레인,2013-05
2013-05-31,17731944,1409333,16322611,니카라과,2013-05
2013-05-31,15280311,29307853,-14027542,튀니지,2013-05
2013-05-31,14040447,5280374,8760073,에스토니아,2013-05
2013-05-31,13536375,3670856,9865519,탄자니아,2013-05
2013-05-31,13349342,12463372,885970,도미니카 공화국,2013-05
2013-05-31,13237103,291048609,-277811506,브루나이,2013-05
2013-05-31,13114532,60371,13054161,코트디봐르,2013-05
2013-05-31,12567464,4095993,8471471,리투아니아,2013-05
2013-05-31,12181146,140036045,-127854899,예맨,2013-05
2013-05-31,11794106,9216994,2577112,수단,2013-05
2013-05-31,11608051,54183,11553868,키르기스스탄,2013-05
2013-05-31,10690289,35,10690254,아메리칸 사모아,2013-05
2013-05-31,10303733,1470,10302263,투르크멘,2013-05
2013-05-31,10284977,15833957,-5548980,불가리아,2013-05
2013-05-31,10085054,3426360,6658694,모잠비크,2013-05
2013-05-31,9390440,7098796,2291644,온두라스,2013-05
2013-05-31,9254772,1110907,8143865,엘살바도르,2013-05
2013-05-31,9009915,507480,8502435,조지아,2013-05
2013-05-31,8326250,585167,7741083,라오스,2013-05
2013-05-31,7340869,3887850,3453019,라트비아,2013-05
2013-05-31,6992439,2003267,4989172,에티오피아,2013-05
2013-05-31,6843154,495,6842659,말리,2013-05
2013-05-31,6676060,1220341,5455719,트리니다드 토바고,2013-05
2013-05-31,5710485,28114501,-22404016,콩고민주공화국,2013-05
2013-05-31,5530300,4950,5525350,아프카니스탄,2013-05
2013-05-31,5286423,0,5286423,지부티,2013-05
2013-05-31,5105887,3158940,1946947,벨라루스,2013-05
2013-05-31,4968644,31197,4937447,팔레스타인 해방기구,2013-05
2013-05-31,4798597,328939,4469658,가봉,2013-05
2013-05-31,4643515,4552585,90930,세네갈,2013-05
2013-05-31,4594445,16105307,-11510862,세르비아,2013-05
2013-05-31,4454854,1041178,3413676,기니,2013-05
2013-05-31,4278827,619438,3659389,쿠바,2013-05
2013-05-31,4261509,356794,3904715,모리셔스,2013-05
2013-05-31,3811340,32395542,-28584202,볼리비아,2013-05
2013-05-31,3716030,0,3716030,타지크,2013-05
2013-05-31,3680358,109307,3571051,괌,2013-05
2013-05-31,3632561,463257,3169304,카메룬,2013-05
2013-05-31,3491291,2054502,1436789,짐바브웨,2013-05
2013-05-31,3490335,13883847,-10393512,파푸아 뉴기니,2013-05
2013-05-31,3474984,340477,3134507,마카오,2013-05
2013-05-31,3443562,424365,3019197,베닝,2013-05
2013-05-31,3169556,878099,2291457,피지,2013-05
2013-05-31,2905286,16053463,-13148177,뉴 칼레도니아,2013-05
2013-05-31,2696116,102081,2594035,가이아나,2013-05
2013-05-31,2535936,0,2535936,네덜란드 열도,2013-05
2013-05-31,2373106,465216,1907890,아이티,2013-05
2013-05-31,2357375,2,2357373,부르키나 파소,2013-05
2013-05-31,2311998,399177,1912821,자마이카,2013-05
2013-05-31,2272943,29374137,-27101194,잠비아,2013-05
2013-05-31,2200038,449556,1750482,크로아티아,2013-05
2013-05-31,1864436,0,1864436,토고,2013-05
2013-05-31,1809272,52543107,-50733835,사이프러스,2013-05
2013-05-31,1803602,4872452,-3068850,마다카스카르,2013-05
2013-05-31,1743743,203386,1540357,수리남,2013-05
2013-05-31,1663358,1839131,-175773,모리타니,2013-05
2013-05-31,1621004,400528,1220476,보스니아-헤르체고비나,2013-05
2013-05-31,1578483,132151,1446332,네팔,2013-05
2013-05-31,1552726,0,1552726,불령 리유니온 코모도 제도,2013-05
2013-05-31,1486071,352470,1133601,시에라 리온,2013-05
2013-05-31,1476978,343187,1133791,말라위,2013-05
2013-05-31,1093331,139783,953548,마티니크,2013-05
2013-05-31,1073173,1909320,-836147,아이슬란드,2013-05
2013-05-31,1061237,78154,983083,아르메니아,2013-05
2013-05-31,1037685,308012,729673,콩고,2013-05
2013-05-31,1017456,140996,876460,세이쉘,2013-05
2013-05-31,1008499,662502,345997,마이크로네시아,2013-05
2013-05-31,907593,63441319,-62533726,티모르,2013-05
2013-05-31,873440,6197980,-5324540,기타국,2013-05
2013-05-31,805216,153123,652093,키리바티,2013-05
2013-05-31,799053,91939,707114,바베이도스,2013-05
2013-05-31,794795,26182,768613,알바니아,2013-05
2013-05-31,759363,0,759363,아루바,2013-05
2013-05-31,747409,100,747309,영령 캐이맨 군도,2013-05
2013-05-31,681470,48005,633465,사모아,2013-05
2013-05-31,673024,528,672496,벨리제,2013-05
2013-05-31,648549,4611,643938,에리트리아,2013-05
2013-05-31,618433,264337,354096,우간다,2013-05
2013-05-31,588908,4357,584551,몰디브,2013-05
2013-05-31,573020,84130,488890,보츠와나,2013-05
2013-05-31,572977,2663,570314,북마리아나 군도,2013-05
2013-05-31,471736,13,471723,중앙아프리카공화국,2013-05
2013-05-31,461454,223116,238338,영령 버진군도,2013-05
2013-05-31,425484,39592,385892,모나코,2013-05
2013-05-31,406162,0,406162,과델로프,2013-05
2013-05-31,374306,63110,311196,바누아투,2013-05
2013-05-31,362667,523157,-160490,몰도바,2013-05
2013-05-31,343589,458907,-115318,도미니카,2013-05
2013-05-31,335742,0,335742,르완다,2013-05
2013-05-31,332256,1075,331181,안도라,2013-05
2013-05-31,307091,49920,257171,마세도니아,2013-05
2013-05-31,295013,197,294816,지브랄타,2013-05
2013-05-31,274634,7421,267213,안티가 바부다,2013-05
2013-05-31,256852,0,256852,그레나다,2013-05
2013-05-31,243665,126479,117186,불령 가이아나,2013-05
2013-05-31,240040,495730,-255690,스와질랜드,2013-05
2013-05-31,212774,592367,-379593,리히텐슈타인,2013-05
2013-05-31,202971,539,202432,세인트 키츠 네비스,2013-05
2013-05-31,178409,0,178409,팔라우,2013-05
2013-05-31,168938,18582,150356,세인트 빈센트 그레나딘,2013-05
2013-05-31,164529,0,164529,챠드,2013-05
2013-05-31,116444,0,116444,감비아,2013-05
2013-05-31,108136,1169427,-1061291,솔로몬 군도,2013-05
2013-05-31,106043,2863,103180,몬테네그로,2013-05
2013-05-31,101919,7993239,-7891320,나미비아,2013-05
2013-05-31,90030,39820,50210,부탄,2013-05
2013-05-31,65219,0,65219,소말리아,2013-05
2013-05-31,62568,0,62568,파로에 군도,2013-05
2013-05-31,60792,0,60792,세인트 루시아,2013-05
2013-05-31,58341,0,58341,투발루,2013-05
2013-05-31,40025,0,40025,카보 베르데,2013-05
2013-05-31,39304,0,39304,불령 남부지역,2013-05
2013-05-31,36250,375,35875,니제르,2013-05
2013-05-31,35951,3262981,-3227030,나우루,2013-05
2013-05-31,34291,0,34291,적도 기니,2013-05
2013-05-31,21411,0,21411,큐라소,2013-05
2013-05-31,20000,0,20000,기네비소,2013-05
2013-05-31,19095,0,19095,투르크 & 카이코스 군도,2013-05
2013-05-31,15968,78302,-62334,통가,2013-05
2013-05-31,14767,0,14767,남수단,2013-05
2013-05-31,9007,0,9007,앙귈라,2013-05
2013-05-31,7302,1278,6024,쿡 아일랜드,2013-05
2013-05-31,5798,520036,-514238,세인트 헬레나,2013-05
2013-05-31,1594,0,1594,세인트 마틴,2013-05
2013-05-31,238,145345,-145107,그린랜드,2013-05
2013-05-31,0,21798,-21798,몬트세라트,2013-05
2013-05-31,0,116400,-116400,상토메 프린스페,2013-05
2013-05-31,0,173561,-173561,포클랜드 군도,2013-05
2013-05-31,0,2755,-2755,미령 버진군도,2013-05
2013-05-31,0,769,-769,레소토,2013-05
2013-05-31,0,31356,-31356,토켈라우,2013-05
2013-05-31,0,5517,-5517,코모로스,2013-05
2013-05-31,0,137527,-137527,안타티카,2013-05
2013-05-31,0,3507,-3507,코스 군도,2013-05
2013-06-30,11398722435,6461543104,4937179331,중국,2013-06
2013-06-30,5292652127,3265591898,2027060229,미국,2013-06
2013-06-30,2824465569,4673539152,-1849073583,일본,2013-06
2013-06-30,2240549143,141563578,2098985565,홍콩,2013-06
2013-06-30,2133840650,852254536,1281586114,싱가포르,2013-06
2013-06-30,1873345037,16280600,1857064437,파나마,2013-06
2013-06-30,1674987626,452402677,1222584949,베트남,2013-06
2013-06-30,1295690033,1199005492,96684541,대만,2013-06
2013-06-30,946068334,735532793,210535541,러시아 연방,2013-06
2013-06-30,906674366,936462680,-29788314,인도네시아,2013-06
2013-06-30,875435899,906945518,-31509619,말레이시아,2013-06
2013-06-30,866963968,412043425,454920543,인도,2013-06
2013-06-30,783469184,1640636889,-857167705,호주,2013-06
2013-06-30,777606927,383930745,393676182,브라질,2013-06
2013-06-30,706412792,1580882349,-874469557,독일,2013-06
2013-06-30,699038457,3029350591,-2330312134,사우디아라비아,2013-06
2013-06-30,679677159,385227429,294449730,필리핀,2013-06
2013-06-30,639389089,179301685,460087404,멕시코,2013-06
2013-06-30,630421854,515224304,115197550,태국,2013-06
2013-06-30,608424609,55953217,552471392,헝가리,2013-06
2013-06-30,518824470,321600710,197223760,영국,2013-06
2013-06-30,453666719,434151475,19515244,캐나다,2013-06
2013-06-30,440653269,57802110,382851159,튀르키예,2013-06
2013-06-30,400500867,1537630540,-1137129673,아랍에미리트 연합,2013-06
2013-06-30,385064694,321641531,63423163,네덜란드,2013-06
2013-06-30,366600528,443094638,-76494110,이란,2013-06
2013-06-30,349887487,4310,349883177,마샬군도,2013-06
2013-06-30,251472583,519690071,-268217488,프랑스,2013-06
2013-06-30,246455425,451427592,-204972167,이탈리아,2013-06
2013-06-30,241411558,52692780,188718778,그리스,2013-06
2013-06-30,236153564,50950112,185203452,폴란드,2013-06
2013-06-30,215639501,15430658,200208843,슬로바키아,2013-06
2013-06-30,210045650,54399002,155646648,덴마크,2013-06
2013-06-30,194791277,352919445,-158128168,칠레,2013-06
2013-06-30,194467990,116797009,77670981,벨기에,2013-06
2013-06-30,192809433,4490761,188318672,우즈베키스탄,2013-06
2013-06-30,153620407,166795298,-13174891,남아프리카공화국,2013-06
2013-06-30,139970800,20675582,119295218,방글라데시,2013-06
2013-06-30,132548397,314607291,-182058894,노르웨이,2013-06
2013-06-30,126504737,985532687,-859027950,이라크,2013-06
2013-06-30,124549095,86394424,38154671,이집트,2013-06
2013-06-30,119751648,66064742,53686906,체코공화국,2013-06
2013-06-30,119569899,254977634,-135407735,페루,2013-06
2013-06-30,112851411,103386861,9464550,스페인,2013-06
2013-06-30,112805583,1571083609,-1458278026,쿠웨이트,2013-06
2013-06-30,112379680,2952701,109426979,룩셈부르그,2013-06
2013-06-30,110858748,5965807,104892941,요르단,2013-06
2013-06-30,108723386,67811086,40912300,이스라엘,2013-06
2013-06-30,105591273,7907450,97683823,슬로베니아,2013-06
2013-06-30,104039168,45248333,58790835,리비아,2013-06
2013-06-30,100432211,45813,100386398,라이베리아,2013-06
2013-06-30,97390070,159564731,-62174661,나이지리아,2013-06
2013-06-30,97149350,2990616,94158734,에쿠아도르,2013-06
2013-06-30,95605961,13542001,82063960,카자흐스탄,2013-06
2013-06-30,91146150,16376003,74770147,콜롬비아,2013-06
2013-06-30,90548140,21541840,69006300,알제리,2013-06
2013-06-30,90251742,472069510,-381817768,오만,2013-06
2013-06-30,88653160,163596712,-74943552,아르헨티나,2013-06
2013-06-30,71894857,107491461,-35596604,뉴질랜드,2013-06
2013-06-30,63969976,122033459,-58063483,스웨덴,2013-06
2013-06-30,62348041,48841415,13506626,파키스탄,2013-06
2013-06-30,61057697,18966909,42090788,미얀마,2013-06
2013-06-30,61057392,33138772,27918620,우크라이나,2013-06
2013-06-30,47691244,94620919,-46929675,오스트리아,2013-06
2013-06-30,47482928,1923769356,-1876286428,카타르,2013-06
2013-06-30,44757097,10180326,34576771,캄보디아,2013-06
2013-06-30,44365436,3306186,41059250,가나,2013-06
2013-06-30,42188368,5290990,36897378,레바논,2013-06
2013-06-30,39228003,1176790,38051213,몽골,2013-06
2013-06-30,38589308,34133021,4456287,루마니아,2013-06
2013-06-30,35589652,107655070,-72065418,사이프러스,2013-06
2013-06-30,34138062,10689,34127373,시리아,2013-06
2013-06-30,31837418,119583424,-87746006,핀란드,2013-06
2013-06-30,31562762,24781944,6780818,과테말라,2013-06
2013-06-30,29455815,7271704,22184111,스리랑카,2013-06
2013-06-30,23917989,205550491,-181632502,스위스,2013-06
2013-06-30,23857626,17515443,6342183,포루투갈,2013-06
2013-06-30,23305646,31894316,-8588670,모로코,2013-06
2013-06-30,23193464,262,23193202,투르크멘,2013-06
2013-06-30,23074441,4673109,18401332,베네주엘라,2013-06
2013-06-30,22756688,5139320,17617368,우루과이,2013-06
2013-06-30,20992678,16015799,4976879,푸에르토리코,2013-06
2013-06-30,20931870,4130837,16801033,케냐,2013-06
2013-06-30,20816758,6684253,14132505,바레인,2013-06
2013-06-30,20323311,29788383,-9465072,코스타리카,2013-06
2013-06-30,19629522,58972613,-39343091,아일랜드,2013-06
2013-06-30,18888599,75,18888524,아제르바이잔,2013-06
2013-06-30,18115022,1623829,16491193,앙골라,2013-06
2013-06-30,17339527,699350,16640177,파라과이,2013-06
2013-06-30,15046461,67068614,-52022153,예맨,2013-06
2013-06-30,15006928,2577397,12429531,니카라과,2013-06
2013-06-30,14669528,5349950,9319578,수단,2013-06
2013-06-30,14288635,32789010,-18500375,튀니지,2013-06
2013-06-30,13958803,4386888,9571915,리투아니아,2013-06
2013-06-30,13905565,11411,13894154,키르기스스탄,2013-06
2013-06-30,13743741,1268381,12475360,엘살바도르,2013-06
2013-06-30,13705904,1470100,12235804,탄자니아,2013-06
2013-06-30,13250252,8764044,4486208,도미니카 공화국,2013-06
2013-06-30,13220019,6949515,6270504,에스토니아,2013-06
2013-06-30,12236078,334845,11901233,조지아,2013-06
2013-06-30,11789525,13448,11776077,아프카니스탄,2013-06
2013-06-30,11574054,3509761,8064293,불가리아,2013-06
2013-06-30,10963308,143223,10820085,코트디봐르,2013-06
2013-06-30,10404433,4882360,5522073,에티오피아,2013-06
2013-06-30,9128126,146522200,-137394074,브루나이,2013-06
2013-06-30,9018923,2727167,6291756,라트비아,2013-06
2013-06-30,9016182,4330291,4685891,온두라스,2013-06
2013-06-30,8535321,2940577,5594744,라오스,2013-06
2013-06-30,8261153,6090529,2170624,벨라루스,2013-06
2013-06-30,8170186,2862916,5307270,모잠비크,2013-06
2013-06-30,7364913,52238,7312675,아메리칸 사모아,2013-06
2013-06-30,7311736,45177223,-37865487,트리니다드 토바고,2013-06
2013-06-30,6957181,43508758,-36551577,파푸아 뉴기니,2013-06
2013-06-30,6924312,751,6923561,르완다,2013-06
2013-06-30,6356089,9600628,-3244539,볼리비아,2013-06
2013-06-30,6229515,198608,6030907,팔레스타인 해방기구,2013-06
2013-06-30,5905993,63067387,-57161394,몰타,2013-06
2013-06-30,5089860,7512432,-2422572,세네갈,2013-06
2013-06-30,4708146,244652,4463494,세르비아,2013-06
2013-06-30,4518727,308688,4210039,모리셔스,2013-06
2013-06-30,4300993,335053,3965940,쿠바,2013-06
2013-06-30,4157662,129935,4027727,가봉,2013-06
2013-06-30,4129235,19033068,-14903833,뉴 칼레도니아,2013-06
2013-06-30,3950668,934254,3016414,크로아티아,2013-06
2013-06-30,3860817,534039,3326778,괌,2013-06
2013-06-30,3756515,102884,3653631,콩고,2013-06
2013-06-30,3443682,0,3443682,지부티,2013-06
2013-06-30,3371479,184934,3186545,베닝,2013-06
2013-06-30,3344524,484727,2859797,아이티,2013-06
2013-06-30,3232613,572073,2660540,피지,2013-06
2013-06-30,3213195,775651,2437544,기니,2013-06
2013-06-30,3090713,65836,3024877,세이쉘,2013-06
2013-06-30,2689082,321,2688761,타지크,2013-06
2013-06-30,2531253,898507,1632746,자마이카,2013-06
2013-06-30,2360254,9070752,-6710498,마다카스카르,2013-06
2013-06-30,2347090,8328073,-5980983,토고,2013-06
2013-06-30,2240797,1680108,560689,말라위,2013-06
2013-06-30,2203883,391643,1812240,카메룬,2013-06
2013-06-30,2044543,0,2044543,네덜란드 열도,2013-06
2013-06-30,1967409,1708435,258974,아이슬란드,2013-06
2013-06-30,1915559,22,1915537,아루바,2013-06
2013-06-30,1855026,380272,1474754,마카오,2013-06
2013-06-30,1789392,8629,1780763,부르키나 파소,2013-06
2013-06-30,1757979,0,1757979,가이아나,2013-06
2013-06-30,1734538,121492,1613046,모나코,2013-06
2013-06-30,1655099,0,1655099,티모르,2013-06
2013-06-30,1647814,450779,1197035,바하마,2013-06
2013-06-30,1641650,8911422,-7269772,콩고민주공화국,2013-06
2013-06-30,1570739,68968,1501771,불령 폴리네시아,2013-06
2013-06-30,1561512,258138,1303374,아르메니아,2013-06
2013-06-30,1435336,581723,853613,짐바브웨,2013-06
2013-06-30,1421177,21760690,-20339513,잠비아,2013-06
2013-06-30,1344255,104,1344151,말리,2013-06
2013-06-30,1208322,160942,1047380,나미비아,2013-06
2013-06-30,1204877,6141832,-4936955,기타국,2013-06
2013-06-30,1188417,0,1188417,중앙아프리카공화국,2013-06
2013-06-30,1124209,343012,781197,수리남,2013-06
2013-06-30,1049610,10457,1039153,불령 리유니온 코모도 제도,2013-06
2013-06-30,1019464,12650,1006814,바베이도스,2013-06
2013-06-30,991755,237771,753984,몰도바,2013-06
2013-06-30,957738,390102,567636,보스니아-헤르체고비나,2013-06
2013-06-30,888116,287346,600770,시에라 리온,2013-06
2013-06-30,873980,12605,861375,알바니아,2013-06
2013-06-30,819073,186550,632523,벨리제,2013-06
2013-06-30,797886,1212593,-414707,모리타니,2013-06
2013-06-30,703524,156103,547421,네팔,2013-06
2013-06-30,672449,0,672449,버뮤다,2013-06
2013-06-30,667981,35893,632088,마세도니아,2013-06
2013-06-30,655000,33,654967,에리트리아,2013-06
2013-06-30,594273,40103,554170,사모아,2013-06
2013-06-30,578849,653241,-74392,우간다,2013-06
2013-06-30,545249,6544,538705,안도라,2013-06
2013-06-30,520300,709856,-189556,리히텐슈타인,2013-06
2013-06-30,481596,28015,453581,보츠와나,2013-06
2013-06-30,476549,1161,475388,북마리아나 군도,2013-06
2013-06-30,450464,20757,429707,니제르,2013-06
2013-06-30,449237,483,448754,영령 캐이맨 군도,2013-06
2013-06-30,395536,0,395536,마티니크,2013-06
2013-06-30,385617,51160,334457,바누아투,2013-06
2013-06-30,381905,0,381905,소말리아,2013-06
2013-06-30,357350,97479,259871,마이크로네시아,2013-06
2013-06-30,348594,251664,96930,스와질랜드,2013-06
2013-06-30,347072,59155,287917,과델로프,2013-06
2013-06-30,343910,759,343151,몬테네그로,2013-06
2013-06-30,326897,0,326897,영령 버진군도,2013-06
2013-06-30,265694,0,265694,세인트 루시아,2013-06
2013-06-30,253949,0,253949,감비아,2013-06
2013-06-30,224580,8283,216297,몰디브,2013-06
2013-06-30,202350,793641,-591291,도미니카,2013-06
2013-06-30,201041,186,200855,부탄,2013-06
2013-06-30,183900,363548,-179648,솔로몬 군도,2013-06
2013-06-30,173792,0,173792,안티가 바부다,2013-06
2013-06-30,163160,0,163160,적도 기니,2013-06
2013-06-30,132194,791,131403,세인트 키츠 네비스,2013-06
2013-06-30,118873,8,118865,팔라우,2013-06
2013-06-30,98732,0,98732,지브랄타,2013-06
2013-06-30,95566,0,95566,노폴크 아일랜드,2013-06
2013-06-30,91458,0,91458,그레나다,2013-06
2013-06-30,87523,166008,-78485,불령 가이아나,2013-06
2013-06-30,75075,0,75075,카보 베르데,2013-06
2013-06-30,74965,0,74965,세인트 빈센트 그레나딘,2013-06
2013-06-30,58651,0,58651,파로에 군도,2013-06
2013-06-30,56850,0,56850,키리바티,2013-06
2013-06-30,52198,0,52198,챠드,2013-06
2013-06-30,39611,91776,-52165,통가,2013-06
2013-06-30,30492,0,30492,투르크 & 카이코스 군도,2013-06
2013-06-30,29825,34,29791,쿡 아일랜드,2013-06
2013-06-30,19318,13652,5666,부룬디,2013-06
2013-06-30,16236,0,16236,세인트 헬레나,2013-06
2013-06-30,13871,16,13855,앙귈라,2013-06
2013-06-30,7607,2882,4725,미령 버진군도,2013-06
2013-06-30,4051,0,4051,상토메 프린스페,2013-06
2013-06-30,1298,0,1298,세인트 마틴,2013-06
2013-06-30,0,3281,-3281,토켈라우,2013-06
2013-06-30,0,47522,-47522,산마리노,2013-06
2013-06-30,0,255,-255,레소토,2013-06
2013-06-30,0,260411,-260411,그린랜드,2013-06
2013-06-30,0,789,-789,몬트세라트,2013-06
2013-06-30,0,1629254,-1629254,나우루,2013-06
2013-07-31,12882114281,7105992337,5776121944,중국,2013-07
2013-07-31,5153830762,3610812192,1543018570,미국,2013-07
2013-07-31,2839173120,5117609245,-2278436125,일본,2013-07
2013-07-31,2255632111,148230202,2107401909,홍콩,2013-07
2013-07-31,1685025064,523166543,1161858521,베트남,2013-07
2013-07-31,1589434490,810124657,779309833,싱가포르,2013-07
2013-07-31,1307014666,1280191279,26823387,대만,2013-07
2013-07-31,1039759315,883578437,156180878,러시아 연방,2013-07
2013-07-31,963965591,491841185,472124406,인도,2013-07
2013-07-31,805816392,285032305,520784087,필리핀,2013-07
2013-07-31,798811884,792489363,6322521,말레이시아,2013-07
2013-07-31,797826789,545632337,252194452,브라질,2013-07
2013-07-31,761554643,203429535,558125108,멕시코,2013-07
2013-07-31,707792207,2891961718,-2184169511,사우디아라비아,2013-07
2013-07-31,693049765,420256595,272793170,태국,2013-07
2013-07-31,678332718,1021421051,-343088333,인도네시아,2013-07
2013-07-31,658451724,25927757,632523967,마샬군도,2013-07
2013-07-31,601368475,1757854957,-1156486482,호주,2013-07
2013-07-31,580365420,415924370,164441050,네덜란드,2013-07
2013-07-31,536933419,1706188981,-1169255562,독일,2013-07
2013-07-31,473156865,52948813,420208052,튀르키예,2013-07
2013-07-31,442428544,1538351511,-1095922967,아랍에미리트 연합,2013-07
2013-07-31,390222972,437066173,-46843201,캐나다,2013-07
2013-07-31,374030437,17157398,356873039,슬로바키아,2013-07
2013-07-31,341519380,543465820,-201946440,영국,2013-07
2013-07-31,270064693,71524057,198540636,폴란드,2013-07
2013-07-31,262277554,420062110,-157784556,프랑스,2013-07
2013-07-31,236471191,477275702,-240804511,이탈리아,2013-07
2013-07-31,221765497,71337802,150427695,덴마크,2013-07
2013-07-31,192240925,0,192240925,버뮤다,2013-07
2013-07-31,191733867,454166472,-262432605,칠레,2013-07
2013-07-31,188800487,244964220,-56163733,노르웨이,2013-07
2013-07-31,184263299,614745297,-430481998,이란,2013-07
2013-07-31,176287099,78065037,98222062,이스라엘,2013-07
2013-07-31,164717409,104628964,60088445,벨기에,2013-07
2013-07-31,162209356,1977634,160231722,우즈베키스탄,2013-07
2013-07-31,143356020,47810001,95546019,체코공화국,2013-07
2013-07-31,142924613,128150831,14773782,남아프리카공화국,2013-07
2013-07-31,140303572,7974479,132329093,슬로베니아,2013-07
2013-07-31,136242788,120312036,15930752,뉴질랜드,2013-07
2013-07-31,131633964,904487085,-772853121,이라크,2013-07
2013-07-31,129817553,44039630,85777923,페루,2013-07
2013-07-31,126956026,106897990,20058036,스페인,2013-07
2013-07-31,126491272,15471036,111020236,베네주엘라,2013-07
2013-07-31,122680775,29499441,93181334,방글라데시,2013-07
2013-07-31,117856581,228952642,-111096061,아르헨티나,2013-07
2013-07-31,117023714,100911,116922803,라이베리아,2013-07
2013-07-31,113841464,149571820,-35730356,파나마,2013-07
2013-07-31,111514151,2476605,109037546,룩셈부르그,2013-07
2013-07-31,110982685,4984854,105997831,그리스,2013-07
2013-07-31,110477162,73171799,37305363,알제리,2013-07
2013-07-31,110068495,5062355,105006140,요르단,2013-07
2013-07-31,107910247,14659168,93251079,카자흐스탄,2013-07
2013-07-31,103483946,85801471,17682475,이집트,2013-07
2013-07-31,101181680,13462555,87719125,콜롬비아,2013-07
2013-07-31,88003246,49491868,38511378,헝가리,2013-07
2013-07-31,87536542,2032549454,-1945012912,쿠웨이트,2013-07
2013-07-31,82957654,39864259,43093395,리비아,2013-07
2013-07-31,77116491,60997930,16118561,나이지리아,2013-07
2013-07-31,72890079,390064305,-317174226,오만,2013-07
2013-07-31,67141974,4805819,62336155,에쿠아도르,2013-07
2013-07-31,59330046,9476385,49853661,우크라이나,2013-07
2013-07-31,57621061,111136615,-53515554,스웨덴,2013-07
2013-07-31,56201204,38502876,17698328,미얀마,2013-07
2013-07-31,55501179,27039953,28461226,파키스탄,2013-07
2013-07-31,51457141,12328464,39128677,캄보디아,2013-07
2013-07-31,48724369,7372212,41352157,몰타,2013-07
2013-07-31,41004977,116934640,-75929663,오스트리아,2013-07
2013-07-31,37277708,67918,37209790,괌,2013-07
2013-07-31,36935711,31892,36903819,불령 폴리네시아,2013-07
2013-07-31,36812590,3384029,33428561,몽골,2013-07
2013-07-31,34993709,48034294,-13040585,루마니아,2013-07
2013-07-31,34737202,1742896145,-1708158943,카타르,2013-07
2013-07-31,33351388,103144091,-69792703,핀란드,2013-07
2013-07-31,30430293,1007876,29422417,가나,2013-07
2013-07-31,29342110,3042045,26300065,케냐,2013-07
2013-07-31,29301189,15047095,14254094,포루투갈,2013-07
2013-07-31,29210000,0,29210000,맨섬,2013-07
2013-07-31,28755024,4463331,24291693,모로코,2013-07
2013-07-31,26688732,2440397,24248335,우루과이,2013-07
2013-07-31,26428804,232027,26196777,시리아,2013-07
2013-07-31,25271089,3320385,21950704,과테말라,2013-07
2013-07-31,24020506,7052122,16968384,레바논,2013-07
2013-07-31,23912745,7992794,15919951,스리랑카,2013-07
2013-07-31,22964892,247869165,-224904273,스위스,2013-07
2013-07-31,21953478,11218,21942260,아제르바이잔,2013-07
2013-07-31,21155090,117008231,-95853141,바레인,2013-07
2013-07-31,20844299,25073314,-4229015,앙골라,2013-07
2013-07-31,20254923,27131146,-6876223,푸에르토리코,2013-07
2013-07-31,18060134,4125950,13934184,니카라과,2013-07
2013-07-31,16909055,29359316,-12450261,튀니지,2013-07
2013-07-31,16630022,1729521,14900501,파라과이,2013-07
2013-07-31,16174379,7103,16167276,키르기스스탄,2013-07
2013-07-31,15951545,76602833,-60651288,예맨,2013-07
2013-07-31,15565966,10588197,4977769,도미니카 공화국,2013-07
2013-07-31,15325448,18787108,-3461660,코스타리카,2013-07
2013-07-31,15056848,95572583,-80515735,아일랜드,2013-07
2013-07-31,15050552,3859952,11190600,리투아니아,2013-07
2013-07-31,13703023,2949,13700074,코트디봐르,2013-07
2013-07-31,12942903,494528,12448375,콩고,2013-07
2013-07-31,12868157,1059198,11808959,엘살바도르,2013-07
2013-07-31,12549335,20070336,-7521001,에스토니아,2013-07
2013-07-31,12086466,26609,12059857,투르크멘,2013-07
2013-07-31,11841593,38037,11803556,모잠비크,2013-07
2013-07-31,11832400,663371,11169029,라오스,2013-07
2013-07-31,11270283,988425,10281858,탄자니아,2013-07
2013-07-31,11114976,22176383,-11061407,불가리아,2013-07
2013-07-31,10915266,5424682,5490584,수단,2013-07
2013-07-31,10331586,3121914,7209672,라트비아,2013-07
2013-07-31,10197040,2822422,7374618,온두라스,2013-07
2013-07-31,9355333,2389662,6965671,에티오피아,2013-07
2013-07-31,9027109,128273240,-119246131,브루나이,2013-07
2013-07-31,7526704,596625,6930079,조지아,2013-07
2013-07-31,7266179,1055783,6210396,벨라루스,2013-07
2013-07-31,6865979,54633553,-47767574,기니,2013-07
2013-07-31,6783951,1022847,5761104,파푸아 뉴기니,2013-07
2013-07-31,6750437,1314119,5436318,크로아티아,2013-07
2013-07-31,6696184,106822746,-100126562,트리니다드 토바고,2013-07
2013-07-31,5128594,226602,4901992,세르비아,2013-07
2013-07-31,5028726,17342614,-12313888,세네갈,2013-07
2013-07-31,4874037,152045,4721992,적도 기니,2013-07
2013-07-31,4871785,454008,4417777,피지,2013-07
2013-07-31,4475401,0,4475401,타지크,2013-07
2013-07-31,4365723,0,4365723,지부티,2013-07
2013-07-31,4205996,5825776,-1619780,볼리비아,2013-07
2013-07-31,3988560,19523796,-15535236,콩고민주공화국,2013-07
2013-07-31,3853674,83523,3770151,아프카니스탄,2013-07
2013-07-31,3738896,112095,3626801,팔레스타인 해방기구,2013-07
2013-07-31,3693497,389231,3304266,베닝,2013-07
2013-07-31,3236244,643950,2592294,카메룬,2013-07
2013-07-31,3208374,527012,2681362,모리셔스,2013-07
2013-07-31,3164828,223237,2941591,아이티,2013-07
2013-07-31,3070742,8348244,-5277502,마다카스카르,2013-07
2013-07-31,3061991,0,3061991,부르키나 파소,2013-07
2013-07-31,2968252,845784,2122468,쿠바,2013-07
2013-07-31,2735936,203427632,-200691696,사이프러스,2013-07
2013-07-31,2731422,0,2731422,에리트리아,2013-07
2013-07-31,2587114,217598,2369516,세이쉘,2013-07
2013-07-31,2545518,425605,2119913,바하마,2013-07
2013-07-31,2416760,9772522,-7355762,뉴 칼레도니아,2013-07
2013-07-31,2329071,6508701,-4179630,기타국,2013-07
2013-07-31,2287945,103247,2184698,가이아나,2013-07
2013-07-31,1966195,0,1966195,아루바,2013-07
2013-07-31,1941115,445815,1495300,마카오,2013-07
2013-07-31,1934330,399909,1534421,가봉,2013-07
2013-07-31,1913671,145,1913526,말리,2013-07
2013-07-31,1751878,73638,1678240,네팔,2013-07
2013-07-31,1715053,91,1714962,토고,2013-07
2013-07-31,1701338,459136,1242202,짐바브웨,2013-07
2013-07-31,1604602,5020,1599582,불령 리유니온 코모도 제도,2013-07
2013-07-31,1579867,2128454,-548587,아이슬란드,2013-07
2013-07-31,1495246,26241179,-24745933,잠비아,2013-07
2013-07-31,1458173,56111,1402062,바베이도스,2013-07
2013-07-31,1283808,62189436,-60905628,티모르,2013-07
2013-07-31,1245553,1077149,168404,아르메니아,2013-07
2013-07-31,1229711,390425,839286,보스니아-헤르체고비나,2013-07
2013-07-31,1186235,829096,357139,자마이카,2013-07
2013-07-31,1136893,277353,859540,키리바티,2013-07
2013-07-31,1090060,53122,1036938,마세도니아,2013-07
2013-07-31,1036532,94886,941646,마이크로네시아,2013-07
2013-07-31,1013872,206776,807096,시에라 리온,2013-07
2013-07-31,989028,36831,952197,말라위,2013-07
2013-07-31,982663,552820,429843,우간다,2013-07
2013-07-31,890870,3093861,-2202991,모리타니,2013-07
2013-07-31,882083,168226,713857,모나코,2013-07
2013-07-31,863364,21,863343,아메리칸 사모아,2013-07
2013-07-31,775480,2991,772489,안티가 바부다,2013-07
2013-07-31,721790,0,721790,보츠와나,2013-07
2013-07-31,711341,18593,692748,알바니아,2013-07
2013-07-31,699219,1361971,-662752,몰도바,2013-07
2013-07-31,690016,383366,306650,도미니카,2013-07
2013-07-31,610915,129933,480982,수리남,2013-07
2013-07-31,576399,4563982,-3987583,스와질랜드,2013-07
2013-07-31,511791,15798,495993,사모아,2013-07
2013-07-31,477941,614933,-136992,리히텐슈타인,2013-07
2013-07-31,476084,372,475712,네덜란드 열도,2013-07
2013-07-31,469926,2768,467158,북마리아나 군도,2013-07
2013-07-31,407293,9486,397807,바누아투,2013-07
2013-07-31,405300,15024,390276,나미비아,2013-07
2013-07-31,384725,0,384725,과델로프,2013-07
2013-07-31,336485,849,335636,그레나다,2013-07
2013-07-31,302038,0,302038,소말리아,2013-07
2013-07-31,283226,45322,237904,벨리제,2013-07
2013-07-31,278653,5151,273502,세인트 키츠 네비스,2013-07
2013-07-31,269031,13925,255106,몰디브,2013-07
2013-07-31,255082,390083,-135001,솔로몬 군도,2013-07
2013-07-31,251863,0,251863,부탄,2013-07
2013-07-31,206063,52037,154026,세인트 빈센트 그레나딘,2013-07
2013-07-31,203304,90963,112341,불령 가이아나,2013-07
2013-07-31,177631,84430,93201,팔라우,2013-07
2013-07-31,177251,4845,172406,르완다,2013-07
2013-07-31,152063,5706,146357,안도라,2013-07
2013-07-31,150038,0,150038,세인트 루시아,2013-07
2013-07-31,123632,5057,118575,몬테네그로,2013-07
2013-07-31,105988,306773,-200785,영령 버진군도,2013-07
2013-07-31,103488,0,103488,영령 캐이맨 군도,2013-07
2013-07-31,102969,0,102969,지브랄타,2013-07
2013-07-31,98101,0,98101,마티니크,2013-07
2013-07-31,91496,0,91496,앙귈라,2013-07
2013-07-31,89146,316,88830,챠드,2013-07
2013-07-31,64029,0,64029,감비아,2013-07
2013-07-31,61314,0,61314,남수단,2013-07
2013-07-31,54097,49159,4938,통가,2013-07
2013-07-31,51090,173496,-122406,그린랜드,2013-07
2013-07-31,48434,1804,46630,몬트세라트,2013-07
2013-07-31,47331,0,47331,노폴크 아일랜드,2013-07
2013-07-31,43712,10280,33432,부룬디,2013-07
2013-07-31,26327,0,26327,카보 베르데,2013-07
2013-07-31,15380,5941,9439,코모로스,2013-07
2013-07-31,2741,0,2741,세인트 마틴,2013-07
2013-07-31,1650,562,1088,투르크 & 카이코스 군도,2013-07
2013-07-31,766,0,766,왈라스 & 퓨투나 군도,2013-07
2013-07-31,456,0,456,상토메 프린스페,2013-07
2013-07-31,400,0,400,나우루,2013-07
2013-07-31,225,0,225,피트카이른,2013-07
2013-07-31,192,0,192,영령 인도양,2013-07
2013-07-31,24,14,10,세인트 헬레나,2013-07
2013-07-31,0,2057,-2057,코스 군도,2013-07
2013-07-31,0,42393,-42393,중앙아프리카공화국,2013-07
2013-07-31,0,112594,-112594,투발루,2013-07
2013-07-31,0,1650,-1650,니우에,2013-07
2013-07-31,0,13838,-13838,토켈라우,2013-07
2013-07-31,0,773,-773,미령 버진군도,2013-07
2013-07-31,0,103444,-103444,산마리노,2013-07
2013-07-31,0,93330,-93330,포클랜드 군도,2013-07
2013-07-31,0,1670,-1670,니제르,2013-07
2013-08-31,12474089434,6549764574,5924324860,중국,2013-08
2013-08-31,4973462842,3210965373,1762497469,미국,2013-08
2013-08-31,2762424162,4854957286,-2092533124,일본,2013-08
2013-08-31,2333563288,176142355,2157420933,홍콩,2013-08
2013-08-31,2055552775,751040882,1304511893,싱가포르,2013-08
2013-08-31,1761322233,594079600,1167242633,베트남,2013-08
2013-08-31,1134540334,1230816966,-96276632,대만,2013-08
2013-08-31,1040988262,1055623620,-14635358,인도네시아,2013-08
2013-08-31,932811203,597386615,335424588,인도,2013-08
2013-08-31,921269284,66240202,855029082,마샬군도,2013-08
2013-08-31,886143788,1758961372,-872817584,호주,2013-08
2013-08-31,857657020,891216110,-33559090,러시아 연방,2013-08
2013-08-31,838660637,228873332,609787305,멕시코,2013-08
2013-08-31,740106799,357607862,382498937,브라질,2013-08
2013-08-31,685784067,1666932898,-981148831,독일,2013-08
2013-08-31,679744339,1041952134,-362207795,말레이시아,2013-08
2013-08-31,650087412,297797613,352289799,필리핀,2013-08
2013-08-31,561733744,3318548582,-2756814838,사우디아라비아,2013-08
2013-08-31,533417792,413815753,119602039,태국,2013-08
2013-08-31,529601467,224903142,304698325,스위스,2013-08
2013-08-31,504372540,0,504372540,영령 버진군도,2013-08
2013-08-31,466236509,1454652773,-988416264,아랍에미리트 연합,2013-08
2013-08-31,444143780,62558416,381585364,튀르키예,2013-08
2013-08-31,433537988,20856199,412681789,슬로바키아,2013-08
2013-08-31,394990788,343228201,51762587,영국,2013-08
2013-08-31,373999458,391017174,-17017716,캐나다,2013-08
2013-08-31,328490549,507529603,-179039054,네덜란드,2013-08
2013-08-31,313434771,75466035,237968736,폴란드,2013-08
2013-08-31,302224564,1786880988,-1484656424,카타르,2013-08
2013-08-31,283096215,752645319,-469549104,프랑스,2013-08
2013-08-31,234660054,242476026,-7815972,이란,2013-08
2013-08-31,229109053,416514480,-187405427,이탈리아,2013-08
2013-08-31,215742954,252538925,-36795971,노르웨이,2013-08
2013-08-31,207376446,70555544,136820902,덴마크,2013-08
2013-08-31,183792299,116589212,67203087,벨기에,2013-08
2013-08-31,180538905,2351192,178187713,우즈베키스탄,2013-08
2013-08-31,180052866,148589989,31462877,남아프리카공화국,2013-08
2013-08-31,170314192,719200410,-548886218,이라크,2013-08
2013-08-31,158073573,321235833,-163162260,칠레,2013-08
2013-08-31,153644047,42943762,110700285,체코공화국,2013-08
2013-08-31,142428982,150422265,-7993283,스페인,2013-08
2013-08-31,125477321,8826873,116650448,슬로베니아,2013-08
2013-08-31,120285392,232247189,-111961797,페루,2013-08
2013-08-31,119262801,129702248,-10439447,아르헨티나,2013-08
2013-08-31,110843070,81001229,29841841,파나마,2013-08
2013-08-31,109716569,271649902,-161933333,나이지리아,2013-08
2013-08-31,108473884,32979809,75494075,헝가리,2013-08
2013-08-31,101339204,46361116,54978088,방글라데시,2013-08
2013-08-31,93946340,3425145,90521195,요르단,2013-08
2013-08-31,93797945,42143341,51654604,콜롬비아,2013-08
2013-08-31,91994308,109895847,-17901539,뉴질랜드,2013-08
2013-08-31,88730846,3825041,84905805,이집트,2013-08
2013-08-31,81028977,1359154698,-1278125721,쿠웨이트,2013-08
2013-08-31,79667133,50225971,29441162,리비아,2013-08
2013-08-31,77208968,5535584,71673384,라이베리아,2013-08
2013-08-31,73653017,27264817,46388200,몰타,2013-08
2013-08-31,73336610,67410361,5926249,이스라엘,2013-08
2013-08-31,70785566,118859788,-48074222,스웨덴,2013-08
2013-08-31,69433828,105856296,-36422468,알제리,2013-08
2013-08-31,62848566,13127597,49720969,카자흐스탄,2013-08
2013-08-31,60615406,26193900,34421506,파키스탄,2013-08
2013-08-31,60177623,4900492,55277131,에쿠아도르,2013-08
2013-08-31,59652344,286396391,-226744047,오만,2013-08
2013-08-31,57392428,55803269,1589159,미얀마,2013-08
2013-08-31,51063031,26838188,24224843,우크라이나,2013-08
2013-08-31,44995383,41284,44954099,시리아,2013-08
2013-08-31,40664351,81310,40583041,괌,2013-08
2013-08-31,40489735,1369269,39120466,몽골,2013-08
2013-08-31,38975359,126845422,-87870063,오스트리아,2013-08
2013-08-31,38322505,11243354,27079151,캄보디아,2013-08
2013-08-31,32321814,47775,32274039,베네주엘라,2013-08
2013-08-31,30298129,81479885,-51181756,루마니아,2013-08
2013-08-31,27975266,3610133,24365133,가나,2013-08
2013-08-31,26838024,54302875,-27464851,아일랜드,2013-08
2013-08-31,25840200,7403012,18437188,스리랑카,2013-08
2013-08-31,25095586,102963245,-77867659,핀란드,2013-08
2013-08-31,24445107,5215150,19229957,모로코,2013-08
2013-08-31,24079711,10781320,13298391,앙골라,2013-08
2013-08-31,23764710,26130542,-2365832,포루투갈,2013-08
2013-08-31,22701155,1824228,20876927,케냐,2013-08
2013-08-31,21995896,15071746,6924150,과테말라,2013-08
2013-08-31,21386361,7668420,13717941,그리스,2013-08
2013-08-31,20654045,17423207,3230838,코스타리카,2013-08
2013-08-31,19675250,19568653,106597,푸에르토리코,2013-08
2013-08-31,19495470,5219605,14275865,레바논,2013-08
2013-08-31,19297038,9149392,10147646,바레인,2013-08
2013-08-31,18930659,4117205,14813454,우루과이,2013-08
2013-08-31,18053441,27113789,-9060348,파라과이,2013-08
2013-08-31,16178070,0,16178070,아제르바이잔,2013-08
2013-08-31,15671451,24736,15646715,키르기스스탄,2013-08
2013-08-31,14913228,7478365,7434863,도미니카 공화국,2013-08
2013-08-31,14493536,12932827,1560709,불가리아,2013-08
2013-08-31,14384087,299059,14085028,탄자니아,2013-08
2013-08-31,13641894,133840480,-120198586,예맨,2013-08
2013-08-31,13231210,1880380,11350830,니카라과,2013-08
2013-08-31,13096639,61851122,-48754483,수단,2013-08
2013-08-31,12323829,30962503,-18638674,튀니지,2013-08
2013-08-31,11217191,1960581,9256610,엘살바도르,2013-08
2013-08-31,10778698,3548238,7230460,리투아니아,2013-08
2013-08-31,10156061,3023515,7132546,벨라루스,2013-08
2013-08-31,9842099,3280,9838819,투르크멘,2013-08
2013-08-31,9590250,47697608,-38107358,트리니다드 토바고,2013-08
2013-08-31,9087232,272929,8814303,코트디봐르,2013-08
2013-08-31,8970970,5799235,3171735,에스토니아,2013-08
2013-08-31,8880784,127198,8753586,모잠비크,2013-08
2013-08-31,8668625,1651678,7016947,온두라스,2013-08
2013-08-31,8243552,672356,7571196,라오스,2013-08
2013-08-31,8156912,3803654,4353258,라트비아,2013-08
2013-08-31,7582705,2052908,5529797,에티오피아,2013-08
2013-08-31,6388628,366050,6022578,콩고,2013-08
2013-08-31,6064882,0,6064882,팔레스타인 해방기구,2013-08
2013-08-31,5173426,620667,4552759,모리셔스,2013-08
2013-08-31,5153930,8580,5145350,말리,2013-08
2013-08-31,5111303,123451486,-118340183,브루나이,2013-08
2013-08-31,4990437,6349495,-1359058,파푸아 뉴기니,2013-08
2013-08-31,4767734,57071233,-52303499,기니,2013-08
2013-08-31,4710839,218581,4492258,쿠바,2013-08
2013-08-31,4704583,301619,4402964,세르비아,2013-08
2013-08-31,4527663,201591,4326072,조지아,2013-08
2013-08-31,4313335,10432298,-6118963,세네갈,2013-08
2013-08-31,4130521,28057801,-23927280,볼리비아,2013-08
2013-08-31,3952034,787785,3164249,베닝,2013-08
2013-08-31,3809895,25082718,-21272823,뉴 칼레도니아,2013-08
2013-08-31,3612920,580045,3032875,카메룬,2013-08
2013-08-31,3607692,0,3607692,지부티,2013-08
2013-08-31,3429170,626043,2803127,피지,2013-08
2013-08-31,3153889,37283,3116606,아이티,2013-08
2013-08-31,3098850,0,3098850,타지크,2013-08
2013-08-31,3037580,127070264,-124032684,사이프러스,2013-08
2013-08-31,2866345,2374537,491808,아이슬란드,2013-08
2013-08-31,2601885,7945495,-5343610,콩고민주공화국,2013-08
2013-08-31,2580062,1576,2578486,아프카니스탄,2013-08
2013-08-31,2389834,7303525,-4913691,기타국,2013-08
2013-08-31,2359735,18,2359717,아메리칸 사모아,2013-08
2013-08-31,2330343,65938,2264405,가이아나,2013-08
2013-08-31,2162351,1062956,1099395,크로아티아,2013-08
2013-08-31,2067793,0,2067793,아루바,2013-08
2013-08-31,2053021,259557,1793464,세이쉘,2013-08
2013-08-31,1987523,2872402,-884879,짐바브웨,2013-08
2013-08-31,1980038,5598152,-3618114,마다카스카르,2013-08
2013-08-31,1929405,15654801,-13725396,잠비아,2013-08
2013-08-31,1790874,2057,1788817,말라위,2013-08
2013-08-31,1754875,16699734,-14944859,가봉,2013-08
2013-08-31,1732699,138187,1594512,토고,2013-08
2013-08-31,1657372,704026,953346,티모르,2013-08
2013-08-31,1604516,8147,1596369,불령 폴리네시아,2013-08
2013-08-31,1546304,262167,1284137,자마이카,2013-08
2013-08-31,1516195,53286,1462909,알바니아,2013-08
2013-08-31,1328481,9146,1319335,바베이도스,2013-08
2013-08-31,1263077,58,1263019,네덜란드 열도,2013-08
2013-08-31,1238120,722164,515956,마카오,2013-08
2013-08-31,1232581,104122,1128459,네팔,2013-08
2013-08-31,1222344,46000,1176344,마이크로네시아,2013-08
2013-08-31,1113655,21059,1092596,바하마,2013-08
2013-08-31,1099270,3963997,-2864727,아르메니아,2013-08
2013-08-31,983735,1445154,-461419,몰도바,2013-08
2013-08-31,924750,147,924603,불령 리유니온 코모도 제도,2013-08
2013-08-31,887389,183228,704161,수리남,2013-08
2013-08-31,815208,824,814384,영령 캐이맨 군도,2013-08
2013-08-31,740914,1430832,-689918,모리타니,2013-08
2013-08-31,724160,444070,280090,보스니아-헤르체고비나,2013-08
2013-08-31,715631,640995,74636,시에라 리온,2013-08
2013-08-31,696620,0,696620,버뮤다,2013-08
2013-08-31,692255,178242,514013,부르키나 파소,2013-08
2013-08-31,670397,95946,574451,모나코,2013-08
2013-08-31,623970,2269616,-1645646,룩셈부르그,2013-08
2013-08-31,618194,8372,609822,북마리아나 군도,2013-08
2013-08-31,589122,17891,571231,벨리제,2013-08
2013-08-31,534785,399981,134804,리히텐슈타인,2013-08
2013-08-31,495153,261331,233822,우간다,2013-08
2013-08-31,459223,24242,434981,팔라우,2013-08
2013-08-31,439359,11848,427511,사모아,2013-08
2013-08-31,439352,140536,298816,마티니크,2013-08
2013-08-31,422680,53526,369154,보츠와나,2013-08
2013-08-31,409480,68575,340905,안티가 바부다,2013-08
2013-08-31,400490,0,400490,과델로프,2013-08
2013-08-31,307297,326512,-19215,몰디브,2013-08
2013-08-31,305840,0,305840,그레나다,2013-08
2013-08-31,213275,856060,-642785,스와질랜드,2013-08
2013-08-31,205740,237335,-31595,바누아투,2013-08
2013-08-31,202376,43346,159030,도미니카,2013-08
2013-08-31,191884,1769,190115,니제르,2013-08
2013-08-31,167375,0,167375,에리트리아,2013-08
2013-08-31,166016,0,166016,소말리아,2013-08
2013-08-31,152643,158,152485,몬테네그로,2013-08
2013-08-31,145426,9942,135484,나미비아,2013-08
2013-08-31,126615,0,126615,적도 기니,2013-08
2013-08-31,123352,0,123352,감비아,2013-08
2013-08-31,118530,3026,115504,안도라,2013-08
2013-08-31,102522,0,102522,세인트 루시아,2013-08
2013-08-31,99747,0,99747,투르크 & 카이코스 군도,2013-08
2013-08-31,97419,0,97419,부탄,2013-08
2013-08-31,92960,0,92960,남수단,2013-08
2013-08-31,88538,231013,-142475,마세도니아,2013-08
2013-08-31,83297,0,83297,챠드,2013-08
2013-08-31,75163,1859403,-1784240,키리바티,2013-08
2013-08-31,66907,87,66820,세인트 키츠 네비스,2013-08
2013-08-31,63742,47,63695,르완다,2013-08
2013-08-31,62265,166558,-104293,불령 가이아나,2013-08
2013-08-31,51643,0,51643,부룬디,2013-08
2013-08-31,45882,0,45882,노폴크 아일랜드,2013-08
2013-08-31,36801,0,36801,지브랄타,2013-08
2013-08-31,29784,31,29753,쿡 아일랜드,2013-08
2013-08-31,19200,734,18466,세인트 헬레나,2013-08
2013-08-31,18944,0,18944,산마리노,2013-08
2013-08-31,18262,0,18262,메요트,2013-08
2013-08-31,16418,38603,-22185,통가,2013-08
2013-08-31,15183,352,14831,큐라소,2013-08
2013-08-31,8604,0,8604,세인트 빈센트 그레나딘,2013-08
2013-08-31,8286,459972,-451686,솔로몬 군도,2013-08
2013-08-31,7686,1113,6573,상토메 프린스페,2013-08
2013-08-31,6117,137318,-131201,그린랜드,2013-08
2013-08-31,5676,0,5676,건지,2013-08
2013-08-31,4056,1525,2531,몬트세라트,2013-08
2013-08-31,1247,91,1156,파로에 군도,2013-08
2013-08-31,100,0,100,카보 베르데,2013-08
2013-08-31,66,0,66,세인트 마틴,2013-08
2013-08-31,0,52,-52,기네비소,2013-08
2013-08-31,0,42832,-42832,중앙아프리카공화국,2013-08
2013-08-31,0,2,-2,마이너 아우틀링 합중국 군도,2013-08
2013-08-31,0,429656,-429656,미령 버진군도,2013-08
2013-08-31,0,10969,-10969,코모로스,2013-08
2013-08-31,0,21305,-21305,앙귈라,2013-08
2013-08-31,0,184,-184,레소토,2013-08
2013-08-31,0,9708,-9708,코스 군도,2013-08
2013-08-31,0,1160,-1160,니우에,2013-08
2013-08-31,0,61382,-61382,허드 앤 맥도날드 군도,2013-08
2013-09-30,11939788435,6617377762,5322410673,중국,2013-09
2013-09-30,4733798906,3177855338,1555943568,미국,2013-09
2013-09-30,2916580851,4901447001,-1984866150,일본,2013-09
2013-09-30,2587170376,137134073,2450036303,홍콩,2013-09
2013-09-30,1833513914,723152982,1110360932,베트남,2013-09
2013-09-30,1778244677,833170839,945073838,싱가포르,2013-09
2013-09-30,1190000141,1293683064,-103682923,대만,2013-09
2013-09-30,962144676,409029622,553115054,인도,2013-09
2013-09-30,878149974,171741907,706408067,네덜란드,2013-09
2013-09-30,870417770,213567306,656850464,멕시코,2013-09
2013-09-30,869806098,1173622278,-303816180,인도네시아,2013-09
2013-09-30,842997899,3631725,839366174,마샬군도,2013-09
2013-09-30,806675415,404386104,402289311,브라질,2013-09
2013-09-30,803410467,851634401,-48223934,러시아 연방,2013-09
2013-09-30,744739610,37573,744702037,라이베리아,2013-09
2013-09-30,723522286,348009747,375512539,필리핀,2013-09
2013-09-30,664708738,1665486186,-1000777448,호주,2013-09
2013-09-30,577575297,385505514,192069783,태국,2013-09
2013-09-30,574087835,1704925771,-1130837936,독일,2013-09
2013-09-30,557713616,809318018,-251604402,말레이시아,2013-09
2013-09-30,535999248,3144775987,-2608776739,사우디아라비아,2013-09
2013-09-30,487884470,53342660,434541810,튀르키예,2013-09
2013-09-30,424703071,16749720,407953351,슬로바키아,2013-09
2013-09-30,409234841,1647600480,-1238365639,아랍에미리트 연합,2013-09
2013-09-30,364554021,293373771,71180250,영국,2013-09
2013-09-30,357334603,486178640,-128844037,이란,2013-09
2013-09-30,334909188,405200646,-70291458,캐나다,2013-09
2013-09-30,280569047,73729542,206839505,폴란드,2013-09
2013-09-30,271353517,441690207,-170336690,프랑스,2013-09
2013-09-30,194689272,466691458,-272002186,이탈리아,2013-09
2013-09-30,191173113,2724569,188448544,우즈베키스탄,2013-09
2013-09-30,172278917,2369272,169909645,파나마,2013-09
2013-09-30,157100693,334850470,-177749777,칠레,2013-09
2013-09-30,153478370,637623477,-484145107,이라크,2013-09
2013-09-30,138419128,37542365,100876763,체코공화국,2013-09
2013-09-30,138010532,148222519,-10211987,벨기에,2013-09
2013-09-30,121547453,5853898,115693555,슬로베니아,2013-09
2013-09-30,116939092,138770287,-21831195,남아프리카공화국,2013-09
2013-09-30,114932395,194148182,-79215787,페루,2013-09
2013-09-30,112649996,99253610,13396386,뉴질랜드,2013-09
2013-09-30,106232042,7958887,98273155,우루과이,2013-09
2013-09-30,104378807,131451543,-27072736,스페인,2013-09
2013-09-30,97285710,18247032,79038678,콜롬비아,2013-09
2013-09-30,97162135,128669090,-31506955,아르헨티나,2013-09
2013-09-30,95179795,27138941,68040854,방글라데시,2013-09
2013-09-30,91150375,28032808,63117567,헝가리,2013-09
2013-09-30,87474126,26465459,61008667,카자흐스탄,2013-09
2013-09-30,84046907,55157353,28889554,이스라엘,2013-09
2013-09-30,80591611,17619715,62971896,이집트,2013-09
2013-09-30,79246666,4784697,74461969,요르단,2013-09
2013-09-30,77688529,104917864,-27229335,스웨덴,2013-09
2013-09-30,76512196,154215143,-77702947,나이지리아,2013-09
2013-09-30,73314568,85704668,-12390100,알제리,2013-09
2013-09-30,65254329,68825046,-3570717,리비아,2013-09
2013-09-30,62085277,22935352,39149925,파키스탄,2013-09
2013-09-30,61587722,221568244,-159980522,노르웨이,2013-09
2013-09-30,59828757,3485454,56343303,에쿠아도르,2013-09
2013-09-30,55273755,64549914,-9276159,미얀마,2013-09
2013-09-30,54942889,1683279820,-1628336931,쿠웨이트,2013-09
2013-09-30,51524020,310242693,-258718673,오만,2013-09
2013-09-30,46020378,1835890851,-1789870473,카타르,2013-09
2013-09-30,45980657,23059826,22920831,우크라이나,2013-09
2013-09-30,42056711,62688077,-20631366,몰타,2013-09
2013-09-30,39707837,104968070,-65260233,오스트리아,2013-09
2013-09-30,38961581,14614310,24347271,캄보디아,2013-09
2013-09-30,35558128,0,35558128,불령 폴리네시아,2013-09
2013-09-30,34293724,3221046,31072678,몽골,2013-09
2013-09-30,34273256,0,34273256,버뮤다,2013-09
2013-09-30,33728105,99431394,-65703289,루마니아,2013-09
2013-09-30,33308091,3911569,29396522,가나,2013-09
2013-09-30,32277850,44427,32233423,시리아,2013-09
2013-09-30,28186048,8788302,19397746,과테말라,2013-09
2013-09-30,27789743,22318054,5471689,앙골라,2013-09
2013-09-30,26348023,82819193,-56471170,핀란드,2013-09
2013-09-30,26266265,64664518,-38398253,덴마크,2013-09
2013-09-30,25759939,13419991,12339948,포루투갈,2013-09
2013-09-30,24656594,227269258,-202612664,스위스,2013-09
2013-09-30,24581007,969162,23611845,베네주엘라,2013-09
2013-09-30,22121244,8180372,13940872,스리랑카,2013-09
2013-09-30,22105196,198665,21906531,아제르바이잔,2013-09
2013-09-30,21795426,4085183,17710243,레바논,2013-09
2013-09-30,19298724,18589117,709607,코스타리카,2013-09
2013-09-30,19195687,7058636,12137051,모로코,2013-09
2013-09-30,18732709,2511375,16221334,케냐,2013-09
2013-09-30,17225871,5237058,11988813,도미니카 공화국,2013-09
2013-09-30,16490833,57445214,-40954381,그리스,2013-09
2013-09-30,14432236,1062656,13369580,파라과이,2013-09
2013-09-30,14107027,20346614,-6239587,푸에르토리코,2013-09
2013-09-30,13702083,813253,12888830,벨라루스,2013-09
2013-09-30,13681263,144727443,-131046180,예맨,2013-09
2013-09-30,13677748,27196,13650552,키르기스스탄,2013-09
2013-09-30,13284177,2043566,11240611,니카라과,2013-09
2013-09-30,12833918,562559,12271359,라오스,2013-09
2013-09-30,12321899,799996,11521903,조지아,2013-09
2013-09-30,11943327,224275,11719052,탄자니아,2013-09
2013-09-30,11415006,8175498,3239508,온두라스,2013-09
2013-09-30,10247124,18246779,-7999655,바레인,2013-09
2013-09-30,10124919,2165035,7959884,에티오피아,2013-09
2013-09-30,9661478,1638872,8022606,쿠바,2013-09
2013-09-30,9548364,1324574,8223790,엘살바도르,2013-09
2013-09-30,9491022,7953828,1537194,불가리아,2013-09
2013-09-30,9024234,3820182,5204052,리투아니아,2013-09
2013-09-30,8953382,2876,8950506,투르크멘,2013-09
2013-09-30,8775346,3925,8771421,코트디봐르,2013-09
2013-09-30,8392540,14848084,-6455544,에스토니아,2013-09
2013-09-30,8280034,72261573,-63981539,아일랜드,2013-09
2013-09-30,7255203,3139265,4115938,수단,2013-09
2013-09-30,6786475,2777055,4009420,튀니지,2013-09
2013-09-30,6609602,41692922,-35083320,트리니다드 토바고,2013-09
2013-09-30,5903712,3110135,2793577,라트비아,2013-09
2013-09-30,5828033,5520,5822513,지부티,2013-09
2013-09-30,5549080,65325,5483755,팔레스타인 해방기구,2013-09
2013-09-30,5443113,118336,5324777,세르비아,2013-09
2013-09-30,5372584,30631027,-25258443,볼리비아,2013-09
2013-09-30,5331437,3891928,1439509,세네갈,2013-09
2013-09-30,4990157,90276132,-85285975,브루나이,2013-09
2013-09-30,4960665,639,4960026,모잠비크,2013-09
2013-09-30,4571346,6534466,-1963120,파푸아 뉴기니,2013-09
2013-09-30,4131379,6629338,-2497959,기타국,2013-09
2013-09-30,3626976,276164,3350812,아르메니아,2013-09
2013-09-30,3528928,1915843,1613085,카메룬,2013-09
2013-09-30,3507770,632944,2874826,모리셔스,2013-09
2013-09-30,3370639,293129,3077510,피지,2013-09
2013-09-30,3153952,1850336,1303616,크로아티아,2013-09
2013-09-30,3144425,253503,2890922,콩고,2013-09
2013-09-30,3111261,355785,2755476,괌,2013-09
2013-09-30,3109729,237795,2871934,베닝,2013-09
2013-09-30,3079202,21690090,-18610888,뉴 칼레도니아,2013-09
2013-09-30,2899931,31961,2867970,아루바,2013-09
2013-09-30,2866875,2303,2864572,아프카니스탄,2013-09
2013-09-30,2848642,397113,2451529,기니,2013-09
2013-09-30,2846860,189983854,-187136994,사이프러스,2013-09
2013-09-30,2693237,0,2693237,네덜란드 열도,2013-09
2013-09-30,2672967,6060453,-3387486,마다카스카르,2013-09
2013-09-30,2577332,1200764,1376568,짐바브웨,2013-09
2013-09-30,2451074,572,2450502,말리,2013-09
2013-09-30,2220634,803,2219831,타지크,2013-09
2013-09-30,2184983,18267,2166716,토고,2013-09
2013-09-30,2162867,239488,1923379,자마이카,2013-09
2013-09-30,2023166,734,2022432,아메리칸 사모아,2013-09
2013-09-30,1904702,3330394,-1425692,콩고민주공화국,2013-09
2013-09-30,1881788,136,1881652,가이아나,2013-09
2013-09-30,1847256,221976,1625280,말라위,2013-09
2013-09-30,1798701,94917,1703784,네팔,2013-09
2013-09-30,1743148,111872,1631276,아이티,2013-09
2013-09-30,1709081,801317,907764,나미비아,2013-09
2013-09-30,1612376,23352634,-21740258,잠비아,2013-09
2013-09-30,1503737,132834,1370903,세이쉘,2013-09
2013-09-30,1463681,82245,1381436,가봉,2013-09
2013-09-30,1322955,248613,1074342,마카오,2013-09
2013-09-30,1293743,1775,1291968,영령 캐이맨 군도,2013-09
2013-09-30,1271973,0,1271973,불령 리유니온 코모도 제도,2013-09
2013-09-30,1153355,48827,1104528,수리남,2013-09
2013-09-30,1151243,0,1151243,티모르,2013-09
2013-09-30,1111978,1960342,-848364,아이슬란드,2013-09
2013-09-30,1103682,6227515,-5123833,룩셈부르그,2013-09
2013-09-30,1087753,24047,1063706,바하마,2013-09
2013-09-30,1081183,173789,907394,부르키나 파소,2013-09
2013-09-30,1056398,723381,333017,마이크로네시아,2013-09
2013-09-30,1013571,860908,152663,보스니아-헤르체고비나,2013-09
2013-09-30,967776,1347250,-379474,키리바티,2013-09
2013-09-30,932617,0,932617,바베이도스,2013-09
2013-09-30,884153,179073,705080,마티니크,2013-09
2013-09-30,880173,1171394,-291221,모리타니,2013-09
2013-09-30,752902,74740,678162,벨리제,2013-09
2013-09-30,715981,173459,542522,마세도니아,2013-09
2013-09-30,698346,785021,-86675,우간다,2013-09
2013-09-30,694756,176594,518162,시에라 리온,2013-09
2013-09-30,668250,207403,460847,바누아투,2013-09
2013-09-30,582544,361515,221029,알바니아,2013-09
2013-09-30,569830,1022,568808,안티가 바부다,2013-09
2013-09-30,551823,260,551563,니제르,2013-09
2013-09-30,442836,122980,319856,모나코,2013-09
2013-09-30,437240,452,436788,부룬디,2013-09
2013-09-30,427183,18005,409178,북마리아나 군도,2013-09
2013-09-30,406623,0,406623,부탄,2013-09
2013-09-30,395207,382945,12262,리히텐슈타인,2013-09
2013-09-30,329488,2842,326646,도미니카,2013-09
2013-09-30,328712,1176093,-847381,몰도바,2013-09
2013-09-30,273377,364023,-90646,적도 기니,2013-09
2013-09-30,259796,58262,201534,사모아,2013-09
2013-09-30,251586,0,251586,보츠와나,2013-09
2013-09-30,241416,495,240921,세인트 루시아,2013-09
2013-09-30,240853,0,240853,팔라우,2013-09
2013-09-30,202188,0,202188,과델로프,2013-09
2013-09-30,195095,1457969,-1262874,솔로몬 군도,2013-09
2013-09-30,181154,0,181154,그레나다,2013-09
2013-09-30,180742,318,180424,르완다,2013-09
2013-09-30,164620,90263,74357,불령 가이아나,2013-09
2013-09-30,145646,2625,143021,몬테네그로,2013-09
2013-09-30,143409,801469,-658060,영령 버진군도,2013-09
2013-09-30,141709,123,141586,지브랄타,2013-09
2013-09-30,126423,0,126423,소말리아,2013-09
2013-09-30,124612,264973,-140361,스와질랜드,2013-09
2013-09-30,111621,0,111621,투르크 & 카이코스 군도,2013-09
2013-09-30,101899,2962,98937,몰디브,2013-09
2013-09-30,84571,39001,45570,통가,2013-09
2013-09-30,83632,0,83632,에리트리아,2013-09
2013-09-30,74264,0,74264,메요트,2013-09
2013-09-30,51601,0,51601,챠드,2013-09
2013-09-30,51008,0,51008,세인트 키츠 네비스,2013-09
2013-09-30,50971,0,50971,세인트 마틴,2013-09
2013-09-30,50607,0,50607,중앙아프리카공화국,2013-09
2013-09-30,50409,31,50378,감비아,2013-09
2013-09-30,18414,0,18414,상토메 프린스페,2013-09
2013-09-30,18312,0,18312,파로에 군도,2013-09
2013-09-30,18080,0,18080,앙귈라,2013-09
2013-09-30,16343,0,16343,남수단,2013-09
2013-09-30,15398,0,15398,큐라소,2013-09
2013-09-30,11604,0,11604,세인트 빈센트 그레나딘,2013-09
2013-09-30,9000,5985,3015,코모로스,2013-09
2013-09-30,7200,6690,510,교황청,2013-09
2013-09-30,7130,221929,-214799,미령 버진군도,2013-09
2013-09-30,1322,314,1008,안도라,2013-09
2013-09-30,1300,0,1300,몬트세라트,2013-09
2013-09-30,472,0,472,건지,2013-09
2013-09-30,175,0,175,카보 베르데,2013-09
2013-09-30,0,568,-568,크리스마스 아일랜드,2013-09
2013-09-30,0,92139,-92139,그린랜드,2013-09
2013-09-30,0,7235,-7235,산마리노,2013-09
2013-09-30,0,114,-114,레소토,2013-09
2013-09-30,0,3800,-3800,세인트 헬레나,2013-09
2013-09-30,0,233,-233,맨섬,2013-09
2013-10-31,13152509513,7442949394,5709560119,중국,2013-10
2013-10-31,5465244249,3508987864,1956256385,미국,2013-10
2013-10-31,2987576992,5094237215,-2106660223,일본,2013-10
2013-10-31,2520634323,149906580,2370727743,홍콩,2013-10
2013-10-31,2218187920,797430403,1420757517,베트남,2013-10
2013-10-31,1529458921,1174413778,355045143,싱가포르,2013-10
2013-10-31,1382391162,1266853157,115538005,대만,2013-10
2013-10-31,1194669282,1024142357,170526925,인도네시아,2013-10
2013-10-31,1066587017,943315947,123271070,러시아 연방,2013-10
2013-10-31,959041012,569999899,389041113,인도,2013-10
2013-10-31,927535212,528577873,398957339,브라질,2013-10
2013-10-31,850804191,211859832,638944359,멕시코,2013-10
2013-10-31,838547504,1677410188,-838862684,호주,2013-10
2013-10-31,827323501,3706423026,-2879099525,사우디아라비아,2013-10
2013-10-31,760782318,307500446,453281872,필리핀,2013-10
2013-10-31,760508518,1406683,759101835,앙골라,2013-10
2013-10-31,696952009,1795519461,-1098567452,독일,2013-10
2013-10-31,637969678,1177420998,-539451320,말레이시아,2013-10
2013-10-31,631125138,419120478,212004660,태국,2013-10
2013-10-31,622482901,57940539,564542362,튀르키예,2013-10
2013-10-31,566453691,1667028986,-1100575295,아랍에미리트 연합,2013-10
2013-10-31,538461602,225,538461377,버뮤다,2013-10
2013-10-31,535513185,462620101,72893084,네덜란드,2013-10
2013-10-31,465385614,460980115,4405499,캐나다,2013-10
2013-10-31,446440745,16958391,429482354,슬로바키아,2013-10
2013-10-31,419334429,357843668,61490761,영국,2013-10
2013-10-31,401146475,53363419,347783056,마샬군도,2013-10
2013-10-31,361936345,719221784,-357285439,프랑스,2013-10
2013-10-31,353773553,84433,353689120,라이베리아,2013-10
2013-10-31,350733438,83279848,267453590,폴란드,2013-10
2013-10-31,341302038,349011959,-7709921,이란,2013-10
2013-10-31,327155684,452270846,-125115162,이탈리아,2013-10
2013-10-31,247938459,385594809,-137656350,칠레,2013-10
2013-10-31,227954605,4505251,223449354,그리스,2013-10
2013-10-31,219481446,123067855,96413591,벨기에,2013-10
2013-10-31,211681207,70283015,141398192,덴마크,2013-10
2013-10-31,193302993,273903668,-80600675,노르웨이,2013-10
2013-10-31,187712526,120414219,67298307,뉴질랜드,2013-10
2013-10-31,175294305,148565148,26729157,남아프리카공화국,2013-10
2013-10-31,174671333,519579696,-344908363,이라크,2013-10
2013-10-31,170585101,2598896,167986205,우즈베키스탄,2013-10
2013-10-31,166625375,151776588,14848787,스페인,2013-10
2013-10-31,154138631,96127780,58010851,이스라엘,2013-10
2013-10-31,147876474,53458666,94417808,체코공화국,2013-10
2013-10-31,138600854,13900317,124700537,콜롬비아,2013-10
2013-10-31,135822962,170700856,-34877894,페루,2013-10
2013-10-31,134401521,4641045,129760476,요르단,2013-10
2013-10-31,126143099,38021771,88121328,이집트,2013-10
2013-10-31,112739905,8730397,104009508,슬로베니아,2013-10
2013-10-31,106985501,259979581,-152994080,나이지리아,2013-10
2013-10-31,98391692,5022994,93368698,에쿠아도르,2013-10
2013-10-31,97692104,58028719,39663385,아르헨티나,2013-10
2013-10-31,94191274,55350134,38841140,헝가리,2013-10
2013-10-31,93898521,13836644,80061877,카자흐스탄,2013-10
2013-10-31,90485960,128751287,-38265327,스웨덴,2013-10
2013-10-31,85833361,34591801,51241560,방글라데시,2013-10
2013-10-31,83253814,297965,82955849,리비아,2013-10
2013-10-31,79346877,1868086646,-1788739769,쿠웨이트,2013-10
2013-10-31,74382557,70231555,4151002,파키스탄,2013-10
2013-10-31,66017753,72085769,-6068016,미얀마,2013-10
2013-10-31,64195546,117979730,-53784184,알제리,2013-10
2013-10-31,63801857,37088322,26713535,우크라이나,2013-10
2013-10-31,63070137,321088643,-258018506,오만,2013-10
2013-10-31,59322359,89909381,-30587022,몰타,2013-10
2013-10-31,57319175,2437641406,-2380322231,카타르,2013-10
2013-10-31,52140210,120417939,-68277729,오스트리아,2013-10
2013-10-31,50534192,12625876,37908316,캄보디아,2013-10
2013-10-31,45967123,5794889,40172234,파나마,2013-10
2013-10-31,38289399,94079,38195320,시리아,2013-10
2013-10-31,35908635,110758785,-74850150,루마니아,2013-10
2013-10-31,34253952,2989188,31264764,과테말라,2013-10
2013-10-31,32136871,1844366,30292505,몽골,2013-10
2013-10-31,30135647,2613476,27522171,아제르바이잔,2013-10
2013-10-31,29814531,4297164,25517367,가나,2013-10
2013-10-31,29096185,21925537,7170648,포루투갈,2013-10
2013-10-31,28934420,69331156,-40396736,아일랜드,2013-10
2013-10-31,27851258,5511146,22340112,기타국,2013-10
2013-10-31,26755697,266452802,-239697105,스위스,2013-10
2013-10-31,26411837,104690863,-78279026,핀란드,2013-10
2013-10-31,25916458,20501270,5415188,코스타리카,2013-10
2013-10-31,25401038,6867289,18533749,모로코,2013-10
2013-10-31,24972151,7215448,17756703,스리랑카,2013-10
2013-10-31,24239105,5784408,18454697,레바논,2013-10
2013-10-31,24078665,87240,23991425,베네주엘라,2013-10
2013-10-31,21309257,24635082,-3325825,바레인,2013-10
2013-10-31,21221894,2536414,18685480,케냐,2013-10
2013-10-31,20977105,9894763,11082342,우루과이,2013-10
2013-10-31,20611820,20770262,-158442,푸에르토리코,2013-10
2013-10-31,19664049,6699909,12964140,도미니카 공화국,2013-10
2013-10-31,19650450,2021284,17629166,니카라과,2013-10
2013-10-31,18393706,6200554,12193152,파라과이,2013-10
2013-10-31,15711563,2048896,13662667,수단,2013-10
2013-10-31,14072818,410836,13661982,라오스,2013-10
2013-10-31,13773068,3429414,10343654,탄자니아,2013-10
2013-10-31,13544263,157447832,-143903569,예맨,2013-10
2013-10-31,12878726,545945,12332781,온두라스,2013-10
2013-10-31,12786551,14449,12772102,키르기스스탄,2013-10
2013-10-31,12254537,2264965,9989572,엘살바도르,2013-10
2013-10-31,11756318,113949,11642369,팔레스타인 해방기구,2013-10
2013-10-31,11648304,5000022,6648282,라트비아,2013-10
2013-10-31,11160380,4442388,6717992,튀니지,2013-10
2013-10-31,11074418,4067011,7007407,리투아니아,2013-10
2013-10-31,10535423,12912062,-2376639,에스토니아,2013-10
2013-10-31,10135919,49753,10086166,코트디봐르,2013-10
2013-10-31,8737623,16160226,-7422603,트리니다드 토바고,2013-10
2013-10-31,8303258,135436,8167822,세르비아,2013-10
2013-10-31,8101200,3499,8097701,투르크멘,2013-10
2013-10-31,8083963,748550,7335413,크로아티아,2013-10
2013-10-31,8070752,703490,7367262,조지아,2013-10
2013-10-31,7953054,152006,7801048,콩고,2013-10
2013-10-31,7721529,33649751,-25928222,브루나이,2013-10
2013-10-31,7682583,2492388,5190195,에티오피아,2013-10
2013-10-31,7163870,588403,6575467,기니,2013-10
2013-10-31,6871020,445,6870575,아프카니스탄,2013-10
2013-10-31,6342675,0,6342675,지부티,2013-10
2013-10-31,5982998,22087907,-16104909,불가리아,2013-10
2013-10-31,5383107,559546,4823561,모잠비크,2013-10
2013-10-31,5219632,2180030,3039602,세네갈,2013-10
2013-10-31,5031162,5909225,-878063,파푸아 뉴기니,2013-10
2013-10-31,4931682,276333,4655349,베닝,2013-10
2013-10-31,4783959,845659,3938300,괌,2013-10
2013-10-31,4394456,9155466,-4761010,뉴 칼레도니아,2013-10
2013-10-31,4365318,537977,3827341,쿠바,2013-10
2013-10-31,4251475,780,4250695,타지크,2013-10
2013-10-31,3937975,297780,3640195,모리셔스,2013-10
2013-10-31,3854016,8328606,-4474590,콩고민주공화국,2013-10
2013-10-31,3688247,12130197,-8441950,볼리비아,2013-10
2013-10-31,3529796,347,3529449,말리,2013-10
2013-10-31,3450347,51192494,-47742147,사이프러스,2013-10
2013-10-31,3066347,2767527,298820,벨라루스,2013-10
2013-10-31,3047990,789456,2258534,카메룬,2013-10
2013-10-31,3041249,334795,2706454,토고,2013-10
2013-10-31,2715730,101873,2613857,아이티,2013-10
2013-10-31,2556879,1161608,1395271,피지,2013-10
2013-10-31,2517609,912,2516697,네덜란드 열도,2013-10
2013-10-31,2365709,892215,1473494,세이쉘,2013-10
2013-10-31,2234690,6268625,-4033935,마다카스카르,2013-10
2013-10-31,2228421,26364435,-24136014,잠비아,2013-10
2013-10-31,2188115,420611,1767504,마카오,2013-10
2013-10-31,2136906,15676,2121230,부르키나 파소,2013-10
2013-10-31,2134559,0,2134559,안타티카,2013-10
2013-10-31,1975248,224478,1750770,자마이카,2013-10
2013-10-31,1944251,1630860,313391,짐바브웨,2013-10
2013-10-31,1771765,2070284,-298519,아이슬란드,2013-10
2013-10-31,1760127,7249,1752878,불령 리유니온 코모도 제도,2013-10
2013-10-31,1696072,12969,1683103,아메리칸 사모아,2013-10
2013-10-31,1688871,48413,1640458,가이아나,2013-10
2013-10-31,1661156,4111689,-2450533,말라위,2013-10
2013-10-31,1633984,57600,1576384,티모르,2013-10
2013-10-31,1610132,3065777,-1455645,알바니아,2013-10
2013-10-31,1498248,79508690,-78010442,가봉,2013-10
2013-10-31,1492620,879381,613239,아르메니아,2013-10
2013-10-31,1452113,71778,1380335,바하마,2013-10
2013-10-31,1368960,210801,1158159,수리남,2013-10
2013-10-31,1116061,2061959,-945898,모리타니,2013-10
2013-10-31,1041641,10584,1031057,불령 폴리네시아,2013-10
2013-10-31,1036476,3304644,-2268168,룩셈부르그,2013-10
2013-10-31,1011849,1071574,-59725,우간다,2013-10
2013-10-31,1003734,540195,463539,보스니아-헤르체고비나,2013-10
2013-10-31,1000928,108063,892865,네팔,2013-10
2013-10-31,997204,71,997133,영령 캐이맨 군도,2013-10
2013-10-31,988309,9399,978910,사모아,2013-10
2013-10-31,961622,275647,685975,시에라 리온,2013-10
2013-10-31,948728,0,948728,아루바,2013-10
2013-10-31,800198,1872828,-1072630,몰도바,2013-10
2013-10-31,784242,47232,737010,북마리아나 군도,2013-10
2013-10-31,783144,64009,719135,마이크로네시아,2013-10
2013-10-31,713967,930431,-216464,리히텐슈타인,2013-10
2013-10-31,671813,7272,664541,안티가 바부다,2013-10
2013-10-31,575322,140439,434883,적도 기니,2013-10
2013-10-31,539604,1106,538498,니제르,2013-10
2013-10-31,535418,19656466,-19121048,스와질랜드,2013-10
2013-10-31,530754,1065,529689,바베이도스,2013-10
2013-10-31,502191,29571,472620,보츠와나,2013-10
2013-10-31,461526,9384,452142,도미니카,2013-10
2013-10-31,430329,0,430329,바누아투,2013-10
2013-10-31,420351,170437,249914,벨리제,2013-10
2013-10-31,388126,0,388126,에리트리아,2013-10
2013-10-31,374972,0,374972,마티니크,2013-10
2013-10-31,349249,22963,326286,미령 버진군도,2013-10
2013-10-31,349238,26748,322490,세인트 루시아,2013-10
2013-10-31,348694,0,348694,감비아,2013-10
2013-10-31,327039,0,327039,부탄,2013-10
2013-10-31,294235,14004,280231,안도라,2013-10
2013-10-31,264934,26,264908,팔라우,2013-10
2013-10-31,258001,887494,-629493,마세도니아,2013-10
2013-10-31,230092,0,230092,세인트 키츠 네비스,2013-10
2013-10-31,227235,1957,225278,몰디브,2013-10
2013-10-31,216013,45561,170452,르완다,2013-10
2013-10-31,208498,58338,150160,나미비아,2013-10
2013-10-31,201032,106,200926,과델로프,2013-10
2013-10-31,177272,581517,-404245,솔로몬 군도,2013-10
2013-10-31,175022,0,175022,챠드,2013-10
2013-10-31,148146,1081,147065,키리바티,2013-10
2013-10-31,134681,880,133801,지브랄타,2013-10
2013-10-31,120600,0,120600,소말리아,2013-10
2013-10-31,93356,211,93145,노폴크 아일랜드,2013-10
2013-10-31,90459,104966,-14507,통가,2013-10
2013-10-31,81290,0,81290,투발루,2013-10
2013-10-31,70996,0,70996,메요트,2013-10
2013-10-31,65430,3470846,-3405416,나우루,2013-10
2013-10-31,63978,0,63978,국제통화기금,2013-10
2013-10-31,60758,0,60758,그레나다,2013-10
2013-10-31,58303,153554,-95251,불령 가이아나,2013-10
2013-10-31,54526,0,54526,파로에 군도,2013-10
2013-10-31,48400,0,48400,세인트 마틴,2013-10
2013-10-31,46234,456285,-410051,영령 버진군도,2013-10
2013-10-31,41818,0,41818,중앙아프리카공화국,2013-10
2013-10-31,40060,0,40060,불령 남부지역,2013-10
2013-10-31,37905,0,37905,기네비소,2013-10
2013-10-31,36330,584,35746,투르크 & 카이코스 군도,2013-10
2013-10-31,35062,9633,25429,몬테네그로,2013-10
2013-10-31,30944,66512,-35568,모나코,2013-10
2013-10-31,30912,27,30885,부룬디,2013-10
2013-10-31,25870,0,25870,남수단,2013-10
2013-10-31,22890,0,22890,앙귈라,2013-10
2013-10-31,21511,0,21511,세인트 빈센트 그레나딘,2013-10
2013-10-31,18545,60,18485,교황청,2013-10
2013-10-31,5520,0,5520,쿡 아일랜드,2013-10
2013-10-31,3520,24422,-20902,산마리노,2013-10
2013-10-31,710,0,710,코스 군도,2013-10
2013-10-31,562,3606,-3044,상토메 프린스페,2013-10
2013-10-31,369,323101,-322732,그린랜드,2013-10
2013-10-31,278,2883,-2605,토켈라우,2013-10
2013-10-31,277,0,277,세인트 헬레나,2013-10
2013-10-31,70,0,70,카보 베르데,2013-10
2013-10-31,0,120,-120,레소토,2013-10
2013-10-31,0,5918,-5918,남조지아 & 남샌드위치 군도,2013-10
2013-10-31,0,101,-101,마이너 아우틀링 합중국 군도,2013-10
2013-10-31,0,3,-3,건지,2013-10
2013-10-31,0,74,-74,몬트세라트,2013-10
2013-10-31,0,2665,-2665,니우에,2013-10
2013-10-31,0,1400,-1400,큐라소,2013-10
2013-11-30,12920192700,7246755287,5673437413,중국,2013-11
2013-11-30,5247925002,3401510488,1846414514,미국,2013-11
2013-11-30,3381553819,4707904738,-1326350919,일본,2013-11
2013-11-30,2321123569,143426297,2177697272,홍콩,2013-11
2013-11-30,1905915419,851392336,1054523083,싱가포르,2013-11
2013-11-30,1733503264,631117368,1102385896,베트남,2013-11
2013-11-30,1200033781,1112101181,87932600,대만,2013-11
2013-11-30,1012109637,1817701711,-805592074,호주,2013-11
2013-11-30,976742843,700,976742143,마샬군도,2013-11
2013-11-30,962880991,1179530673,-216649682,말레이시아,2013-11
2013-11-30,886983680,1126973252,-239989572,러시아 연방,2013-11
2013-11-30,865218490,467810089,397408401,인도,2013-11
2013-11-30,800673127,269856551,530816576,필리핀,2013-11
2013-11-30,795045831,977597053,-182551222,인도네시아,2013-11
2013-11-30,774532104,555647983,218884121,브라질,2013-11
2013-11-30,740313564,1637519597,-897206033,독일,2013-11
2013-11-30,682959403,447444442,235514961,태국,2013-11
2013-11-30,631625214,3118374573,-2486749359,사우디아라비아,2013-11
2013-11-30,622684608,1698640727,-1075956119,아랍에미리트 연합,2013-11
2013-11-30,617173945,185234553,431939392,멕시코,2013-11
2013-11-30,614910815,148975685,465935130,나이지리아,2013-11
2013-11-30,489172920,66098918,423074002,튀르키예,2013-11
2013-11-30,451507713,436648643,14859070,네덜란드,2013-11
2013-11-30,393113924,360264865,32849059,캐나다,2013-11
2013-11-30,355445152,310130321,45314831,영국,2013-11
2013-11-30,346698291,444716718,-98018427,이란,2013-11
2013-11-30,312558030,260850015,51708015,노르웨이,2013-11
2013-11-30,310253211,13997082,296256129,슬로바키아,2013-11
2013-11-30,275414100,62302713,213111387,폴란드,2013-11
2013-11-30,257598127,468040907,-210442780,이탈리아,2013-11
2013-11-30,227338482,543313196,-315974714,이라크,2013-11
2013-11-30,224115153,391184819,-167069666,프랑스,2013-11
2013-11-30,207739065,54807343,152931722,앙골라,2013-11
2013-11-30,186501691,97254990,89246701,벨기에,2013-11
2013-11-30,183658211,118454022,65204189,스페인,2013-11
2013-11-30,178904842,3415675,175489167,파나마,2013-11
2013-11-30,178268330,394298702,-216030372,칠레,2013-11
2013-11-30,173949106,113445980,60503126,뉴질랜드,2013-11
2013-11-30,154366064,2449383,151916681,우즈베키스탄,2013-11
2013-11-30,141975622,147629099,-5653477,남아프리카공화국,2013-11
2013-11-30,138907281,95722966,43184315,이집트,2013-11
2013-11-30,135221346,5948810,129272536,요르단,2013-11
2013-11-30,134741306,36529477,98211829,체코공화국,2013-11
2013-11-30,124889143,31154921,93734222,방글라데시,2013-11
2013-11-30,118300574,15718065,102582509,콜롬비아,2013-11
2013-11-30,107401274,9147478,98253796,슬로베니아,2013-11
2013-11-30,106026873,74943453,31083420,카자흐스탄,2013-11
2013-11-30,103724987,62714954,41010033,이스라엘,2013-11
2013-11-30,97839282,212245239,-114405957,페루,2013-11
2013-11-30,96285493,125569602,-29284109,리비아,2013-11
2013-11-30,95483297,181509022,-86025725,스웨덴,2013-11
2013-11-30,86146846,358921972,-272775126,오만,2013-11
2013-11-30,82279170,52063673,30215497,알제리,2013-11
2013-11-30,72755271,25445706,47309565,파키스탄,2013-11
2013-11-30,72448262,45777007,26671255,헝가리,2013-11
2013-11-30,63083947,1510768858,-1447684911,쿠웨이트,2013-11
2013-11-30,60749474,4366068,56383406,에쿠아도르,2013-11
2013-11-30,60366510,69653232,-9286722,아르헨티나,2013-11
2013-11-30,55461478,51504838,3956640,미얀마,2013-11
2013-11-30,55157805,9263181,45894624,캄보디아,2013-11
2013-11-30,52946397,234969,52711428,시리아,2013-11
2013-11-30,51848902,62850842,-11001940,아일랜드,2013-11
2013-11-30,49738838,62283,49676555,라이베리아,2013-11
2013-11-30,49563228,96726017,-47162789,오스트리아,2013-11
2013-11-30,48065819,52987924,-4922105,우크라이나,2013-11
2013-11-30,44773054,2550289905,-2505516851,카타르,2013-11
2013-11-30,37243917,2445984,34797933,레바논,2013-11
2013-11-30,36084326,102,36084224,불령 폴리네시아,2013-11
2013-11-30,35153183,20326038,14827145,푸에르토리코,2013-11
2013-11-30,32649440,32,32649408,아제르바이잔,2013-11
2013-11-30,31061633,19837462,11224171,포루투갈,2013-11
2013-11-30,28725438,61852903,-33127465,덴마크,2013-11
2013-11-30,27793830,3772584,24021246,과테말라,2013-11
2013-11-30,27264519,4459458,22805061,스리랑카,2013-11
2013-11-30,26302111,62868958,-36566847,루마니아,2013-11
2013-11-30,24454923,6815314,17639609,도미니카 공화국,2013-11
2013-11-30,24340373,7705122,16635251,모로코,2013-11
2013-11-30,23897215,237698498,-213801283,스위스,2013-11
2013-11-30,23807686,3935324,19872362,우루과이,2013-11
2013-11-30,23520222,130272502,-106752280,핀란드,2013-11
2013-11-30,23163598,1807900,21355698,몽골,2013-11
2013-11-30,22356417,504356,21852061,라오스,2013-11
2013-11-30,21738954,84796807,-63057853,바레인,2013-11
2013-11-30,20412820,2768711,17644109,가나,2013-11
2013-11-30,19987927,21237291,-1249364,코스타리카,2013-11
2013-11-30,19335364,3469128,15866236,그리스,2013-11
2013-11-30,18981855,19466862,-485007,파라과이,2013-11
2013-11-30,18807731,1644336,17163395,케냐,2013-11
2013-11-30,18304063,24882853,-6578790,에스토니아,2013-11
2013-11-30,18248757,6222232,12026525,베네주엘라,2013-11
2013-11-30,16797499,2851,16794648,투르크멘,2013-11
2013-11-30,16228535,1739417,14489118,니카라과,2013-11
2013-11-30,15044691,3751992,11292699,튀니지,2013-11
2013-11-30,14609746,176503949,-161894203,브루나이,2013-11
2013-11-30,14401711,1966902,12434809,엘살바도르,2013-11
2013-11-30,13167047,150089244,-136922197,예맨,2013-11
2013-11-30,13081446,128840,12952606,팔레스타인 해방기구,2013-11
2013-11-30,11975169,1049823,10925346,조지아,2013-11
2013-11-30,11349100,0,11349100,키리바티,2013-11
2013-11-30,9956325,2903123,7053202,리투아니아,2013-11
2013-11-30,9930860,33309629,-23378769,몰타,2013-11
2013-11-30,9866129,11365846,-1499717,탄자니아,2013-11
2013-11-30,9825604,212319,9613285,키르기스스탄,2013-11
2013-11-30,9179840,147904,9031936,코트디봐르,2013-11
2013-11-30,8928776,13425010,-4496234,불가리아,2013-11
2013-11-30,8810507,3480306,5330201,라트비아,2013-11
2013-11-30,8678858,876279,7802579,수단,2013-11
2013-11-30,8493129,1116341,7376788,온두라스,2013-11
2013-11-30,7833206,526521,7306685,트리니다드 토바고,2013-11
2013-11-30,7223756,2263434,4960322,에티오피아,2013-11
2013-11-30,6730653,2470079,4260574,세네갈,2013-11
2013-11-30,5806581,778354,5028227,모리셔스,2013-11
2013-11-30,5770282,19749733,-13979451,콩고민주공화국,2013-11
2013-11-30,5703212,179786,5523426,마이크로네시아,2013-11
2013-11-30,5163817,585,5163232,말리,2013-11
2013-11-30,5146686,6564,5140122,타지크,2013-11
2013-11-30,5025319,553207,4472112,괌,2013-11
2013-11-30,4833559,708479,4125080,쿠바,2013-11
2013-11-30,4748033,25443362,-20695329,파푸아 뉴기니,2013-11
2013-11-30,4307878,329444,3978434,카메룬,2013-11
2013-11-30,4259118,2203133,2055985,크로아티아,2013-11
2013-11-30,4137707,1173,4136534,아프카니스탄,2013-11
2013-11-30,4050119,17875191,-13825072,뉴 칼레도니아,2013-11
2013-11-30,3991262,47300562,-43309300,볼리비아,2013-11
2013-11-30,3919750,19581035,-15661285,잠비아,2013-11
2013-11-30,3819231,7367915,-3548684,세르비아,2013-11
2013-11-30,3553682,1462595,2091087,벨라루스,2013-11
2013-11-30,3543330,44,3543286,아메리칸 사모아,2013-11
2013-11-30,3075904,426188,2649716,피지,2013-11
2013-11-30,2983332,736096,2247236,사이프러스,2013-11
2013-11-30,2966039,273294,2692745,모잠비크,2013-11
2013-11-30,2902878,4515993,-1613115,아이슬란드,2013-11
2013-11-30,2859038,432031,2427007,콩고,2013-11
2013-11-30,2766898,126110,2640788,바하마,2013-11
2013-11-30,2691287,655769,2035518,기니,2013-11
2013-11-30,2642812,207666,2435146,가이아나,2013-11
2013-11-30,2618125,12659,2605466,토고,2013-11
2013-11-30,2542758,9265125,-6722367,가봉,2013-11
2013-11-30,2490002,4757128,-2267126,기타국,2013-11
2013-11-30,2444014,481988,1962026,아이티,2013-11
2013-11-30,2421818,256623,2165195,베닝,2013-11
2013-11-30,2419733,0,2419733,지부티,2013-11
2013-11-30,2311638,486984,1824654,마카오,2013-11
2013-11-30,2124161,13765595,-11641434,말라위,2013-11
2013-11-30,1960438,69552,1890886,알바니아,2013-11
2013-11-30,1762401,59299,1703102,아루바,2013-11
2013-11-30,1754137,25939,1728198,르완다,2013-11
2013-11-30,1735721,596120,1139601,보스니아-헤르체고비나,2013-11
2013-11-30,1714836,9476,1705360,불령 리유니온 코모도 제도,2013-11
2013-11-30,1577522,92659,1484863,세이쉘,2013-11
2013-11-30,1495296,282093,1213203,부르키나 파소,2013-11
2013-11-30,1464004,2059577,-595573,안티가 바부다,2013-11
2013-11-30,1442280,1239960,202320,모리타니,2013-11
2013-11-30,1440083,58900,1381183,티모르,2013-11
2013-11-30,1401577,7848423,-6446846,마다카스카르,2013-11
2013-11-30,1284500,33770,1250730,자마이카,2013-11
2013-11-30,1270262,693825,576437,몰도바,2013-11
2013-11-30,1230139,83,1230056,네덜란드 열도,2013-11
2013-11-30,1200425,1605931,-405506,우간다,2013-11
2013-11-30,1087047,116477,970570,아르메니아,2013-11
2013-11-30,1033753,319177,714576,시에라 리온,2013-11
2013-11-30,1032649,384379,648270,수리남,2013-11
2013-11-30,1002162,341688,660474,부탄,2013-11
2013-11-30,958553,33004,925549,짐바브웨,2013-11
2013-11-30,955890,224972,730918,적도 기니,2013-11
2013-11-30,952395,6931607,-5979212,룩셈부르그,2013-11
2013-11-30,847076,8021,839055,바베이도스,2013-11
2013-11-30,792508,350,792158,버뮤다,2013-11
2013-11-30,746190,49453,696737,네팔,2013-11
2013-11-30,703323,0,703323,마티니크,2013-11
2013-11-30,684734,8705,676029,북마리아나 군도,2013-11
2013-11-30,667218,28,667190,과델로프,2013-11
2013-11-30,657066,38104,618962,세인트 루시아,2013-11
2013-11-30,628581,15597,612984,보츠와나,2013-11
2013-11-30,616076,123416,492660,마세도니아,2013-11
2013-11-30,491983,29388,462595,벨리제,2013-11
2013-11-30,482991,63114,419877,사모아,2013-11
2013-11-30,445272,0,445272,에리트리아,2013-11
2013-11-30,433395,850,432545,영령 캐이맨 군도,2013-11
2013-11-30,424036,5654771,-5230735,나미비아,2013-11
2013-11-30,340243,3160,337083,팔라우,2013-11
2013-11-30,331361,559539,-228178,스와질랜드,2013-11
2013-11-30,307899,125,307774,세인트 키츠 네비스,2013-11
2013-11-30,267601,0,267601,레소토,2013-11
2013-11-30,245089,1204,243885,그레나다,2013-11
2013-11-30,236576,85083,151493,도미니카,2013-11
2013-11-30,231887,551157,-319270,리히텐슈타인,2013-11
2013-11-30,227147,52243,174904,바누아투,2013-11
2013-11-30,202831,685,202146,영령 버진군도,2013-11
2013-11-30,171827,11610,160217,몰디브,2013-11
2013-11-30,164221,1988,162233,몬테네그로,2013-11
2013-11-30,157200,0,157200,니제르,2013-11
2013-11-30,121682,31283,90399,안도라,2013-11
2013-11-30,114137,38546,75591,불령 가이아나,2013-11
2013-11-30,107343,0,107343,투르크 & 카이코스 군도,2013-11
2013-11-30,106473,144309,-37836,부룬디,2013-11
2013-11-30,103997,586326,-482329,솔로몬 군도,2013-11
2013-11-30,101207,0,101207,카보 베르데,2013-11
2013-11-30,97589,0,97589,지브랄타,2013-11
2013-11-30,68989,0,68989,소말리아,2013-11
2013-11-30,53272,14,53258,챠드,2013-11
2013-11-30,46999,158847,-111848,모나코,2013-11
2013-11-30,42032,0,42032,세인트 빈센트 그레나딘,2013-11
2013-11-30,31614,0,31614,국제통화기금,2013-11
2013-11-30,31080,0,31080,나우루,2013-11
2013-11-30,14518,3684,10834,코모로스,2013-11
2013-11-30,13047,0,13047,교황청,2013-11
2013-11-30,12416,2392,10024,상토메 프린스페,2013-11
2013-11-30,7910,0,7910,앙귈라,2013-11
2013-11-30,7082,0,7082,감비아,2013-11
2013-11-30,4247,0,4247,남수단,2013-11
2013-11-30,2911,0,2911,파로에 군도,2013-11
2013-11-30,1745,0,1745,중앙아프리카공화국,2013-11
2013-11-30,1375,0,1375,세인트 마틴,2013-11
2013-11-30,1026,1647789,-1646763,통가,2013-11
2013-11-30,289,96320,-96031,그린랜드,2013-11
2013-11-30,102,26,76,쿡 아일랜드,2013-11
2013-11-30,89,0,89,세인트 헬레나,2013-11
2013-11-30,1,0,1,투발루,2013-11
2013-11-30,0,2946,-2946,미령 버진군도,2013-11
2013-11-30,0,59,-59,노폴크 아일랜드,2013-11
2013-11-30,0,42990,-42990,산마리노,2013-11
2013-11-30,0,108,-108,토켈라우,2013-11
2013-11-30,0,33000,-33000,몬트세라트,2013-11
2013-12-31,12985768328,7072484084,5913284244,중국,2013-12
2013-12-31,5151571399,3757690417,1393880982,미국,2013-12
2013-12-31,2664269482,4837697375,-2173427893,일본,2013-12
2013-12-31,2265821348,152102760,2113718588,홍콩,2013-12
2013-12-31,1814582064,612603659,1201978405,베트남,2013-12
2013-12-31,1365622023,1055750546,309871477,대만,2013-12
2013-12-31,1351997049,801829965,550167084,싱가포르,2013-12
2013-12-31,1221591216,5737304,1215853912,마샬군도,2013-12
2013-12-31,1193758585,198691910,995066675,멕시코,2013-12
2013-12-31,958067386,1176054493,-217987107,인도네시아,2013-12
2013-12-31,931951016,443164385,488786631,인도,2013-12
2013-12-31,889493637,1132720133,-243226496,러시아 연방,2013-12
2013-12-31,822738515,468070102,354668413,브라질,2013-12
2013-12-31,792369651,1911026104,-1118656453,호주,2013-12
2013-12-31,786700138,3352341701,-2565641563,사우디아라비아,2013-12
2013-12-31,736235154,1082918512,-346683358,말레이시아,2013-12
2013-12-31,716103439,232899836,483203603,필리핀,2013-12
2013-12-31,679149786,129639617,549510169,남아프리카공화국,2013-12
2013-12-31,589421743,1642297250,-1052875507,독일,2013-12
2013-12-31,585377375,388090848,197286527,태국,2013-12
2013-12-31,571093181,1654872667,-1083779486,아랍에미리트 연합,2013-12
2013-12-31,543927417,67160804,476766613,튀르키예,2013-12
2013-12-31,461517164,485350609,-23833445,네덜란드,2013-12
2013-12-31,461224792,301316,460923476,라이베리아,2013-12
2013-12-31,438544007,348987197,89556810,캐나다,2013-12
2013-12-31,373182247,861667719,-488485472,영국,2013-12
2013-12-31,338447791,440769052,-102321261,이란,2013-12
2013-12-31,292510069,18143048,274367021,슬로바키아,2013-12
2013-12-31,274343893,496705571,-222361678,이탈리아,2013-12
2013-12-31,273264828,82080927,191183901,폴란드,2013-12
2013-12-31,223213835,410086602,-186872767,칠레,2013-12
2013-12-31,214198933,120779865,93419068,덴마크,2013-12
2013-12-31,206414119,441233619,-234819500,프랑스,2013-12
2013-12-31,200622611,120,200622491,버뮤다,2013-12
2013-12-31,183489594,706707382,-523217788,이라크,2013-12
2013-12-31,181724375,1534292,180190083,우즈베키스탄,2013-12
2013-12-31,167745765,164621380,3124385,벨기에,2013-12
2013-12-31,157793888,13488698,144305190,콜롬비아,2013-12
2013-12-31,157641227,138009910,19631317,이집트,2013-12
2013-12-31,156060601,208355477,-52294876,스페인,2013-12
2013-12-31,140668413,1449749248,-1309080835,쿠웨이트,2013-12
2013-12-31,138992565,7060093,131932472,요르단,2013-12
2013-12-31,137554445,322569204,-185014759,노르웨이,2013-12
2013-12-31,127493770,42946847,84546923,체코공화국,2013-12
2013-12-31,126131036,101811868,24319168,페루,2013-12
2013-12-31,123906754,9968541,113938213,슬로베니아,2013-12
2013-12-31,119204499,107944643,11259856,뉴질랜드,2013-12
2013-12-31,108955265,47254795,61700470,리비아,2013-12
2013-12-31,105883419,76416119,29467300,이스라엘,2013-12
2013-12-31,104915509,205042603,-100127094,스웨덴,2013-12
2013-12-31,101861282,100089469,1771813,아일랜드,2013-12
2013-12-31,98268236,360728699,-262460463,오만,2013-12
2013-12-31,93852282,12046821,81805461,카자흐스탄,2013-12
2013-12-31,85221048,270766154,-185545106,나이지리아,2013-12
2013-12-31,82346949,24333528,58013421,방글라데시,2013-12
2013-12-31,74718817,41253274,33465543,헝가리,2013-12
2013-12-31,69833306,70873538,-1040232,파키스탄,2013-12
2013-12-31,68248124,16873131,51374993,몰타,2013-12
2013-12-31,67539704,24421840,43117864,그리스,2013-12
2013-12-31,66081158,33250009,32831149,아르헨티나,2013-12
2013-12-31,62944217,59407085,3537132,알제리,2013-12
2013-12-31,62496702,10042695,52454007,캄보디아,2013-12
2013-12-31,60791161,3340107,57451054,에쿠아도르,2013-12
2013-12-31,57860266,1888913720,-1831053454,카타르,2013-12
2013-12-31,54528203,37553487,16974716,미얀마,2013-12
2013-12-31,53562292,169967,53392325,시리아,2013-12
2013-12-31,47049120,149965800,-102916680,우크라이나,2013-12
2013-12-31,45515669,3946591,41569078,레바논,2013-12
2013-12-31,43151838,0,43151838,영령 캐이맨 군도,2013-12
2013-12-31,39296851,144622040,-105325189,오스트리아,2013-12
2013-12-31,38447645,74251393,-35803748,루마니아,2013-12
2013-12-31,38317710,124806,38192904,괌,2013-12
2013-12-31,34309069,22823809,11485260,푸에르토리코,2013-12
2013-12-31,32928793,504313,32424480,아제르바이잔,2013-12
2013-12-31,32423091,2501116,29921975,앙골라,2013-12
2013-12-31,31768359,2846810,28921549,파나마,2013-12
2013-12-31,31179819,61757595,-30577776,모로코,2013-12
2013-12-31,30190223,14571738,15618485,포루투갈,2013-12
2013-12-31,27427356,78476185,-51048829,바레인,2013-12
2013-12-31,26104391,5873111,20231280,스리랑카,2013-12
2013-12-31,25311328,111309162,-85997834,핀란드,2013-12
2013-12-31,25157303,23655499,1501804,코스타리카,2013-12
2013-12-31,24947703,9027792,15919911,과테말라,2013-12
2013-12-31,24417099,31434979,-7017880,튀니지,2013-12
2013-12-31,23121874,133412,22988462,베네주엘라,2013-12
2013-12-31,23057163,229478554,-206421391,스위스,2013-12
2013-12-31,21990479,626903,21363576,라오스,2013-12
2013-12-31,21489198,4107399,17381799,가나,2013-12
2013-12-31,21376343,347310,21029033,파라과이,2013-12
2013-12-31,20678582,2105021,18573561,몽골,2013-12
2013-12-31,19464906,9753875,9711031,도미니카 공화국,2013-12
2013-12-31,18998775,163254860,-144256085,예맨,2013-12
2013-12-31,18769944,2161667,16608277,니카라과,2013-12
2013-12-31,17493839,1425302,16068537,엘살바도르,2013-12
2013-12-31,15816388,715016,15101372,코트디봐르,2013-12
2013-12-31,15588645,2811038,12777607,케냐,2013-12
2013-12-31,14644828,41583252,-26938424,에스토니아,2013-12
2013-12-31,14572639,4976495,9596144,탄자니아,2013-12
2013-12-31,13392385,893119,12499266,수단,2013-12
2013-12-31,13112742,3100,13109642,키르기스스탄,2013-12
2013-12-31,12709619,593657,12115962,온두라스,2013-12
2013-12-31,12229091,3584293,8644798,우루과이,2013-12
2013-12-31,11906235,3783574,8122661,리투아니아,2013-12
2013-12-31,11372470,3840,11368630,투르크멘,2013-12
2013-12-31,11279286,101255,11178031,모잠비크,2013-12
2013-12-31,11215213,38873522,-27658309,트리니다드 토바고,2013-12
2013-12-31,10933400,19032519,-8099119,불가리아,2013-12
2013-12-31,10402988,911237,9491751,에티오피아,2013-12
2013-12-31,10283431,273461593,-263178162,브루나이,2013-12
2013-12-31,9773401,30078724,-20305323,기타국,2013-12
2013-12-31,9529270,234597,9294673,팔레스타인 해방기구,2013-12
2013-12-31,9319306,558383,8760923,조지아,2013-12
2013-12-31,8129712,3198009,4931703,쿠바,2013-12
2013-12-31,7915028,3957365,3957663,라트비아,2013-12
2013-12-31,7454927,642329,6812598,볼리비아,2013-12
2013-12-31,6859425,141659,6717766,아르메니아,2013-12
2013-12-31,6093994,4293688,1800306,세네갈,2013-12
2013-12-31,6092782,1033424,5059358,피지,2013-12
2013-12-31,5800611,8046388,-2245777,파푸아 뉴기니,2013-12
2013-12-31,5777060,137413,5639647,마이크로네시아,2013-12
2013-12-31,5630163,861,5629302,지부티,2013-12
2013-12-31,5470866,155640,5315226,마카오,2013-12
2013-12-31,5035280,22389403,-17354123,세르비아,2013-12
2013-12-31,4785309,10874640,-6089331,콩고민주공화국,2013-12
2013-12-31,4244021,9469,4234552,아프카니스탄,2013-12
2013-12-31,4114728,311490,3803238,베닝,2013-12
2013-12-31,3591740,2397605,1194135,크로아티아,2013-12
2013-12-31,3469688,57821188,-54351500,기니,2013-12
2013-12-31,3369208,472596,2896612,모리셔스,2013-12
2013-12-31,3325842,36,3325806,타지크,2013-12
2013-12-31,3213863,412298,2801565,보스니아-헤르체고비나,2013-12
2013-12-31,3143498,34262,3109236,아루바,2013-12
2013-12-31,2955555,755774,2199781,토고,2013-12
2013-12-31,2947830,1778863,1168967,카메룬,2013-12
2013-12-31,2718006,16657977,-13939971,뉴 칼레도니아,2013-12
2013-12-31,2705960,75297,2630663,세이쉘,2013-12
2013-12-31,2615457,121890,2493567,자마이카,2013-12
2013-12-31,2532277,1624327,907950,벨라루스,2013-12
2013-12-31,2521708,8940967,-6419259,말라위,2013-12
2013-12-31,2501161,629408,1871753,사이프러스,2013-12
2013-12-31,2465440,20253,2445187,바하마,2013-12
2013-12-31,2355164,22074,2333090,안티가 바부다,2013-12
2013-12-31,2318243,2454580,-136337,아이슬란드,2013-12
2013-12-31,2275553,703160,1572393,아이티,2013-12
2013-12-31,2270296,31,2270265,네덜란드 열도,2013-12
2013-12-31,2161496,50156,2111340,알바니아,2013-12
2013-12-31,2136562,19929844,-17793282,잠비아,2013-12
2013-12-31,2129594,3436746,-1307152,콩고,2013-12
2013-12-31,2104230,18377961,-16273731,에리트리아,2013-12
2013-12-31,2095225,134504,1960721,네팔,2013-12
2013-12-31,2050881,14,2050867,불령 리유니온 코모도 제도,2013-12
2013-12-31,1996677,8060700,-6064023,마다카스카르,2013-12
2013-12-31,1851372,112923,1738449,마세도니아,2013-12
2013-12-31,1734066,3455582,-1721516,짐바브웨,2013-12
2013-12-31,1620996,147545,1473451,부르키나 파소,2013-12
2013-12-31,1613806,166619,1447187,수리남,2013-12
2013-12-31,1611444,483541,1127903,시에라 리온,2013-12
2013-12-31,1552027,105422139,-103870112,니제르,2013-12
2013-12-31,1534615,512,1534103,아메리칸 사모아,2013-12
2013-12-31,1442317,192446,1249871,가이아나,2013-12
2013-12-31,1383772,4301309,-2917537,가봉,2013-12
2013-12-31,1196282,250172,946110,우간다,2013-12
2013-12-31,1128088,360566,767522,몰도바,2013-12
2013-12-31,980944,21610,959334,불령 폴리네시아,2013-12
2013-12-31,923009,556,922453,마티니크,2013-12
2013-12-31,833917,64842,769075,벨리제,2013-12
2013-12-31,826224,41482,784742,르완다,2013-12
2013-12-31,825756,834,824922,말리,2013-12
2013-12-31,816256,0,816256,북마리아나 군도,2013-12
2013-12-31,733579,6222,727357,도미니카,2013-12
2013-12-31,731140,8499,722641,사모아,2013-12
2013-12-31,725125,1194172,-469047,모리타니,2013-12
2013-12-31,705557,8410,697147,키리바티,2013-12
2013-12-31,652968,0,652968,부탄,2013-12
2013-12-31,629910,36,629874,세인트 키츠 네비스,2013-12
2013-12-31,599181,83,599098,티모르,2013-12
2013-12-31,594227,2537025,-1942798,룩셈부르그,2013-12
2013-12-31,588480,8347,580133,바베이도스,2013-12
2013-12-31,481559,571,480988,팔라우,2013-12
2013-12-31,451102,0,451102,과델로프,2013-12
2013-12-31,436773,0,436773,세인트 루시아,2013-12
2013-12-31,397602,83765,313837,바누아투,2013-12
2013-12-31,379412,29572,349840,보츠와나,2013-12
2013-12-31,375844,547444,-171600,리히텐슈타인,2013-12
2013-12-31,360707,409,360298,몬테네그로,2013-12
2013-12-31,357549,318869,38680,스와질랜드,2013-12
2013-12-31,322713,55,322658,그레나다,2013-12
2013-12-31,321288,136939,184349,모나코,2013-12
2013-12-31,306314,898,305416,몰디브,2013-12
2013-12-31,289769,0,289769,영령 버진군도,2013-12
2013-12-31,208093,8395626,-8187533,나미비아,2013-12
2013-12-31,200410,0,200410,불령 가이아나,2013-12
2013-12-31,192483,0,192483,감비아,2013-12
2013-12-31,189710,1640172,-1450462,솔로몬 군도,2013-12
2013-12-31,167175,0,167175,소말리아,2013-12
2013-12-31,150080,0,150080,국제통화기금,2013-12
2013-12-31,111648,252722,-141074,적도 기니,2013-12
2013-12-31,110205,4945,105260,안도라,2013-12
2013-12-31,95325,205,95120,앙귈라,2013-12
2013-12-31,76282,0,76282,투르크 & 카이코스 군도,2013-12
2013-12-31,65451,134,65317,챠드,2013-12
2013-12-31,48158,0,48158,남수단,2013-12
2013-12-31,47493,0,47493,세인트 빈센트 그레나딘,2013-12
2013-12-31,46086,12788,33298,노폴크 아일랜드,2013-12
2013-12-31,31790,0,31790,산마리노,2013-12
2013-12-31,31510,950,30560,토켈라우,2013-12
2013-12-31,25287,36199,-10912,기네비소,2013-12
2013-12-31,20321,182533,-162212,중앙아프리카공화국,2013-12
2013-12-31,18920,369508,-350588,통가,2013-12
2013-12-31,13714,0,13714,코모로스,2013-12
2013-12-31,13592,769,12823,지브랄타,2013-12
2013-12-31,7143,9044,-1901,카보 베르데,2013-12
2013-12-31,4688,22262,-17574,부룬디,2013-12
2013-12-31,4559,0,4559,영령 인도양,2013-12
2013-12-31,3853,0,3853,건지,2013-12
2013-12-31,3608,6679880,-6676272,나우루,2013-12
2013-12-31,1200,3462,-2262,교황청,2013-12
2013-12-31,700,2417,-1717,몬트세라트,2013-12
2013-12-31,447,0,447,세인트 마틴,2013-12
2013-12-31,343,0,343,파로에 군도,2013-12
2013-12-31,206,0,206,쿡 아일랜드,2013-12
2013-12-31,98,353738,-353640,그린랜드,2013-12
2013-12-31,20,3850,-3830,미령 버진군도,2013-12
2013-12-31,0,3523,-3523,세인트 헬레나,2013-12
2013-12-31,0,258781,-258781,포클랜드 군도,2013-12
2013-12-31,0,24,-24,니우에,2013-12
2013-12-31,0,87252,-87252,허드 앤 맥도날드 군도,2013-12
2013-12-31,0,1146,-1146,코스 군도,2013-12
2013-12-31,0,71528,-71528,상토메 프린스페,2013-12
2013-12-31,0,2875,-2875,투발루,2013-12
2014-01-31,11482347663,7470240123,4012107540,중국,2014-01
2014-01-31,4856161763,3617782860,1238378903,미국,2014-01
2014-01-31,2810869830,4025509437,-1214639607,일본,2014-01
2014-01-31,1944287243,1237327321,706959922,싱가포르,2014-01
2014-01-31,1936612945,177659786,1758953159,홍콩,2014-01
2014-01-31,1733302937,568821249,1164481688,베트남,2014-01
2014-01-31,1309034033,1216739067,92294966,대만,2014-01
2014-01-31,1244231350,1107066820,137164530,인도네시아,2014-01
2014-01-31,938299388,454410838,483888550,인도,2014-01
2014-01-31,829414539,1243608933,-414194394,러시아 연방,2014-01
2014-01-31,824477722,1628744465,-804266743,호주,2014-01
2014-01-31,805506189,274880131,530626058,필리핀,2014-01
2014-01-31,800319519,488123970,312195549,브라질,2014-01
2014-01-31,709132037,500484,708631553,마샬군도,2014-01
2014-01-31,706472122,289044889,417427233,멕시코,2014-01
2014-01-31,703975017,3206481042,-2502506025,사우디아라비아,2014-01
2014-01-31,683528334,1087932628,-404404294,말레이시아,2014-01
2014-01-31,648015351,1182950581,-534935230,영국,2014-01
2014-01-31,617878146,387714452,230163694,태국,2014-01
2014-01-31,616766319,1087816283,-471049964,아랍에미리트 연합,2014-01
2014-01-31,603335930,1563339652,-960003722,독일,2014-01
2014-01-31,589706569,24504760,565201809,앙골라,2014-01
2014-01-31,535362995,65716906,469646089,튀르키예,2014-01
2014-01-31,532701396,277235752,255465644,네덜란드,2014-01
2014-01-31,447330854,414348647,32982207,캐나다,2014-01
2014-01-31,376863072,15715250,361147822,슬로바키아,2014-01
2014-01-31,338286679,197365,338089314,라이베리아,2014-01
2014-01-31,321019216,93370488,227648728,그리스,2014-01
2014-01-31,320329230,55356947,264972283,폴란드,2014-01
2014-01-31,289855964,493384382,-203528418,이탈리아,2014-01
2014-01-31,264842228,223882656,40959572,이란,2014-01
2014-01-31,256915831,422262585,-165346754,프랑스,2014-01
2014-01-31,214442078,75053959,139388119,덴마크,2014-01
2014-01-31,197318564,372745490,-175426926,칠레,2014-01
2014-01-31,179443842,155389897,24053945,벨기에,2014-01
2014-01-31,177157510,714022715,-536865205,이라크,2014-01
2014-01-31,169268613,2994979,166273634,우즈베키스탄,2014-01
2014-01-31,158610248,198518864,-39908616,스페인,2014-01
2014-01-31,156372259,131485180,24887079,이집트,2014-01
2014-01-31,149638633,136527179,13111454,뉴질랜드,2014-01
2014-01-31,149009148,42361366,106647782,체코공화국,2014-01
2014-01-31,133817428,8555156,125262272,요르단,2014-01
2014-01-31,132749774,9983239,122766535,슬로베니아,2014-01
2014-01-31,130893883,74387440,56506443,콜롬비아,2014-01
2014-01-31,130649228,113468069,17181159,남아프리카공화국,2014-01
2014-01-31,111335752,35594277,75741475,헝가리,2014-01
2014-01-31,103885128,127881917,-23996789,페루,2014-01
2014-01-31,98481066,12140907,86340159,파나마,2014-01
2014-01-31,98394384,488313,97906071,리비아,2014-01
2014-01-31,97242139,79950309,17291830,이스라엘,2014-01
2014-01-31,89969508,484602032,-394632524,오만,2014-01
2014-01-31,86196586,135327310,-49130724,스웨덴,2014-01
2014-01-31,79567981,25023477,54544504,방글라데시,2014-01
2014-01-31,75256882,2023318138,-1948061256,쿠웨이트,2014-01
2014-01-31,71028162,10182224,60845938,카자흐스탄,2014-01
2014-01-31,70903794,297504106,-226600312,알제리,2014-01
2014-01-31,68904083,32634979,36269104,아르헨티나,2014-01
2014-01-31,66488917,527632476,-461143559,나이지리아,2014-01
2014-01-31,65881357,43963227,21918130,파키스탄,2014-01
2014-01-31,58485038,6066531,52418507,에쿠아도르,2014-01
2014-01-31,52887993,54127849,-1239856,아일랜드,2014-01
2014-01-31,52811366,37642979,15168387,미얀마,2014-01
2014-01-31,50698116,13391235,37306881,캄보디아,2014-01
2014-01-31,47157713,112181360,-65023647,오스트리아,2014-01
2014-01-31,44861376,61734618,-16873242,루마니아,2014-01
2014-01-31,42649841,139569862,-96920021,우크라이나,2014-01
2014-01-31,36451274,2501399574,-2464948300,카타르,2014-01
2014-01-31,35976814,12347789,23629025,포루투갈,2014-01
2014-01-31,35896919,25537,35871382,시리아,2014-01
2014-01-31,34592393,193164,34399229,괌,2014-01
2014-01-31,30270247,19980,30250267,아제르바이잔,2014-01
2014-01-31,28742675,104985908,-76243233,핀란드,2014-01
2014-01-31,28154738,2532372,25622366,레바논,2014-01
2014-01-31,25959213,67816906,-41857693,바레인,2014-01
2014-01-31,22607138,6203068,16404070,스리랑카,2014-01
2014-01-31,22429859,15476225,6953634,과테말라,2014-01
2014-01-31,21769149,184433903,-162664754,스위스,2014-01
2014-01-31,21605039,1318166,20286873,몽골,2014-01
2014-01-31,21055344,12740638,8314706,모로코,2014-01
2014-01-31,19835537,135479423,-115643886,예맨,2014-01
2014-01-31,19665961,20410746,-744785,푸에르토리코,2014-01
2014-01-31,19396253,10241989,9154264,도미니카 공화국,2014-01
2014-01-31,19325436,20850093,-1524657,코스타리카,2014-01
2014-01-31,19243762,388298,18855464,라오스,2014-01
2014-01-31,17815250,3664255,14150995,가나,2014-01
2014-01-31,16650495,253450741,-236800246,노르웨이,2014-01
2014-01-31,16521936,431458,16090478,파라과이,2014-01
2014-01-31,15633884,2121843,13512041,니카라과,2014-01
2014-01-31,14522443,5959771,8562672,튀니지,2014-01
2014-01-31,13861315,129103,13732212,키르기스스탄,2014-01
2014-01-31,13321255,1773673,11547582,엘살바도르,2014-01
2014-01-31,13135604,1026601,12109003,케냐,2014-01
2014-01-31,11829194,4066794,7762400,에티오피아,2014-01
2014-01-31,11665734,2830320,8835414,리투아니아,2014-01
2014-01-31,10581436,196839,10384597,코트디봐르,2014-01
2014-01-31,10553556,17569915,-7016359,탄자니아,2014-01
2014-01-31,10538293,5074,10533219,투르크멘,2014-01
2014-01-31,10056087,87128469,-77072382,에스토니아,2014-01
2014-01-31,9866618,1219629,8646989,온두라스,2014-01
2014-01-31,9693383,3175044,6518339,우루과이,2014-01
2014-01-31,9675341,22307625,-12632284,불가리아,2014-01
2014-01-31,8384551,591796,7792755,크로아티아,2014-01
2014-01-31,8087858,3104538,4983320,라트비아,2014-01
2014-01-31,7705239,3307075,4398164,수단,2014-01
2014-01-31,7459371,134676,7324695,마이크로네시아,2014-01
2014-01-31,7412777,16857798,-9445021,트리니다드 토바고,2014-01
2014-01-31,6771826,27012805,-20240979,볼리비아,2014-01
2014-01-31,6229842,445245,5784597,조지아,2014-01
2014-01-31,6145502,271243,5874259,팔레스타인 해방기구,2014-01
2014-01-31,6049726,665929,5383797,피지,2014-01
2014-01-31,5442684,2442,5440242,아프카니스탄,2014-01
2014-01-31,4781645,37983,4743662,베닝,2014-01
2014-01-31,4661712,1109047,3552665,쿠바,2014-01
2014-01-31,4113597,5574521,-1460924,몰타,2014-01
2014-01-31,3772381,1286909,2485472,세네갈,2014-01
2014-01-31,3730824,1348043,2382781,콩고,2014-01
2014-01-31,3674294,300175,3374119,베네주엘라,2014-01
2014-01-31,3346718,283366,3063352,모잠비크,2014-01
2014-01-31,3250687,0,3250687,지부티,2014-01
2014-01-31,3198433,0,3198433,타지크,2014-01
2014-01-31,3151604,34484,3117120,말리,2014-01
2014-01-31,3088029,11510905,-8422876,세르비아,2014-01
2014-01-31,2967763,852332,2115431,모리셔스,2014-01
2014-01-31,2964973,38040,2926933,아메리칸 사모아,2014-01
2014-01-31,2877198,5957308,-3080110,파푸아 뉴기니,2014-01
2014-01-31,2827305,389952,2437353,보스니아-헤르체고비나,2014-01
2014-01-31,2791484,0,2791484,부르키나 파소,2014-01
2014-01-31,2771413,177450,2593963,카메룬,2014-01
2014-01-31,2723739,250,2723489,가이아나,2014-01
2014-01-31,2526441,5038040,-2511599,벨라루스,2014-01
2014-01-31,2063940,30359656,-28295716,콩고민주공화국,2014-01
2014-01-31,2053064,886553,1166511,마카오,2014-01
2014-01-31,1988040,149158648,-147170608,브루나이,2014-01
2014-01-31,1926608,1072872,853736,토고,2014-01
2014-01-31,1910356,16784840,-14874484,뉴 칼레도니아,2014-01
2014-01-31,1830444,0,1830444,에리트리아,2014-01
2014-01-31,1813290,264294,1548996,짐바브웨,2014-01
2014-01-31,1753378,1244451,508927,자마이카,2014-01
2014-01-31,1707326,2786018,-1078692,아이슬란드,2014-01
2014-01-31,1704787,0,1704787,불령 리유니온 코모도 제도,2014-01
2014-01-31,1626902,117667,1509235,아루바,2014-01
2014-01-31,1590741,10858,1579883,바하마,2014-01
2014-01-31,1565285,37236889,-35671604,잠비아,2014-01
2014-01-31,1540553,204039,1336514,아르메니아,2014-01
2014-01-31,1529109,79920730,-78391621,기니,2014-01
2014-01-31,1519763,870683,649080,사이프러스,2014-01
2014-01-31,1469097,5139218,-3670121,기타국,2014-01
2014-01-31,1467363,2689319,-1221956,룩셈부르그,2014-01
2014-01-31,1396797,89079,1307718,세이쉘,2014-01
2014-01-31,1392687,107919,1284768,네팔,2014-01
2014-01-31,1367401,0,1367401,불령 폴리네시아,2014-01
2014-01-31,1288550,623346,665204,아이티,2014-01
2014-01-31,1225254,35949,1189305,네덜란드 열도,2014-01
2014-01-31,1133987,1679876,-545889,우간다,2014-01
2014-01-31,1069894,7712927,-6643033,마다카스카르,2014-01
2014-01-31,942615,529260,413355,시에라 리온,2014-01
2014-01-31,911596,0,911596,북마리아나 군도,2014-01
2014-01-31,871414,75137762,-74266348,가봉,2014-01
2014-01-31,829981,2727011,-1897030,말라위,2014-01
2014-01-31,803799,111940,691859,티모르,2014-01
2014-01-31,783158,234010,549148,수리남,2014-01
2014-01-31,758926,284426,474500,모리타니,2014-01
2014-01-31,751097,1319939,-568842,바누아투,2014-01
2014-01-31,743634,433112,310522,마세도니아,2014-01
2014-01-31,716010,359,715651,마티니크,2014-01
2014-01-31,714181,31161,683020,니제르,2014-01
2014-01-31,566004,231137,334867,몰도바,2014-01
2014-01-31,559639,0,559639,보츠와나,2014-01
2014-01-31,554605,51,554554,버뮤다,2014-01
2014-01-31,516346,0,516346,키리바티,2014-01
2014-01-31,484116,212689,271427,르완다,2014-01
2014-01-31,467989,95085,372904,스와질랜드,2014-01
2014-01-31,465845,284,465561,안티가 바부다,2014-01
2014-01-31,440085,49337,390748,알바니아,2014-01
2014-01-31,426331,397278,29053,리히텐슈타인,2014-01
2014-01-31,368008,120,367888,영령 캐이맨 군도,2014-01
2014-01-31,358140,215,357925,세인트 루시아,2014-01
2014-01-31,286736,34079,252657,사모아,2014-01
2014-01-31,273984,2394,271590,바베이도스,2014-01
2014-01-31,262133,3394,258739,과델로프,2014-01
2014-01-31,252494,0,252494,챠드,2014-01
2014-01-31,252032,20002,232030,그레나다,2014-01
2014-01-31,248063,0,248063,몰디브,2014-01
2014-01-31,246246,2883049,-2636803,나미비아,2014-01
2014-01-31,245570,78302,167268,도미니카,2014-01
2014-01-31,225363,861,224502,감비아,2014-01
2014-01-31,224280,0,224280,세인트 빈센트 그레나딘,2014-01
2014-01-31,195058,3811,191247,팔라우,2014-01
2014-01-31,183811,171707,12104,벨리제,2014-01
2014-01-31,175256,775774,-600518,솔로몬 군도,2014-01
2014-01-31,164226,101402,62824,불령 가이아나,2014-01
2014-01-31,162722,0,162722,소말리아,2014-01
2014-01-31,130838,5830,125008,안도라,2014-01
2014-01-31,114619,30970767,-30856148,지브랄타,2014-01
2014-01-31,113245,0,113245,국제통화기금,2014-01
2014-01-31,68513,66469,2044,기네비소,2014-01
2014-01-31,66045,0,66045,메요트,2014-01
2014-01-31,64885,3696,61189,부탄,2014-01
2014-01-31,62112,154,61958,몬테네그로,2014-01
2014-01-31,44363,0,44363,카보 베르데,2014-01
2014-01-31,35324,0,35324,쿡 아일랜드,2014-01
2014-01-31,30556,71338,-40782,통가,2014-01
2014-01-31,23730,2462,21268,영령 버진군도,2014-01
2014-01-31,16695,365,16330,포클랜드 군도,2014-01
2014-01-31,13938,0,13938,적도 기니,2014-01
2014-01-31,9160,336444,-327284,모나코,2014-01
2014-01-31,6339,0,6339,부룬디,2014-01
2014-01-31,4308,14215,-9907,나우루,2014-01
2014-01-31,4050,0,4050,남수단,2014-01
2014-01-31,3300,23644,-20344,산마리노,2014-01
2014-01-31,1760,22,1738,세인트 키츠 네비스,2014-01
2014-01-31,908,0,908,세인트 마틴,2014-01
2014-01-31,586,4806,-4220,미령 버진군도,2014-01
2014-01-31,406,0,406,상토메 프린스페,2014-01
2014-01-31,343,4340,-3997,몬트세라트,2014-01
2014-01-31,277,176241,-175964,그린랜드,2014-01
2014-01-31,54,0,54,파로에 군도,2014-01
2014-01-31,0,34576,-34576,남조지아 & 남샌드위치 군도,2014-01
2014-01-31,0,10836,-10836,허드 앤 맥도날드 군도,2014-01
2014-01-31,0,404,-404,저어지,2014-01
2014-01-31,0,33836,-33836,중앙아프리카공화국,2014-01
2014-01-31,0,130,-130,맨섬,2014-01
2014-01-31,0,31,-31,노폴크 아일랜드,2014-01
2014-01-31,0,10286,-10286,투르크 & 카이코스 군도,2014-01
2014-01-31,0,700,-700,세인트 헬레나,2014-01
2014-02-28,10757677300,5789784448,4967892852,중국,2014-02
2014-02-28,4664001383,3928296093,735705290,미국,2014-02
2014-02-28,2713692273,830407734,1883284539,싱가포르,2014-02
2014-02-28,2607399996,4445635886,-1838235890,일본,2014-02
2014-02-28,1976298786,126456769,1849842017,홍콩,2014-02
2014-02-28,1732673534,509965337,1222708197,베트남,2014-02
2014-02-28,1176254656,1102300436,73954220,대만,2014-02
2014-02-28,1008725153,508133713,500591440,인도,2014-02
2014-02-28,828943964,1139965790,-311021826,러시아 연방,2014-02
2014-02-28,814874031,411400855,403473176,브라질,2014-02
2014-02-28,757295125,1614804043,-857508918,독일,2014-02
2014-02-28,695789967,273363697,422426270,필리핀,2014-02
2014-02-28,694801635,167347546,527454089,멕시코,2014-02
2014-02-28,687060088,985427463,-298367375,인도네시아,2014-02
2014-02-28,683353578,1968706422,-1285352844,호주,2014-02
2014-02-28,630523088,405379324,225143764,태국,2014-02
2014-02-28,629624898,1154597354,-524972456,아랍에미리트 연합,2014-02
2014-02-28,617000033,3352064239,-2735064206,사우디아라비아,2014-02
2014-02-28,597255645,847055814,-249800169,말레이시아,2014-02
2014-02-28,574690087,356155061,218535026,네덜란드,2014-02
2014-02-28,557381970,831561760,-274179790,영국,2014-02
2014-02-28,447949830,57757128,390192702,튀르키예,2014-02
2014-02-28,418954878,422565142,-3610264,캐나다,2014-02
2014-02-28,370439124,15923257,354515867,슬로바키아,2014-02
2014-02-28,322188945,72578609,249610336,폴란드,2014-02
2014-02-28,319161733,7888,319153845,마샬군도,2014-02
2014-02-28,309815565,438587955,-128772390,프랑스,2014-02
2014-02-28,273519381,444656814,-171137433,이탈리아,2014-02
2014-02-28,252881812,80679,252801133,라이베리아,2014-02
2014-02-28,252355998,1159147079,-906791081,쿠웨이트,2014-02
2014-02-28,243696712,866192153,-622495441,이란,2014-02
2014-02-28,181984155,149346660,32637495,벨기에,2014-02
2014-02-28,170363457,276720815,-106357358,칠레,2014-02
2014-02-28,156307951,1713823,154594128,우즈베키스탄,2014-02
2014-02-28,151992214,69577704,82414510,콜롬비아,2014-02
2014-02-28,147498271,174549347,-27051076,스페인,2014-02
2014-02-28,143872188,108429614,35442574,이집트,2014-02
2014-02-28,143565735,110448353,33117382,뉴질랜드,2014-02
2014-02-28,135837371,569824740,-433987369,이라크,2014-02
2014-02-28,132485876,41488652,90997224,체코공화국,2014-02
2014-02-28,120396812,10534363,109862449,슬로베니아,2014-02
2014-02-28,116753117,129574446,-12821329,남아프리카공화국,2014-02
2014-02-28,109874564,33449873,76424691,방글라데시,2014-02
2014-02-28,109699822,46215203,63484619,헝가리,2014-02
2014-02-28,108548570,63994629,44553941,이스라엘,2014-02
2014-02-28,107083964,346944557,-239860593,오만,2014-02
2014-02-28,105867199,132693810,-26826611,페루,2014-02
2014-02-28,101864623,305200639,-203336016,나이지리아,2014-02
2014-02-28,98896474,4582478,94313996,요르단,2014-02
2014-02-28,92203071,77723139,14479932,알제리,2014-02
2014-02-28,90398080,1631329,88766751,케냐,2014-02
2014-02-28,83969554,128287498,-44317944,카자흐스탄,2014-02
2014-02-28,81894850,344115,81550735,리비아,2014-02
2014-02-28,78658805,66097785,12561020,아일랜드,2014-02
2014-02-28,78021692,3086799,74934893,파나마,2014-02
2014-02-28,70782746,106456762,-35674016,스웨덴,2014-02
2014-02-28,63309125,37606251,25702874,파키스탄,2014-02
2014-02-28,59362762,2814270,56548492,에쿠아도르,2014-02
2014-02-28,54283936,111422094,-57138158,오스트리아,2014-02
2014-02-28,51248095,16577228,34670867,캄보디아,2014-02
2014-02-28,50704661,36415134,14289527,아르헨티나,2014-02
2014-02-28,49570569,67497875,-17927306,우크라이나,2014-02
2014-02-28,49112129,44473899,4638230,미얀마,2014-02
2014-02-28,48550660,221921753,-173371093,노르웨이,2014-02
2014-02-28,45881039,2547342878,-2501461839,카타르,2014-02
2014-02-28,43047229,54549379,-11502150,루마니아,2014-02
2014-02-28,32318818,16163114,16155704,포루투갈,2014-02
2014-02-28,31557269,72239598,-40682329,덴마크,2014-02
2014-02-28,29232637,213454037,-184221400,스위스,2014-02
2014-02-28,28592521,14497,28578024,아제르바이잔,2014-02
2014-02-28,26679802,7954129,18725673,스리랑카,2014-02
2014-02-28,26364374,89850511,-63486137,바레인,2014-02
2014-02-28,24842767,1930080,22912687,앙골라,2014-02
2014-02-28,22469572,101301384,-78831812,핀란드,2014-02
2014-02-28,22287066,37167723,-14880657,과테말라,2014-02
2014-02-28,21902969,9425565,12477404,모로코,2014-02
2014-02-28,21164728,37479559,-16314831,그리스,2014-02
2014-02-28,21018804,2569947,18448857,레바논,2014-02
2014-02-28,20249201,22090856,-1841655,코스타리카,2014-02
2014-02-28,20091806,131722,19960084,코트디봐르,2014-02
2014-02-28,20086891,1803883,18283008,몽골,2014-02
2014-02-28,19811157,4611264,15199893,리투아니아,2014-02
2014-02-28,19066831,22955881,-3889050,푸에르토리코,2014-02
2014-02-28,18183042,3547593,14635449,우루과이,2014-02
2014-02-28,18050129,142831,17907298,시리아,2014-02
2014-02-28,16465890,2887355,13578535,가나,2014-02
2014-02-28,16378637,21899415,-5520778,튀니지,2014-02
2014-02-28,15974995,575531,15399464,라오스,2014-02
2014-02-28,15638312,1276061,14362251,파라과이,2014-02
2014-02-28,15543140,10511802,5031338,도미니카 공화국,2014-02
2014-02-28,14410253,7376093,7034160,탄자니아,2014-02
2014-02-28,14038213,1193327,12844886,수단,2014-02
2014-02-28,14022018,344116865,-330094847,예맨,2014-02
2014-02-28,12849195,1507497,11341698,니카라과,2014-02
2014-02-28,12275679,88539,12187140,키르기스스탄,2014-02
2014-02-28,11146679,18634254,-7487575,트리니다드 토바고,2014-02
2014-02-28,10839435,33437770,-22598335,불가리아,2014-02
2014-02-28,10831154,514562,10316592,조지아,2014-02
2014-02-28,10807336,1278590,9528746,엘살바도르,2014-02
2014-02-28,10764171,36521,10727650,투르크멘,2014-02
2014-02-28,9812386,125364530,-115552144,브루나이,2014-02
2014-02-28,9139875,3411297,5728578,온두라스,2014-02
2014-02-28,8907799,126309,8781490,팔레스타인 해방기구,2014-02
2014-02-28,8653035,495966,8157069,크로아티아,2014-02
2014-02-28,7940556,2478102,5462454,에티오피아,2014-02
2014-02-28,7810966,5397002,2413964,에스토니아,2014-02
2014-02-28,7056207,3165968,3890239,라트비아,2014-02
2014-02-28,6215960,5594875,621085,모잠비크,2014-02
2014-02-28,6107781,1097,6106684,아프카니스탄,2014-02
2014-02-28,5608676,1446866,4161810,기니,2014-02
2014-02-28,5499475,85595993,-80096518,가봉,2014-02
2014-02-28,5272646,151413,5121233,괌,2014-02
2014-02-28,4991258,44662,4946596,베네주엘라,2014-02
2014-02-28,4971175,6038329,-1067154,몰타,2014-02
2014-02-28,4654290,12081183,-7426893,세르비아,2014-02
2014-02-28,4472564,13384273,-8911709,볼리비아,2014-02
2014-02-28,4427632,2209,4425423,타지크,2014-02
2014-02-28,4245021,787183,3457838,세네갈,2014-02
2014-02-28,4118017,2800498,1317519,파푸아 뉴기니,2014-02
2014-02-28,3926351,3859835,66516,벨라루스,2014-02
2014-02-28,3916706,101472032,-97555326,콩고,2014-02
2014-02-28,3792920,26593216,-22800296,잠비아,2014-02
2014-02-28,3775337,447509,3327828,베닝,2014-02
2014-02-28,3675480,419828,3255652,모리셔스,2014-02
2014-02-28,3210526,40,3210486,아메리칸 사모아,2014-02
2014-02-28,3051862,125634,2926228,지부티,2014-02
2014-02-28,2965484,599636,2365848,아이티,2014-02
2014-02-28,2814175,506518,2307657,쿠바,2014-02
2014-02-28,2519462,51713,2467749,가이아나,2014-02
2014-02-28,2493306,57874530,-55381224,사이프러스,2014-02
2014-02-28,2418364,2769148,-350784,아이슬란드,2014-02
2014-02-28,2367132,229626,2137506,마카오,2014-02
2014-02-28,2214902,702583,1512319,뉴 칼레도니아,2014-02
2014-02-28,2114400,90434,2023966,아르메니아,2014-02
2014-02-28,2082629,0,2082629,부르키나 파소,2014-02
2014-02-28,2021244,172689,1848555,짐바브웨,2014-02
2014-02-28,2017891,9251,2008640,카메룬,2014-02
2014-02-28,1988387,239565,1748822,피지,2014-02
2014-02-28,1970521,16987597,-15017076,마다카스카르,2014-02
2014-02-28,1943554,5168,1938386,불령 리유니온 코모도 제도,2014-02
2014-02-28,1894568,1005566,889002,보스니아-헤르체고비나,2014-02
2014-02-28,1708344,790679,917665,자마이카,2014-02
2014-02-28,1702557,131699,1570858,세이쉘,2014-02
2014-02-28,1507077,0,1507077,네덜란드 열도,2014-02
2014-02-28,1362835,990,1361845,바하마,2014-02
2014-02-28,1324842,1325497,-655,모리타니,2014-02
2014-02-28,1320940,21045855,-19724915,보츠와나,2014-02
2014-02-28,1311928,4956,1306972,말리,2014-02
2014-02-28,1288577,3945128,-2656551,기타국,2014-02
2014-02-28,1279451,27589,1251862,아루바,2014-02
2014-02-28,1244175,99759,1144416,알바니아,2014-02
2014-02-28,1232038,1402826,-170788,토고,2014-02
2014-02-28,1133321,0,1133321,불령 폴리네시아,2014-02
2014-02-28,1104261,137591,966670,네팔,2014-02
2014-02-28,997625,361329,636296,수리남,2014-02
2014-02-28,968225,42617841,-41649616,콩고민주공화국,2014-02
2014-02-28,856104,37693,818411,북마리아나 군도,2014-02
2014-02-28,822179,71121,751058,벨리제,2014-02
2014-02-28,819716,14,819702,르완다,2014-02
2014-02-28,755264,9345110,-8589846,룩셈부르그,2014-02
2014-02-28,731779,970102,-238323,키리바티,2014-02
2014-02-28,697152,1406869,-709717,우간다,2014-02
2014-02-28,682796,229196,453600,시에라 리온,2014-02
2014-02-28,663871,0,663871,안티가 바부다,2014-02
2014-02-28,631230,162640,468590,티모르,2014-02
2014-02-28,604674,1269915,-665241,말라위,2014-02
2014-02-28,586583,0,586583,영령 캐이맨 군도,2014-02
2014-02-28,567473,0,567473,바베이도스,2014-02
2014-02-28,559241,1062277,-503036,나미비아,2014-02
2014-02-28,526319,2552733,-2026414,몰도바,2014-02
2014-02-28,501914,63395,438519,사모아,2014-02
2014-02-28,490138,743027,-252889,리히텐슈타인,2014-02
2014-02-28,481859,0,481859,세인트 루시아,2014-02
2014-02-28,466818,0,466818,과델로프,2014-02
2014-02-28,453654,7438,446216,팔라우,2014-02
2014-02-28,436146,41000,395146,마이크로네시아,2014-02
2014-02-28,413714,204,413510,버뮤다,2014-02
2014-02-28,372307,336,371971,마티니크,2014-02
2014-02-28,369893,213868,156025,스와질랜드,2014-02
2014-02-28,334797,103674,231123,마세도니아,2014-02
2014-02-28,298060,0,298060,에리트리아,2014-02
2014-02-28,289573,49956,239617,불령 가이아나,2014-02
2014-02-28,288143,50221,237922,도미니카,2014-02
2014-02-28,203116,0,203116,지브랄타,2014-02
2014-02-28,187658,171784,15874,모나코,2014-02
2014-02-28,163539,177,163362,세인트 키츠 네비스,2014-02
2014-02-28,145889,197592,-51703,솔로몬 군도,2014-02
2014-02-28,145510,80,145430,몰디브,2014-02
2014-02-28,138172,0,138172,국제통화기금,2014-02
2014-02-28,129662,1107452,-977790,바누아투,2014-02
2014-02-28,109323,111,109212,몬테네그로,2014-02
2014-02-28,105068,32251,72817,감비아,2014-02
2014-02-28,98127,70517334,-70419207,적도 기니,2014-02
2014-02-28,96390,115732,-19342,영령 버진군도,2014-02
2014-02-28,90596,0,90596,노폴크 아일랜드,2014-02
2014-02-28,89983,0,89983,그레나다,2014-02
2014-02-28,78533,0,78533,챠드,2014-02
2014-02-28,73410,0,73410,부탄,2014-02
2014-02-28,70100,0,70100,소말리아,2014-02
2014-02-28,63896,1681,62215,중앙아프리카공화국,2014-02
2014-02-28,53580,152,53428,부룬디,2014-02
2014-02-28,52756,248,52508,투르크 & 카이코스 군도,2014-02
2014-02-28,50029,10290,39739,니제르,2014-02
2014-02-28,45275,867,44408,안도라,2014-02
2014-02-28,37420,0,37420,세인트 빈센트 그레나딘,2014-02
2014-02-28,23825,0,23825,앙귈라,2014-02
2014-02-28,18058,21668,-3610,나우루,2014-02
2014-02-28,17804,784,17020,포클랜드 군도,2014-02
2014-02-28,16322,0,16322,남조지아 & 남샌드위치 군도,2014-02
2014-02-28,13567,0,13567,카보 베르데,2014-02
2014-02-28,10328,0,10328,남수단,2014-02
2014-02-28,4610,0,4610,투발루,2014-02
2014-02-28,1750,0,1750,상토메 프린스페,2014-02
2014-02-28,1600,7551,-5951,통가,2014-02
2014-02-28,1257,0,1257,코모로스,2014-02
2014-02-28,590,0,590,교황청,2014-02
2014-02-28,456,42200,-41744,기네비소,2014-02
2014-02-28,212,0,212,세인트 마틴,2014-02
2014-02-28,0,43,-43,피트카이른,2014-02
2014-02-28,0,7357,-7357,파로에 군도,2014-02
2014-02-28,0,324384,-324384,그린랜드,2014-02
2014-02-28,0,42271,-42271,미령 버진군도,2014-02
2014-02-28,0,83390,-83390,토켈라우,2014-02
2014-02-28,0,53248,-53248,산마리노,2014-02
2014-02-28,0,165,-165,몬트세라트,2014-02
2014-03-31,12186981771,7605655116,4581326655,중국,2014-03
2014-03-31,5814181509,3954447003,1859734506,미국,2014-03
2014-03-31,2783089468,4744745038,-1961655570,일본,2014-03
2014-03-31,2329908444,1167217783,1162690661,싱가포르,2014-03
2014-03-31,2278012933,154347698,2123665235,홍콩,2014-03
2014-03-31,2095882609,659633071,1436249538,베트남,2014-03
2014-03-31,1368786811,1066080992,302705819,인도네시아,2014-03
2014-03-31,1308575290,1237379831,71195459,대만,2014-03
2014-03-31,1109395702,536051402,573344300,인도,2014-03
2014-03-31,1019868769,295051427,724817342,필리핀,2014-03
2014-03-31,977134234,1263,977132971,마샬군도,2014-03
2014-03-31,900240247,276976893,623263354,브라질,2014-03
2014-03-31,850886039,1483189672,-632303633,러시아 연방,2014-03
2014-03-31,814301343,341399379,472901964,멕시코,2014-03
2014-03-31,808194308,1738865852,-930671544,독일,2014-03
2014-03-31,705670160,1125174078,-419503918,아랍에미리트 연합,2014-03
2014-03-31,697394294,934676949,-237282655,말레이시아,2014-03
2014-03-31,653683549,408121103,245562446,태국,2014-03
2014-03-31,626600901,2940379890,-2313778989,사우디아라비아,2014-03
2014-03-31,614881703,1864531674,-1249649971,호주,2014-03
2014-03-31,572515583,45438445,527077138,튀르키예,2014-03
2014-03-31,486973356,719071850,-232098494,영국,2014-03
2014-03-31,458223988,381525422,76698566,캐나다,2014-03
2014-03-31,438174946,469081832,-30906886,네덜란드,2014-03
2014-03-31,409603167,17282711,392320456,슬로바키아,2014-03
2014-03-31,308430289,518861948,-210431659,이탈리아,2014-03
2014-03-31,303418891,70112844,233306047,폴란드,2014-03
2014-03-31,300888311,218427233,82461078,이란,2014-03
2014-03-31,282752289,97697990,185054299,벨기에,2014-03
2014-03-31,225453734,5379720,220074014,몰타,2014-03
2014-03-31,221243426,420803375,-199559949,프랑스,2014-03
2014-03-31,221037717,69871117,151166600,덴마크,2014-03
2014-03-31,213783398,8816599,204966799,우즈베키스탄,2014-03
2014-03-31,208255303,334768976,-126513673,칠레,2014-03
2014-03-31,197699009,6950000,190749009,요르단,2014-03
2014-03-31,183640728,43080854,140559874,이집트,2014-03
2014-03-31,181613286,294737068,-113123782,스페인,2014-03
2014-03-31,169829285,13364009,156465276,파나마,2014-03
2014-03-31,146101736,136590822,9510914,뉴질랜드,2014-03
2014-03-31,142184757,780056082,-637871325,이라크,2014-03
2014-03-31,142150262,197451442,-55301180,남아프리카공화국,2014-03
2014-03-31,140801887,74698522,66103365,이스라엘,2014-03
2014-03-31,138143213,41257884,96885329,체코공화국,2014-03
2014-03-31,131993399,10780252,121213147,슬로베니아,2014-03
2014-03-31,130984590,17824616,113159974,콜롬비아,2014-03
2014-03-31,124383424,66542529,57840895,알제리,2014-03
2014-03-31,114668766,77244160,37424606,페루,2014-03
2014-03-31,112968039,215969557,-103001518,나이지리아,2014-03
2014-03-31,110838880,5758105,105080775,라이베리아,2014-03
2014-03-31,106596710,1474762,105121948,리비아,2014-03
2014-03-31,102196869,32581928,69614941,방글라데시,2014-03
2014-03-31,91728927,415655758,-323926831,오만,2014-03
2014-03-31,90019814,1776901093,-1686881279,쿠웨이트,2014-03
2014-03-31,85165146,40365899,44799247,헝가리,2014-03
2014-03-31,80219296,122522838,-42303542,스웨덴,2014-03
2014-03-31,79409799,11076084,68333715,카자흐스탄,2014-03
2014-03-31,69180985,4173810,65007175,에쿠아도르,2014-03
2014-03-31,67755000,239,67754761,맨섬,2014-03
2014-03-31,63873382,3090889640,-3027016258,카타르,2014-03
2014-03-31,62458632,23190767,39267865,아르헨티나,2014-03
2014-03-31,60416782,43210195,17206587,미얀마,2014-03
2014-03-31,60356981,24395753,35961228,파키스탄,2014-03
2014-03-31,58383884,3910753,54473131,기타국,2014-03
2014-03-31,54318256,15861102,38457154,캄보디아,2014-03
2014-03-31,52613883,106776583,-54162700,오스트리아,2014-03
2014-03-31,50056189,45999971,4056218,루마니아,2014-03
2014-03-31,41778829,14294818,27484011,포루투갈,2014-03
2014-03-31,40776104,991456,39784648,몽골,2014-03
2014-03-31,36751492,57470069,-20718577,앙골라,2014-03
2014-03-31,36406827,222584195,-186177368,스위스,2014-03
2014-03-31,31552357,43118466,-11566109,과테말라,2014-03
2014-03-31,31218238,44,31218194,불령 폴리네시아,2014-03
2014-03-31,30590340,61212654,-30622314,아일랜드,2014-03
2014-03-31,27288984,88859481,-61570497,우크라이나,2014-03
2014-03-31,27149544,135728915,-108579371,핀란드,2014-03
2014-03-31,26461245,25625634,835611,코스타리카,2014-03
2014-03-31,26232732,0,26232732,시리아,2014-03
2014-03-31,26193315,9638935,16554380,모로코,2014-03
2014-03-31,25694759,8984605,16710154,스리랑카,2014-03
2014-03-31,24960415,2321684,22638731,레바논,2014-03
2014-03-31,24487269,16659,24470610,투르크멘,2014-03
2014-03-31,24266638,115367515,-91100877,바레인,2014-03
2014-03-31,23537252,659703,22877549,파라과이,2014-03
2014-03-31,23225030,10350640,12874390,우루과이,2014-03
2014-03-31,22354248,2849017,19505231,그리스,2014-03
2014-03-31,20189375,2387962,17801413,가나,2014-03
2014-03-31,18618528,1730221,16888307,케냐,2014-03
2014-03-31,18345561,233075823,-214730262,예맨,2014-03
2014-03-31,16396520,968777,15427743,수단,2014-03
2014-03-31,16041129,7201744,8839385,도미니카 공화국,2014-03
2014-03-31,15898139,711813,15186326,라오스,2014-03
2014-03-31,15456889,217159,15239730,코트디봐르,2014-03
2014-03-31,14497151,14574207,-77056,푸에르토리코,2014-03
2014-03-31,14354398,0,14354398,아제르바이잔,2014-03
2014-03-31,13923285,2681741,11241544,에티오피아,2014-03
2014-03-31,13489992,4376488,9113504,리투아니아,2014-03
2014-03-31,13239316,1746946,11492370,니카라과,2014-03
2014-03-31,12995171,14350,12980821,팔레스타인 해방기구,2014-03
2014-03-31,12892022,248443764,-235551742,노르웨이,2014-03
2014-03-31,12761210,87740,12673470,키르기스스탄,2014-03
2014-03-31,12593964,492715,12101249,조지아,2014-03
2014-03-31,12299361,906631,11392730,탄자니아,2014-03
2014-03-31,12218574,6994631,5223943,튀니지,2014-03
2014-03-31,11322053,810209,10511844,크로아티아,2014-03
2014-03-31,10744487,6659193,4085294,온두라스,2014-03
2014-03-31,10366988,20985839,-10618851,에스토니아,2014-03
2014-03-31,9889616,6027409,3862207,불가리아,2014-03
2014-03-31,9278058,31533197,-22255139,엘살바도르,2014-03
2014-03-31,8650854,396096,8254758,볼리비아,2014-03
2014-03-31,8325126,142932,8182194,괌,2014-03
2014-03-31,7560977,0,7560977,마이크로네시아,2014-03
2014-03-31,7533398,4937657,2595741,라트비아,2014-03
2014-03-31,6949794,1935776,5014018,트리니다드 토바고,2014-03
2014-03-31,6372192,73990,6298202,모잠비크,2014-03
2014-03-31,6273793,147587,6126206,베닝,2014-03
2014-03-31,6260960,0,6260960,지부티,2014-03
2014-03-31,5989102,2490798,3498304,아이슬란드,2014-03
2014-03-31,5949275,6881797,-932522,세르비아,2014-03
2014-03-31,5752600,959689,4792911,피지,2014-03
2014-03-31,5568350,2893517,2674833,세네갈,2014-03
2014-03-31,5393014,11916035,-6523021,뉴 칼레도니아,2014-03
2014-03-31,5370997,129281168,-123910171,브루나이,2014-03
2014-03-31,4875464,5268432,-392968,벨라루스,2014-03
2014-03-31,4787477,854662,3932815,모리셔스,2014-03
2014-03-31,4640904,82448,4558456,베네주엘라,2014-03
2014-03-31,4363245,69957893,-65594648,파푸아 뉴기니,2014-03
2014-03-31,4143734,0,4143734,타지크,2014-03
2014-03-31,3967080,881060,3086020,쿠바,2014-03
2014-03-31,3923574,79519988,-75596414,기니,2014-03
2014-03-31,3895327,36830498,-32935171,잠비아,2014-03
2014-03-31,3228887,1096,3227791,아프카니스탄,2014-03
2014-03-31,3152773,776821,2375952,카메룬,2014-03
2014-03-31,2944657,1294462,1650195,토고,2014-03
2014-03-31,2739658,1038217,1701441,사이프러스,2014-03
2014-03-31,2586813,2663411,-76598,모리타니,2014-03
2014-03-31,2559619,414831,2144788,짐바브웨,2014-03
2014-03-31,2335448,9589,2325859,불령 리유니온 코모도 제도,2014-03
2014-03-31,2301813,721915,1579898,자마이카,2014-03
2014-03-31,2214878,202023,2012855,아이티,2014-03
2014-03-31,2141080,2601806,-460726,콩고,2014-03
2014-03-31,2117368,23374499,-21257131,콩고민주공화국,2014-03
2014-03-31,1898143,83443,1814700,세이쉘,2014-03
2014-03-31,1812087,1039667,772420,보스니아-헤르체고비나,2014-03
2014-03-31,1733857,25802,1708055,아르메니아,2014-03
2014-03-31,1683932,377400,1306532,마카오,2014-03
2014-03-31,1557903,77904144,-76346241,가봉,2014-03
2014-03-31,1536763,313652,1223111,르완다,2014-03
2014-03-31,1495107,8537766,-7042659,마다카스카르,2014-03
2014-03-31,1328315,84809,1243506,네팔,2014-03
2014-03-31,1320505,620981,699524,말라위,2014-03
2014-03-31,1224200,359599,864601,우간다,2014-03
2014-03-31,1223082,875,1222207,바베이도스,2014-03
2014-03-31,1202761,23394,1179367,아메리칸 사모아,2014-03
2014-03-31,1181106,0,1181106,에리트리아,2014-03
2014-03-31,1111521,619975,491546,시에라 리온,2014-03
2014-03-31,1063783,2948381,-1884598,룩셈부르그,2014-03
2014-03-31,1023605,156431,867174,알바니아,2014-03
2014-03-31,958740,2009924,-1051184,키리바티,2014-03
2014-03-31,955279,0,955279,네덜란드 열도,2014-03
2014-03-31,953003,0,953003,가이아나,2014-03
2014-03-31,918499,0,918499,안티가 바부다,2014-03
2014-03-31,902809,46222,856587,마세도니아,2014-03
2014-03-31,898710,6002,892708,말리,2014-03
2014-03-31,845287,1139154,-293867,몰도바,2014-03
2014-03-31,825941,15607,810334,북마리아나 군도,2014-03
2014-03-31,741534,36814,704720,보츠와나,2014-03
2014-03-31,705045,7644,697401,니제르,2014-03
2014-03-31,647442,18428087,-17780645,나미비아,2014-03
2014-03-31,646226,104451,541775,수리남,2014-03
2014-03-31,636059,0,636059,소말리아,2014-03
2014-03-31,583109,118181,464928,스와질랜드,2014-03
2014-03-31,564458,532930,31528,리히텐슈타인,2014-03
2014-03-31,544029,40,543989,버뮤다,2014-03
2014-03-31,521304,0,521304,티모르,2014-03
2014-03-31,508756,61379,447377,아루바,2014-03
2014-03-31,485544,7208882,-6723338,바누아투,2014-03
2014-03-31,479443,35130,444313,바하마,2014-03
2014-03-31,434446,292215,142231,부르키나 파소,2014-03
2014-03-31,431865,0,431865,그레나다,2014-03
2014-03-31,425414,155312,270102,벨리제,2014-03
2014-03-31,414697,0,414697,팔라우,2014-03
2014-03-31,389916,4840,385076,도미니카,2014-03
2014-03-31,383152,60694,322458,사모아,2014-03
2014-03-31,345849,0,345849,앙귈라,2014-03
2014-03-31,290770,122135,168635,몰디브,2014-03
2014-03-31,278712,0,278712,영령 캐이맨 군도,2014-03
2014-03-31,270876,109,270767,과델로프,2014-03
2014-03-31,267380,5491,261889,중앙아프리카공화국,2014-03
2014-03-31,261572,0,261572,영령 버진군도,2014-03
2014-03-31,233321,0,233321,지브랄타,2014-03
2014-03-31,227332,0,227332,카보 베르데,2014-03
2014-03-31,203591,93476,110115,적도 기니,2014-03
2014-03-31,201749,161,201588,마티니크,2014-03
2014-03-31,176494,1018083,-841589,솔로몬 군도,2014-03
2014-03-31,165277,142003,23274,모나코,2014-03
2014-03-31,157396,0,157396,세인트 빈센트 그레나딘,2014-03
2014-03-31,149246,0,149246,감비아,2014-03
2014-03-31,143407,801,142606,세인트 루시아,2014-03
2014-03-31,134842,6923,127919,투르크 & 카이코스 군도,2014-03
2014-03-31,131045,0,131045,세인트 키츠 네비스,2014-03
2014-03-31,128650,51,128599,불령 가이아나,2014-03
2014-03-31,112055,601,111454,몬테네그로,2014-03
2014-03-31,94550,0,94550,부룬디,2014-03
2014-03-31,73491,12900,60591,부탄,2014-03
2014-03-31,68251,0,68251,남수단,2014-03
2014-03-31,61156,35225,25931,기네비소,2014-03
2014-03-31,49471,0,49471,세인트 마틴,2014-03
2014-03-31,47190,30940,16250,노폴크 아일랜드,2014-03
2014-03-31,30222,1022,29200,쿡 아일랜드,2014-03
2014-03-31,18988,0,18988,메요트,2014-03
2014-03-31,15990,0,15990,레소토,2014-03
2014-03-31,14853,0,14853,교황청,2014-03
2014-03-31,12425,1382,11043,산마리노,2014-03
2014-03-31,10323,48,10275,챠드,2014-03
2014-03-31,9582,289,9293,포클랜드 군도,2014-03
2014-03-31,9533,7154,2379,코모로스,2014-03
2014-03-31,4608,0,4608,코스 군도,2014-03
2014-03-31,4052,0,4052,통가,2014-03
2014-03-31,2600,2060,540,미령 버진군도,2014-03
2014-03-31,1525,0,1525,남조지아 & 남샌드위치 군도,2014-03
2014-03-31,1225,0,1225,파로에 군도,2014-03
2014-03-31,1068,0,1068,세인트 헬레나,2014-03
2014-03-31,0,360,-360,몬트세라트,2014-03
2014-03-31,0,120,-120,스발비드 군도,2014-03
2014-03-31,0,79,-79,니우에,2014-03
2014-03-31,0,216608,-216608,그린랜드,2014-03
2014-03-31,0,2134,-2134,안도라,2014-03
2014-03-31,0,1693,-1693,나우루,2014-03
2014-04-30,12410094981,7910699291,4499395690,중국,2014-04
2014-04-30,6376333605,4134306767,2242026838,미국,2014-04
2014-04-30,2717013724,4887821895,-2170808171,일본,2014-04
2014-04-30,2708374833,1046706486,1661668347,싱가포르,2014-04
2014-04-30,2267187304,160104141,2107083163,홍콩,2014-04
2014-04-30,1815755823,628186323,1187569500,베트남,2014-04
2014-04-30,1401796901,332386810,1069410091,멕시코,2014-04
2014-04-30,1239632734,1358056764,-118424030,대만,2014-04
2014-04-30,1100033530,425446512,674587018,인도,2014-04
2014-04-30,1042213541,337733044,704480497,필리핀,2014-04
2014-04-30,988058845,1250402078,-262343233,인도네시아,2014-04
2014-04-30,928161768,1277385869,-349224101,러시아 연방,2014-04
2014-04-30,870442913,1858876559,-988433646,호주,2014-04
2014-04-30,844851291,2873939270,-2029087979,사우디아라비아,2014-04
2014-04-30,819963661,1940054487,-1120090826,독일,2014-04
2014-04-30,786622556,395932138,390690418,브라질,2014-04
2014-04-30,742110011,912372696,-170262685,말레이시아,2014-04
2014-04-30,669751569,463377887,206373682,태국,2014-04
2014-04-30,625273692,59409909,565863783,튀르키예,2014-04
2014-04-30,575130059,1592915126,-1017785067,아랍에미리트 연합,2014-04
2014-04-30,560848955,60648,560788307,라이베리아,2014-04
2014-04-30,536558949,414557922,122001027,네덜란드,2014-04
2014-04-30,462914200,442021808,20892392,캐나다,2014-04
2014-04-30,454650548,914320700,-459670152,영국,2014-04
2014-04-30,401735231,19493977,382241254,슬로바키아,2014-04
2014-04-30,352365436,60892832,291472604,폴란드,2014-04
2014-04-30,323477384,435485852,-112008468,이란,2014-04
2014-04-30,309928803,500857756,-190928953,이탈리아,2014-04
2014-04-30,267106905,8977,267097928,마샬군도,2014-04
2014-04-30,248405403,26524736,221880667,파나마,2014-04
2014-04-30,241932786,465684050,-223751264,프랑스,2014-04
2014-04-30,241576354,155941941,85634413,벨기에,2014-04
2014-04-30,225558351,2618294,222940057,우즈베키스탄,2014-04
2014-04-30,212740995,680596706,-467855711,칠레,2014-04
2014-04-30,192929011,403577132,-210648121,이라크,2014-04
2014-04-30,186388392,129493893,56894499,뉴질랜드,2014-04
2014-04-30,175851901,63108603,112743298,이집트,2014-04
2014-04-30,151318539,163041463,-11722924,스페인,2014-04
2014-04-30,148984490,51505612,97478878,체코공화국,2014-04
2014-04-30,146973933,168942030,-21968097,남아프리카공화국,2014-04
2014-04-30,144994898,10674887,134320011,슬로베니아,2014-04
2014-04-30,139055493,32493462,106562031,방글라데시,2014-04
2014-04-30,130415251,130688187,-272936,스웨덴,2014-04
2014-04-30,128792948,143226213,-14433265,페루,2014-04
2014-04-30,125180424,16406615,108773809,콜롬비아,2014-04
2014-04-30,125008194,91661339,33346855,이스라엘,2014-04
2014-04-30,120997833,1125555405,-1004557572,쿠웨이트,2014-04
2014-04-30,115472876,5687136,109785740,요르단,2014-04
2014-04-30,115230043,92567290,22662753,알제리,2014-04
2014-04-30,99174087,158972309,-59798222,리비아,2014-04
2014-04-30,99113829,224772783,-125658954,나이지리아,2014-04
2014-04-30,96158150,374473505,-278315355,오만,2014-04
2014-04-30,92542772,45846982,46695790,헝가리,2014-04
2014-04-30,83153226,110600542,-27447316,오스트리아,2014-04
2014-04-30,79520535,216776936,-137256401,예맨,2014-04
2014-04-30,75124699,3502033,71622666,에쿠아도르,2014-04
2014-04-30,71175244,9034259,62140985,카자흐스탄,2014-04
2014-04-30,70380513,42099075,28281438,미얀마,2014-04
2014-04-30,64978002,56494401,8483601,아르헨티나,2014-04
2014-04-30,61263906,66558253,-5294347,파키스탄,2014-04
2014-04-30,59706688,178513120,-118806432,노르웨이,2014-04
2014-04-30,59081136,22110184,36970952,캄보디아,2014-04
2014-04-30,57234431,47599277,9635154,루마니아,2014-04
2014-04-30,49105458,33759255,15346203,몰타,2014-04
2014-04-30,48827387,2032114568,-1983287181,카타르,2014-04
2014-04-30,43498667,20408023,23090644,앙골라,2014-04
2014-04-30,39900428,11140,39889288,시리아,2014-04
2014-04-30,38508073,16646191,21861882,포루투갈,2014-04
2014-04-30,37453507,2595559,34857948,몽골,2014-04
2014-04-30,35987313,331808,35655505,괌,2014-04
2014-04-30,33523727,429483,33094244,피지,2014-04
2014-04-30,31788750,249110722,-217321972,스위스,2014-04
2014-04-30,31765637,74225078,-42459441,덴마크,2014-04
2014-04-30,31651281,9155494,22495787,모로코,2014-04
2014-04-30,31435614,2072,31433542,투르크멘,2014-04
2014-04-30,30863454,74634644,-43771190,과테말라,2014-04
2014-04-30,30798012,8801348,21996664,스리랑카,2014-04
2014-04-30,29678273,34974996,-5296723,튀니지,2014-04
2014-04-30,29127587,40820,29086767,코트디봐르,2014-04
2014-04-30,29090773,111558591,-82467818,핀란드,2014-04
2014-04-30,26101353,3463,26097890,아제르바이잔,2014-04
2014-04-30,24516188,67995888,-43479700,우크라이나,2014-04
2014-04-30,24371806,28320536,-3948730,코스타리카,2014-04
2014-04-30,22951730,12693726,10258004,도미니카 공화국,2014-04
2014-04-30,22523463,63196156,-40672693,그리스,2014-04
2014-04-30,20761466,3809061,16952405,우루과이,2014-04
2014-04-30,20420317,5944266,14476051,바레인,2014-04
2014-04-30,19725535,2350296,17375239,케냐,2014-04
2014-04-30,19227231,989581,18237650,니카라과,2014-04
2014-04-30,19172770,2554831,16617939,가나,2014-04
2014-04-30,19088858,929833,18159025,파라과이,2014-04
2014-04-30,18241523,74341545,-56100022,아일랜드,2014-04
2014-04-30,16509773,2110805,14398968,트리니다드 토바고,2014-04
2014-04-30,16509380,2343900,14165480,레바논,2014-04
2014-04-30,15569048,388966,15180082,조지아,2014-04
2014-04-30,14455152,4777337,9677815,리투아니아,2014-04
2014-04-30,13894490,1208106,12686384,수단,2014-04
2014-04-30,13685356,19715534,-6030178,푸에르토리코,2014-04
2014-04-30,13370511,95931484,-82560973,에스토니아,2014-04
2014-04-30,13141573,2741979,10399594,라오스,2014-04
2014-04-30,12376221,5317746,7058475,라트비아,2014-04
2014-04-30,12332755,12409433,-76678,모잠비크,2014-04
2014-04-30,12229434,60845,12168589,키르기스스탄,2014-04
2014-04-30,11934993,32536425,-20601432,볼리비아,2014-04
2014-04-30,11237720,5740211,5497509,온두라스,2014-04
2014-04-30,11232992,1440139,9792853,베닝,2014-04
2014-04-30,11018425,6435408,4583017,에티오피아,2014-04
2014-04-30,10938915,6817531,4121384,엘살바도르,2014-04
2014-04-30,10770918,167748295,-156977377,브루나이,2014-04
2014-04-30,9416865,740656,8676209,탄자니아,2014-04
2014-04-30,8637230,16619329,-7982099,불가리아,2014-04
2014-04-30,8460519,758280,7702239,크로아티아,2014-04
2014-04-30,7622306,9043419,-1421113,뉴 칼레도니아,2014-04
2014-04-30,7453316,11405936,-3952620,세르비아,2014-04
2014-04-30,6446261,0,6446261,팔레스타인 해방기구,2014-04
2014-04-30,5450946,5310684,140262,파푸아 뉴기니,2014-04
2014-04-30,5378244,0,5378244,지부티,2014-04
2014-04-30,5192143,6516125,-1323982,세네갈,2014-04
2014-04-30,4984024,514636,4469388,모리셔스,2014-04
2014-04-30,4928797,2668028,2260769,아이슬란드,2014-04
2014-04-30,4787248,8773008,-3985760,벨라루스,2014-04
2014-04-30,4776350,125479,4650871,쿠바,2014-04
2014-04-30,4640637,207757,4432880,타지크,2014-04
2014-04-30,4585738,6464295,-1878557,베네주엘라,2014-04
2014-04-30,4353073,82998,4270075,카메룬,2014-04
2014-04-30,4227920,103746663,-99518743,콩고,2014-04
2014-04-30,3776483,690466,3086017,사이프러스,2014-04
2014-04-30,3521281,4644,3516637,네덜란드 열도,2014-04
2014-04-30,3478843,10066605,-6587762,시에라 리온,2014-04
2014-04-30,3456779,7395501,-3938722,마다카스카르,2014-04
2014-04-30,3452941,135208300,-131755359,기니,2014-04
2014-04-30,3169121,39231,3129890,아메리칸 사모아,2014-04
2014-04-30,3118141,0,3118141,아루바,2014-04
2014-04-30,2949561,226440,2723121,아이티,2014-04
2014-04-30,2864990,3753,2861237,불령 리유니온 코모도 제도,2014-04
2014-04-30,2809059,3240421,-431362,토고,2014-04
2014-04-30,2794112,704,2793408,아프카니스탄,2014-04
2014-04-30,2784931,1851990,932941,부르키나 파소,2014-04
2014-04-30,2732934,198032,2534902,짐바브웨,2014-04
2014-04-30,2705436,5312164,-2606728,기타국,2014-04
2014-04-30,2651352,51830,2599522,르완다,2014-04
2014-04-30,2277234,284737,1992497,마카오,2014-04
2014-04-30,2162651,2363042,-200391,룩셈부르그,2014-04
2014-04-30,2056754,0,2056754,과델로프,2014-04
2014-04-30,2000360,3775,1996585,바하마,2014-04
2014-04-30,1989741,31589405,-29599664,콩고민주공화국,2014-04
2014-04-30,1979932,36151,1943781,마티니크,2014-04
2014-04-30,1943314,261742,1681572,세이쉘,2014-04
2014-04-30,1928691,1681,1927010,영령 캐이맨 군도,2014-04
2014-04-30,1848690,773476,1075214,보스니아-헤르체고비나,2014-04
2014-04-30,1800266,14622990,-12822724,잠비아,2014-04
2014-04-30,1777116,971318,805798,자마이카,2014-04
2014-04-30,1647806,0,1647806,말리,2014-04
2014-04-30,1645002,77171,1567831,바베이도스,2014-04
2014-04-30,1627137,56332,1570805,네팔,2014-04
2014-04-30,1566977,3074811,-1507834,말라위,2014-04
2014-04-30,1335191,316965,1018226,가봉,2014-04
2014-04-30,1298079,0,1298079,국제통화기금,2014-04
2014-04-30,1190099,18,1190081,불령 폴리네시아,2014-04
2014-04-30,1083533,141766,941767,벨리제,2014-04
2014-04-30,1082472,4293,1078179,보츠와나,2014-04
2014-04-30,1073954,760,1073194,버뮤다,2014-04
2014-04-30,986283,105633,880650,수리남,2014-04
2014-04-30,974453,90178,884275,가이아나,2014-04
2014-04-30,910058,216756,693302,아르메니아,2014-04
2014-04-30,886118,48068,838050,도미니카,2014-04
2014-04-30,859018,557008,302010,몰도바,2014-04
2014-04-30,855694,1786578,-930884,우간다,2014-04
2014-04-30,834434,18844,815590,북마리아나 군도,2014-04
2014-04-30,772226,52635,719591,알바니아,2014-04
2014-04-30,766254,873100,-106846,리히텐슈타인,2014-04
2014-04-30,736340,20382,715958,사모아,2014-04
2014-04-30,637820,2906078,-2268258,모리타니,2014-04
2014-04-30,521217,69,521148,불령 가이아나,2014-04
2014-04-30,488117,6985198,-6497081,바누아투,2014-04
2014-04-30,479972,45,479927,안티가 바부다,2014-04
2014-04-30,449762,49201,400561,모나코,2014-04
2014-04-30,445707,1237,444470,몰디브,2014-04
2014-04-30,443856,308133,135723,마이크로네시아,2014-04
2014-04-30,395298,0,395298,세인트 빈센트 그레나딘,2014-04
2014-04-30,390538,0,390538,상토메 프린스페,2014-04
2014-04-30,387994,9475455,-9087461,나미비아,2014-04
2014-04-30,345870,0,345870,에리트리아,2014-04
2014-04-30,335688,121440,214248,마세도니아,2014-04
2014-04-30,318801,7473,311328,세인트 루시아,2014-04
2014-04-30,294833,445,294388,키리바티,2014-04
2014-04-30,293728,0,293728,부탄,2014-04
2014-04-30,290297,150393,139904,감비아,2014-04
2014-04-30,269302,0,269302,그레나다,2014-04
2014-04-30,263702,186854,76848,스와질랜드,2014-04
2014-04-30,256147,172679,83468,영령 버진군도,2014-04
2014-04-30,245510,0,245510,팔라우,2014-04
2014-04-30,208080,1494322,-1286242,솔로몬 군도,2014-04
2014-04-30,183727,0,183727,세인트 키츠 네비스,2014-04
2014-04-30,181430,0,181430,몬테네그로,2014-04
2014-04-30,179490,34812,144678,니제르,2014-04
2014-04-30,174791,0,174791,메요트,2014-04
2014-04-30,172575,4180,168395,미령 버진군도,2014-04
2014-04-30,157680,0,157680,소말리아,2014-04
2014-04-30,137825,107850,29975,티모르,2014-04
2014-04-30,135702,36,135666,카보 베르데,2014-04
2014-04-30,109035,9222,99813,부룬디,2014-04
2014-04-30,103089,0,103089,크리스마스 아일랜드,2014-04
2014-04-30,84800,9161,75639,토켈라우,2014-04
2014-04-30,82989,121747,-38758,적도 기니,2014-04
2014-04-30,80249,40,80209,챠드,2014-04
2014-04-30,63980,1323,62657,지브랄타,2014-04
2014-04-30,57094,82287,-25193,통가,2014-04
2014-04-30,44506,144,44362,투르크 & 카이코스 군도,2014-04
2014-04-30,39710,32347,7363,산마리노,2014-04
2014-04-30,30354,148,30206,중앙아프리카공화국,2014-04
2014-04-30,14078,0,14078,코모로스,2014-04
2014-04-30,13897,0,13897,포클랜드 군도,2014-04
2014-04-30,3755,0,3755,건지,2014-04
2014-04-30,3700,58,3642,앙귈라,2014-04
2014-04-30,2999,276,2723,쿡 아일랜드,2014-04
2014-04-30,2750,252,2498,안도라,2014-04
2014-04-30,1992,33182,-31190,기네비소,2014-04
2014-04-30,600,8587,-7987,세인트 헬레나,2014-04
2014-04-30,377,0,377,세인트 마틴,2014-04
2014-04-30,103,278313,-278210,그린랜드,2014-04
2014-04-30,0,0,0,코스 군도,2014-04
2014-04-30,0,13008,-13008,노폴크 아일랜드,2014-04
2014-04-30,0,1091,-1091,몬트세라트,2014-04
2014-04-30,0,4302554,-4302554,안타티카,2014-04
2014-05-31,11305150046,7523403230,3781746816,중국,2014-05
2014-05-31,6058690822,3708716399,2349974423,미국,2014-05
2014-05-31,2705134747,4327965578,-1622830831,일본,2014-05
2014-05-31,2383207594,770268554,1612939040,싱가포르,2014-05
2014-05-31,2288314203,135908657,2152405546,홍콩,2014-05
2014-05-31,1719707799,1486681862,233025937,러시아 연방,2014-05
2014-05-31,1693661598,479444651,1214216947,베트남,2014-05
2014-05-31,1188015975,1315772012,-127756037,대만,2014-05
2014-05-31,1055263791,1528664437,-473400646,호주,2014-05
2014-05-31,1034536067,258278622,776257445,인도,2014-05
2014-05-31,891846979,1097289533,-205442554,인도네시아,2014-05
2014-05-31,803162160,258480953,544681207,필리핀,2014-05
2014-05-31,796132312,238905235,557227077,멕시코,2014-05
2014-05-31,689489391,421155340,268334051,브라질,2014-05
2014-05-31,638098055,3027106523,-2389008468,사우디아라비아,2014-05
2014-05-31,612551707,680460847,-67909140,말레이시아,2014-05
2014-05-31,611749916,1695834763,-1084084847,독일,2014-05
2014-05-31,596926685,472975835,123950850,태국,2014-05
2014-05-31,557776210,2280761,555495449,룩셈부르그,2014-05
2014-05-31,547440349,32871594,514568755,튀르키예,2014-05
2014-05-31,512741843,330385907,182355936,영국,2014-05
2014-05-31,505022681,9217352,495805329,마샬군도,2014-05
2014-05-31,504323969,1548990487,-1044666518,아랍에미리트 연합,2014-05
2014-05-31,411785364,546530859,-134745495,캐나다,2014-05
2014-05-31,408659196,90290507,318368689,덴마크,2014-05
2014-05-31,389070013,439493436,-50423423,네덜란드,2014-05
2014-05-31,366451131,223964014,142487117,이란,2014-05
2014-05-31,347549414,18368368,329181046,슬로바키아,2014-05
2014-05-31,316673694,75120065,241553629,폴란드,2014-05
2014-05-31,274528396,569974284,-295445888,이탈리아,2014-05
2014-05-31,262236040,1769617595,-1507381555,쿠웨이트,2014-05
2014-05-31,248064536,129991918,118072618,벨기에,2014-05
2014-05-31,225933556,4020102,221913454,그리스,2014-05
2014-05-31,195981300,288697081,-92715781,칠레,2014-05
2014-05-31,192133080,1819046,190314034,우즈베키스탄,2014-05
2014-05-31,186424858,6459585,179965273,이집트,2014-05
2014-05-31,179694477,719632166,-539937689,프랑스,2014-05
2014-05-31,172460434,50753061,121707373,체코공화국,2014-05
2014-05-31,161421486,12609476,148812010,슬로베니아,2014-05
2014-05-31,151401519,140702690,10698829,뉴질랜드,2014-05
2014-05-31,148664195,364265226,-215601031,스페인,2014-05
2014-05-31,136884325,251056982,-114172657,알제리,2014-05
2014-05-31,129252897,457812732,-328559835,이라크,2014-05
2014-05-31,122285568,10024655,112260913,요르단,2014-05
2014-05-31,119401078,83675583,35725495,남아프리카공화국,2014-05
2014-05-31,113904961,24645808,89259153,방글라데시,2014-05
2014-05-31,108806327,332007179,-223200852,오만,2014-05
2014-05-31,103930701,159444608,-55513907,페루,2014-05
2014-05-31,97765285,23839960,73925325,콜롬비아,2014-05
2014-05-31,97652636,81714050,15938586,리비아,2014-05
2014-05-31,87486089,65053515,22432574,이스라엘,2014-05
2014-05-31,83210491,5773060,77437431,파나마,2014-05
2014-05-31,81063459,49949,81013510,라이베리아,2014-05
2014-05-31,79087981,47963689,31124292,헝가리,2014-05
2014-05-31,76579798,265243772,-188663974,예맨,2014-05
2014-05-31,76529240,131756870,-55227630,나이지리아,2014-05
2014-05-31,74893110,14152108,60741002,카자흐스탄,2014-05
2014-05-31,69724655,119535772,-49811117,오스트리아,2014-05
2014-05-31,68246939,18416938,49830001,미얀마,2014-05
2014-05-31,63496559,24744693,38751866,아르헨티나,2014-05
2014-05-31,60607329,131158304,-70550975,스웨덴,2014-05
2014-05-31,59139306,22017104,37122202,파키스탄,2014-05
2014-05-31,58377938,4794343,53583595,에쿠아도르,2014-05
2014-05-31,51973007,390826892,-338853885,노르웨이,2014-05
2014-05-31,51897803,1688653362,-1636755559,카타르,2014-05
2014-05-31,50287908,10075681,40212227,캄보디아,2014-05
2014-05-31,48396854,47342302,1054552,루마니아,2014-05
2014-05-31,44068349,18105547,25962802,뉴 칼레도니아,2014-05
2014-05-31,41964186,96187854,-54223668,핀란드,2014-05
2014-05-31,40358482,345,40358137,시리아,2014-05
2014-05-31,38161191,61268681,-23107490,아일랜드,2014-05
2014-05-31,32959627,1735739,31223888,몽골,2014-05
2014-05-31,30718254,14509625,16208629,포루투갈,2014-05
2014-05-31,30610406,257579,30352827,앙골라,2014-05
2014-05-31,28774835,2193267,26581568,파푸아 뉴기니,2014-05
2014-05-31,27999293,392559,27606734,피지,2014-05
2014-05-31,25869699,62227589,-36357890,모로코,2014-05
2014-05-31,25643854,3995915,21647939,튀니지,2014-05
2014-05-31,24868691,35792831,-10924140,과테말라,2014-05
2014-05-31,23963302,66196057,-42232755,바레인,2014-05
2014-05-31,23244992,2637939,20607053,레바논,2014-05
2014-05-31,23078668,6145080,16933588,스리랑카,2014-05
2014-05-31,22771621,44249233,-21477612,우크라이나,2014-05
2014-05-31,22164562,228857095,-206692533,스위스,2014-05
2014-05-31,21647032,3994164,17652868,우루과이,2014-05
2014-05-31,19511062,401018,19110044,코트디봐르,2014-05
2014-05-31,18935087,1930233,17004854,파라과이,2014-05
2014-05-31,18782269,2694838,16087431,가나,2014-05
2014-05-31,17831317,27386692,-9555375,코스타리카,2014-05
2014-05-31,16812109,400,16811709,아제르바이잔,2014-05
2014-05-31,16562591,11725,16550866,투르크멘,2014-05
2014-05-31,16366443,6985385,9381058,에티오피아,2014-05
2014-05-31,16315554,1755475,14560079,케냐,2014-05
2014-05-31,16000043,1083466,14916577,조지아,2014-05
2014-05-31,15608042,4671316,10936726,리투아니아,2014-05
2014-05-31,15573738,2139874,13433864,니카라과,2014-05
2014-05-31,15261498,11782666,3478832,도미니카 공화국,2014-05
2014-05-31,14117997,938224,13179773,수단,2014-05
2014-05-31,13244138,20893025,-7648887,푸에르토리코,2014-05
2014-05-31,13054533,29672239,-16617706,볼리비아,2014-05
2014-05-31,12938810,142140,12796670,팔레스타인 해방기구,2014-05
2014-05-31,12774983,73637613,-60862630,에스토니아,2014-05
2014-05-31,12476817,219893,12256924,모잠비크,2014-05
2014-05-31,12400405,2972611,9427794,라오스,2014-05
2014-05-31,12384591,24215,12360376,키르기스스탄,2014-05
2014-05-31,11786310,3994832,7791478,엘살바도르,2014-05
2014-05-31,10596539,933835,9662704,탄자니아,2014-05
2014-05-31,10554129,19304562,-8750433,불가리아,2014-05
2014-05-31,9669822,3971632,5698190,라트비아,2014-05
2014-05-31,8746469,1322234,7424235,트리니다드 토바고,2014-05
2014-05-31,8337489,609951,7727538,크로아티아,2014-05
2014-05-31,8171599,6469644,1701955,온두라스,2014-05
2014-05-31,7679437,1364450,6314987,베네주엘라,2014-05
2014-05-31,7571181,422228,7148953,마이크로네시아,2014-05
2014-05-31,6995470,166158511,-159163041,브루나이,2014-05
2014-05-31,5944965,4707848,1237117,세네갈,2014-05
2014-05-31,5445541,415,5445126,지부티,2014-05
2014-05-31,5266623,653390,4613233,베닝,2014-05
2014-05-31,5259716,607613,4652103,쿠바,2014-05
2014-05-31,5244584,7697,5236887,사모아,2014-05
2014-05-31,5051514,34680088,-29628574,몰타,2014-05
2014-05-31,4920099,413495,4506604,타지크,2014-05
2014-05-31,4809392,124683,4684709,괌,2014-05
2014-05-31,4743273,1166,4742107,아프카니스탄,2014-05
2014-05-31,4499297,4853405,-354108,벨라루스,2014-05
2014-05-31,4487122,99170553,-94683431,콩고,2014-05
2014-05-31,4279836,2237808,2042028,아이슬란드,2014-05
2014-05-31,3502364,155117,3347247,아이티,2014-05
2014-05-31,3259797,0,3259797,에리트리아,2014-05
2014-05-31,3189403,378796,2810607,사이프러스,2014-05
2014-05-31,3174348,285927,2888421,모리셔스,2014-05
2014-05-31,3108069,7930339,-4822270,세르비아,2014-05
2014-05-31,2960694,138466,2822228,카메룬,2014-05
2014-05-31,2821433,67051,2754382,가이아나,2014-05
2014-05-31,2612204,263326,2348878,마카오,2014-05
2014-05-31,2467316,2224237,243079,부르키나 파소,2014-05
2014-05-31,2429181,353082,2076099,짐바브웨,2014-05
2014-05-31,2333740,412966,1920774,아메리칸 사모아,2014-05
2014-05-31,2234849,868477,1366372,보스니아-헤르체고비나,2014-05
2014-05-31,2226557,26324511,-24097954,잠비아,2014-05
2014-05-31,2023508,0,2023508,불령 리유니온 코모도 제도,2014-05
2014-05-31,1943220,8880446,-6937226,마다카스카르,2014-05
2014-05-31,1932345,2316462,-384117,우간다,2014-05
2014-05-31,1883021,808411,1074610,자마이카,2014-05
2014-05-31,1709863,20036038,-18326175,콩고민주공화국,2014-05
2014-05-31,1674868,57388,1617480,네팔,2014-05
2014-05-31,1670216,272991,1397225,세이쉘,2014-05
2014-05-31,1658527,8452118,-6793591,토고,2014-05
2014-05-31,1631557,0,1631557,세인트 키츠 네비스,2014-05
2014-05-31,1436054,0,1436054,말리,2014-05
2014-05-31,1408609,20310,1388299,키리바티,2014-05
2014-05-31,1373103,135335,1237768,바하마,2014-05
2014-05-31,1370883,125907,1244976,아르메니아,2014-05
2014-05-31,1298776,1447163,-148387,기니,2014-05
2014-05-31,1281361,55919,1225442,네덜란드 열도,2014-05
2014-05-31,1235320,36510,1198810,아루바,2014-05
2014-05-31,1212776,31704,1181072,알바니아,2014-05
2014-05-31,1099494,0,1099494,영령 캐이맨 군도,2014-05
2014-05-31,981901,43721,938180,마세도니아,2014-05
2014-05-31,957300,62009,895291,수리남,2014-05
2014-05-31,923534,2094,921440,불령 폴리네시아,2014-05
2014-05-31,830329,0,830329,안티가 바부다,2014-05
2014-05-31,815244,1669,813575,마티니크,2014-05
2014-05-31,801114,9021,792093,바베이도스,2014-05
2014-05-31,766583,607585,158998,시에라 리온,2014-05
2014-05-31,755928,388,755540,보츠와나,2014-05
2014-05-31,751646,44,751602,과델로프,2014-05
2014-05-31,729569,0,729569,팔라우,2014-05
2014-05-31,692885,74273165,-73580280,가봉,2014-05
2014-05-31,690637,8469208,-7778571,기타국,2014-05
2014-05-31,592271,794962,-202691,리히텐슈타인,2014-05
2014-05-31,578544,14,578530,북마리아나 군도,2014-05
2014-05-31,563648,14790,548858,모나코,2014-05
2014-05-31,538790,1198117,-659327,모리타니,2014-05
2014-05-31,502797,694155,-191358,몰도바,2014-05
2014-05-31,486972,8865,478107,세인트 루시아,2014-05
2014-05-31,460250,0,460250,그레나다,2014-05
2014-05-31,439289,302973,136316,벨리제,2014-05
2014-05-31,408017,135655,272362,말라위,2014-05
2014-05-31,344038,7584,336454,도미니카,2014-05
2014-05-31,281444,189409,92035,스와질랜드,2014-05
2014-05-31,274819,14208,260611,영령 버진군도,2014-05
2014-05-31,268725,2028683,-1759958,니제르,2014-05
2014-05-31,243007,0,243007,감비아,2014-05
2014-05-31,236240,21931,214309,미령 버진군도,2014-05
2014-05-31,209729,4912,204817,몰디브,2014-05
2014-05-31,201209,0,201209,세인트 빈센트 그레나딘,2014-05
2014-05-31,200757,95550,105207,티모르,2014-05
2014-05-31,186036,19402397,-19216361,나미비아,2014-05
2014-05-31,185654,217229,-31575,르완다,2014-05
2014-05-31,152077,340,151737,버뮤다,2014-05
2014-05-31,133763,414,133349,중앙아프리카공화국,2014-05
2014-05-31,128967,350456,-221489,솔로몬 군도,2014-05
2014-05-31,121622,200512,-78890,바누아투,2014-05
2014-05-31,117397,77541,39856,통가,2014-05
2014-05-31,105867,0,105867,소말리아,2014-05
2014-05-31,87210,71,87139,불령 가이아나,2014-05
2014-05-31,77512,466,77046,나우루,2014-05
2014-05-31,59762,14454,45308,앙귈라,2014-05
2014-05-31,50834,8342996,-8292162,지브랄타,2014-05
2014-05-31,47740,0,47740,세인트 마틴,2014-05
2014-05-31,37603,0,37603,쿡 아일랜드,2014-05
2014-05-31,34104,883,33221,부탄,2014-05
2014-05-31,34009,1337,32672,부룬디,2014-05
2014-05-31,26925,0,26925,적도 기니,2014-05
2014-05-31,18845,0,18845,투르크 & 카이코스 군도,2014-05
2014-05-31,14955,1242,13713,몬테네그로,2014-05
2014-05-31,11667,64485,-52818,산마리노,2014-05
2014-05-31,10581,55440,-44859,파로에 군도,2014-05
2014-05-31,3986,0,3986,카보 베르데,2014-05
2014-05-31,2782,31630,-28848,안도라,2014-05
2014-05-31,1300,0,1300,챠드,2014-05
2014-05-31,848,0,848,포클랜드 군도,2014-05
2014-05-31,420,3940,-3520,코모로스,2014-05
2014-05-31,96,689,-593,영령 인도양,2014-05
2014-05-31,0,180557,-180557,그린랜드,2014-05
2014-05-31,0,2948,-2948,세인트 헬레나,2014-05
2014-05-31,0,27083,-27083,크리스마스 아일랜드,2014-05
2014-05-31,0,29443,-29443,건지,2014-05
2014-05-31,0,29325,-29325,토켈라우,2014-05
2014-05-31,0,33143,-33143,기네비소,2014-05
2014-05-31,0,232,-232,노폴크 아일랜드,2014-05
2014-05-31,0,5766,-5766,몬트세라트,2014-05
2014-05-31,0,2099203,-2099203,안타티카,2014-05
2014-06-30,11278077647,7550892415,3727185232,중국,2014-06
2014-06-30,6086843865,3650298333,2436545532,미국,2014-06
2014-06-30,2563081096,4369146669,-1806065573,일본,2014-06
2014-06-30,2425874004,157524764,2268349240,홍콩,2014-06
2014-06-30,1706981559,622960277,1084021282,베트남,2014-06
2014-06-30,1616072725,915114120,700958605,싱가포르,2014-06
2014-06-30,1307408748,1258262262,49146486,대만,2014-06
2014-06-30,1096535407,3761,1096531646,마샬군도,2014-06
2014-06-30,1082168098,479047894,603120204,인도,2014-06
2014-06-30,904845328,895226921,9618407,인도네시아,2014-06
2014-06-30,892274689,962262436,-69987747,러시아 연방,2014-06
2014-06-30,830992909,1778077989,-947085080,호주,2014-06
2014-06-30,801948361,235290723,566657638,멕시코,2014-06
2014-06-30,783976535,260165076,523811459,필리핀,2014-06
2014-06-30,681900229,967471712,-285571483,말레이시아,2014-06
2014-06-30,677050219,3095147589,-2418097370,사우디아라비아,2014-06
2014-06-30,666902076,281836176,385065900,브라질,2014-06
2014-06-30,639816162,158548098,481268064,노르웨이,2014-06
2014-06-30,619866111,485115365,134750746,태국,2014-06
2014-06-30,587352734,43669005,543683729,튀르키예,2014-06
2014-06-30,581857348,1727826594,-1145969246,독일,2014-06
2014-06-30,555608165,1491287040,-935678875,아랍에미리트 연합,2014-06
2014-06-30,518327016,588685557,-70358541,영국,2014-06
2014-06-30,432668355,365182700,67485655,네덜란드,2014-06
2014-06-30,394545482,508405620,-113860138,캐나다,2014-06
2014-06-30,387892442,84,387892358,버뮤다,2014-06
2014-06-30,381493364,469005859,-87512495,이란,2014-06
2014-06-30,357299123,661814218,-304515095,프랑스,2014-06
2014-06-30,342994772,9952716,333042056,파나마,2014-06
2014-06-30,323706694,10742,323695952,바하마,2014-06
2014-06-30,314733707,17724685,297009022,슬로바키아,2014-06
2014-06-30,287477334,43364054,244113280,폴란드,2014-06
2014-06-30,269886714,484690232,-214803518,이탈리아,2014-06
2014-06-30,247996417,3712408,244284009,그리스,2014-06
2014-06-30,225074201,3601710,221472491,몰타,2014-06
2014-06-30,215524778,121793378,93731400,벨기에,2014-06
2014-06-30,213874141,103557329,110316812,덴마크,2014-06
2014-06-30,187104285,29022898,158081387,이집트,2014-06
2014-06-30,179633581,1529976308,-1350342727,쿠웨이트,2014-06
2014-06-30,172499807,1233049,171266758,우즈베키스탄,2014-06
2014-06-30,165157739,333288840,-168131101,칠레,2014-06
2014-06-30,159314846,153442058,5872788,알제리,2014-06
2014-06-30,155452023,206978732,-51526709,스페인,2014-06
2014-06-30,151671279,654559630,-502888351,이라크,2014-06
2014-06-30,145472375,37765100,107707275,체코공화국,2014-06
2014-06-30,135909635,76656180,59253455,페루,2014-06
2014-06-30,134546008,112837523,21708485,남아프리카공화국,2014-06
2014-06-30,133949960,8751999,125197961,슬로베니아,2014-06
2014-06-30,122477094,129986388,-7509294,뉴질랜드,2014-06
2014-06-30,113715720,187943,113527777,라이베리아,2014-06
2014-06-30,109623033,5703000,103920033,요르단,2014-06
2014-06-30,107316263,120133619,-12817356,이스라엘,2014-06
2014-06-30,104334940,23254290,81080650,방글라데시,2014-06
2014-06-30,102995131,28230315,74764816,콜롬비아,2014-06
2014-06-30,96377927,247119043,-150741116,오만,2014-06
2014-06-30,82807185,246384255,-163577070,나이지리아,2014-06
2014-06-30,81085040,96631861,-15546821,오스트리아,2014-06
2014-06-30,79364493,33690597,45673896,헝가리,2014-06
2014-06-30,78827990,1050801,77777189,리비아,2014-06
2014-06-30,75919649,10650526,65269123,카자흐스탄,2014-06
2014-06-30,75117964,361472085,-286354121,스웨덴,2014-06
2014-06-30,71586316,18482807,53103509,아르헨티나,2014-06
2014-06-30,67750000,60,67749940,맨섬,2014-06
2014-06-30,67674454,30796557,36877897,미얀마,2014-06
2014-06-30,66527203,23200124,43327079,파키스탄,2014-06
2014-06-30,65469377,48738260,16731117,루마니아,2014-06
2014-06-30,62864765,1724777799,-1661913034,카타르,2014-06
2014-06-30,52762864,4969236,47793628,에쿠아도르,2014-06
2014-06-30,49262536,13052219,36210317,캄보디아,2014-06
2014-06-30,42215818,170366,42045452,시리아,2014-06
2014-06-30,39066794,102711011,-63644217,핀란드,2014-06
2014-06-30,35547278,99953748,-64406470,아일랜드,2014-06
2014-06-30,32770245,103823,32666422,괌,2014-06
2014-06-30,32286893,5119678,27167215,튀니지,2014-06
2014-06-30,30850106,7790419,23059687,스리랑카,2014-06
2014-06-30,29809607,12800967,17008640,포루투갈,2014-06
2014-06-30,28885068,1612,28883456,아제르바이잔,2014-06
2014-06-30,28792013,2634460,26157553,몽골,2014-06
2014-06-30,27985608,211970,27773638,아메리칸 사모아,2014-06
2014-06-30,26776229,55485098,-28708869,우크라이나,2014-06
2014-06-30,25430483,3333146,22097337,레바논,2014-06
2014-06-30,24646195,30612504,-5966309,코스타리카,2014-06
2014-06-30,24625061,11775939,12849122,우루과이,2014-06
2014-06-30,23988149,9487808,14500341,모로코,2014-06
2014-06-30,23741513,20499225,3242288,과테말라,2014-06
2014-06-30,23105024,5190704,17914320,앙골라,2014-06
2014-06-30,23100454,136134849,-113034395,바레인,2014-06
2014-06-30,22939848,19978766,2961082,푸에르토리코,2014-06
2014-06-30,22359105,3582176,18776929,수단,2014-06
2014-06-30,21981008,201997829,-180016821,스위스,2014-06
2014-06-30,21163098,4830661,16332437,리투아니아,2014-06
2014-06-30,20971677,2838722,18132955,가나,2014-06
2014-06-30,19285875,6491,19279384,투르크멘,2014-06
2014-06-30,18409909,160566174,-142156265,예맨,2014-06
2014-06-30,17448314,839169,16609145,코트디봐르,2014-06
2014-06-30,17343038,10015123,7327915,도미니카 공화국,2014-06
2014-06-30,16946078,2414438,14531640,케냐,2014-06
2014-06-30,14338907,1515785,12823122,조지아,2014-06
2014-06-30,14094615,833802,13260813,탄자니아,2014-06
2014-06-30,13239213,1878568,11360645,니카라과,2014-06
2014-06-30,13022945,1266807,11756138,키르기스스탄,2014-06
2014-06-30,12414324,9520888,2893436,에스토니아,2014-06
2014-06-30,12353304,517838,11835466,라오스,2014-06
2014-06-30,12221469,4535788,7685681,라트비아,2014-06
2014-06-30,12199303,965944,11233359,파라과이,2014-06
2014-06-30,12038894,1012895,11025999,엘살바도르,2014-06
2014-06-30,10944040,1078589,9865451,크로아티아,2014-06
2014-06-30,10675127,88701,10586426,팔레스타인 해방기구,2014-06
2014-06-30,8789938,7538067,1251871,온두라스,2014-06
2014-06-30,8754706,561510,8193196,피지,2014-06
2014-06-30,8272231,6117405,2154826,불가리아,2014-06
2014-06-30,8239756,6003540,2236216,에티오피아,2014-06
2014-06-30,8120526,113107224,-104986698,브루나이,2014-06
2014-06-30,7967138,3908621,4058517,세네갈,2014-06
2014-06-30,7229017,162279,7066738,베닝,2014-06
2014-06-30,6994899,30435601,-23440702,볼리비아,2014-06
2014-06-30,6607319,1443976,5163343,베네주엘라,2014-06
2014-06-30,6537812,17923812,-11386000,트리니다드 토바고,2014-06
2014-06-30,6499563,162787,6336776,모잠비크,2014-06
2014-06-30,6065714,20689396,-14623682,뉴 칼레도니아,2014-06
2014-06-30,5819955,38296894,-32476939,세르비아,2014-06
2014-06-30,5278025,461686,4816339,쿠바,2014-06
2014-06-30,4365820,1803,4364017,르완다,2014-06
2014-06-30,4329053,1008,4328045,아프카니스탄,2014-06
2014-06-30,4272757,45098,4227659,아이티,2014-06
2014-06-30,4232862,2253623,1979239,아이슬란드,2014-06
2014-06-30,4035347,182028,3853319,모리셔스,2014-06
2014-06-30,3962744,0,3962744,타지크,2014-06
2014-06-30,3748668,0,3748668,지부티,2014-06
2014-06-30,3598453,2344695,1253758,콩고,2014-06
2014-06-30,3471370,606836,2864534,카메룬,2014-06
2014-06-30,3406037,477720,2928317,시에라 리온,2014-06
2014-06-30,3105418,1080192,2025226,기니,2014-06
2014-06-30,3079838,53464315,-50384477,사이프러스,2014-06
2014-06-30,3066407,4863292,-1796885,기타국,2014-06
2014-06-30,3059662,2697021,362641,우간다,2014-06
2014-06-30,2744111,2604535,139576,벨라루스,2014-06
2014-06-30,2683215,4163,2679052,불령 리유니온 코모도 제도,2014-06
2014-06-30,2583382,25613,2557769,네덜란드 열도,2014-06
2014-06-30,2498902,357105,2141797,짐바브웨,2014-06
2014-06-30,2488762,8162327,-5673565,파푸아 뉴기니,2014-06
2014-06-30,2220007,153053,2066954,마카오,2014-06
2014-06-30,2189627,7920323,-5730696,콩고민주공화국,2014-06
2014-06-30,1819574,264364,1555210,가이아나,2014-06
2014-06-30,1795256,2147899,-352643,토고,2014-06
2014-06-30,1785116,14096002,-12310886,마다카스카르,2014-06
2014-06-30,1732709,0,1732709,아루바,2014-06
2014-06-30,1678805,32796,1646009,불령 폴리네시아,2014-06
2014-06-30,1647364,1442331,205033,모리타니,2014-06
2014-06-30,1632455,116052,1516403,네팔,2014-06
2014-06-30,1545467,933978,611489,부르키나 파소,2014-06
2014-06-30,1531450,3419794,-1888344,가봉,2014-06
2014-06-30,1390375,205675,1184700,세이쉘,2014-06
2014-06-30,1341181,3083663,-1742482,룩셈부르그,2014-06
2014-06-30,1318332,183961,1134371,알바니아,2014-06
2014-06-30,1195721,268868,926853,자마이카,2014-06
2014-06-30,1159873,82490,1077383,마세도니아,2014-06
2014-06-30,1134204,92531,1041673,수리남,2014-06
2014-06-30,1093414,28111819,-27018405,잠비아,2014-06
2014-06-30,1077432,1233274,-155842,아르메니아,2014-06
2014-06-30,1049289,0,1049289,바베이도스,2014-06
2014-06-30,983648,0,983648,에리트리아,2014-06
2014-06-30,943441,32800,910641,사모아,2014-06
2014-06-30,942609,643955,298654,보스니아-헤르체고비나,2014-06
2014-06-30,926386,7198,919188,보츠와나,2014-06
2014-06-30,833637,321603,512034,몰도바,2014-06
2014-06-30,817970,0,817970,영령 캐이맨 군도,2014-06
2014-06-30,714338,900,713438,키리바티,2014-06
2014-06-30,677971,12094,665877,도미니카,2014-06
2014-06-30,658976,24635,634341,말라위,2014-06
2014-06-30,553266,0,553266,과델로프,2014-06
2014-06-30,505544,61,505483,북마리아나 군도,2014-06
2014-06-30,467809,0,467809,마티니크,2014-06
2014-06-30,420621,54076449,-53655828,티모르,2014-06
2014-06-30,418199,293077,125122,적도 기니,2014-06
2014-06-30,387312,59,387253,말리,2014-06
2014-06-30,384051,28605,355446,모나코,2014-06
2014-06-30,376290,163685,212605,바누아투,2014-06
2014-06-30,358316,1052101,-693785,마이크로네시아,2014-06
2014-06-30,325976,679886,-353910,리히텐슈타인,2014-06
2014-06-30,312484,702,311782,세인트 키츠 네비스,2014-06
2014-06-30,309025,177791,131234,벨리제,2014-06
2014-06-30,303448,5154,298294,그레나다,2014-06
2014-06-30,293573,0,293573,몰디브,2014-06
2014-06-30,279682,631970,-352288,솔로몬 군도,2014-06
2014-06-30,269244,0,269244,팔라우,2014-06
2014-06-30,265648,124075,141573,스와질랜드,2014-06
2014-06-30,263961,0,263961,소말리아,2014-06
2014-06-30,256909,120,256789,안티가 바부다,2014-06
2014-06-30,249627,0,249627,국제통화기금,2014-06
2014-06-30,207861,9081290,-8873429,나미비아,2014-06
2014-06-30,186952,0,186952,지브랄타,2014-06
2014-06-30,172457,11536,160921,니제르,2014-06
2014-06-30,107917,179,107738,감비아,2014-06
2014-06-30,107000,20427,86573,영령 버진군도,2014-06
2014-06-30,104857,67862,36995,산마리노,2014-06
2014-06-30,95502,0,95502,세인트 빈센트 그레나딘,2014-06
2014-06-30,63582,46319,17263,불령 가이아나,2014-06
2014-06-30,51964,0,51964,투발루,2014-06
2014-06-30,50050,66,49984,챠드,2014-06
2014-06-30,49671,0,49671,중앙아프리카공화국,2014-06
2014-06-30,49537,15274,34263,몬테네그로,2014-06
2014-06-30,47140,0,47140,투르크 & 카이코스 군도,2014-06
2014-06-30,34048,0,34048,세인트 루시아,2014-06
2014-06-30,33359,169,33190,부탄,2014-06
2014-06-30,29518,0,29518,메요트,2014-06
2014-06-30,17633,0,17633,큐라소,2014-06
2014-06-30,17470,0,17470,세인트 마틴,2014-06
2014-06-30,11794,7755,4039,코모로스,2014-06
2014-06-30,4668,4053,615,앙귈라,2014-06
2014-06-30,4336,5,4331,통가,2014-06
2014-06-30,1725,32472,-30747,토켈라우,2014-06
2014-06-30,262,4617,-4355,상토메 프린스페,2014-06
2014-06-30,162,1430,-1268,안도라,2014-06
2014-06-30,0,788817,-788817,안타티카,2014-06
2014-06-30,0,2297,-2297,건지,2014-06
2014-06-30,0,32,-32,부룬디,2014-06
2014-06-30,0,174,-174,쿡 아일랜드,2014-06
2014-06-30,0,36256,-36256,허드 앤 맥도날드 군도,2014-06
2014-06-30,0,3786824,-3786824,나우루,2014-06
2014-06-30,0,28080,-28080,세인트 헬레나,2014-06
2014-06-30,0,154180,-154180,파로에 군도,2014-06
2014-06-30,0,218504,-218504,그린랜드,2014-06
2014-06-30,0,5233,-5233,니우에,2014-06
2014-06-30,0,77,-77,피트카이른,2014-06
2014-06-30,0,3910,-3910,미령 버진군도,2014-06
2014-06-30,0,15,-15,기네비소,2014-06
2014-06-30,0,15,-15,포클랜드 군도,2014-06
2014-06-30,0,9261,-9261,노폴크 아일랜드,2014-06
2014-06-30,0,15,-15,카보 베르데,2014-06
2014-06-30,0,462,-462,알랜드 군도,2014-06
2014-07-31,11960508236,7423535047,4536973189,중국,2014-07
2014-07-31,6102797915,3874494974,2228302941,미국,2014-07
2014-07-31,2992685837,4633002295,-1640316458,일본,2014-07
2014-07-31,2190757142,158756998,2032000144,홍콩,2014-07
2014-07-31,1943434621,1047916284,895518337,싱가포르,2014-07
2014-07-31,1802428926,653960321,1148468605,베트남,2014-07
2014-07-31,1351484240,1410242393,-58758153,대만,2014-07
2014-07-31,1180522940,516633424,663889516,인도,2014-07
2014-07-31,1022867114,1692299304,-669432190,호주,2014-07
2014-07-31,911733634,1411424118,-499690484,러시아 연방,2014-07
2014-07-31,894605010,254099941,640505069,멕시코,2014-07
2014-07-31,844208774,284524432,559684342,필리핀,2014-07
2014-07-31,801291790,447862248,353429542,브라질,2014-07
2014-07-31,702411506,1008996309,-306584803,인도네시아,2014-07
2014-07-31,692588830,1459994711,-767405881,아랍에미리트 연합,2014-07
2014-07-31,692240772,527923233,164317539,태국,2014-07
2014-07-31,684460534,1999886345,-1315425811,독일,2014-07
2014-07-31,667070499,3490995137,-2823924638,사우디아라비아,2014-07
2014-07-31,642470430,748931216,-106460786,말레이시아,2014-07
2014-07-31,601895730,82481071,519414659,튀르키예,2014-07
2014-07-31,574251222,12343,574238879,영령 캐이맨 군도,2014-07
2014-07-31,562567759,354093805,208473954,네덜란드,2014-07
2014-07-31,464849854,471801155,-6951301,영국,2014-07
2014-07-31,459779080,443219205,16559875,캐나다,2014-07
2014-07-31,372861281,21503293,351357988,슬로바키아,2014-07
2014-07-31,344526951,443934299,-99407348,이란,2014-07
2014-07-31,330680789,81318359,249362430,폴란드,2014-07
2014-07-31,280220959,668517153,-388296194,이탈리아,2014-07
2014-07-31,248687170,11617,248675553,마샬군도,2014-07
2014-07-31,235587354,1046075216,-810487862,프랑스,2014-07
2014-07-31,216235001,112088693,104146308,덴마크,2014-07
2014-07-31,213432961,219158720,-5725759,스페인,2014-07
2014-07-31,202125724,32154251,169971473,이집트,2014-07
2014-07-31,198731680,198517880,213800,벨기에,2014-07
2014-07-31,192689172,67560801,125128371,파나마,2014-07
2014-07-31,191505289,6985028,184520261,요르단,2014-07
2014-07-31,172058550,1118013,170940537,우즈베키스탄,2014-07
2014-07-31,165726384,453115836,-287389452,칠레,2014-07
2014-07-31,164720582,1657790238,-1493069656,쿠웨이트,2014-07
2014-07-31,160891676,12677702,148213974,슬로베니아,2014-07
2014-07-31,159635024,131614235,28020789,뉴질랜드,2014-07
2014-07-31,159473024,178795398,-19322374,남아프리카공화국,2014-07
2014-07-31,146427316,61115217,85312099,체코공화국,2014-07
2014-07-31,139130352,80203034,58927318,알제리,2014-07
2014-07-31,129002030,119845377,9156653,페루,2014-07
2014-07-31,125481652,138212,125343440,라이베리아,2014-07
2014-07-31,123748708,570283567,-446534859,이라크,2014-07
2014-07-31,105746761,376834962,-271088201,오만,2014-07
2014-07-31,105316111,28805859,76510252,콜롬비아,2014-07
2014-07-31,102555679,32798508,69757171,방글라데시,2014-07
2014-07-31,102492541,0,102492541,버뮤다,2014-07
2014-07-31,88311389,97508400,-9197011,아루바,2014-07
2014-07-31,88176706,58374655,29802051,헝가리,2014-07
2014-07-31,86214190,68617640,17596550,이스라엘,2014-07
2014-07-31,80374621,41642150,38732471,아르헨티나,2014-07
2014-07-31,78837428,136953485,-58116057,오스트리아,2014-07
2014-07-31,77481631,127806333,-50324702,스웨덴,2014-07
2014-07-31,72970694,130263942,-57293248,카자흐스탄,2014-07
2014-07-31,71317725,28510071,42807654,파키스탄,2014-07
2014-07-31,69885979,6116253,63769726,에쿠아도르,2014-07
2014-07-31,67415371,131265654,-63850283,나이지리아,2014-07
2014-07-31,65418129,212367,65205762,탄자니아,2014-07
2014-07-31,63441884,52824622,10617262,미얀마,2014-07
2014-07-31,59559235,2301147197,-2241587962,카타르,2014-07
2014-07-31,56626513,16231211,40395302,캄보디아,2014-07
2014-07-31,55586851,53044499,2542352,루마니아,2014-07
2014-07-31,45908541,11519460,34389081,세네갈,2014-07
2014-07-31,44736505,2569218,42167287,레바논,2014-07
2014-07-31,44066820,44510382,-443562,리비아,2014-07
2014-07-31,42414043,305073,42108970,괌,2014-07
2014-07-31,36355487,202854,36152633,시리아,2014-07
2014-07-31,34751321,835972,33915349,몽골,2014-07
2014-07-31,33566793,16988578,16578215,포루투갈,2014-07
2014-07-31,32259381,13965216,18294165,뉴 칼레도니아,2014-07
2014-07-31,31829801,125934999,-94105198,핀란드,2014-07
2014-07-31,31383342,282740288,-251356946,스위스,2014-07
2014-07-31,30232592,98742479,-68509887,아일랜드,2014-07
2014-07-31,28995667,13503053,15492614,바레인,2014-07
2014-07-31,28810409,242742478,-213932069,노르웨이,2014-07
2014-07-31,28647426,1390210,27257216,코트디봐르,2014-07
2014-07-31,27486030,15889438,11596592,모로코,2014-07
2014-07-31,26881268,24658922,2222346,코스타리카,2014-07
2014-07-31,26835607,35482778,-8647171,앙골라,2014-07
2014-07-31,26664217,9562690,17101527,우루과이,2014-07
2014-07-31,25897265,10023304,15873961,스리랑카,2014-07
2014-07-31,23908169,5716624,18191545,튀니지,2014-07
2014-07-31,23414860,3861108,19553752,리투아니아,2014-07
2014-07-31,22835753,3373095,19462658,그리스,2014-07
2014-07-31,22393476,34069754,-11676278,우크라이나,2014-07
2014-07-31,21426041,9611,21416430,투르크멘,2014-07
2014-07-31,20867550,41802207,-20934657,과테말라,2014-07
2014-07-31,20645832,58037922,-37392090,예맨,2014-07
2014-07-31,20556237,24436060,-3879823,푸에르토리코,2014-07
2014-07-31,20061527,0,20061527,아제르바이잔,2014-07
2014-07-31,19631930,2504670,17127260,니카라과,2014-07
2014-07-31,18542191,1261733,17280458,파푸아 뉴기니,2014-07
2014-07-31,17495196,4001863,13493333,에스토니아,2014-07
2014-07-31,16823387,6479093,10344294,불가리아,2014-07
2014-07-31,16814488,12849536,3964952,파라과이,2014-07
2014-07-31,16727670,20814492,-4086822,볼리비아,2014-07
2014-07-31,16660731,1124273,15536458,키르기스스탄,2014-07
2014-07-31,16443390,1566181,14877209,가나,2014-07
2014-07-31,14617471,415107,14202364,피지,2014-07
2014-07-31,14272641,12049435,2223206,도미니카 공화국,2014-07
2014-07-31,13971940,2000232,11971708,케냐,2014-07
2014-07-31,12851717,614405,12237312,마이크로네시아,2014-07
2014-07-31,12676355,6997184,5679171,라트비아,2014-07
2014-07-31,12630881,1228442,11402439,라오스,2014-07
2014-07-31,11689841,345721,11344120,조지아,2014-07
2014-07-31,10833612,5206455,5627157,에티오피아,2014-07
2014-07-31,10381375,2735976,7645399,수단,2014-07
2014-07-31,10149057,3953731,6195326,베네주엘라,2014-07
2014-07-31,9374467,2137082,7237385,엘살바도르,2014-07
2014-07-31,9297451,1524400,7773051,트리니다드 토바고,2014-07
2014-07-31,8236384,3369,8233015,아프카니스탄,2014-07
2014-07-31,8100725,5187219,2913506,몰타,2014-07
2014-07-31,7895020,1438700,6456320,온두라스,2014-07
2014-07-31,7785398,239173,7546225,팔레스타인 해방기구,2014-07
2014-07-31,7640479,0,7640479,지부티,2014-07
2014-07-31,7568925,177729,7391196,모잠비크,2014-07
2014-07-31,7562545,2631197,4931348,세르비아,2014-07
2014-07-31,6944523,77300342,-70355819,브루나이,2014-07
2014-07-31,6823931,1074890,5749041,크로아티아,2014-07
2014-07-31,6376182,26308281,-19932099,콩고민주공화국,2014-07
2014-07-31,5417657,449792,4967865,모리셔스,2014-07
2014-07-31,5281573,554344,4727229,베닝,2014-07
2014-07-31,4676763,0,4676763,타지크,2014-07
2014-07-31,4236146,33698,4202448,불령 폴리네시아,2014-07
2014-07-31,3990869,230063,3760806,아이티,2014-07
2014-07-31,3635755,93079,3542676,쿠바,2014-07
2014-07-31,3189980,190594927,-187404947,기니,2014-07
2014-07-31,3133044,774263,2358781,카메룬,2014-07
2014-07-31,3100988,5814761,-2713773,벨라루스,2014-07
2014-07-31,3003149,665137,2338012,세이쉘,2014-07
2014-07-31,2790976,165600,2625376,부르키나 파소,2014-07
2014-07-31,2736800,1267906,1468894,사이프러스,2014-07
2014-07-31,2671703,31524438,-28852735,잠비아,2014-07
2014-07-31,2665177,1352190,1312987,콩고,2014-07
2014-07-31,2619310,5511714,-2892404,기타국,2014-07
2014-07-31,2523131,0,2523131,네덜란드 열도,2014-07
2014-07-31,2301243,6746,2294497,불령 리유니온 코모도 제도,2014-07
2014-07-31,2154312,3011267,-856955,토고,2014-07
2014-07-31,2026692,285025,1741667,마카오,2014-07
2014-07-31,1990418,199936,1790482,네팔,2014-07
2014-07-31,1922467,299578,1622889,짐바브웨,2014-07
2014-07-31,1896818,129606,1767212,가이아나,2014-07
2014-07-31,1837105,0,1837105,에리트리아,2014-07
2014-07-31,1790303,11858395,-10068092,마다카스카르,2014-07
2014-07-31,1783649,355860,1427789,안타티카,2014-07
2014-07-31,1713034,813170,899864,자마이카,2014-07
2014-07-31,1712225,6279745,-4567520,나미비아,2014-07
2014-07-31,1548130,2143144,-595014,아이슬란드,2014-07
2014-07-31,1540847,29156,1511691,바하마,2014-07
2014-07-31,1459773,0,1459773,바베이도스,2014-07
2014-07-31,1429659,2511088,-1081429,몰도바,2014-07
2014-07-31,1422171,206821,1215350,아메리칸 사모아,2014-07
2014-07-31,1255968,326335,929633,수리남,2014-07
2014-07-31,1211145,2471017,-1259872,룩셈부르그,2014-07
2014-07-31,1208998,230998,978000,아르메니아,2014-07
2014-07-31,1194792,20534,1174258,말라위,2014-07
2014-07-31,1127955,986437,141518,모리타니,2014-07
2014-07-31,1019528,8284506,-7264978,가봉,2014-07
2014-07-31,1016048,640628,375420,시에라 리온,2014-07
2014-07-31,1007421,0,1007421,마티니크,2014-07
2014-07-31,974391,60716,913675,알바니아,2014-07
2014-07-31,902124,114049,788075,사모아,2014-07
2014-07-31,833415,1301527,-468112,우간다,2014-07
2014-07-31,827735,0,827735,북마리아나 군도,2014-07
2014-07-31,803646,82635,721011,마세도니아,2014-07
2014-07-31,775793,6032,769761,니제르,2014-07
2014-07-31,650805,852,649953,보츠와나,2014-07
2014-07-31,619593,54632,564961,몰디브,2014-07
2014-07-31,568038,80976,487062,도미니카,2014-07
2014-07-31,550317,0,550317,과델로프,2014-07
2014-07-31,543579,21914,521665,안티가 바부다,2014-07
2014-07-31,519166,88365,430801,르완다,2014-07
2014-07-31,475808,1040159,-564351,리히텐슈타인,2014-07
2014-07-31,450262,1058691,-608429,보스니아-헤르체고비나,2014-07
2014-07-31,436703,23500,413203,키리바티,2014-07
2014-07-31,379734,0,379734,챠드,2014-07
2014-07-31,376962,729,376233,팔라우,2014-07
2014-07-31,369579,1171907,-802328,솔로몬 군도,2014-07
2014-07-31,358380,41,358339,불령 가이아나,2014-07
2014-07-31,349525,313,349212,티모르,2014-07
2014-07-31,318557,0,318557,소말리아,2014-07
2014-07-31,318207,0,318207,세인트 키츠 네비스,2014-07
2014-07-31,294546,977,293569,지브랄타,2014-07
2014-07-31,258583,57119,201464,바누아투,2014-07
2014-07-31,252599,0,252599,감비아,2014-07
2014-07-31,247111,280282,-33171,스와질랜드,2014-07
2014-07-31,245195,0,245195,세인트 루시아,2014-07
2014-07-31,215743,3430,212313,영령 버진군도,2014-07
2014-07-31,187688,2482,185206,중앙아프리카공화국,2014-07
2014-07-31,182015,830,181185,그레나다,2014-07
2014-07-31,177580,0,177580,메요트,2014-07
2014-07-31,175591,0,175591,국제통화기금,2014-07
2014-07-31,165658,6822,158836,벨리제,2014-07
2014-07-31,158068,40108,117960,모나코,2014-07
2014-07-31,100335,0,100335,투르크 & 카이코스 군도,2014-07
2014-07-31,68771,0,68771,세인트 빈센트 그레나딘,2014-07
2014-07-31,67148,0,67148,교황청,2014-07
2014-07-31,46846,0,46846,부탄,2014-07
2014-07-31,41140,22096,19044,산마리노,2014-07
2014-07-31,37820,8898,28922,부룬디,2014-07
2014-07-31,21548,0,21548,큐라소,2014-07
2014-07-31,18245,245,18000,말리,2014-07
2014-07-31,17605,2129,15476,몬테네그로,2014-07
2014-07-31,13258,4857,8401,안도라,2014-07
2014-07-31,11128,0,11128,코모로스,2014-07
2014-07-31,8508,27212,-18704,기네비소,2014-07
2014-07-31,4680,0,4680,레소토,2014-07
2014-07-31,3920,0,3920,쿡 아일랜드,2014-07
2014-07-31,1951,0,1951,남수단,2014-07
2014-07-31,984,0,984,카보 베르데,2014-07
2014-07-31,871,285692,-284821,그린랜드,2014-07
2014-07-31,789,13237,-12448,앙귈라,2014-07
2014-07-31,100,0,100,통가,2014-07
2014-07-31,47,33112,-33065,토켈라우,2014-07
2014-07-31,0,414,-414,포클랜드 군도,2014-07
2014-07-31,0,2450,-2450,니우에,2014-07
2014-07-31,0,2356,-2356,미령 버진군도,2014-07
2014-07-31,0,16,-16,몬트세라트,2014-07
2014-07-31,0,279779,-279779,적도 기니,2014-07
2014-07-31,0,100,-100,맨섬,2014-07
2014-07-31,0,1205,-1205,코스 군도,2014-07
2014-08-31,11984392777,6772882896,5211509881,중국,2014-08
2014-08-31,5318312342,3333577636,1984734706,미국,2014-08
2014-08-31,2520905828,4218520363,-1697614535,일본,2014-08
2014-08-31,2280062413,144047645,2136014768,홍콩,2014-08
2014-08-31,1743187576,823767181,919420395,싱가포르,2014-08
2014-08-31,1698774582,732718881,966055701,베트남,2014-08
2014-08-31,1295502970,1331868606,-36365636,대만,2014-08
2014-08-31,1026373878,515540651,510833227,인도,2014-08
2014-08-31,914945114,3950,914941164,마샬군도,2014-08
2014-08-31,882881611,314365162,568516449,필리핀,2014-08
2014-08-31,849203364,985290375,-136087011,인도네시아,2014-08
2014-08-31,846291245,1045530,845245715,라이베리아,2014-08
2014-08-31,828088026,1546372917,-718284891,호주,2014-08
2014-08-31,802176497,392687389,409489108,멕시코,2014-08
2014-08-31,701193513,1308784904,-607591391,러시아 연방,2014-08
2014-08-31,682061954,422049351,260012603,브라질,2014-08
2014-08-31,624159442,290398171,333761271,네덜란드,2014-08
2014-08-31,611784577,409892164,201892413,태국,2014-08
2014-08-31,594858938,44690587,550168351,헝가리,2014-08
2014-08-31,534998859,882622508,-347623649,말레이시아,2014-08
2014-08-31,522933715,1867032799,-1344099084,독일,2014-08
2014-08-31,522700188,172,522700016,버뮤다,2014-08
2014-08-31,521987964,70923861,451064103,튀르키예,2014-08
2014-08-31,510908292,1760209176,-1249300884,아랍에미리트 연합,2014-08
2014-08-31,482882974,3398401858,-2915518884,사우디아라비아,2014-08
2014-08-31,410557270,335497962,75059308,영국,2014-08
2014-08-31,337565389,437065215,-99499826,캐나다,2014-08
2014-08-31,330827981,61650808,269177173,폴란드,2014-08
2014-08-31,328774364,455621562,-126847198,이란,2014-08
2014-08-31,324003792,24349510,299654282,슬로바키아,2014-08
2014-08-31,314312507,553291482,-238978975,이탈리아,2014-08
2014-08-31,250061209,1222381005,-972319796,쿠웨이트,2014-08
2014-08-31,249115257,84332,249030925,바하마,2014-08
2014-08-31,185173836,7497487,177676349,이집트,2014-08
2014-08-31,178294876,188248792,-9953916,벨기에,2014-08
2014-08-31,169075748,267121157,-98045409,스페인,2014-08
2014-08-31,168581753,384580361,-215998608,프랑스,2014-08
2014-08-31,155132679,11129760,144002919,슬로베니아,2014-08
2014-08-31,152678630,1217862,151460768,우즈베키스탄,2014-08
2014-08-31,140285770,117065101,23220669,뉴질랜드,2014-08
2014-08-31,132497884,41520972,90976912,체코공화국,2014-08
2014-08-31,119986880,208008236,-88021356,알제리,2014-08
2014-08-31,117973010,606802299,-488829289,이라크,2014-08
2014-08-31,116630011,515501584,-398871573,칠레,2014-08
2014-08-31,115586891,2141708054,-2026121163,카타르,2014-08
2014-08-31,111414030,235326479,-123912449,나이지리아,2014-08
2014-08-31,104203322,18096268,86107054,콜롬비아,2014-08
2014-08-31,99295180,78405975,20889205,페루,2014-08
2014-08-31,99204733,458132181,-358927448,오만,2014-08
2014-08-31,98181600,109152566,-10970966,남아프리카공화국,2014-08
2014-08-31,96963693,28299513,68664180,방글라데시,2014-08
2014-08-31,87260396,59742166,27518230,이스라엘,2014-08
2014-08-31,79512783,107037938,-27525155,오스트리아,2014-08
2014-08-31,73822840,20440289,53382551,파나마,2014-08
2014-08-31,71207915,111650742,-40442827,스웨덴,2014-08
2014-08-31,67522953,1075633,66447320,탄자니아,2014-08
2014-08-31,66289149,182765272,-116476123,에쿠아도르,2014-08
2014-08-31,60406275,33770415,26635860,카자흐스탄,2014-08
2014-08-31,60352756,61980,60290776,괌,2014-08
2014-08-31,58663224,23662117,35001107,파키스탄,2014-08
2014-08-31,58594779,55095776,3499003,아르헨티나,2014-08
2014-08-31,53216276,6854241,46362035,요르단,2014-08
2014-08-31,50672216,229753,50442463,베네주엘라,2014-08
2014-08-31,50409217,60164617,-9755400,미얀마,2014-08
2014-08-31,47631267,144536,47486731,피지,2014-08
2014-08-31,46439927,20574184,25865743,캄보디아,2014-08
2014-08-31,43484119,42972275,511844,루마니아,2014-08
2014-08-31,35039118,212449,34826669,시리아,2014-08
2014-08-31,34614263,67667547,-33053284,아일랜드,2014-08
2014-08-31,27841175,120710425,-92869250,핀란드,2014-08
2014-08-31,26094863,17482842,8612021,포루투갈,2014-08
2014-08-31,25489741,7109495,18380246,과테말라,2014-08
2014-08-31,24529632,219650925,-195121293,스위스,2014-08
2014-08-31,24063502,14502956,9560546,뉴 칼레도니아,2014-08
2014-08-31,23940563,1152521,22788042,몽골,2014-08
2014-08-31,23838116,83346774,-59508658,덴마크,2014-08
2014-08-31,23127040,1935669,21191371,레바논,2014-08
2014-08-31,22176474,34453958,-12277484,우크라이나,2014-08
2014-08-31,22046675,7325210,14721465,스리랑카,2014-08
2014-08-31,21741835,4278870,17462965,리투아니아,2014-08
2014-08-31,21588953,738737,20850216,앙골라,2014-08
2014-08-31,20801550,68412781,-47611231,모로코,2014-08
2014-08-31,20096163,3529907,16566256,케냐,2014-08
2014-08-31,19784561,47257543,-27472982,그리스,2014-08
2014-08-31,19232778,9569551,9663227,바레인,2014-08
2014-08-31,18168119,818116,17350003,코트디봐르,2014-08
2014-08-31,18143047,174610034,-156466987,리비아,2014-08
2014-08-31,18127560,25446097,-7318537,볼리비아,2014-08
2014-08-31,17423198,156898757,-139475559,예맨,2014-08
2014-08-31,17293020,2795101,14497919,가나,2014-08
2014-08-31,15482867,242782730,-227299863,노르웨이,2014-08
2014-08-31,15237724,823496,14414228,키르기스스탄,2014-08
2014-08-31,14998528,4574,14993954,아제르바이잔,2014-08
2014-08-31,14481485,8351741,6129744,도미니카 공화국,2014-08
2014-08-31,14285024,2665162,11619862,우루과이,2014-08
2014-08-31,13843689,62127,13781562,투르크멘,2014-08
2014-08-31,13748653,7702961,6045692,파라과이,2014-08
2014-08-31,13216490,1964163,11252327,콩고,2014-08
2014-08-31,12169639,2007100,10162539,니카라과,2014-08
2014-08-31,12148924,22830155,-10681231,푸에르토리코,2014-08
2014-08-31,11105517,4271765,6833752,튀니지,2014-08
2014-08-31,10298123,22868578,-12570455,코스타리카,2014-08
2014-08-31,10235564,1772300,8463264,라오스,2014-08
2014-08-31,9814078,5989514,3824564,라트비아,2014-08
2014-08-31,9590665,1894524,7696141,엘살바도르,2014-08
2014-08-31,9569459,7621786,1947673,불가리아,2014-08
2014-08-31,8969886,5717482,3252404,에티오피아,2014-08
2014-08-31,8854498,14980695,-6126197,에스토니아,2014-08
2014-08-31,8372148,150818,8221330,모잠비크,2014-08
2014-08-31,7899866,695032,7204834,조지아,2014-08
2014-08-31,7677158,132490095,-124812937,몰타,2014-08
2014-08-31,7515284,3724072,3791212,온두라스,2014-08
2014-08-31,7255496,1459439,5796057,크로아티아,2014-08
2014-08-31,7146571,3465103,3681468,수단,2014-08
2014-08-31,5543942,346,5543596,지부티,2014-08
2014-08-31,5342903,0,5342903,팔라우,2014-08
2014-08-31,4985862,279662,4706200,모리셔스,2014-08
2014-08-31,4898558,1747933,3150625,솔로몬 군도,2014-08
2014-08-31,4788695,361752,4426943,세르비아,2014-08
2014-08-31,4711838,1505232,3206606,트리니다드 토바고,2014-08
2014-08-31,4600163,8962386,-4362223,세네갈,2014-08
2014-08-31,4588145,90958737,-86370592,브루나이,2014-08
2014-08-31,4352790,1520,4351270,아프카니스탄,2014-08
2014-08-31,4295242,1287026,3008216,보스니아-헤르체고비나,2014-08
2014-08-31,4206545,81627,4124918,베닝,2014-08
2014-08-31,4195142,203135,3992007,쿠바,2014-08
2014-08-31,4035529,0,4035529,타지크,2014-08
2014-08-31,3559896,555208,3004688,마카오,2014-08
2014-08-31,3355923,3712070,-356147,기타국,2014-08
2014-08-31,3123907,1421794,1702113,기니,2014-08
2014-08-31,3059351,760440,2298911,카메룬,2014-08
2014-08-31,3040629,1240603,1800026,자마이카,2014-08
2014-08-31,2971358,16128,2955230,팔레스타인 해방기구,2014-08
2014-08-31,2942058,43338698,-40396640,파푸아 뉴기니,2014-08
2014-08-31,2825463,1078,2824385,아메리칸 사모아,2014-08
2014-08-31,2577747,78464,2499283,아이티,2014-08
2014-08-31,2562915,1750548,812367,벨라루스,2014-08
2014-08-31,2379994,25186113,-22806119,사이프러스,2014-08
2014-08-31,2181550,0,2181550,불령 리유니온 코모도 제도,2014-08
2014-08-31,2082537,551042,1531495,짐바브웨,2014-08
2014-08-31,1754121,122987,1631134,가이아나,2014-08
2014-08-31,1610535,8233690,-6623155,마다카스카르,2014-08
2014-08-31,1586667,1674479,-87812,토고,2014-08
2014-08-31,1466831,93450,1373381,네팔,2014-08
2014-08-31,1407779,268690,1139089,세이쉘,2014-08
2014-08-31,1357100,179036,1178064,부르키나 파소,2014-08
2014-08-31,1313441,3782547,-2469106,우간다,2014-08
2014-08-31,1258644,288854,969790,아르메니아,2014-08
2014-08-31,1236181,781954,454227,마이크로네시아,2014-08
2014-08-31,1214405,90810,1123595,알바니아,2014-08
2014-08-31,1137617,2054512,-916895,아이슬란드,2014-08
2014-08-31,1101053,78459117,-77358064,가봉,2014-08
2014-08-31,1100435,0,1100435,에리트리아,2014-08
2014-08-31,1075293,12733667,-11658374,콩고민주공화국,2014-08
2014-08-31,1041026,35911078,-34870052,잠비아,2014-08
2014-08-31,994860,2946292,-1951432,룩셈부르그,2014-08
2014-08-31,962636,678099,284537,말라위,2014-08
2014-08-31,952404,992640,-40236,키리바티,2014-08
2014-08-31,924417,406155,518262,마세도니아,2014-08
2014-08-31,884700,244196,640504,수리남,2014-08
2014-08-31,877432,40,877392,북마리아나 군도,2014-08
2014-08-31,869963,395,869568,니제르,2014-08
2014-08-31,803659,146376,657283,스와질랜드,2014-08
2014-08-31,763318,12579,750739,네덜란드 열도,2014-08
2014-08-31,730211,1437,728774,바베이도스,2014-08
2014-08-31,620345,0,620345,소말리아,2014-08
2014-08-31,591849,55966,535883,사모아,2014-08
2014-08-31,586453,0,586453,아루바,2014-08
2014-08-31,585571,454886,130685,시에라 리온,2014-08
2014-08-31,570449,32152,538297,르완다,2014-08
2014-08-31,545316,3298578,-2753262,몰도바,2014-08
2014-08-31,510120,654499,-144379,리히텐슈타인,2014-08
2014-08-31,454806,0,454806,마티니크,2014-08
2014-08-31,438897,297527,141370,영령 버진군도,2014-08
2014-08-31,429102,1336,427766,벨리제,2014-08
2014-08-31,427069,0,427069,불령 폴리네시아,2014-08
2014-08-31,417722,1040570,-622848,모리타니,2014-08
2014-08-31,395173,10441,384732,보츠와나,2014-08
2014-08-31,322583,17089533,-16766950,티모르,2014-08
2014-08-31,310738,11179,299559,도미니카,2014-08
2014-08-31,310346,197104,113242,바누아투,2014-08
2014-08-31,284118,0,284118,과델로프,2014-08
2014-08-31,252030,0,252030,그레나다,2014-08
2014-08-31,237712,0,237712,세인트 루시아,2014-08
2014-08-31,232358,0,232358,감비아,2014-08
2014-08-31,209354,105144,104210,모나코,2014-08
2014-08-31,175820,0,175820,세인트 키츠 네비스,2014-08
2014-08-31,173248,38287095,-38113847,적도 기니,2014-08
2014-08-31,137401,4614,132787,몰디브,2014-08
2014-08-31,121631,0,121631,챠드,2014-08
2014-08-31,96371,222,96149,영령 캐이맨 군도,2014-08
2014-08-31,90991,62612,28379,산마리노,2014-08
2014-08-31,87541,27486067,-27398526,나미비아,2014-08
2014-08-31,80341,0,80341,안티가 바부다,2014-08
2014-08-31,75344,96282,-20938,말리,2014-08
2014-08-31,55221,0,55221,상토메 프린스페,2014-08
2014-08-31,50830,1475,49355,부탄,2014-08
2014-08-31,44610,9271,35339,투르크 & 카이코스 군도,2014-08
2014-08-31,42247,85911,-43664,불령 가이아나,2014-08
2014-08-31,40917,0,40917,지브랄타,2014-08
2014-08-31,31594,15762,15832,코모로스,2014-08
2014-08-31,29781,0,29781,레소토,2014-08
2014-08-31,27906,0,27906,국제통화기금,2014-08
2014-08-31,22487,140,22347,세인트 빈센트 그레나딘,2014-08
2014-08-31,18673,44,18629,나우루,2014-08
2014-08-31,18375,0,18375,남수단,2014-08
2014-08-31,8156,0,8156,카보 베르데,2014-08
2014-08-31,6670,0,6670,앙귈라,2014-08
2014-08-31,6570,1183,5387,몬테네그로,2014-08
2014-08-31,3375,0,3375,중앙아프리카공화국,2014-08
2014-08-31,2853,4769,-1916,통가,2014-08
2014-08-31,2781,0,2781,기네비소,2014-08
2014-08-31,223,99000,-98777,파로에 군도,2014-08
2014-08-31,24,17887,-17863,부룬디,2014-08
2014-08-31,0,1412,-1412,안도라,2014-08
2014-08-31,0,1700,-1700,몬트세라트,2014-08
2014-08-31,0,24152,-24152,미령 버진군도,2014-08
2014-08-31,0,1,-1,코스 군도,2014-08
2014-08-31,0,70502,-70502,안타티카,2014-08
2014-08-31,0,346461,-346461,그린랜드,2014-08
2014-08-31,0,419,-419,큐라소,2014-08
2014-08-31,0,382,-382,니우에,2014-08
2014-08-31,0,90,-90,맨섬,2014-08
2014-08-31,0,3432,-3432,토켈라우,2014-08
2014-09-30,12700145881,7630021057,5070124824,중국,2014-09
2014-09-30,5664961041,3973897595,1691063446,미국,2014-09
2014-09-30,2702707335,4694707986,-1992000651,일본,2014-09
2014-09-30,2325190156,909982659,1415207497,싱가포르,2014-09
2014-09-30,2298876025,146856604,2152019421,홍콩,2014-09
2014-09-30,1886505548,912922920,973582628,베트남,2014-09
2014-09-30,1230673947,1393743829,-163069882,대만,2014-09
2014-09-30,1060989397,433455109,627534288,인도,2014-09
2014-09-30,1010974791,53600650,957374141,마샬군도,2014-09
2014-09-30,871886975,1761822122,-889935147,호주,2014-09
2014-09-30,863457971,263749492,599708479,필리핀,2014-09
2014-09-30,859918933,242014726,617904207,멕시코,2014-09
2014-09-30,804853929,966207937,-161354008,인도네시아,2014-09
2014-09-30,751332197,249142079,502190118,브라질,2014-09
2014-09-30,717594405,366,717594039,버뮤다,2014-09
2014-09-30,697276306,1663800096,-966523790,러시아 연방,2014-09
2014-09-30,625527284,442743473,182783811,태국,2014-09
2014-09-30,587889155,3429644609,-2841755454,사우디아라비아,2014-09
2014-09-30,580970901,997465107,-416494206,말레이시아,2014-09
2014-09-30,554450759,1852269657,-1297818898,독일,2014-09
2014-09-30,545394693,1234537676,-689142983,아랍에미리트 연합,2014-09
2014-09-30,539026911,43735145,495291766,튀르키예,2014-09
2014-09-30,438432878,414827560,23605318,이란,2014-09
2014-09-30,435103925,415672779,19431146,영국,2014-09
2014-09-30,374756859,234333705,140423154,네덜란드,2014-09
2014-09-30,367630947,485584531,-117953584,캐나다,2014-09
2014-09-30,332831515,19721143,313110372,슬로바키아,2014-09
2014-09-30,315232122,66486645,248745477,폴란드,2014-09
2014-09-30,241179454,28276092,212903362,이집트,2014-09
2014-09-30,236402500,531154613,-294752113,이탈리아,2014-09
2014-09-30,213048464,119106517,93941947,벨기에,2014-09
2014-09-30,206310038,69926065,136383973,덴마크,2014-09
2014-09-30,187715015,1887312803,-1699597788,카타르,2014-09
2014-09-30,173044646,376334162,-203289516,프랑스,2014-09
2014-09-30,170703538,1197480,169506058,우즈베키스탄,2014-09
2014-09-30,159640991,335523205,-175882214,스페인,2014-09
2014-09-30,154653038,203391528,-48738490,알제리,2014-09
2014-09-30,149194105,135709751,13484354,뉴질랜드,2014-09
2014-09-30,142345040,418002631,-275657591,칠레,2014-09
2014-09-30,134005589,9392923,124612666,슬로베니아,2014-09
2014-09-30,130162150,23354370,106807780,콜롬비아,2014-09
2014-09-30,118140584,309100368,-190959784,이라크,2014-09
2014-09-30,116672540,38880493,77792047,체코공화국,2014-09
2014-09-30,108071347,127950640,-19879293,남아프리카공화국,2014-09
2014-09-30,95730017,210451752,-114721735,나이지리아,2014-09
2014-09-30,90204313,636773,89567540,라이베리아,2014-09
2014-09-30,89393638,384802882,-295409244,오만,2014-09
2014-09-30,88488349,28640668,59847681,방글라데시,2014-09
2014-09-30,88380590,78980424,9400166,페루,2014-09
2014-09-30,84145360,100748408,-16603048,오스트리아,2014-09
2014-09-30,78792328,1130759049,-1051966721,쿠웨이트,2014-09
2014-09-30,77275427,17998020,59277407,포루투갈,2014-09
2014-09-30,76777708,154682727,-77905019,파나마,2014-09
2014-09-30,75751098,475,75750623,바하마,2014-09
2014-09-30,73776530,77635254,-3858724,이스라엘,2014-09
2014-09-30,68357929,39151575,29206354,헝가리,2014-09
2014-09-30,64277677,119692167,-55414490,카자흐스탄,2014-09
2014-09-30,64176628,6534155,57642473,요르단,2014-09
2014-09-30,62956675,31832610,31124065,파키스탄,2014-09
2014-09-30,62585205,71606,62513599,모나코,2014-09
2014-09-30,62404954,111184839,-48779885,에쿠아도르,2014-09
2014-09-30,59986959,82023050,-22036091,미얀마,2014-09
2014-09-30,57252843,173910226,-116657383,노르웨이,2014-09
2014-09-30,54543752,67380185,-12836433,아르헨티나,2014-09
2014-09-30,53581559,65882274,-12300715,루마니아,2014-09
2014-09-30,53322892,3896950,49425942,파푸아 뉴기니,2014-09
2014-09-30,53312904,132077,53180827,베네주엘라,2014-09
2014-09-30,50383989,125268354,-74884365,스웨덴,2014-09
2014-09-30,49031456,18515506,30515950,캄보디아,2014-09
2014-09-30,38491677,4449,38487228,괌,2014-09
2014-09-30,31527217,104901868,-73374651,리비아,2014-09
2014-09-30,28412853,2471321,25941532,피지,2014-09
2014-09-30,27632560,9515295,18117265,스리랑카,2014-09
2014-09-30,27538413,1079560,26458853,몽골,2014-09
2014-09-30,26519587,6803093,19716494,과테말라,2014-09
2014-09-30,24969383,842524,24126859,앙골라,2014-09
2014-09-30,24927709,117262873,-92335164,핀란드,2014-09
2014-09-30,24328549,18527171,5801378,우크라이나,2014-09
2014-09-30,22822712,71655728,-48833016,아일랜드,2014-09
2014-09-30,22259743,1508573,20751170,레바논,2014-09
2014-09-30,22055592,103479457,-81423865,그리스,2014-09
2014-09-30,21287068,1077,21285991,시리아,2014-09
2014-09-30,20853644,1523845,19329799,코트디봐르,2014-09
2014-09-30,20767310,16062665,4704645,파라과이,2014-09
2014-09-30,19483955,259895057,-240411102,스위스,2014-09
2014-09-30,19361418,2633522,16727896,케냐,2014-09
2014-09-30,19197586,1980,19195606,투르크멘,2014-09
2014-09-30,18116932,22699867,-4582935,푸에르토리코,2014-09
2014-09-30,18038141,3567500,14470641,리투아니아,2014-09
2014-09-30,17462706,10609352,6853354,모로코,2014-09
2014-09-30,17193327,4621384,12571943,에티오피아,2014-09
2014-09-30,16881661,8149350,8732311,우루과이,2014-09
2014-09-30,16505724,2371811,14133913,가나,2014-09
2014-09-30,16334636,71537775,-55203139,바레인,2014-09
2014-09-30,16299312,12419187,3880125,도미니카 공화국,2014-09
2014-09-30,15852857,56250,15796607,키르기스스탄,2014-09
2014-09-30,14786524,0,14786524,아제르바이잔,2014-09
2014-09-30,14551322,19566588,-5015266,코스타리카,2014-09
2014-09-30,13906768,572031,13334737,탄자니아,2014-09
2014-09-30,12646146,1242995,11403151,예맨,2014-09
2014-09-30,12319462,9584378,2735084,모잠비크,2014-09
2014-09-30,12124116,2353330,9770786,니카라과,2014-09
2014-09-30,12016034,2473652,9542382,엘살바도르,2014-09
2014-09-30,12005701,11167714,837987,온두라스,2014-09
2014-09-30,11582264,58358464,-46776200,트리니다드 토바고,2014-09
2014-09-30,10709981,622916,10087065,조지아,2014-09
2014-09-30,10661207,20495553,-9834346,튀니지,2014-09
2014-09-30,9683970,31011206,-21327236,불가리아,2014-09
2014-09-30,8439696,6440242,1999454,에스토니아,2014-09
2014-09-30,8231847,157403343,-149171496,몰타,2014-09
2014-09-30,7696912,4594118,3102794,볼리비아,2014-09
2014-09-30,5982532,4849863,1132669,세네갈,2014-09
2014-09-30,5872387,21538,5850849,사모아,2014-09
2014-09-30,5822690,3214,5819476,아프카니스탄,2014-09
2014-09-30,5812502,4918981,893521,수단,2014-09
2014-09-30,5475522,551696,4923826,세르비아,2014-09
2014-09-30,5187984,4229890,958094,라트비아,2014-09
2014-09-30,5140978,724901,4416077,크로아티아,2014-09
2014-09-30,4694688,422,4694266,지부티,2014-09
2014-09-30,4531228,71271834,-66740606,기니,2014-09
2014-09-30,4394355,1020426,3373929,마이크로네시아,2014-09
2014-09-30,4195132,112334,4082798,아이티,2014-09
2014-09-30,4179193,9108234,-4929041,뉴 칼레도니아,2014-09
2014-09-30,4047433,59,4047374,베닝,2014-09
2014-09-30,3959205,51383240,-47424035,브루나이,2014-09
2014-09-30,3883016,4126179,-243163,라오스,2014-09
2014-09-30,3575653,2268597,1307056,콩고,2014-09
2014-09-30,3260201,0,3260201,타지크,2014-09
2014-09-30,3251073,13788,3237285,팔레스타인 해방기구,2014-09
2014-09-30,3237164,153475,3083689,가이아나,2014-09
2014-09-30,3106324,3656282,-549958,기타국,2014-09
2014-09-30,3021605,33573357,-30551752,잠비아,2014-09
2014-09-30,2725300,25593152,-22867852,사이프러스,2014-09
2014-09-30,2584479,430737,2153742,모리셔스,2014-09
2014-09-30,2372085,0,2372085,네덜란드 열도,2014-09
2014-09-30,2340052,533063,1806989,쿠바,2014-09
2014-09-30,2336621,9507953,-7171332,마다카스카르,2014-09
2014-09-30,2051194,157792,1893402,카메룬,2014-09
2014-09-30,1995104,215681,1779423,아메리칸 사모아,2014-09
2014-09-30,1979613,0,1979613,바베이도스,2014-09
2014-09-30,1979482,766797,1212685,벨라루스,2014-09
2014-09-30,1899638,363997,1535641,부르키나 파소,2014-09
2014-09-30,1849337,274275,1575062,마카오,2014-09
2014-09-30,1740703,520571,1220132,네팔,2014-09
2014-09-30,1695005,0,1695005,불령 리유니온 코모도 제도,2014-09
2014-09-30,1680158,0,1680158,말리,2014-09
2014-09-30,1669713,614670,1055043,세이쉘,2014-09
2014-09-30,1658954,1400,1657554,부룬디,2014-09
2014-09-30,1547302,1554326,-7024,토고,2014-09
2014-09-30,1487146,632583,854563,키리바티,2014-09
2014-09-30,1472774,280822,1191952,짐바브웨,2014-09
2014-09-30,1456554,0,1456554,아루바,2014-09
2014-09-30,1430638,324214,1106424,말라위,2014-09
2014-09-30,1383721,7642879,-6259158,콩고민주공화국,2014-09
2014-09-30,1362265,287371,1074894,시에라 리온,2014-09
2014-09-30,1261904,193341,1068563,수리남,2014-09
2014-09-30,1115345,1490857,-375512,아이슬란드,2014-09
2014-09-30,1075406,1079612,-4206,자마이카,2014-09
2014-09-30,1056423,0,1056423,마티니크,2014-09
2014-09-30,1038332,0,1038332,영령 캐이맨 군도,2014-09
2014-09-30,998692,2601128,-1602436,룩셈부르그,2014-09
2014-09-30,954591,458,954133,부탄,2014-09
2014-09-30,932462,761442,171020,우간다,2014-09
2014-09-30,908891,50186,858705,보츠와나,2014-09
2014-09-30,904567,687971,216596,모리타니,2014-09
2014-09-30,876656,2419,874237,에리트리아,2014-09
2014-09-30,849086,1401533,-552447,알바니아,2014-09
2014-09-30,812438,2307175,-1494737,몰도바,2014-09
2014-09-30,807855,0,807855,북마리아나 군도,2014-09
2014-09-30,751751,36221,715530,벨리제,2014-09
2014-09-30,634756,582651,52105,마세도니아,2014-09
2014-09-30,572435,16242630,-15670195,티모르,2014-09
2014-09-30,543517,136877415,-136333898,가봉,2014-09
2014-09-30,499016,226715,272301,아르메니아,2014-09
2014-09-30,497941,20,497921,불령 폴리네시아,2014-09
2014-09-30,487863,1059949,-572086,리히텐슈타인,2014-09
2014-09-30,482558,1161376,-678818,보스니아-헤르체고비나,2014-09
2014-09-30,471529,8092480,-7620951,스와질랜드,2014-09
2014-09-30,426255,0,426255,과델로프,2014-09
2014-09-30,419014,0,419014,국제통화기금,2014-09
2014-09-30,390891,7461417,-7070526,나미비아,2014-09
2014-09-30,388952,400,388552,안티가 바부다,2014-09
2014-09-30,385512,15608,369904,도미니카,2014-09
2014-09-30,319006,264580,54426,소말리아,2014-09
2014-09-30,305327,0,305327,감비아,2014-09
2014-09-30,284124,42359,241765,몰디브,2014-09
2014-09-30,219363,294485,-75122,바누아투,2014-09
2014-09-30,202883,20900,181983,그레나다,2014-09
2014-09-30,191621,0,191621,니제르,2014-09
2014-09-30,175522,430313,-254791,적도 기니,2014-09
2014-09-30,153297,14236,139061,르완다,2014-09
2014-09-30,145911,49724,96187,큐라소,2014-09
2014-09-30,117035,2476,114559,몬테네그로,2014-09
2014-09-30,111889,0,111889,팔라우,2014-09
2014-09-30,99693,241,99452,세인트 루시아,2014-09
2014-09-30,91677,0,91677,솔로몬 군도,2014-09
2014-09-30,90341,64269,26072,중앙아프리카공화국,2014-09
2014-09-30,87445,40914,46531,불령 가이아나,2014-09
2014-09-30,81333,442,80891,세인트 키츠 네비스,2014-09
2014-09-30,50022,359,49663,지브랄타,2014-09
2014-09-30,48100,0,48100,남조지아 & 남샌드위치 군도,2014-09
2014-09-30,39861,150793,-110932,통가,2014-09
2014-09-30,39853,0,39853,카보 베르데,2014-09
2014-09-30,39290,0,39290,영령 인도양,2014-09
2014-09-30,31134,0,31134,쿡 아일랜드,2014-09
2014-09-30,22746,17,22729,챠드,2014-09
2014-09-30,20599,272280,-251681,영령 버진군도,2014-09
2014-09-30,17885,0,17885,메요트,2014-09
2014-09-30,17719,2337,15382,미령 버진군도,2014-09
2014-09-30,15295,0,15295,허드 앤 맥도날드 군도,2014-09
2014-09-30,14992,70102,-55110,산마리노,2014-09
2014-09-30,13390,44185,-30795,토켈라우,2014-09
2014-09-30,13034,7158,5876,안도라,2014-09
2014-09-30,10116,0,10116,세인트 빈센트 그레나딘,2014-09
2014-09-30,4704,0,4704,상토메 프린스페,2014-09
2014-09-30,3000,6431,-3431,투르크 & 카이코스 군도,2014-09
2014-09-30,2862,364,2498,레소토,2014-09
2014-09-30,2824,0,2824,코스 군도,2014-09
2014-09-30,2655,34434,-31779,기네비소,2014-09
2014-09-30,328,4461,-4133,코모로스,2014-09
2014-09-30,205,0,205,나우루,2014-09
2014-09-30,0,703,-703,마이너 아우틀링 합중국 군도,2014-09
2014-09-30,0,1060,-1060,크리스마스 아일랜드,2014-09
2014-09-30,0,66828,-66828,파로에 군도,2014-09
2014-09-30,0,2735,-2735,교황청,2014-09
2014-09-30,0,336557,-336557,그린랜드,2014-09
2014-09-30,0,315,-315,노폴크 아일랜드,2014-09
2014-10-31,13586043899,8116946012,5469097887,중국,2014-10
2014-10-31,6798528015,3729272394,3069255621,미국,2014-10
2014-10-31,2888627157,4619033940,-1730406783,일본,2014-10
2014-10-31,2394180476,129325020,2264855456,홍콩,2014-10
2014-10-31,2138138208,889961599,1248176609,베트남,2014-10
2014-10-31,1355638112,836131692,519506420,싱가포르,2014-10
2014-10-31,1239772754,1439881084,-200108330,대만,2014-10
2014-10-31,1115223258,500188397,615034861,인도,2014-10
2014-10-31,1109397135,1120959956,-11562821,인도네시아,2014-10
2014-10-31,1055867895,63924601,991943294,파나마,2014-10
2014-10-31,1040573667,1768356559,-727782892,호주,2014-10
2014-10-31,963164586,252195672,710968914,멕시코,2014-10
2014-10-31,826195747,2691041110,-1864845363,사우디아라비아,2014-10
2014-10-31,768688036,265143136,503544900,필리핀,2014-10
2014-10-31,756950472,597927213,159023259,브라질,2014-10
2014-10-31,714096180,1445412606,-731316426,러시아 연방,2014-10
2014-10-31,673816125,228049108,445767017,노르웨이,2014-10
2014-10-31,657973803,466689828,191283975,태국,2014-10
2014-10-31,641362374,1114159222,-472796848,말레이시아,2014-10
2014-10-31,594441025,1361676978,-767235953,아랍에미리트 연합,2014-10
2014-10-31,586278163,38653156,547625007,튀르키예,2014-10
2014-10-31,579066173,1655590741,-1076524568,독일,2014-10
2014-10-31,441056186,406291221,34764965,영국,2014-10
2014-10-31,440379689,95631296,344748393,몰타,2014-10
2014-10-31,409426245,12239,409414006,마샬군도,2014-10
2014-10-31,381204242,182545760,198658482,이란,2014-10
2014-10-31,360687348,15978847,344708501,슬로바키아,2014-10
2014-10-31,350932408,50473998,300458410,폴란드,2014-10
2014-10-31,335702532,703366290,-367663758,캐나다,2014-10
2014-10-31,331024572,511123465,-180098893,이탈리아,2014-10
2014-10-31,304583713,419096071,-114512358,네덜란드,2014-10
2014-10-31,284718104,1461446539,-1176728435,쿠웨이트,2014-10
2014-10-31,211587705,78393614,133194091,브루나이,2014-10
2014-10-31,209860104,89422781,120437323,덴마크,2014-10
2014-10-31,206856298,110223205,96633093,콜롬비아,2014-10
2014-10-31,205444131,25629953,179814178,이집트,2014-10
2014-10-31,184760842,140455097,44305745,스페인,2014-10
2014-10-31,176322297,113439056,62883241,뉴질랜드,2014-10
2014-10-31,168030510,131570273,36460237,벨기에,2014-10
2014-10-31,163221656,361449033,-198227377,칠레,2014-10
2014-10-31,162908199,586246850,-423338651,프랑스,2014-10
2014-10-31,148542021,53845661,94696360,체코공화국,2014-10
2014-10-31,137662057,10232035,127430022,슬로베니아,2014-10
2014-10-31,137057374,1001459,136055915,우즈베키스탄,2014-10
2014-10-31,132490509,246727051,-114236542,알제리,2014-10
2014-10-31,117189131,104370601,12818530,오스트리아,2014-10
2014-10-31,114847785,177720876,-62873091,페루,2014-10
2014-10-31,104146269,141208191,-37061922,남아프리카공화국,2014-10
2014-10-31,102967151,83730559,19236592,이스라엘,2014-10
2014-10-31,101176139,5242990,95933149,파푸아 뉴기니,2014-10
2014-10-31,100487303,351162179,-250674876,이라크,2014-10
2014-10-31,96816109,5529418,91286691,요르단,2014-10
2014-10-31,96395534,35965841,60429693,방글라데시,2014-10
2014-10-31,95638398,37447,95600951,모나코,2014-10
2014-10-31,92861829,2893709,89968120,탄자니아,2014-10
2014-10-31,85101948,267032,84834916,라이베리아,2014-10
2014-10-31,84834152,226425260,-141591108,나이지리아,2014-10
2014-10-31,83100631,345736790,-262636159,오만,2014-10
2014-10-31,76734694,5076982,71657712,카자흐스탄,2014-10
2014-10-31,75806720,164,75806556,아루바,2014-10
2014-10-31,70500000,30,70499970,맨섬,2014-10
2014-10-31,69575765,94535168,-24959403,미얀마,2014-10
2014-10-31,69398855,6410714,62988141,에쿠아도르,2014-10
2014-10-31,68289576,1756987328,-1688697752,카타르,2014-10
2014-10-31,66396981,38457760,27939221,파키스탄,2014-10
2014-10-31,64991560,20207476,44784084,캄보디아,2014-10
2014-10-31,62149488,44893894,17255594,헝가리,2014-10
2014-10-31,57112068,72632599,-15520531,아르헨티나,2014-10
2014-10-31,55659374,97081747,-41422373,아일랜드,2014-10
2014-10-31,55631549,94174512,-38542963,리비아,2014-10
2014-10-31,55412572,108283729,-52871157,스웨덴,2014-10
2014-10-31,48801612,215633,48585979,괌,2014-10
2014-10-31,44139782,54511537,-10371755,루마니아,2014-10
2014-10-31,36901997,197010,36704987,피지,2014-10
2014-10-31,34990180,0,34990180,시리아,2014-10
2014-10-31,32010076,2658323,29351753,몽골,2014-10
2014-10-31,30779539,1109458,29670081,앙골라,2014-10
2014-10-31,30085978,2928363,27157615,케냐,2014-10
2014-10-31,29189314,980,29188334,아제르바이잔,2014-10
2014-10-31,28689897,9203428,19486469,과테말라,2014-10
2014-10-31,27208440,6928055,20280385,스리랑카,2014-10
2014-10-31,27045589,15920943,11124646,포루투갈,2014-10
2014-10-31,26265431,86817212,-60551781,핀란드,2014-10
2014-10-31,26173660,2946734,23226926,세네갈,2014-10
2014-10-31,25930577,8449856,17480721,모로코,2014-10
2014-10-31,25501208,1773168,23728040,니카라과,2014-10
2014-10-31,25439901,250333690,-224893789,스위스,2014-10
2014-10-31,25383303,69665604,-44282301,우크라이나,2014-10
2014-10-31,25244272,826538,24417734,베네주엘라,2014-10
2014-10-31,24882074,11831842,13050232,도미니카 공화국,2014-10
2014-10-31,23455625,2581826,20873799,그리스,2014-10
2014-10-31,23133046,12240817,10892229,바레인,2014-10
2014-10-31,22448730,1729700,20719030,레바논,2014-10
2014-10-31,21054664,3393043,17661621,우루과이,2014-10
2014-10-31,20096198,32339347,-12243149,뉴 칼레도니아,2014-10
2014-10-31,19810499,24102591,-4292092,파라과이,2014-10
2014-10-31,19028153,4539107,14489046,리투아니아,2014-10
2014-10-31,17939214,26901691,-8962477,푸에르토리코,2014-10
2014-10-31,16399746,22802060,-6402314,코스타리카,2014-10
2014-10-31,15510049,162828,15347221,코트디봐르,2014-10
2014-10-31,15295073,3349250,11945823,가나,2014-10
2014-10-31,14860068,2106722,12753346,엘살바도르,2014-10
2014-10-31,14733005,185369976,-170636971,예맨,2014-10
2014-10-31,13235353,483903,12751450,조지아,2014-10
2014-10-31,13203742,4712862,8490880,키르기스스탄,2014-10
2014-10-31,11742263,4003130,7739133,튀니지,2014-10
2014-10-31,11708291,104382,11603909,카메룬,2014-10
2014-10-31,11160312,3687140,7473172,수단,2014-10
2014-10-31,11118302,1290418,9827884,라오스,2014-10
2014-10-31,10334971,1549032,8785939,온두라스,2014-10
2014-10-31,10246305,279155,9967150,쿠바,2014-10
2014-10-31,9939027,5027687,4911340,라트비아,2014-10
2014-10-31,9903299,0,9903299,안타티카,2014-10
2014-10-31,9722962,5908255,3814707,크로아티아,2014-10
2014-10-31,9576246,3794649,5781597,에티오피아,2014-10
2014-10-31,9199706,22776778,-13577072,볼리비아,2014-10
2014-10-31,8526215,32405447,-23879232,불가리아,2014-10
2014-10-31,7718851,1993197,5725654,트리니다드 토바고,2014-10
2014-10-31,7540897,1475,7539422,투르크멘,2014-10
2014-10-31,7483587,28712,7454875,모잠비크,2014-10
2014-10-31,6950237,8206172,-1255935,에스토니아,2014-10
2014-10-31,6548574,37759,6510815,사모아,2014-10
2014-10-31,6134217,82169,6052048,팔레스타인 해방기구,2014-10
2014-10-31,5085109,504728,4580381,세르비아,2014-10
2014-10-31,5056094,132346,4923748,아이티,2014-10
2014-10-31,5003696,1829502,3174194,콩고,2014-10
2014-10-31,4328737,0,4328737,지부티,2014-10
2014-10-31,4223716,473984,3749732,모리셔스,2014-10
2014-10-31,4071844,9649,4062195,아프카니스탄,2014-10
2014-10-31,4049251,85911,3963340,불령 리유니온 코모도 제도,2014-10
2014-10-31,4012223,0,4012223,북마리아나 군도,2014-10
2014-10-31,3914096,281177,3632919,베닝,2014-10
2014-10-31,3878513,589959,3288554,벨라루스,2014-10
2014-10-31,3850925,959181,2891744,자마이카,2014-10
2014-10-31,3391983,4577811,-1185828,기타국,2014-10
2014-10-31,3329659,0,3329659,타지크,2014-10
2014-10-31,3287207,178491,3108716,세이쉘,2014-10
2014-10-31,2937086,290684,2646402,마카오,2014-10
2014-10-31,2875393,67951772,-65076379,기니,2014-10
2014-10-31,2853492,1386092,1467400,짐바브웨,2014-10
2014-10-31,2845054,11466059,-8621005,마다카스카르,2014-10
2014-10-31,2755678,85293,2670385,알바니아,2014-10
2014-10-31,2703146,291981,2411165,아메리칸 사모아,2014-10
2014-10-31,2478851,171989,2306862,네팔,2014-10
2014-10-31,2329664,39450026,-37120362,잠비아,2014-10
2014-10-31,2320597,475684,1844913,시에라 리온,2014-10
2014-10-31,2300808,28082,2272726,나미비아,2014-10
2014-10-31,2088865,329669,1759196,부르키나 파소,2014-10
2014-10-31,1919198,1516017,403181,토고,2014-10
2014-10-31,1835667,323026,1512641,사이프러스,2014-10
2014-10-31,1807331,123,1807208,바베이도스,2014-10
2014-10-31,1702962,536666,1166296,말라위,2014-10
2014-10-31,1655632,8580,1647052,가이아나,2014-10
2014-10-31,1654985,1250437,404548,보스니아-헤르체고비나,2014-10
2014-10-31,1636975,1254,1635721,네덜란드 열도,2014-10
2014-10-31,1491786,23576454,-22084668,콩고민주공화국,2014-10
2014-10-31,1438992,0,1438992,불령 폴리네시아,2014-10
2014-10-31,1407059,2524095,-1117036,룩셈부르그,2014-10
2014-10-31,1393914,459963,933951,마이크로네시아,2014-10
2014-10-31,1379224,0,1379224,팔라우,2014-10
2014-10-31,1326098,1451297,-125199,우간다,2014-10
2014-10-31,1164570,7839990,-6675420,가봉,2014-10
2014-10-31,1131731,2399650,-1267919,아이슬란드,2014-10
2014-10-31,1006330,2907511,-1901181,몰도바,2014-10
2014-10-31,1002549,614405,388144,리히텐슈타인,2014-10
2014-10-31,1001999,19728422,-18726423,에리트리아,2014-10
2014-10-31,975462,480,974982,바하마,2014-10
2014-10-31,960796,1950,958846,버뮤다,2014-10
2014-10-31,919065,93368,825697,마세도니아,2014-10
2014-10-31,814162,9526,804636,보츠와나,2014-10
2014-10-31,788292,178669,609623,수리남,2014-10
2014-10-31,778463,1000,777463,르완다,2014-10
2014-10-31,727856,0,727856,니제르,2014-10
2014-10-31,724090,367808,356282,아르메니아,2014-10
2014-10-31,625058,86980,538078,키리바티,2014-10
2014-10-31,575829,5428627,-4852798,스와질랜드,2014-10
2014-10-31,574482,0,574482,소말리아,2014-10
2014-10-31,544087,1308328,-764241,모리타니,2014-10
2014-10-31,529165,845,528320,영령 캐이맨 군도,2014-10
2014-10-31,513421,1577,511844,안티가 바부다,2014-10
2014-10-31,497956,0,497956,감비아,2014-10
2014-10-31,475299,0,475299,마티니크,2014-10
2014-10-31,445203,14616,430587,도미니카,2014-10
2014-10-31,424419,705162,-280743,바누아투,2014-10
2014-10-31,419864,1320,418544,말리,2014-10
2014-10-31,405491,77,405414,세인트 키츠 네비스,2014-10
2014-10-31,375495,126284,249211,적도 기니,2014-10
2014-10-31,367992,1600977,-1232985,솔로몬 군도,2014-10
2014-10-31,365921,1208158,-842237,몰디브,2014-10
2014-10-31,361266,131,361135,지브랄타,2014-10
2014-10-31,260032,0,260032,과델로프,2014-10
2014-10-31,224214,126,224088,남수단,2014-10
2014-10-31,222007,0,222007,세인트 루시아,2014-10
2014-10-31,174832,23,174809,챠드,2014-10
2014-10-31,166367,175229,-8862,티모르,2014-10
2014-10-31,161526,38642,122884,벨리제,2014-10
2014-10-31,140216,0,140216,부탄,2014-10
2014-10-31,112426,0,112426,메요트,2014-10
2014-10-31,105720,19030,86690,부룬디,2014-10
2014-10-31,105540,0,105540,큐라소,2014-10
2014-10-31,92551,0,92551,투발루,2014-10
2014-10-31,90756,0,90756,상토메 프린스페,2014-10
2014-10-31,87605,0,87605,국제통화기금,2014-10
2014-10-31,87431,0,87431,나우루,2014-10
2014-10-31,72403,0,72403,투르크 & 카이코스 군도,2014-10
2014-10-31,61760,7226,54534,미령 버진군도,2014-10
2014-10-31,44105,0,44105,그레나다,2014-10
2014-10-31,35879,0,35879,중앙아프리카공화국,2014-10
2014-10-31,31064,0,31064,카보 베르데,2014-10
2014-10-31,25750,0,25750,앙귈라,2014-10
2014-10-31,25043,435,24608,몬테네그로,2014-10
2014-10-31,19713,0,19713,세인트 빈센트 그레나딘,2014-10
2014-10-31,17000,285023,-268023,영령 버진군도,2014-10
2014-10-31,16575,43875,-27300,통가,2014-10
2014-10-31,12736,25543,-12807,안도라,2014-10
2014-10-31,11620,44565,-32945,불령 가이아나,2014-10
2014-10-31,5780,0,5780,포클랜드 군도,2014-10
2014-10-31,4076,0,4076,쿡 아일랜드,2014-10
2014-10-31,249,0,249,세인트 마틴,2014-10
2014-10-31,0,7125,-7125,코모로스,2014-10
2014-10-31,0,389801,-389801,그린랜드,2014-10
2014-10-31,0,15,-15,기네비소,2014-10
2014-10-31,0,220,-220,교황청,2014-10
2014-10-31,0,526,-526,니우에,2014-10
2014-10-31,0,67735,-67735,산마리노,2014-10
2014-10-31,0,1610,-1610,코스 군도,2014-10
2014-10-31,0,735,-735,토켈라우,2014-10
2014-10-31,0,15,-15,피트카이른,2014-10
2014-10-31,0,25412,-25412,남조지아 & 남샌드위치 군도,2014-10
2014-11-30,12471043145,7685026446,4786016699,중국,2014-11
2014-11-30,6304664359,3499329710,2805334649,미국,2014-11
2014-11-30,2500868662,138268280,2362600382,홍콩,2014-11
2014-11-30,2499017437,4344355844,-1845338407,일본,2014-11
2014-11-30,1943242632,678584184,1264658448,베트남,2014-11
2014-11-30,1372786856,817618171,555168685,싱가포르,2014-11
2014-11-30,1291185463,192440297,1098745166,멕시코,2014-11
2014-11-30,1178254445,1304888439,-126633994,대만,2014-11
2014-11-30,1011703472,837880258,173823214,인도네시아,2014-11
2014-11-30,990705351,370567895,620137456,인도,2014-11
2014-11-30,817301141,2962807803,-2145506662,사우디아라비아,2014-11
2014-11-30,767313180,258509491,508803689,필리핀,2014-11
2014-11-30,735101314,1399628002,-664526688,호주,2014-11
2014-11-30,685017710,1038966810,-353949100,아랍에미리트 연합,2014-11
2014-11-30,610419569,405953818,204465751,태국,2014-11
2014-11-30,577934486,1203693103,-625758617,러시아 연방,2014-11
2014-11-30,562206026,461745285,100460741,브라질,2014-11
2014-11-30,526375373,1698735911,-1172360538,독일,2014-11
2014-11-30,511156904,843981671,-332824767,말레이시아,2014-11
2014-11-30,499566516,63287776,436278740,튀르키예,2014-11
2014-11-30,494563126,1721,494561405,영령 버진군도,2014-11
2014-11-30,407228646,78473,407150173,마샬군도,2014-11
2014-11-30,399771224,720658093,-320886869,영국,2014-11
2014-11-30,393402173,299125591,94276582,캐나다,2014-11
2014-11-30,382149309,127791654,254357655,나이지리아,2014-11
2014-11-30,349770967,359701140,-9930173,이란,2014-11
2014-11-30,332597271,18701287,313895984,슬로바키아,2014-11
2014-11-30,298223525,456645660,-158422135,이탈리아,2014-11
2014-11-30,285375140,68165102,217210038,폴란드,2014-11
2014-11-30,262998076,30099172,232898904,이집트,2014-11
2014-11-30,206320805,73681991,132638814,덴마크,2014-11
2014-11-30,191641011,446604203,-254963192,네덜란드,2014-11
2014-11-30,175914317,633695130,-457780813,이라크,2014-11
2014-11-30,171553519,244887313,-73333794,스페인,2014-11
2014-11-30,160170720,142096477,18074243,벨기에,2014-11
2014-11-30,146128747,435413228,-289284481,칠레,2014-11
2014-11-30,145661217,646534529,-500873312,프랑스,2014-11
2014-11-30,137989387,37368602,100620785,체코공화국,2014-11
2014-11-30,130305763,134829,130170934,마카오,2014-11
2014-11-30,127219276,69689173,57530103,리비아,2014-11
2014-11-30,125375707,75200338,50175369,페루,2014-11
2014-11-30,118502135,1712527,116789608,우즈베키스탄,2014-11
2014-11-30,113409570,8420799,104988771,슬로베니아,2014-11
2014-11-30,113049599,107969257,5080342,오스트리아,2014-11
2014-11-30,110583168,4215298,106367870,요르단,2014-11
2014-11-30,108136870,991155176,-883018306,쿠웨이트,2014-11
2014-11-30,104417230,18450570,85966660,방글라데시,2014-11
2014-11-30,103860245,97965400,5894845,콜롬비아,2014-11
2014-11-30,101502294,10440663,91061631,바하마,2014-11
2014-11-30,101219544,464505,100755039,앙골라,2014-11
2014-11-30,100858898,40,100858858,버뮤다,2014-11
2014-11-30,98045997,72318695,25727302,이스라엘,2014-11
2014-11-30,90078746,81550514,8528232,카자흐스탄,2014-11
2014-11-30,86923515,126721795,-39798280,뉴질랜드,2014-11
2014-11-30,83721642,149228595,-65506953,알제리,2014-11
2014-11-30,80908464,122312645,-41404181,남아프리카공화국,2014-11
2014-11-30,77148776,386910232,-309761456,오만,2014-11
2014-11-30,73530065,1841194922,-1767664857,카타르,2014-11
2014-11-30,72761203,5127120,67634083,에쿠아도르,2014-11
2014-11-30,71308930,160,71308770,맨섬,2014-11
2014-11-30,71077608,38940319,32137289,미얀마,2014-11
2014-11-30,70157546,476207,69681339,피지,2014-11
2014-11-30,66189191,24081266,42107925,파키스탄,2014-11
2014-11-30,64668815,19405044,45263771,푸에르토리코,2014-11
2014-11-30,64469891,100247120,-35777229,파나마,2014-11
2014-11-30,64395156,2706508,61688648,케냐,2014-11
2014-11-30,60684068,13032914,47651154,캄보디아,2014-11
2014-11-30,59725361,32118371,27606990,아르헨티나,2014-11
2014-11-30,56779375,159699520,-102920145,스웨덴,2014-11
2014-11-30,48352781,34341799,14010982,헝가리,2014-11
2014-11-30,46945335,47528084,-582749,루마니아,2014-11
2014-11-30,40463494,95147,40368347,시리아,2014-11
2014-11-30,37029106,81369865,-44340759,아일랜드,2014-11
2014-11-30,35741375,44389,35696986,베네주엘라,2014-11
2014-11-30,28781567,3476644,25304923,몽골,2014-11
2014-11-30,28632716,11679174,16953542,포루투갈,2014-11
2014-11-30,27415326,17952094,9463232,뉴 칼레도니아,2014-11
2014-11-30,26128962,6737090,19391872,과테말라,2014-11
2014-11-30,25175099,8069,25167030,아제르바이잔,2014-11
2014-11-30,24882880,10922238,13960642,모로코,2014-11
2014-11-30,24755666,1443036,23312630,레바논,2014-11
2014-11-30,24707121,6140510,18566611,스리랑카,2014-11
2014-11-30,23868625,4922199,18946426,우루과이,2014-11
2014-11-30,23698301,2264,23696037,키리바티,2014-11
2014-11-30,23604917,52508978,-28904061,우크라이나,2014-11
2014-11-30,22499262,223377535,-200878273,스위스,2014-11
2014-11-30,21784373,12633054,9151319,도미니카 공화국,2014-11
2014-11-30,20184650,27538482,-7353832,코스타리카,2014-11
2014-11-30,20166374,5246239,14920135,파라과이,2014-11
2014-11-30,19790456,21552820,-1762364,그리스,2014-11
2014-11-30,19736879,10142375,9594504,바레인,2014-11
2014-11-30,18100881,198534,17902347,모나코,2014-11
2014-11-30,17432371,124273735,-106841364,핀란드,2014-11
2014-11-30,16249244,1051727,15197517,라오스,2014-11
2014-11-30,15400774,4186036,11214738,가나,2014-11
2014-11-30,14190427,363969677,-349779250,예맨,2014-11
2014-11-30,13767563,3920206,9847357,리투아니아,2014-11
2014-11-30,13679456,594308,13085148,조지아,2014-11
2014-11-30,13233757,1722759,11510998,엘살바도르,2014-11
2014-11-30,11545514,283755147,-272209633,노르웨이,2014-11
2014-11-30,11171227,3130320,8040907,탄자니아,2014-11
2014-11-30,11103787,63705,11040082,키르기스스탄,2014-11
2014-11-30,10499735,3270862,7228873,에티오피아,2014-11
2014-11-30,9474004,1833234,7640770,니카라과,2014-11
2014-11-30,9359288,52336544,-42977256,트리니다드 토바고,2014-11
2014-11-30,9331886,1536,9330350,투르크멘,2014-11
2014-11-30,9187830,916742,8271088,코트디봐르,2014-11
2014-11-30,8907898,4401571,4506327,튀니지,2014-11
2014-11-30,8594831,1133816,7461015,온두라스,2014-11
2014-11-30,8572625,4440406,4132219,라트비아,2014-11
2014-11-30,8447630,2784088,5663542,수단,2014-11
2014-11-30,8112650,59679612,-51566962,볼리비아,2014-11
2014-11-30,7994077,6910009,1084068,에스토니아,2014-11
2014-11-30,7594998,29627756,-22032758,브루나이,2014-11
2014-11-30,7064239,195396,6868843,괌,2014-11
2014-11-30,6839813,11786636,-4946823,파푸아 뉴기니,2014-11
2014-11-30,6376880,3891617,2485263,불가리아,2014-11
2014-11-30,6096795,27467003,-21370208,몰타,2014-11
2014-11-30,6086947,0,6086947,세인트 마틴,2014-11
2014-11-30,5892742,26234,5866508,사모아,2014-11
2014-11-30,5581879,125341,5456538,모잠비크,2014-11
2014-11-30,5576170,844321,4731849,크로아티아,2014-11
2014-11-30,5236991,2299176,2937815,콩고,2014-11
2014-11-30,4965464,244802,4720662,세르비아,2014-11
2014-11-30,4076815,26557,4050258,팔레스타인 해방기구,2014-11
2014-11-30,4074697,612396,3462301,타지크,2014-11
2014-11-30,4013080,108712327,-104699247,기니,2014-11
2014-11-30,3964498,2423,3962075,아프카니스탄,2014-11
2014-11-30,3903856,1937110,1966746,쿠바,2014-11
2014-11-30,3870576,610941,3259635,카메룬,2014-11
2014-11-30,3868310,337633,3530677,모리셔스,2014-11
2014-11-30,3532732,2748901,783831,세네갈,2014-11
2014-11-30,3467695,582257,2885438,베닝,2014-11
2014-11-30,3266556,88356,3178200,라이베리아,2014-11
2014-11-30,3120236,983013,2137223,사이프러스,2014-11
2014-11-30,2649773,0,2649773,지부티,2014-11
2014-11-30,2641179,0,2641179,에리트리아,2014-11
2014-11-30,2596921,1332741,1264180,토고,2014-11
2014-11-30,2296798,108901,2187897,아이티,2014-11
2014-11-30,2218978,113676,2105302,말라위,2014-11
2014-11-30,2198649,1100662,1097987,보스니아-헤르체고비나,2014-11
2014-11-30,2161428,2649730,-488302,벨라루스,2014-11
2014-11-30,2113838,196025,1917813,짐바브웨,2014-11
2014-11-30,1984847,307224,1677623,세이쉘,2014-11
2014-11-30,1969993,218210,1751783,가이아나,2014-11
2014-11-30,1957095,4163132,-2206037,기타국,2014-11
2014-11-30,1874414,2784016,-909602,룩셈부르그,2014-11
2014-11-30,1798831,191555,1607276,네팔,2014-11
2014-11-30,1754479,23166456,-21411977,잠비아,2014-11
2014-11-30,1624828,2273909,-649081,네덜란드 열도,2014-11
2014-11-30,1521047,0,1521047,북마리아나 군도,2014-11
2014-11-30,1449075,1351186,97889,아이슬란드,2014-11
2014-11-30,1343792,116073,1227719,아르메니아,2014-11
2014-11-30,1274692,10249755,-8975063,마다카스카르,2014-11
2014-11-30,1194013,12032841,-10838828,콩고민주공화국,2014-11
2014-11-30,1163301,38913,1124388,불령 폴리네시아,2014-11
2014-11-30,1118514,0,1118514,불령 리유니온 코모도 제도,2014-11
2014-11-30,1087514,51263380,-50175866,가봉,2014-11
2014-11-30,1043007,0,1043007,바베이도스,2014-11
2014-11-30,990370,67426,922944,알바니아,2014-11
2014-11-30,843593,4933304,-4089711,아루바,2014-11
2014-11-30,836034,641367,194667,몰도바,2014-11
2014-11-30,789855,166056,623799,소말리아,2014-11
2014-11-30,743425,700039,43386,자마이카,2014-11
2014-11-30,705207,733,704474,티모르,2014-11
2014-11-30,700976,1647253,-946277,우간다,2014-11
2014-11-30,664577,31,664546,부르키나 파소,2014-11
2014-11-30,641907,0,641907,영령 캐이맨 군도,2014-11
2014-11-30,603361,2466,600895,몰디브,2014-11
2014-11-30,593937,61,593876,안티가 바부다,2014-11
2014-11-30,575167,216832,358335,아메리칸 사모아,2014-11
2014-11-30,555185,367187,187998,수리남,2014-11
2014-11-30,527048,792995,-265947,리히텐슈타인,2014-11
2014-11-30,464804,86,464718,보츠와나,2014-11
2014-11-30,459480,0,459480,팔라우,2014-11
2014-11-30,456136,584647,-128511,시에라 리온,2014-11
2014-11-30,438119,19010,419109,마이크로네시아,2014-11
2014-11-30,432607,0,432607,말리,2014-11
2014-11-30,374442,0,374442,마티니크,2014-11
2014-11-30,356128,874,355254,지브랄타,2014-11
2014-11-30,343708,3016444,-2672736,모리타니,2014-11
2014-11-30,270815,105865,164950,도미니카,2014-11
2014-11-30,242575,251022,-8447,르완다,2014-11
2014-11-30,241695,0,241695,그레나다,2014-11
2014-11-30,239344,5781356,-5542012,나미비아,2014-11
2014-11-30,233016,0,233016,챠드,2014-11
2014-11-30,221742,868,220874,부탄,2014-11
2014-11-30,221137,1498,219639,벨리제,2014-11
2014-11-30,218213,0,218213,세인트 루시아,2014-11
2014-11-30,209603,14182,195421,과델로프,2014-11
2014-11-30,207968,522886,-314918,스와질랜드,2014-11
2014-11-30,186176,0,186176,세인트 키츠 네비스,2014-11
2014-11-30,181974,1007666,-825692,바누아투,2014-11
2014-11-30,138098,28848,109250,마세도니아,2014-11
2014-11-30,133212,70,133142,감비아,2014-11
2014-11-30,122902,662267,-539365,솔로몬 군도,2014-11
2014-11-30,114470,185,114285,투르크 & 카이코스 군도,2014-11
2014-11-30,107944,0,107944,국제통화기금,2014-11
2014-11-30,105069,0,105069,카보 베르데,2014-11
2014-11-30,90529,375,90154,니제르,2014-11
2014-11-30,51224,419,50805,몬테네그로,2014-11
2014-11-30,46769,0,46769,중앙아프리카공화국,2014-11
2014-11-30,27835,0,27835,투발루,2014-11
2014-11-30,26400,0,26400,세인트 빈센트 그레나딘,2014-11
2014-11-30,14483,596,13887,토켈라우,2014-11
2014-11-30,12790,0,12790,적도 기니,2014-11
2014-11-30,9622,820079,-810457,통가,2014-11
2014-11-30,6050,1237,4813,안도라,2014-11
2014-11-30,4943,0,4943,남수단,2014-11
2014-11-30,2860,0,2860,쿡 아일랜드,2014-11
2014-11-30,2510,0,2510,상토메 프린스페,2014-11
2014-11-30,2125,0,2125,큐라소,2014-11
2014-11-30,1824,43729,-41905,불령 가이아나,2014-11
2014-11-30,405,0,405,기네비소,2014-11
2014-11-30,120,0,120,몬트세라트,2014-11
2014-11-30,73,2250,-2177,미령 버진군도,2014-11
2014-11-30,0,35,-35,나우루,2014-11
2014-11-30,0,13,-13,파로에 군도,2014-11
2014-11-30,0,365,-365,니우에,2014-11
2014-11-30,0,4226,-4226,코스 군도,2014-11
2014-11-30,0,11771,-11771,산마리노,2014-11
2014-11-30,0,3556,-3556,코모로스,2014-11
2014-11-30,0,43,-43,부룬디,2014-11
2014-11-30,0,377552,-377552,그린랜드,2014-11
2014-12-31,13165237867,8603139531,4562098336,중국,2014-12
2014-12-31,6239395215,3878834194,2360561021,미국,2014-12
2014-12-31,2419357232,120632641,2298724591,홍콩,2014-12
2014-12-31,2393255279,4457867577,-2064612298,일본,2014-12
2014-12-31,2104342475,653166335,1451176140,베트남,2014-12
2014-12-31,1314102054,900724290,413377764,싱가포르,2014-12
2014-12-31,1252788143,1320634402,-67846259,대만,2014-12
2014-12-31,1189535905,24373,1189511532,마샬군도,2014-12
2014-12-31,1135517494,276913978,858603516,인도,2014-12
2014-12-31,904582194,1616938930,-712356736,호주,2014-12
2014-12-31,846052046,1455257,844596789,앙골라,2014-12
2014-12-31,819514383,330682826,488831557,멕시코,2014-12
2014-12-31,798596076,2226526620,-1427930544,사우디아라비아,2014-12
2014-12-31,798257540,945431111,-147173571,인도네시아,2014-12
2014-12-31,755422257,245272837,510149420,필리핀,2014-12
2014-12-31,709800278,452976004,256824274,브라질,2014-12
2014-12-31,656911707,1080770165,-423858458,말레이시아,2014-12
2014-12-31,612566731,468889249,143677482,태국,2014-12
2014-12-31,600081548,51215445,548866103,튀르키예,2014-12
2014-12-31,596153960,1338090153,-741936193,아랍에미리트 연합,2014-12
2014-12-31,521242740,1944509516,-1423266776,독일,2014-12
2014-12-31,477625670,1043028859,-565403189,러시아 연방,2014-12
2014-12-31,453181295,529697950,-76516655,영국,2014-12
2014-12-31,438684382,284531394,154152988,이란,2014-12
2014-12-31,428794506,358832220,69962286,캐나다,2014-12
2014-12-31,368267909,346216,367921693,라이베리아,2014-12
2014-12-31,354843039,19118454,335724585,슬로바키아,2014-12
2014-12-31,334886516,539254532,-204368016,네덜란드,2014-12
2014-12-31,334006522,67367365,266639157,폴란드,2014-12
2014-12-31,286742108,527764178,-241022070,이탈리아,2014-12
2014-12-31,280093940,17657522,262436418,파나마,2014-12
2014-12-31,248540232,80605535,167934697,덴마크,2014-12
2014-12-31,243674460,60315636,183358824,체코공화국,2014-12
2014-12-31,233640915,26467184,207173731,이집트,2014-12
2014-12-31,232313918,636330937,-404017019,이라크,2014-12
2014-12-31,226850670,278303365,-51452695,스페인,2014-12
2014-12-31,202863061,8236,202854825,버뮤다,2014-12
2014-12-31,199454292,339833497,-140379205,칠레,2014-12
2014-12-31,187080905,240826657,-53745752,벨기에,2014-12
2014-12-31,186598766,654963216,-468364450,프랑스,2014-12
2014-12-31,151908192,1917660,149990532,우즈베키스탄,2014-12
2014-12-31,141771076,185525558,-43754482,페루,2014-12
2014-12-31,138805075,10646741,128158334,슬로베니아,2014-12
2014-12-31,134318586,138536042,-4217456,남아프리카공화국,2014-12
2014-12-31,126919284,443584134,-316664850,오만,2014-12
2014-12-31,119189720,98896473,20293247,콜롬비아,2014-12
2014-12-31,118371338,118181359,189979,뉴질랜드,2014-12
2014-12-31,116997053,34766888,82230165,미얀마,2014-12
2014-12-31,110177850,102204711,7973139,이스라엘,2014-12
2014-12-31,108941875,1043985617,-935043742,쿠웨이트,2014-12
2014-12-31,98179955,29705267,68474688,방글라데시,2014-12
2014-12-31,97507354,4568281,92939073,에쿠아도르,2014-12
2014-12-31,97124029,512653238,-415529209,나이지리아,2014-12
2014-12-31,91514417,14489129,77025288,포루투갈,2014-12
2014-12-31,90009385,2209526719,-2119517334,카타르,2014-12
2014-12-31,89287389,6591072,82696317,요르단,2014-12
2014-12-31,88397986,121694501,-33296515,알제리,2014-12
2014-12-31,86093908,7034151,79059757,카자흐스탄,2014-12
2014-12-31,79754135,28562331,51191804,그리스,2014-12
2014-12-31,77073012,130101080,-53028068,오스트리아,2014-12
2014-12-31,75294863,5353952,69940911,바하마,2014-12
2014-12-31,67961579,37631336,30330243,파키스탄,2014-12
2014-12-31,63504740,265522,63239218,모나코,2014-12
2014-12-31,62212772,44176900,18035872,헝가리,2014-12
2014-12-31,61749543,14364978,47384565,캄보디아,2014-12
2014-12-31,61314487,40447256,20867231,아르헨티나,2014-12
2014-12-31,56463725,179467077,-123003352,스웨덴,2014-12
2014-12-31,54081165,11269858,42811307,리비아,2014-12
2014-12-31,53296465,218359210,-165062745,노르웨이,2014-12
2014-12-31,52022597,11591,52011006,시리아,2014-12
2014-12-31,45125176,72421464,-27296288,루마니아,2014-12
2014-12-31,41024367,9941467,31082900,모로코,2014-12
2014-12-31,36128871,22345098,13783773,과테말라,2014-12
2014-12-31,34430695,7270950,27159745,우루과이,2014-12
2014-12-31,34407329,22110573,12296756,푸에르토리코,2014-12
2014-12-31,30092682,7399466,22693216,몰타,2014-12
2014-12-31,28677640,101888238,-73210598,아일랜드,2014-12
2014-12-31,28585121,49677,28535444,베네주엘라,2014-12
2014-12-31,28319925,3958400,24361525,에티오피아,2014-12
2014-12-31,27348514,85698729,-58350215,우크라이나,2014-12
2014-12-31,27178072,245163,26932909,괌,2014-12
2014-12-31,27074078,498882,26575196,파라과이,2014-12
2014-12-31,26963530,218900105,-191936575,스위스,2014-12
2014-12-31,26924176,7991127,18933049,스리랑카,2014-12
2014-12-31,26567948,2140396,24427552,레바논,2014-12
2014-12-31,25618074,6463815,19154259,가나,2014-12
2014-12-31,25515255,846648,24668607,피지,2014-12
2014-12-31,24271591,4511275,19760316,리투아니아,2014-12
2014-12-31,23718727,17204765,6513962,바레인,2014-12
2014-12-31,23484302,128521866,-105037564,핀란드,2014-12
2014-12-31,22598517,8873296,13725221,도미니카 공화국,2014-12
2014-12-31,21469586,3428291,18041295,케냐,2014-12
2014-12-31,21340892,18476444,2864448,코스타리카,2014-12
2014-12-31,21205354,14963220,6242134,뉴 칼레도니아,2014-12
2014-12-31,20346399,0,20346399,아제르바이잔,2014-12
2014-12-31,18112572,3302455,14810117,몽골,2014-12
2014-12-31,17957028,32669495,-14712467,볼리비아,2014-12
2014-12-31,16016016,2356614,13659402,파푸아 뉴기니,2014-12
2014-12-31,15691820,271074968,-255383148,예맨,2014-12
2014-12-31,14421247,463,14420784,아메리칸 사모아,2014-12
2014-12-31,14082064,976259,13105805,코트디봐르,2014-12
2014-12-31,13566706,843069,12723637,니카라과,2014-12
2014-12-31,12907128,659025,12248103,라오스,2014-12
2014-12-31,12725712,112546,12613166,모잠비크,2014-12
2014-12-31,12536202,113698484,-101162282,브루나이,2014-12
2014-12-31,12198126,1093907,11104219,엘살바도르,2014-12
2014-12-31,11590102,994786,10595316,트리니다드 토바고,2014-12
2014-12-31,11113489,12801273,-1687784,조지아,2014-12
2014-12-31,10819505,6234402,4585103,탄자니아,2014-12
2014-12-31,10816161,4066567,6749594,튀니지,2014-12
2014-12-31,10607883,1003784,9604099,온두라스,2014-12
2014-12-31,10348190,82521,10265669,팔레스타인 해방기구,2014-12
2014-12-31,9355372,2045422,7309950,수단,2014-12
2014-12-31,8960216,4864868,4095348,불가리아,2014-12
2014-12-31,8573232,1120,8572112,투르크멘,2014-12
2014-12-31,8237653,1919012,6318641,세네갈,2014-12
2014-12-31,7900507,4132567,3767940,라트비아,2014-12
2014-12-31,7327570,11209120,-3881550,에스토니아,2014-12
2014-12-31,7287540,24007,7263533,키르기스스탄,2014-12
2014-12-31,7185942,306146,6879796,르완다,2014-12
2014-12-31,6057280,0,6057280,지부티,2014-12
2014-12-31,5830017,193375,5636642,마이크로네시아,2014-12
2014-12-31,5664037,571,5663466,아프카니스탄,2014-12
2014-12-31,5437022,8252857,-2815835,세르비아,2014-12
2014-12-31,5423986,29509,5394477,사모아,2014-12
2014-12-31,5329093,1425239,3903854,카메룬,2014-12
2014-12-31,5287221,381275,4905946,모리셔스,2014-12
2014-12-31,4740525,5435314,-694789,쿠바,2014-12
2014-12-31,4678332,8206312,-3527980,마다카스카르,2014-12
2014-12-31,4397070,1138366,3258704,기니,2014-12
2014-12-31,4357218,259394,4097824,마카오,2014-12
2014-12-31,3929784,664916,3264868,베닝,2014-12
2014-12-31,3912557,2924945,987612,벨라루스,2014-12
2014-12-31,3828731,1577704,2251027,타지크,2014-12
2014-12-31,3795159,105471,3689688,아이티,2014-12
2014-12-31,3591754,0,3591754,팔라우,2014-12
2014-12-31,3422810,3698,3419112,부르키나 파소,2014-12
2014-12-31,3151661,23119523,-19967862,콩고민주공화국,2014-12
2014-12-31,3106993,971475,2135518,크로아티아,2014-12
2014-12-31,2867885,257592,2610293,짐바브웨,2014-12
2014-12-31,2724463,8439032,-5714569,아루바,2014-12
2014-12-31,2679233,0,2679233,에리트리아,2014-12
2014-12-31,2599766,183924,2415842,세이쉘,2014-12
2014-12-31,2271939,139625,2132314,불령 리유니온 코모도 제도,2014-12
2014-12-31,2261409,5401062,-3139653,콩고,2014-12
2014-12-31,1934709,14074,1920635,불령 폴리네시아,2014-12
2014-12-31,1887121,2594287,-707166,토고,2014-12
2014-12-31,1882767,973809,908958,보스니아-헤르체고비나,2014-12
2014-12-31,1876910,112145,1764765,불령 가이아나,2014-12
2014-12-31,1875888,0,1875888,말리,2014-12
2014-12-31,1834085,355655,1478430,자마이카,2014-12
2014-12-31,1797371,1145067,652304,네팔,2014-12
2014-12-31,1655088,123399,1531689,네덜란드 열도,2014-12
2014-12-31,1607440,206685,1400755,알바니아,2014-12
2014-12-31,1584545,542439,1042106,몰도바,2014-12
2014-12-31,1544893,67095,1477798,마세도니아,2014-12
2014-12-31,1540894,4788024,-3247130,기타국,2014-12
2014-12-31,1503131,43926570,-42423439,가봉,2014-12
2014-12-31,1430340,0,1430340,바베이도스,2014-12
2014-12-31,1420243,7159599,-5739356,나미비아,2014-12
2014-12-31,1417618,690201,727417,사이프러스,2014-12
2014-12-31,1413217,1830094,-416877,아이슬란드,2014-12
2014-12-31,1350984,286124,1064860,안티가 바부다,2014-12
2014-12-31,1335019,3909232,-2574213,룩셈부르그,2014-12
2014-12-31,1287578,2760425,-1472847,모리타니,2014-12
2014-12-31,1244590,140949,1103641,북마리아나 군도,2014-12
2014-12-31,1156388,12121381,-10964993,말라위,2014-12
2014-12-31,1090427,1348248,-257821,우간다,2014-12
2014-12-31,956018,34058755,-33102737,잠비아,2014-12
2014-12-31,911704,303717,607987,수리남,2014-12
2014-12-31,866409,0,866409,마티니크,2014-12
2014-12-31,854906,45984,808922,보츠와나,2014-12
2014-12-31,844429,0,844429,키리바티,2014-12
2014-12-31,818187,1036203,-218016,시에라 리온,2014-12
2014-12-31,727645,84353,643292,아르메니아,2014-12
2014-12-31,570100,238588,331512,가이아나,2014-12
2014-12-31,535423,84096,451327,소말리아,2014-12
2014-12-31,478364,3689,474675,몰디브,2014-12
2014-12-31,460349,0,460349,니제르,2014-12
2014-12-31,458677,0,458677,도미니카,2014-12
2014-12-31,439722,1609202,-1169480,바누아투,2014-12
2014-12-31,395618,98018,297600,영령 버진군도,2014-12
2014-12-31,389061,13,389048,세인트 루시아,2014-12
2014-12-31,378204,577979,-199775,리히텐슈타인,2014-12
2014-12-31,343109,228515,114594,티모르,2014-12
2014-12-31,332925,0,332925,영령 캐이맨 군도,2014-12
2014-12-31,312001,2634777,-2322776,솔로몬 군도,2014-12
2014-12-31,308186,223857,84329,벨리제,2014-12
2014-12-31,304370,431,303939,부탄,2014-12
2014-12-31,302777,56301065,-55998288,적도 기니,2014-12
2014-12-31,290083,94597,195486,스와질랜드,2014-12
2014-12-31,224637,0,224637,카보 베르데,2014-12
2014-12-31,221097,13919,207178,감비아,2014-12
2014-12-31,219075,0,219075,과델로프,2014-12
2014-12-31,200184,259,199925,세인트 키츠 네비스,2014-12
2014-12-31,188121,3451,184670,몬테네그로,2014-12
2014-12-31,181425,163,181262,큐라소,2014-12
2014-12-31,128765,122360,6405,파로에 군도,2014-12
2014-12-31,113503,4913,108590,미령 버진군도,2014-12
2014-12-31,108567,0,108567,지브랄타,2014-12
2014-12-31,98653,5078,93575,부룬디,2014-12
2014-12-31,85622,0,85622,노폴크 아일랜드,2014-12
2014-12-31,74822,0,74822,국제통화기금,2014-12
2014-12-31,63230,0,63230,투르크 & 카이코스 군도,2014-12
2014-12-31,50552,56,50496,챠드,2014-12
2014-12-31,43378,0,43378,그레나다,2014-12
2014-12-31,40374,0,40374,교황청,2014-12
2014-12-31,36758,0,36758,쿡 아일랜드,2014-12
2014-12-31,33202,18967,14235,중앙아프리카공화국,2014-12
2014-12-31,26102,0,26102,세인트 빈센트 그레나딘,2014-12
2014-12-31,24580,4173,20407,기네비소,2014-12
2014-12-31,18445,26613,-8168,산마리노,2014-12
2014-12-31,16508,0,16508,남수단,2014-12
2014-12-31,11267,457260,-445993,그린랜드,2014-12
2014-12-31,7290,0,7290,앙귈라,2014-12
2014-12-31,5609,16,5593,남조지아 & 남샌드위치 군도,2014-12
2014-12-31,2691,277013,-274322,통가,2014-12
2014-12-31,2404,0,2404,건지,2014-12
2014-12-31,222,5481,-5259,안도라,2014-12
2014-12-31,101,0,101,세인트 마틴,2014-12
2014-12-31,0,875,-875,메요트,2014-12
2014-12-31,0,10582,-10582,코모로스,2014-12
2014-12-31,0,67,-67,크리스마스 아일랜드,2014-12
2014-12-31,0,2387,-2387,코스 군도,2014-12
2014-12-31,0,2096,-2096,나우루,2014-12
2014-12-31,0,11107,-11107,토켈라우,2014-12
2014-12-31,0,456,-456,왈라스 & 퓨투나 군도,2014-12
2014-12-31,0,210,-210,맨섬,2014-12
2014-12-31,0,761,-761,서사하라,2014-12
2014-12-31,0,7822,-7822,포클랜드 군도,2014-12
2015-01-31,12083947251,8143271146,3940676105,중국,2015-01
2015-01-31,5561545397,3625061884,1936483513,미국,2015-01
2015-01-31,2251306583,3827246849,-1575940266,일본,2015-01
2015-01-31,2170483312,175487495,1994995817,홍콩,2015-01
2015-01-31,2163835578,704086438,1459749140,베트남,2015-01
2015-01-31,1717014231,826658133,890356098,싱가포르,2015-01
2015-01-31,1552810626,1275512,1551535114,앙골라,2015-01
2015-01-31,1060959303,1513687205,-452727902,대만,2015-01
2015-01-31,995701120,435419004,560282116,인도,2015-01
2015-01-31,797796210,141819322,655976888,멕시코,2015-01
2015-01-31,760970009,1623382718,-862412709,호주,2015-01
2015-01-31,720435994,275216752,445219242,필리핀,2015-01
2015-01-31,714823943,1686373324,-971549381,사우디아라비아,2015-01
2015-01-31,713032627,900,713031727,버뮤다,2015-01
2015-01-31,699581181,830697148,-131115967,인도네시아,2015-01
2015-01-31,664692584,1092,664691492,마샬군도,2015-01
2015-01-31,656207432,458019847,198187585,브라질,2015-01
2015-01-31,540660837,417506836,123154001,태국,2015-01
2015-01-31,495244701,65657999,429586702,튀르키예,2015-01
2015-01-31,474884388,1611616157,-1136731769,독일,2015-01
2015-01-31,474758961,947884717,-473125756,말레이시아,2015-01
2015-01-31,464999538,819774427,-354774889,아랍에미리트 연합,2015-01
2015-01-31,423696168,469588576,-45892408,영국,2015-01
2015-01-31,379976757,144316581,235660176,이란,2015-01
2015-01-31,357349844,382965182,-25615338,캐나다,2015-01
2015-01-31,355128953,21533922,333595031,슬로바키아,2015-01
2015-01-31,331274892,986909175,-655634283,러시아 연방,2015-01
2015-01-31,304672749,2123994,302548755,파나마,2015-01
2015-01-31,291050748,49988291,241062457,폴란드,2015-01
2015-01-31,280555505,472902197,-192346692,이탈리아,2015-01
2015-01-31,239745002,427300329,-187555327,네덜란드,2015-01
2015-01-31,221950966,264009167,-42058201,벨기에,2015-01
2015-01-31,179821083,431479492,-251658409,프랑스,2015-01
2015-01-31,177619040,279299934,-101680894,스페인,2015-01
2015-01-31,169175299,17730573,151444726,이집트,2015-01
2015-01-31,161908356,44756356,117152000,체코공화국,2015-01
2015-01-31,157414729,414719897,-257305168,칠레,2015-01
2015-01-31,137706488,131435672,6270816,페루,2015-01
2015-01-31,132448532,574965175,-442516643,이라크,2015-01
2015-01-31,126702934,8657937,118044997,슬로베니아,2015-01
2015-01-31,115915584,5959402,109956182,몰타,2015-01
2015-01-31,108752528,61466750,47285778,콜롬비아,2015-01
2015-01-31,107960031,84432476,23527555,이스라엘,2015-01
2015-01-31,107048498,1837985,105210513,우즈베키스탄,2015-01
2015-01-31,97453500,47194534,50258966,헝가리,2015-01
2015-01-31,97160744,129371592,-32210848,뉴질랜드,2015-01
2015-01-31,95436655,7318535,88118120,요르단,2015-01
2015-01-31,94348526,27897024,66451502,방글라데시,2015-01
2015-01-31,92111191,133301010,-41189819,남아프리카공화국,2015-01
2015-01-31,87187870,790579599,-703391729,쿠웨이트,2015-01
2015-01-31,86428830,70485014,15943816,아르헨티나,2015-01
2015-01-31,84238779,173913624,-89674845,알제리,2015-01
2015-01-31,78092680,17095676,60997004,포루투갈,2015-01
2015-01-31,70500000,0,70500000,맨섬,2015-01
2015-01-31,69781904,38875721,30906183,미얀마,2015-01
2015-01-31,69262681,96657447,-27394766,오스트리아,2015-01
2015-01-31,66514428,48407234,18107194,에쿠아도르,2015-01
2015-01-31,66254447,507752062,-441497615,오만,2015-01
2015-01-31,65968746,75021204,-9052458,아일랜드,2015-01
2015-01-31,65257902,1821922562,-1756664660,카타르,2015-01
2015-01-31,64837443,24930414,39907029,파키스탄,2015-01
2015-01-31,57230840,2146322,55084518,파푸아 뉴기니,2015-01
2015-01-31,55532584,20760916,34771668,캄보디아,2015-01
2015-01-31,51151177,76772689,-25621512,나이지리아,2015-01
2015-01-31,49492736,216573230,-167080494,스웨덴,2015-01
2015-01-31,45462732,12590043,32872689,푸에르토리코,2015-01
2015-01-31,42926728,10145125,32781603,카자흐스탄,2015-01
2015-01-31,42334491,2456341,39878150,리비아,2015-01
2015-01-31,39318185,44028394,-4710209,루마니아,2015-01
2015-01-31,31936910,62966354,-31029444,덴마크,2015-01
2015-01-31,30196380,199444178,-169247798,스위스,2015-01
2015-01-31,23491062,8011129,15479933,스리랑카,2015-01
2015-01-31,22210779,9006373,13204406,모로코,2015-01
2015-01-31,21560992,103561756,-82000764,핀란드,2015-01
2015-01-31,21208740,11633452,9575288,과테말라,2015-01
2015-01-31,21142598,119031773,-97889175,우크라이나,2015-01
2015-01-31,20959895,1805422,19154473,케냐,2015-01
2015-01-31,19884422,3516669,16367753,우루과이,2015-01
2015-01-31,19724110,166,19723944,시리아,2015-01
2015-01-31,19431475,23682331,-4250856,그리스,2015-01
2015-01-31,18869199,1735642,17133557,레바논,2015-01
2015-01-31,18428264,3546259,14882005,가나,2015-01
2015-01-31,18409674,5533691,12875983,몽골,2015-01
2015-01-31,18192966,4503585,13689381,리투아니아,2015-01
2015-01-31,16210247,44359,16165888,아제르바이잔,2015-01
2015-01-31,15809586,57795893,-41986307,바레인,2015-01
2015-01-31,15711115,7303099,8408016,도미니카 공화국,2015-01
2015-01-31,15398463,1471099,13927364,수단,2015-01
2015-01-31,15358126,2836,15355290,투르크멘,2015-01
2015-01-31,14839835,414658,14425177,피지,2015-01
2015-01-31,14665498,708998,13956500,파라과이,2015-01
2015-01-31,14447719,696984,13750735,베네주엘라,2015-01
2015-01-31,14175308,4736544,9438764,튀니지,2015-01
2015-01-31,13038840,1320030,11718810,조지아,2015-01
2015-01-31,12231399,141718367,-129486968,예맨,2015-01
2015-01-31,11977749,208542625,-196564876,노르웨이,2015-01
2015-01-31,11577545,2477778,9099767,라오스,2015-01
2015-01-31,11415937,3784154,7631783,뉴 칼레도니아,2015-01
2015-01-31,11029089,1568371,9460718,엘살바도르,2015-01
2015-01-31,10596390,1492109,9104281,코트디봐르,2015-01
2015-01-31,10548396,2333090,8215306,탄자니아,2015-01
2015-01-31,10176416,6483520,3692896,불가리아,2015-01
2015-01-31,10033900,1673410,8360490,니카라과,2015-01
2015-01-31,9541715,295435,9246280,팔레스타인 해방기구,2015-01
2015-01-31,8629852,15969252,-7339400,코스타리카,2015-01
2015-01-31,7796949,1913346,5883603,에티오피아,2015-01
2015-01-31,7591622,26573139,-18981517,볼리비아,2015-01
2015-01-31,7295096,820044,6475052,온두라스,2015-01
2015-01-31,6830705,329601,6501104,키르기스스탄,2015-01
2015-01-31,6305995,541390,5764605,크로아티아,2015-01
2015-01-31,6274682,39103792,-32829110,트리니다드 토바고,2015-01
2015-01-31,5946324,4401201,1545123,라트비아,2015-01
2015-01-31,5653879,2263,5651616,아프카니스탄,2015-01
2015-01-31,5140673,8771337,-3630664,에스토니아,2015-01
2015-01-31,5073854,3245918,1827936,세네갈,2015-01
2015-01-31,4986192,13413,4972779,모잠비크,2015-01
2015-01-31,4936871,63215560,-58278689,브루나이,2015-01
2015-01-31,4912509,0,4912509,지부티,2015-01
2015-01-31,4172939,137566,4035373,괌,2015-01
2015-01-31,4170315,9712992,-5542677,세르비아,2015-01
2015-01-31,3966179,374660,3591519,마카오,2015-01
2015-01-31,3785836,304608,3481228,베닝,2015-01
2015-01-31,3329911,321081,3008830,사이프러스,2015-01
2015-01-31,3233073,28308,3204765,사모아,2015-01
2015-01-31,2766926,3223301,-456375,기니,2015-01
2015-01-31,2713480,620147,2093333,아이티,2015-01
2015-01-31,2651547,6116526,-3464979,콩고,2015-01
2015-01-31,2430167,362064,2068103,모리셔스,2015-01
2015-01-31,2378525,14055494,-11676969,마다카스카르,2015-01
2015-01-31,2339580,212020,2127560,라이베리아,2015-01
2015-01-31,2227323,953354,1273969,쿠바,2015-01
2015-01-31,2190435,177367,2013068,세이쉘,2015-01
2015-01-31,2186773,2664485,-477712,짐바브웨,2015-01
2015-01-31,2179344,7548557,-5369213,토고,2015-01
2015-01-31,2163540,2759515,-595975,아이슬란드,2015-01
2015-01-31,1962564,5442726,-3480162,말라위,2015-01
2015-01-31,1866133,31677723,-29811590,잠비아,2015-01
2015-01-31,1796454,77190,1719264,네덜란드 열도,2015-01
2015-01-31,1727478,4569065,-2841587,벨라루스,2015-01
2015-01-31,1719894,425953,1293941,카메룬,2015-01
2015-01-31,1684806,4279582,-2594776,기타국,2015-01
2015-01-31,1606566,85656,1520910,네팔,2015-01
2015-01-31,1550346,3716107,-2165761,아루바,2015-01
2015-01-31,1506576,0,1506576,불령 폴리네시아,2015-01
2015-01-31,1454575,250302,1204273,수리남,2015-01
2015-01-31,1398749,10717867,-9319118,바하마,2015-01
2015-01-31,1371465,1954,1369511,말리,2015-01
2015-01-31,1262729,16540388,-15277659,콩고민주공화국,2015-01
2015-01-31,1244476,3958486,-2714010,타지크,2015-01
2015-01-31,1186830,235712,951118,부르키나 파소,2015-01
2015-01-31,1007162,0,1007162,바베이도스,2015-01
2015-01-31,940357,0,940357,불령 리유니온 코모도 제도,2015-01
2015-01-31,917747,1085915,-168168,자마이카,2015-01
2015-01-31,910965,1938,909027,세인트 키츠 네비스,2015-01
2015-01-31,904206,2066,902140,북마리아나 군도,2015-01
2015-01-31,900959,672372,228587,아메리칸 사모아,2015-01
2015-01-31,896222,175141,721081,알바니아,2015-01
2015-01-31,888381,2604172,-1715791,룩셈부르그,2015-01
2015-01-31,854776,111909,742867,르완다,2015-01
2015-01-31,839642,82432,757210,우간다,2015-01
2015-01-31,825046,91783,733263,티모르,2015-01
2015-01-31,782683,1157262,-374579,몰도바,2015-01
2015-01-31,747955,0,747955,영령 버진군도,2015-01
2015-01-31,707018,166586,540432,가이아나,2015-01
2015-01-31,661987,777080,-115093,리히텐슈타인,2015-01
2015-01-31,659752,10425846,-9766094,가봉,2015-01
2015-01-31,630239,1404603,-774364,시에라 리온,2015-01
2015-01-31,583071,464,582607,마티니크,2015-01
2015-01-31,564798,414,564384,영령 캐이맨 군도,2015-01
2015-01-31,460819,10065,450754,보츠와나,2015-01
2015-01-31,435938,1446,434492,벨리제,2015-01
2015-01-31,434477,5000610,-4566133,나미비아,2015-01
2015-01-31,405025,300773,104252,키리바티,2015-01
2015-01-31,401996,1425134,-1023138,바누아투,2015-01
2015-01-31,394510,225920,168590,스와질랜드,2015-01
2015-01-31,357514,2335682,-1978168,모리타니,2015-01
2015-01-31,325857,99,325758,챠드,2015-01
2015-01-31,305988,0,305988,안티가 바부다,2015-01
2015-01-31,305132,791819,-486687,보스니아-헤르체고비나,2015-01
2015-01-31,303790,291884,11906,아르메니아,2015-01
2015-01-31,297175,13833883,-13536708,에리트리아,2015-01
2015-01-31,285593,0,285593,세인트 빈센트 그레나딘,2015-01
2015-01-31,281516,30997,250519,마이크로네시아,2015-01
2015-01-31,265250,1900,263350,세인트 루시아,2015-01
2015-01-31,256057,255996,61,소말리아,2015-01
2015-01-31,247559,0,247559,국제통화기금,2015-01
2015-01-31,242270,0,242270,과델로프,2015-01
2015-01-31,234287,2080,232207,몰디브,2015-01
2015-01-31,230424,1844,228580,부탄,2015-01
2015-01-31,209891,603315,-393424,솔로몬 군도,2015-01
2015-01-31,181155,0,181155,메요트,2015-01
2015-01-31,174795,502,174293,팔라우,2015-01
2015-01-31,132174,0,132174,투르크 & 카이코스 군도,2015-01
2015-01-31,130398,0,130398,도미니카,2015-01
2015-01-31,130148,0,130148,지브랄타,2015-01
2015-01-31,107305,19052,88253,니제르,2015-01
2015-01-31,104127,31451,72676,감비아,2015-01
2015-01-31,95670,0,95670,남수단,2015-01
2015-01-31,75850,4001,71849,안도라,2015-01
2015-01-31,72988,0,72988,그레나다,2015-01
2015-01-31,63620,6307,57313,통가,2015-01
2015-01-31,59867,133658699,-133598832,적도 기니,2015-01
2015-01-31,45927,83489,-37562,마세도니아,2015-01
2015-01-31,39919,0,39919,카보 베르데,2015-01
2015-01-31,37429,121146,-83717,불령 가이아나,2015-01
2015-01-31,32381,0,32381,레소토,2015-01
2015-01-31,31084,22,31062,쿡 아일랜드,2015-01
2015-01-31,26267,0,26267,중앙아프리카공화국,2015-01
2015-01-31,16116,1019,15097,몬테네그로,2015-01
2015-01-31,12731,400889,-388158,모나코,2015-01
2015-01-31,12012,159,11853,앙귈라,2015-01
2015-01-31,8150,0,8150,세인트 헬레나,2015-01
2015-01-31,7391,13956,-6565,부룬디,2015-01
2015-01-31,1600,250479,-248879,포클랜드 군도,2015-01
2015-01-31,1286,7281,-5995,미령 버진군도,2015-01
2015-01-31,540,0,540,파로에 군도,2015-01
2015-01-31,534,31479,-30945,남조지아 & 남샌드위치 군도,2015-01
2015-01-31,0,218,-218,코모로스,2015-01
2015-01-31,0,70,-70,크리스마스 아일랜드,2015-01
2015-01-31,0,345,-345,마이너 아우틀링 합중국 군도,2015-01
2015-01-31,0,4273,-4273,니우에,2015-01
2015-01-31,0,35,-35,산마리노,2015-01
2015-01-31,0,103,-103,몬트세라트,2015-01
2015-01-31,0,161260,-161260,기네비소,2015-01
2015-01-31,0,184208,-184208,그린랜드,2015-01
2015-01-31,0,153029,-153029,토켈라우,2015-01
2015-01-31,0,2425,-2425,세인트 바르탤르미,2015-01
2015-01-31,0,1851,-1851,코스 군도,2015-01
2015-01-31,0,17,-17,나우루,2015-01
2015-02-28,9927641709,6980873854,2946767855,중국,2015-02
2015-02-28,5021263686,2998216182,2023047504,미국,2015-02
2015-02-28,2435701129,219139802,2216561327,노르웨이,2015-02
2015-02-28,2000724388,3837614341,-1836889953,일본,2015-02
2015-02-28,1967141454,634666741,1332474713,베트남,2015-02
2015-02-28,1825242874,1451232359,374010515,호주,2015-02
2015-02-28,1810259426,145085731,1665173695,홍콩,2015-02
2015-02-28,1147169890,20686,1147149204,마샬군도,2015-02
2015-02-28,974583734,1279351256,-304767522,대만,2015-02
2015-02-28,960099267,321323023,638776244,인도,2015-02
2015-02-28,852298053,643937065,208360988,싱가포르,2015-02
2015-02-28,798257703,123716838,674540865,멕시코,2015-02
2015-02-28,692942839,1658847261,-965904422,사우디아라비아,2015-02
2015-02-28,672202926,277795103,394407823,필리핀,2015-02
2015-02-28,658445920,785701456,-127255536,인도네시아,2015-02
2015-02-28,654090645,263427483,390663162,브라질,2015-02
2015-02-28,543730532,366289347,177441185,태국,2015-02
2015-02-28,480821738,733851338,-253029600,아랍에미리트 연합,2015-02
2015-02-28,470053838,664774552,-194720714,말레이시아,2015-02
2015-02-28,431951683,53907056,378044627,튀르키예,2015-02
2015-02-28,401384148,1623085848,-1221701700,독일,2015-02
2015-02-28,371405420,274495635,96909785,캐나다,2015-02
2015-02-28,359466844,214529603,144937241,이란,2015-02
2015-02-28,345344375,385874312,-40529937,영국,2015-02
2015-02-28,324082763,1004892297,-680809534,러시아 연방,2015-02
2015-02-28,288211107,406680347,-118469240,이탈리아,2015-02
2015-02-28,265663662,14335794,251327868,슬로바키아,2015-02
2015-02-28,255079048,428666887,-173587839,네덜란드,2015-02
2015-02-28,249784442,43677,249740765,베네주엘라,2015-02
2015-02-28,213288163,57908954,155379209,폴란드,2015-02
2015-02-28,173245028,2724124,170520904,이집트,2015-02
2015-02-28,157046935,105038701,52008234,스페인,2015-02
2015-02-28,146307373,379048890,-232741517,프랑스,2015-02
2015-02-28,141448234,390839420,-249391186,칠레,2015-02
2015-02-28,137193009,91590618,45602391,벨기에,2015-02
2015-02-28,125419516,94149399,31270117,뉴질랜드,2015-02
2015-02-28,123588764,1306008323,-1182419559,카타르,2015-02
2015-02-28,120510870,37348283,83162587,헝가리,2015-02
2015-02-28,114833112,36584061,78249051,체코공화국,2015-02
2015-02-28,111062326,1290451,109771875,우즈베키스탄,2015-02
2015-02-28,99534900,7336534,92198366,슬로베니아,2015-02
2015-02-28,98286828,375553333,-277266505,이라크,2015-02
2015-02-28,94989571,19636467,75353104,콜롬비아,2015-02
2015-02-28,92229710,65273066,26956644,알제리,2015-02
2015-02-28,88858985,82435482,6423503,페루,2015-02
2015-02-28,84622110,125843145,-41221035,남아프리카공화국,2015-02
2015-02-28,81569510,34313769,47255741,방글라데시,2015-02
2015-02-28,78409377,74718024,3691353,이스라엘,2015-02
2015-02-28,74681172,6314690,68366482,요르단,2015-02
2015-02-28,74225463,89890915,-15665452,오스트리아,2015-02
2015-02-28,72911724,40304251,32607473,미얀마,2015-02
2015-02-28,72417247,791715966,-719298719,쿠웨이트,2015-02
2015-02-28,71308930,77,71308853,맨섬,2015-02
2015-02-28,71125041,2025053,69099988,토고,2015-02
2015-02-28,65999346,360253854,-294254508,오만,2015-02
2015-02-28,62989846,64315162,-1325316,아르헨티나,2015-02
2015-02-28,62358861,96112204,-33753343,덴마크,2015-02
2015-02-28,61897056,5551680,56345376,에쿠아도르,2015-02
2015-02-28,59548061,1121259,58426802,앙골라,2015-02
2015-02-28,56609025,19249000,37360025,파키스탄,2015-02
2015-02-28,49602522,93792147,-44189625,나이지리아,2015-02
2015-02-28,49198435,45303650,3894785,루마니아,2015-02
2015-02-28,49050838,2887160,46163678,파나마,2015-02
2015-02-28,48530527,97854252,-49323725,스웨덴,2015-02
2015-02-28,47563917,19953032,27610885,캄보디아,2015-02
2015-02-28,42956116,42345727,610389,예맨,2015-02
2015-02-28,39190578,12283197,26907381,카자흐스탄,2015-02
2015-02-28,38254343,103296217,-65041874,핀란드,2015-02
2015-02-28,37675148,494862,37180286,리비아,2015-02
2015-02-28,34473548,1891436,32582112,세네갈,2015-02
2015-02-28,32563400,67477,32495923,라이베리아,2015-02
2015-02-28,26466061,15505217,10960844,포루투갈,2015-02
2015-02-28,26240851,53434554,-27193703,아일랜드,2015-02
2015-02-28,26080963,189801994,-163721031,스위스,2015-02
2015-02-28,23096497,8247145,14849352,우루과이,2015-02
2015-02-28,22569736,2055615,20514121,케냐,2015-02
2015-02-28,21401353,17472857,3928496,과테말라,2015-02
2015-02-28,21000524,6688824,14311700,도미니카 공화국,2015-02
2015-02-28,20433870,3774996,16658874,리투아니아,2015-02
2015-02-28,20305802,16435116,3870686,모로코,2015-02
2015-02-28,18806971,73707564,-54900593,우크라이나,2015-02
2015-02-28,18774962,1508878,17266084,수단,2015-02
2015-02-28,18704763,13685066,5019697,코스타리카,2015-02
2015-02-28,17931672,1159982,16771690,파라과이,2015-02
2015-02-28,17864696,5157400,12707296,스리랑카,2015-02
2015-02-28,17663051,57473,17605578,시리아,2015-02
2015-02-28,16616429,3009639,13606790,가나,2015-02
2015-02-28,16158986,60,16158926,아제르바이잔,2015-02
2015-02-28,16012085,15487821,524264,푸에르토리코,2015-02
2015-02-28,15410091,2293784,13116307,레바논,2015-02
2015-02-28,15109960,36643782,-21533822,바레인,2015-02
2015-02-28,14617427,36433547,-21816120,그리스,2015-02
2015-02-28,13317722,26689136,-13371414,볼리비아,2015-02
2015-02-28,13288238,10708316,2579922,뉴 칼레도니아,2015-02
2015-02-28,12724499,4336770,8387729,튀니지,2015-02
2015-02-28,12684625,768231,11916394,엘살바도르,2015-02
2015-02-28,12524012,3603526,8920486,몽골,2015-02
2015-02-28,11566363,23532168,-11965805,탄자니아,2015-02
2015-02-28,11234617,386986,10847631,트리니다드 토바고,2015-02
2015-02-28,10931424,1593331,9338093,라오스,2015-02
2015-02-28,9955935,3401532,6554403,라트비아,2015-02
2015-02-28,9657094,1221773,8435321,에티오피아,2015-02
2015-02-28,9496183,0,9496183,팔레스타인 해방기구,2015-02
2015-02-28,8890494,2073,8888421,투르크멘,2015-02
2015-02-28,8204683,31418102,-23213419,파푸아 뉴기니,2015-02
2015-02-28,8045412,1144935,6900477,코트디봐르,2015-02
2015-02-28,8029143,712881,7316262,크로아티아,2015-02
2015-02-28,7656210,5276271,2379939,온두라스,2015-02
2015-02-28,7587742,118750199,-111162457,브루나이,2015-02
2015-02-28,7108911,962517,6146394,니카라과,2015-02
2015-02-28,5629765,364021,5265744,피지,2015-02
2015-02-28,5534168,321623,5212545,모잠비크,2015-02
2015-02-28,5313071,4578616,734455,불가리아,2015-02
2015-02-28,5156473,37298,5119175,마이크로네시아,2015-02
2015-02-28,4810858,787,4810071,아프카니스탄,2015-02
2015-02-28,4777319,754516,4022803,조지아,2015-02
2015-02-28,4600542,118699,4481843,키르기스스탄,2015-02
2015-02-28,4537387,401428,4135959,부르키나 파소,2015-02
2015-02-28,4225172,10403806,-6178634,세르비아,2015-02
2015-02-28,3757710,194560,3563150,괌,2015-02
2015-02-28,3602306,7657140,-4054834,에스토니아,2015-02
2015-02-28,3229225,2335583,893642,기니,2015-02
2015-02-28,3100181,61735,3038446,가이아나,2015-02
2015-02-28,3060421,356222,2704199,모리셔스,2015-02
2015-02-28,3027513,105036,2922477,카메룬,2015-02
2015-02-28,2886704,0,2886704,지부티,2015-02
2015-02-28,2848019,2375677,472342,아이슬란드,2015-02
2015-02-28,2790864,17,2790847,불령 폴리네시아,2015-02
2015-02-28,2704504,19598053,-16893549,잠비아,2015-02
2015-02-28,2537703,2794962,-257259,마다카스카르,2015-02
2015-02-28,2469270,85832,2383438,사모아,2015-02
2015-02-28,2383045,3685063,-1302018,콩고,2015-02
2015-02-28,2324422,6464168,-4139746,몰타,2015-02
2015-02-28,2244182,636869,1607313,마카오,2015-02
2015-02-28,2222399,20026461,-17804062,콩고민주공화국,2015-02
2015-02-28,2102595,163478,1939117,아이티,2015-02
2015-02-28,1985710,1728,1983982,베닝,2015-02
2015-02-28,1975015,206,1974809,불령 리유니온 코모도 제도,2015-02
2015-02-28,1923051,1266,1921785,타지크,2015-02
2015-02-28,1922868,219862,1703006,짐바브웨,2015-02
2015-02-28,1915102,46263,1868839,네덜란드 열도,2015-02
2015-02-28,1885735,81160,1804575,쿠바,2015-02
2015-02-28,1830400,4805653,-2975253,벨라루스,2015-02
2015-02-28,1660165,0,1660165,아루바,2015-02
2015-02-28,1513266,902723,610543,사이프러스,2015-02
2015-02-28,1442708,119256,1323452,네팔,2015-02
2015-02-28,1440667,105,1440562,바하마,2015-02
2015-02-28,1404820,3469068,-2064248,룩셈부르그,2015-02
2015-02-28,1183099,262640,920459,세이쉘,2015-02
2015-02-28,932216,6171287,-5239071,기타국,2015-02
2015-02-28,928403,698411,229992,보스니아-헤르체고비나,2015-02
2015-02-28,905289,41777107,-40871818,가봉,2015-02
2015-02-28,904383,167701,736682,자마이카,2015-02
2015-02-28,829740,77206,752534,수리남,2015-02
2015-02-28,820367,45,820322,북마리아나 군도,2015-02
2015-02-28,769345,80309,689036,아르메니아,2015-02
2015-02-28,696769,8832,687937,바베이도스,2015-02
2015-02-28,687360,586428,100932,시에라 리온,2015-02
2015-02-28,683679,2494117,-1810438,우간다,2015-02
2015-02-28,676224,0,676224,도미니카,2015-02
2015-02-28,665528,168,665360,키리바티,2015-02
2015-02-28,632123,2275165,-1643042,모리타니,2015-02
2015-02-28,621333,35764,585569,벨리제,2015-02
2015-02-28,598418,7641479,-7043061,말라위,2015-02
2015-02-28,578993,1680,577313,안티가 바부다,2015-02
2015-02-28,522041,0,522041,말리,2015-02
2015-02-28,486384,29,486355,티모르,2015-02
2015-02-28,460799,69730,391069,마세도니아,2015-02
2015-02-28,440458,4280,436178,몰디브,2015-02
2015-02-28,432063,1450031,-1017968,몰도바,2015-02
2015-02-28,427900,0,427900,에리트리아,2015-02
2015-02-28,416353,0,416353,버뮤다,2015-02
2015-02-28,403848,129133,274715,알바니아,2015-02
2015-02-28,397436,0,397436,영령 캐이맨 군도,2015-02
2015-02-28,371336,30376,340960,보츠와나,2015-02
2015-02-28,342653,127649,215004,아메리칸 사모아,2015-02
2015-02-28,333529,0,333529,과델로프,2015-02
2015-02-28,310681,3903330,-3592649,리히텐슈타인,2015-02
2015-02-28,306075,1151635,-845560,나미비아,2015-02
2015-02-28,305452,3171,302281,영령 버진군도,2015-02
2015-02-28,298164,84019,214145,스와질랜드,2015-02
2015-02-28,295441,221080,74361,바누아투,2015-02
2015-02-28,269488,31242,238246,르완다,2015-02
2015-02-28,267838,111,267727,세인트 키츠 네비스,2015-02
2015-02-28,239622,0,239622,마티니크,2015-02
2015-02-28,216515,0,216515,세인트 루시아,2015-02
2015-02-28,188259,293,187966,부탄,2015-02
2015-02-28,187034,0,187034,팔라우,2015-02
2015-02-28,173829,1314601,-1140772,솔로몬 군도,2015-02
2015-02-28,165482,0,165482,지브랄타,2015-02
2015-02-28,141634,188934,-47300,소말리아,2015-02
2015-02-28,136670,0,136670,국제통화기금,2015-02
2015-02-28,134138,42256,91882,불령 가이아나,2015-02
2015-02-28,117378,0,117378,그레나다,2015-02
2015-02-28,96495,0,96495,남수단,2015-02
2015-02-28,83464,0,83464,니제르,2015-02
2015-02-28,67039,0,67039,감비아,2015-02
2015-02-28,60688,0,60688,세인트 빈센트 그레나딘,2015-02
2015-02-28,58485,0,58485,메요트,2015-02
2015-02-28,56657,120,56537,챠드,2015-02
2015-02-28,54561,118935805,-118881244,적도 기니,2015-02
2015-02-28,36115,11486,24629,나우루,2015-02
2015-02-28,35579,34374,1205,안도라,2015-02
2015-02-28,35258,6488,28770,통가,2015-02
2015-02-28,35000,25281,9719,기네비소,2015-02
2015-02-28,28024,473733,-445709,모나코,2015-02
2015-02-28,23054,2033,21021,몬테네그로,2015-02
2015-02-28,20865,0,20865,큐라소,2015-02
2015-02-28,6259,0,6259,포클랜드 군도,2015-02
2015-02-28,5676,0,5676,카보 베르데,2015-02
2015-02-28,5490,0,5490,앙귈라,2015-02
2015-02-28,5440,0,5440,산마리노,2015-02
2015-02-28,3342,57375,-54033,부룬디,2015-02
2015-02-28,3200,0,3200,남조지아 & 남샌드위치 군도,2015-02
2015-02-28,1316,3679,-2363,세인트 헬레나,2015-02
2015-02-28,625,0,625,중앙아프리카공화국,2015-02
2015-02-28,146,0,146,세인트 마틴,2015-02
2015-02-28,0,375641,-375641,그린랜드,2015-02
2015-02-28,0,3093,-3093,니우에,2015-02
2015-02-28,0,9558,-9558,코모로스,2015-02
2015-02-28,0,853,-853,코스 군도,2015-02
2015-02-28,0,35593,-35593,몬트세라트,2015-02
2015-02-28,0,7455,-7455,쿡 아일랜드,2015-02
2015-02-28,0,31,-31,크리스마스 아일랜드,2015-02
2015-02-28,0,1121,-1121,레소토,2015-02
2015-02-28,0,5268,-5268,미령 버진군도,2015-02
2015-02-28,0,17619,-17619,토켈라우,2015-02
2015-03-31,11868032003,7226910580,4641121423,중국,2015-03
2015-03-31,6795063949,4055574194,2739489755,미국,2015-03
2015-03-31,2545223968,125162869,2420061099,홍콩,2015-03
2015-03-31,2443344217,701426389,1741917828,베트남,2015-03
2015-03-31,2127216181,4383839034,-2256622853,일본,2015-03
2015-03-31,1586323257,810564660,775758597,싱가포르,2015-03
2015-03-31,1393868613,307410501,1086458112,멕시코,2015-03
2015-03-31,1102064014,1462013922,-359949908,대만,2015-03
2015-03-31,1069518064,329535187,739982877,인도,2015-03
2015-03-31,887263733,1538677949,-651414216,사우디아라비아,2015-03
2015-03-31,818049932,266528255,551521677,필리핀,2015-03
2015-03-31,759677627,1308349230,-548671603,호주,2015-03
2015-03-31,683284893,385683391,297601502,브라질,2015-03
2015-03-31,675337966,772822429,-97484463,인도네시아,2015-03
2015-03-31,595743412,925992168,-330248756,말레이시아,2015-03
2015-03-31,583575983,726114749,-142538766,아랍에미리트 연합,2015-03
2015-03-31,571545297,464402031,107143266,태국,2015-03
2015-03-31,556922856,57351099,499571757,튀르키예,2015-03
2015-03-31,505957087,1871302055,-1365344968,독일,2015-03
2015-03-31,455233895,239489322,215744573,이란,2015-03
2015-03-31,452682688,333705834,118976854,캐나다,2015-03
2015-03-31,406407850,486668568,-80260718,영국,2015-03
2015-03-31,366014468,881557543,-515543075,러시아 연방,2015-03
2015-03-31,363656117,73690,363582427,라이베리아,2015-03
2015-03-31,356050977,546270824,-190219847,이탈리아,2015-03
2015-03-31,349248845,594969980,-245721135,프랑스,2015-03
2015-03-31,336413069,361786778,-25373709,네덜란드,2015-03
2015-03-31,306872908,26773857,280099051,몰타,2015-03
2015-03-31,303778096,21012258,282765838,슬로바키아,2015-03
2015-03-31,299553924,269694449,29859475,노르웨이,2015-03
2015-03-31,222088322,89500799,132587523,덴마크,2015-03
2015-03-31,216367384,13495625,202871759,파나마,2015-03
2015-03-31,213911997,64406378,149505619,폴란드,2015-03
2015-03-31,197148581,7726,197140855,마샬군도,2015-03
2015-03-31,195034753,180969983,14064770,스페인,2015-03
2015-03-31,182833021,33033027,149799994,이집트,2015-03
2015-03-31,167785041,130521935,37263106,벨기에,2015-03
2015-03-31,167679216,453861103,-286181887,칠레,2015-03
2015-03-31,150990229,118909327,32080902,뉴질랜드,2015-03
2015-03-31,144577389,43066370,101511019,체코공화국,2015-03
2015-03-31,129667489,846002,128821487,우즈베키스탄,2015-03
2015-03-31,121353554,674121169,-552767615,이라크,2015-03
2015-03-31,116589579,28846164,87743415,방글라데시,2015-03
2015-03-31,114766771,77627932,37138839,남아프리카공화국,2015-03
2015-03-31,113231708,7738820,105492888,슬로베니아,2015-03
2015-03-31,110157647,137643821,-27486174,알제리,2015-03
2015-03-31,107249616,19330771,87918845,콜롬비아,2015-03
2015-03-31,106188477,51846294,54342183,헝가리,2015-03
2015-03-31,105398269,83534883,21863386,이스라엘,2015-03
2015-03-31,99528969,67634600,31894369,페루,2015-03
2015-03-31,96751101,55588827,41162274,아르헨티나,2015-03
2015-03-31,92438319,99744010,-7305691,오스트리아,2015-03
2015-03-31,86552095,2604335,83947760,그리스,2015-03
2015-03-31,80094197,112741372,-32647175,예맨,2015-03
2015-03-31,79349813,1268352,78081461,앙골라,2015-03
2015-03-31,75861617,62337342,13524275,나이지리아,2015-03
2015-03-31,75470922,320410638,-244939716,오만,2015-03
2015-03-31,71808930,81,71808849,맨섬,2015-03
2015-03-31,69994008,21760247,48233761,캄보디아,2015-03
2015-03-31,67201282,21428736,45772546,파키스탄,2015-03
2015-03-31,65472532,813577970,-748105438,쿠웨이트,2015-03
2015-03-31,62767059,5277747,57489312,요르단,2015-03
2015-03-31,62578151,1716584961,-1654006810,카타르,2015-03
2015-03-31,58162656,63363741,-5201085,에쿠아도르,2015-03
2015-03-31,57883208,43618803,14264405,미얀마,2015-03
2015-03-31,47816947,122433330,-74616383,스웨덴,2015-03
2015-03-31,47068090,9957476,37110614,모로코,2015-03
2015-03-31,46093885,6880831,39213054,카자흐스탄,2015-03
2015-03-31,42488403,58238497,-15750094,루마니아,2015-03
2015-03-31,42164000,713697,41450303,리비아,2015-03
2015-03-31,41346502,565538,40780964,크로아티아,2015-03
2015-03-31,37687135,178241,37508894,마카오,2015-03
2015-03-31,36293843,2673966,33619877,토고,2015-03
2015-03-31,34556191,361272,34194919,피지,2015-03
2015-03-31,33829843,232299758,-198469915,스위스,2015-03
2015-03-31,30490929,16565433,13925496,포루투갈,2015-03
2015-03-31,29702857,7310621,22392236,뉴 칼레도니아,2015-03
2015-03-31,24756670,41945311,-17188641,과테말라,2015-03
2015-03-31,24386959,244986,24141973,파라과이,2015-03
2015-03-31,24104694,3552442,20552252,몽골,2015-03
2015-03-31,23306864,2394660,20912204,케냐,2015-03
2015-03-31,23066989,8236102,14830887,스리랑카,2015-03
2015-03-31,22799782,12704925,10094857,코스타리카,2015-03
2015-03-31,22311537,96508541,-74197004,아일랜드,2015-03
2015-03-31,20754390,1490830,19263560,수단,2015-03
2015-03-31,20455296,8419663,12035633,도미니카 공화국,2015-03
2015-03-31,19612363,117875367,-98263004,핀란드,2015-03
2015-03-31,19161104,4098825,15062279,가나,2015-03
2015-03-31,19060745,2360875,16699870,레바논,2015-03
2015-03-31,18950346,20661883,-1711537,리투아니아,2015-03
2015-03-31,17556548,19184684,-1628136,푸에르토리코,2015-03
2015-03-31,17281754,28572069,-11290315,바레인,2015-03
2015-03-31,16588279,9034700,7553579,우루과이,2015-03
2015-03-31,15571334,4198805,11372529,탄자니아,2015-03
2015-03-31,15318969,1369717,13949252,엘살바도르,2015-03
2015-03-31,15238527,3161968,12076559,라오스,2015-03
2015-03-31,15231758,69511585,-54279827,우크라이나,2015-03
2015-03-31,11879746,5361,11874385,투르크멘,2015-03
2015-03-31,11696554,13194673,-1498119,튀니지,2015-03
2015-03-31,10352836,15517823,-5164987,온두라스,2015-03
2015-03-31,10079832,2119867,7959965,코트디봐르,2015-03
2015-03-31,9986147,921128,9065019,니카라과,2015-03
2015-03-31,9738076,0,9738076,시리아,2015-03
2015-03-31,9473455,7625619,1847836,불가리아,2015-03
2015-03-31,9068109,4977193,4090916,에티오피아,2015-03
2015-03-31,8971081,36578292,-27607211,브루나이,2015-03
2015-03-31,8905673,0,8905673,팔레스타인 해방기구,2015-03
2015-03-31,8905070,3345,8901725,아제르바이잔,2015-03
2015-03-31,8887688,0,8887688,지부티,2015-03
2015-03-31,8631676,313505,8318171,모잠비크,2015-03
2015-03-31,8581866,137127,8444739,키르기스스탄,2015-03
2015-03-31,7780193,2316311,5463882,파푸아 뉴기니,2015-03
2015-03-31,6996429,29686421,-22689992,볼리비아,2015-03
2015-03-31,6346675,3066865,3279810,세네갈,2015-03
2015-03-31,6291241,765776,5525465,트리니다드 토바고,2015-03
2015-03-31,6117034,1708,6115326,아프카니스탄,2015-03
2015-03-31,5971286,73887,5897399,베네주엘라,2015-03
2015-03-31,5672278,341433,5330845,조지아,2015-03
2015-03-31,5647054,134775,5512279,괌,2015-03
2015-03-31,5004101,4796061,208040,라트비아,2015-03
2015-03-31,4755085,0,4755085,불령 폴리네시아,2015-03
2015-03-31,4724326,3699150,1025176,기니,2015-03
2015-03-31,4484031,512673,3971358,모리셔스,2015-03
2015-03-31,4447083,110,4446973,불령 리유니온 코모도 제도,2015-03
2015-03-31,4360903,14348239,-9987336,에스토니아,2015-03
2015-03-31,3931517,26581577,-22650060,세르비아,2015-03
2015-03-31,3812323,8848220,-5035897,벨라루스,2015-03
2015-03-31,3557979,2042165,1515814,아이슬란드,2015-03
2015-03-31,3407958,576729,2831229,베닝,2015-03
2015-03-31,3012592,31733,2980859,아이티,2015-03
2015-03-31,2937738,3070036,-132298,콩고,2015-03
2015-03-31,2899404,30141494,-27242090,콩고민주공화국,2015-03
2015-03-31,2890187,902119,1988068,말라위,2015-03
2015-03-31,2705020,18372,2686648,사모아,2015-03
2015-03-31,2650125,0,2650125,타지크,2015-03
2015-03-31,2449892,26085304,-23635412,잠비아,2015-03
2015-03-31,2444025,76960859,-74516834,가봉,2015-03
2015-03-31,2400816,934320,1466496,쿠바,2015-03
2015-03-31,2259432,188908,2070524,가이아나,2015-03
2015-03-31,2248680,110727,2137953,네팔,2015-03
2015-03-31,2234979,4790251,-2555272,말리,2015-03
2015-03-31,2146290,3615,2142675,네덜란드 열도,2015-03
2015-03-31,2128237,825903,1302334,세이쉘,2015-03
2015-03-31,2104408,601314,1503094,사이프러스,2015-03
2015-03-31,2023189,52192,1970997,우간다,2015-03
2015-03-31,1857980,441944,1416036,자마이카,2015-03
2015-03-31,1786244,132951,1653293,카메룬,2015-03
2015-03-31,1748588,11345740,-9597152,마다카스카르,2015-03
2015-03-31,1660248,466720,1193528,보스니아-헤르체고비나,2015-03
2015-03-31,1655726,0,1655726,아루바,2015-03
2015-03-31,1648645,316761,1331884,짐바브웨,2015-03
2015-03-31,1568408,119638,1448770,알바니아,2015-03
2015-03-31,1562725,0,1562725,버뮤다,2015-03
2015-03-31,1384302,561900,822402,부르키나 파소,2015-03
2015-03-31,1289663,127374,1162289,티모르,2015-03
2015-03-31,1140441,3878749,-2738308,룩셈부르그,2015-03
2015-03-31,1125430,273570,851860,아메리칸 사모아,2015-03
2015-03-31,1108026,97200,1010826,르완다,2015-03
2015-03-31,1036996,0,1036996,부룬디,2015-03
2015-03-31,1020051,570,1019481,북마리아나 군도,2015-03
2015-03-31,1005205,96156,909049,마세도니아,2015-03
2015-03-31,995738,3204769,-2209031,기타국,2015-03
2015-03-31,851382,5208,846174,바하마,2015-03
2015-03-31,851083,25344153,-24493070,보츠와나,2015-03
2015-03-31,837733,0,837733,과델로프,2015-03
2015-03-31,810542,1328728,-518186,키리바티,2015-03
2015-03-31,760630,0,760630,마티니크,2015-03
2015-03-31,716079,242602,473477,수리남,2015-03
2015-03-31,696122,793789,-97667,리히텐슈타인,2015-03
2015-03-31,664981,5087373,-4422392,모리타니,2015-03
2015-03-31,652860,1222,651638,니제르,2015-03
2015-03-31,615548,124,615424,영령 캐이맨 군도,2015-03
2015-03-31,608900,0,608900,바베이도스,2015-03
2015-03-31,569866,134010,435856,아르메니아,2015-03
2015-03-31,529408,536293,-6885,몰디브,2015-03
2015-03-31,484384,1182590,-698206,시에라 리온,2015-03
2015-03-31,483051,78073,404978,마이크로네시아,2015-03
2015-03-31,472446,29,472417,안티가 바부다,2015-03
2015-03-31,440001,0,440001,감비아,2015-03
2015-03-31,427942,3142,424800,세인트 키츠 네비스,2015-03
2015-03-31,408499,680520,-272021,나미비아,2015-03
2015-03-31,346241,0,346241,소말리아,2015-03
2015-03-31,342609,1471026,-1128417,몰도바,2015-03
2015-03-31,300301,0,300301,에리트리아,2015-03
2015-03-31,280390,256,280134,세인트 루시아,2015-03
2015-03-31,278583,193357,85226,벨리제,2015-03
2015-03-31,272984,630321,-357337,솔로몬 군도,2015-03
2015-03-31,271748,258,271490,부탄,2015-03
2015-03-31,262769,0,262769,도미니카,2015-03
2015-03-31,257269,0,257269,세인트 마틴,2015-03
2015-03-31,255043,1935,253108,팔라우,2015-03
2015-03-31,231251,86929221,-86697970,적도 기니,2015-03
2015-03-31,225108,0,225108,영령 버진군도,2015-03
2015-03-31,221158,0,221158,그레나다,2015-03
2015-03-31,205892,0,205892,지브랄타,2015-03
2015-03-31,199184,200918,-1734,바누아투,2015-03
2015-03-31,189370,0,189370,챠드,2015-03
2015-03-31,165768,0,165768,카보 베르데,2015-03
2015-03-31,165509,425,165084,레소토,2015-03
2015-03-31,134668,1909719,-1775051,스와질랜드,2015-03
2015-03-31,130464,0,130464,세인트 빈센트 그레나딘,2015-03
2015-03-31,122280,29197,93083,불령 가이아나,2015-03
2015-03-31,108319,0,108319,메요트,2015-03
2015-03-31,96439,0,96439,국제통화기금,2015-03
2015-03-31,96266,0,96266,남수단,2015-03
2015-03-31,34563,5970,28593,안도라,2015-03
2015-03-31,31905,0,31905,스발비드 군도,2015-03
2015-03-31,23795,0,23795,투발루,2015-03
2015-03-31,18110,60347,-42237,통가,2015-03
2015-03-31,18099,748,17351,나우루,2015-03
2015-03-31,16065,5130,10935,미령 버진군도,2015-03
2015-03-31,16038,0,16038,큐라소,2015-03
2015-03-31,12896,417113,-404217,모나코,2015-03
2015-03-31,11570,37638,-26068,기네비소,2015-03
2015-03-31,9340,10055,-715,산마리노,2015-03
2015-03-31,9106,93,9013,몬테네그로,2015-03
2015-03-31,9020,9735,-715,앙귈라,2015-03
2015-03-31,5017,0,5017,포클랜드 군도,2015-03
2015-03-31,4389,0,4389,상토메 프린스페,2015-03
2015-03-31,1999,20814,-18815,중앙아프리카공화국,2015-03
2015-03-31,254,0,254,파로에 군도,2015-03
2015-03-31,42,364978,-364936,그린랜드,2015-03
2015-03-31,0,83,-83,세인트 헬레나,2015-03
2015-03-31,0,5341,-5341,세인트 바르탤르미,2015-03
2015-03-31,0,255,-255,코스 군도,2015-03
2015-03-31,0,9887,-9887,토켈라우,2015-03
2015-03-31,0,347,-347,교황청,2015-03
2015-03-31,0,794,-794,몬트세라트,2015-03
2015-03-31,0,584665,-584665,안타티카,2015-03
2015-03-31,0,4796,-4796,피트카이른,2015-03
2015-03-31,0,7291,-7291,코모로스,2015-03
2015-03-31,0,149,-149,노폴크 아일랜드,2015-03
2015-03-31,0,9599,-9599,니우에,2015-03
2015-03-31,0,7245,-7245,투르크 & 카이코스 군도,2015-03
2015-04-30,11765636558,7648402488,4117234070,중국,2015-04
2015-04-30,6204676220,3842048672,2362627548,미국,2015-04
2015-04-30,2650179906,110120626,2540059280,홍콩,2015-04
2015-04-30,2461287388,724657058,1736630330,베트남,2015-04
2015-04-30,2380418820,4276097345,-1895678525,일본,2015-04
2015-04-30,1166926908,643590073,523336835,싱가포르,2015-04
2015-04-30,1146416991,1455796644,-309379653,대만,2015-04
2015-04-30,1059238981,367308198,691930783,인도,2015-04
2015-04-30,1040711807,366271471,674440336,멕시코,2015-04
2015-04-30,924825881,2010796324,-1085970443,사우디아라비아,2015-04
2015-04-30,841542328,744217031,97325297,인도네시아,2015-04
2015-04-30,812755350,1437302470,-624547120,호주,2015-04
2015-04-30,779559935,293721224,485838711,필리핀,2015-04
2015-04-30,686746166,704815463,-18069297,아랍에미리트 연합,2015-04
2015-04-30,591759473,261284010,330475463,브라질,2015-04
2015-04-30,573138351,432440089,140698262,태국,2015-04
2015-04-30,571895908,708522736,-136626828,말레이시아,2015-04
2015-04-30,550098607,226203919,323894688,스위스,2015-04
2015-04-30,541070760,1737493693,-1196422933,독일,2015-04
2015-04-30,535244287,429954562,105289725,영국,2015-04
2015-04-30,496682299,40193092,456489207,튀르키예,2015-04
2015-04-30,420772763,905927679,-485154916,러시아 연방,2015-04
2015-04-30,420115696,445664423,-25548727,캐나다,2015-04
2015-04-30,363624246,9536,363614710,마샬군도,2015-04
2015-04-30,362251966,202112979,160138987,이란,2015-04
2015-04-30,304873992,18221336,286652656,슬로바키아,2015-04
2015-04-30,287871998,1326769,286545229,파나마,2015-04
2015-04-30,275611401,414471720,-138860319,네덜란드,2015-04
2015-04-30,263850411,468555121,-204704710,이탈리아,2015-04
2015-04-30,256811677,26189633,230622044,이집트,2015-04
2015-04-30,245863984,119026895,126837089,덴마크,2015-04
2015-04-30,228836701,3412,228833289,라이베리아,2015-04
2015-04-30,211642474,73793191,137849283,폴란드,2015-04
2015-04-30,203698398,0,203698398,버뮤다,2015-04
2015-04-30,199505031,270976582,-71471551,스페인,2015-04
2015-04-30,178148914,112849231,65299683,벨기에,2015-04
2015-04-30,177772763,56123099,121649664,체코공화국,2015-04
2015-04-30,175802520,505682851,-329880331,프랑스,2015-04
2015-04-30,173976249,528351912,-354375663,칠레,2015-04
2015-04-30,170798480,1079307,169719173,우즈베키스탄,2015-04
2015-04-30,168113980,234663313,-66549333,이라크,2015-04
2015-04-30,157309943,29010447,128299496,방글라데시,2015-04
2015-04-30,155664453,6802617,148861836,몰타,2015-04
2015-04-30,136414193,273139280,-136725087,노르웨이,2015-04
2015-04-30,136390904,92938551,43452353,페루,2015-04
2015-04-30,131856565,148843688,-16987123,남아프리카공화국,2015-04
2015-04-30,122200417,104259135,17941282,오스트리아,2015-04
2015-04-30,118555893,11445811,107110082,슬로베니아,2015-04
2015-04-30,107548212,18694640,88853572,콜롬비아,2015-04
2015-04-30,107265903,72688613,34577290,이스라엘,2015-04
2015-04-30,89511324,9282259,80229065,요르단,2015-04
2015-04-30,86770240,12555891,74214349,알제리,2015-04
2015-04-30,84836895,665623488,-580786593,쿠웨이트,2015-04
2015-04-30,80319073,251502928,-171183855,오만,2015-04
2015-04-30,80259252,46411959,33847293,리비아,2015-04
2015-04-30,78040908,107629164,-29588256,뉴질랜드,2015-04
2015-04-30,71808930,0,71808930,맨섬,2015-04
2015-04-30,70941813,34602636,36339177,파키스탄,2015-04
2015-04-30,70589813,35517826,35071987,아르헨티나,2015-04
2015-04-30,68500577,62700375,5800202,헝가리,2015-04
2015-04-30,65458096,21541694,43916402,캄보디아,2015-04
2015-04-30,59194359,133597199,-74402840,스웨덴,2015-04
2015-04-30,57721862,194785866,-137064004,나이지리아,2015-04
2015-04-30,52794868,60131932,-7337064,루마니아,2015-04
2015-04-30,51992360,44992919,6999441,미얀마,2015-04
2015-04-30,44727766,956494,43771272,크로아티아,2015-04
2015-04-30,44184820,1566776655,-1522591835,카타르,2015-04
2015-04-30,39995790,4359787,35636003,에쿠아도르,2015-04
2015-04-30,39626085,297402,39328683,피지,2015-04
2015-04-30,35572596,25937185,9635411,카자흐스탄,2015-04
2015-04-30,34922598,12098782,22823816,모로코,2015-04
2015-04-30,32640417,24506722,8133695,포루투갈,2015-04
2015-04-30,31616130,15085921,16530209,과테말라,2015-04
2015-04-30,30975455,936123,30039332,앙골라,2015-04
2015-04-30,30519877,99596088,-69076211,아일랜드,2015-04
2015-04-30,27849033,5258581,22590452,몽골,2015-04
2015-04-30,27663690,4591827,23071863,리투아니아,2015-04
2015-04-30,26202917,16093400,10109517,코스타리카,2015-04
2015-04-30,24991467,7586727,17404740,스리랑카,2015-04
2015-04-30,24109531,96079430,-71969899,핀란드,2015-04
2015-04-30,23026137,575913,22450224,파라과이,2015-04
2015-04-30,22427447,19576071,2851376,푸에르토리코,2015-04
2015-04-30,22350398,7264560,15085838,도미니카 공화국,2015-04
2015-04-30,21622361,20494444,1127917,그리스,2015-04
2015-04-30,21330051,2241574,19088477,레바논,2015-04
2015-04-30,20268879,2533053,17735826,케냐,2015-04
2015-04-30,18843820,2933201,15910619,우루과이,2015-04
2015-04-30,18784228,3345659,15438569,라오스,2015-04
2015-04-30,17524738,65347465,-47822727,바레인,2015-04
2015-04-30,16584499,4105407,12479092,가나,2015-04
2015-04-30,16500023,84650,16415373,베네주엘라,2015-04
2015-04-30,15585053,0,15585053,팔레스타인 해방기구,2015-04
2015-04-30,15400930,2828332,12572598,튀니지,2015-04
2015-04-30,15350486,975176,14375310,니카라과,2015-04
2015-04-30,15337961,1386931,13951030,토고,2015-04
2015-04-30,12951963,3047603,9904360,에티오피아,2015-04
2015-04-30,11777435,57388227,-45610792,우크라이나,2015-04
2015-04-30,11725604,1381516,10344088,수단,2015-04
2015-04-30,11548938,4612152,6936786,온두라스,2015-04
2015-04-30,11447026,11170,11435856,시리아,2015-04
2015-04-30,11222888,21028364,-9805476,볼리비아,2015-04
2015-04-30,10817305,3326407,7490898,탄자니아,2015-04
2015-04-30,9523752,1535473,7988279,코트디봐르,2015-04
2015-04-30,9264002,703534,8560468,엘살바도르,2015-04
2015-04-30,9227079,776,9226303,아제르바이잔,2015-04
2015-04-30,8776335,4101,8772234,투르크멘,2015-04
2015-04-30,8111058,113740,7997318,키르기스스탄,2015-04
2015-04-30,7647247,36051,7611196,괌,2015-04
2015-04-30,7617488,5673102,1944386,불가리아,2015-04
2015-04-30,7594731,12695450,-5100719,세르비아,2015-04
2015-04-30,7529850,5763764,1766086,라트비아,2015-04
2015-04-30,7405460,7166162,239298,뉴 칼레도니아,2015-04
2015-04-30,7400234,750118,6650116,트리니다드 토바고,2015-04
2015-04-30,7334686,1139498,6195188,파푸아 뉴기니,2015-04
2015-04-30,6453339,4158159,2295180,벨라루스,2015-04
2015-04-30,6374042,0,6374042,지부티,2015-04
2015-04-30,5383266,10905,5372361,쿠바,2015-04
2015-04-30,5327114,418828,4908286,카메룬,2015-04
2015-04-30,5297688,118381053,-113083365,브루나이,2015-04
2015-04-30,5283358,5971657,-688299,에스토니아,2015-04
2015-04-30,5281172,3370719,1910453,기니,2015-04
2015-04-30,5162411,0,5162411,마이크로네시아,2015-04
2015-04-30,4967601,234615,4732986,아이티,2015-04
2015-04-30,4638563,936188,3702375,조지아,2015-04
2015-04-30,4196741,2873779,1322962,세네갈,2015-04
2015-04-30,4091493,321640,3769853,모리셔스,2015-04
2015-04-30,3692753,39893889,-36201136,사이프러스,2015-04
2015-04-30,3681709,1675,3680034,팔라우,2015-04
2015-04-30,3442575,9693,3432882,모잠비크,2015-04
2015-04-30,3275191,165763,3109428,마카오,2015-04
2015-04-30,3086798,4942435,-1855637,아이슬란드,2015-04
2015-04-30,2997367,41024,2956343,사모아,2015-04
2015-04-30,2946049,39101906,-36155857,잠비아,2015-04
2015-04-30,2757682,676700,2080982,콩고,2015-04
2015-04-30,2585152,414267,2170885,자마이카,2015-04
2015-04-30,2551667,135141,2416526,가이아나,2015-04
2015-04-30,2457886,6864,2451022,아프카니스탄,2015-04
2015-04-30,2444410,273587,2170823,아메리칸 사모아,2015-04
2015-04-30,2423589,2211779,211810,베닝,2015-04
2015-04-30,2411396,59216,2352180,네팔,2015-04
2015-04-30,1989268,60839994,-58850726,예맨,2015-04
2015-04-30,1975898,3036273,-1060375,기타국,2015-04
2015-04-30,1950340,3662,1946678,네덜란드 열도,2015-04
2015-04-30,1903696,421253,1482443,말리,2015-04
2015-04-30,1765288,14282,1751006,보츠와나,2015-04
2015-04-30,1735860,8148339,-6412479,마다카스카르,2015-04
2015-04-30,1722290,169450,1552840,알바니아,2015-04
2015-04-30,1676667,765314,911353,짐바브웨,2015-04
2015-04-30,1647664,37259595,-35611931,콩고민주공화국,2015-04
2015-04-30,1562985,42650867,-41087882,가봉,2015-04
2015-04-30,1486847,22022,1464825,르완다,2015-04
2015-04-30,1484568,5662,1478906,불령 리유니온 코모도 제도,2015-04
2015-04-30,1456738,1176,1455562,타지크,2015-04
2015-04-30,1429529,10014,1419515,바하마,2015-04
2015-04-30,1411845,779865,631980,보스니아-헤르체고비나,2015-04
2015-04-30,1358159,138392,1219767,세이쉘,2015-04
2015-04-30,1339949,3631917,-2291968,룩셈부르그,2015-04
2015-04-30,1233457,89552,1143905,아루바,2015-04
2015-04-30,1205940,448400,757540,부르키나 파소,2015-04
2015-04-30,1098244,44586,1053658,영령 캐이맨 군도,2015-04
2015-04-30,1003305,106016,897289,마세도니아,2015-04
2015-04-30,934652,0,934652,티모르,2015-04
2015-04-30,890487,0,890487,큐라소,2015-04
2015-04-30,881956,12497,869459,키리바티,2015-04
2015-04-30,851554,1347390,-495836,나미비아,2015-04
2015-04-30,812161,407750,404411,수리남,2015-04
2015-04-30,792778,0,792778,안티가 바부다,2015-04
2015-04-30,759293,0,759293,국제통화기금,2015-04
2015-04-30,673315,66263,607052,말라위,2015-04
2015-04-30,667736,0,667736,마티니크,2015-04
2015-04-30,624748,42998,581750,영령 버진군도,2015-04
2015-04-30,586344,62,586282,북마리아나 군도,2015-04
2015-04-30,584506,1920536,-1336030,우간다,2015-04
2015-04-30,581680,54,581626,니제르,2015-04
2015-04-30,571999,21571,550428,바베이도스,2015-04
2015-04-30,568182,463182,105000,리히텐슈타인,2015-04
2015-04-30,536818,437301,99517,스와질랜드,2015-04
2015-04-30,516355,0,516355,과델로프,2015-04
2015-04-30,502155,96382,405773,아르메니아,2015-04
2015-04-30,497091,2047168,-1550077,몰디브,2015-04
2015-04-30,432910,31683,401227,불령 폴리네시아,2015-04
2015-04-30,426542,1470162,-1043620,모리타니,2015-04
2015-04-30,389992,536980,-146988,시에라 리온,2015-04
2015-04-30,381869,0,381869,세인트 빈센트 그레나딘,2015-04
2015-04-30,320604,33297,287307,감비아,2015-04
2015-04-30,311773,613356,-301583,몰도바,2015-04
2015-04-30,289949,0,289949,그레나다,2015-04
2015-04-30,278571,913918,-635347,솔로몬 군도,2015-04
2015-04-30,272651,23639,249012,벨리제,2015-04
2015-04-30,258764,515919,-257155,바누아투,2015-04
2015-04-30,249619,430,249189,카보 베르데,2015-04
2015-04-30,216969,205,216764,세인트 루시아,2015-04
2015-04-30,212458,0,212458,도미니카,2015-04
2015-04-30,190811,68,190743,세인트 키츠 네비스,2015-04
2015-04-30,189649,0,189649,부탄,2015-04
2015-04-30,149773,20037,129736,안도라,2015-04
2015-04-30,128427,48,128379,불령 가이아나,2015-04
2015-04-30,86839,0,86839,챠드,2015-04
2015-04-30,79125,3020,76105,지브랄타,2015-04
2015-04-30,77214,5728,71486,산마리노,2015-04
2015-04-30,66956,0,66956,기네비소,2015-04
2015-04-30,63672,56257,7415,소말리아,2015-04
2015-04-30,43442,0,43442,투르크 & 카이코스 군도,2015-04
2015-04-30,34368,493865,-459497,모나코,2015-04
2015-04-30,30321,1062,29259,메요트,2015-04
2015-04-30,26012,28996,-2984,통가,2015-04
2015-04-30,17955,253,17702,중앙아프리카공화국,2015-04
2015-04-30,16676,1109,15567,몬테네그로,2015-04
2015-04-30,9600,0,9600,부룬디,2015-04
2015-04-30,9523,34867033,-34857510,적도 기니,2015-04
2015-04-30,7308,46,7262,몬트세라트,2015-04
2015-04-30,5970,179508,-173538,포클랜드 군도,2015-04
2015-04-30,4588,7629,-3041,미령 버진군도,2015-04
2015-04-30,2959,0,2959,쿡 아일랜드,2015-04
2015-04-30,1892,0,1892,에리트리아,2015-04
2015-04-30,130,0,130,앙귈라,2015-04
2015-04-30,70,0,70,세인트 마틴,2015-04
2015-04-30,28,0,28,남수단,2015-04
2015-04-30,0,573,-573,파로에 군도,2015-04
2015-04-30,0,927,-927,코스 군도,2015-04
2015-04-30,0,161,-161,나우루,2015-04
2015-04-30,0,299645,-299645,그린랜드,2015-04
2015-04-30,0,1217,-1217,크리스마스 아일랜드,2015-04
2015-04-30,0,3402964,-3402964,안타티카,2015-04
2015-04-30,0,12218,-12218,세인트 바르탤르미,2015-04
2015-04-30,0,1064,-1064,니우에,2015-04
2015-04-30,0,3070,-3070,토켈라우,2015-04
2015-04-30,0,14764,-14764,코모로스,2015-04
2015-05-31,10927132581,6993228668,3933903913,중국,2015-05
2015-05-31,5623941107,3529282931,2094658176,미국,2015-05
2015-05-31,2559831406,119096534,2440734872,홍콩,2015-05
2015-05-31,2331637206,3503700385,-1172063179,일본,2015-05
2015-05-31,2244149446,616332998,1627816448,베트남,2015-05
2015-05-31,1044615310,699688298,344927012,싱가포르,2015-05
2015-05-31,1007100789,399953364,607147425,멕시코,2015-05
2015-05-31,1004278904,398096721,606182183,인도,2015-05
2015-05-31,991491446,1338308997,-346817551,대만,2015-05
2015-05-31,932767846,620218852,312548994,영국,2015-05
2015-05-31,823556624,1202433352,-378876728,호주,2015-05
2015-05-31,751468777,2486127637,-1734658860,사우디아라비아,2015-05
2015-05-31,710386410,237071580,473314830,필리핀,2015-05
2015-05-31,641781590,538070757,103710833,말레이시아,2015-05
2015-05-31,639711631,723240323,-83528692,인도네시아,2015-05
2015-05-31,521473398,80880492,440592906,튀르키예,2015-05
2015-05-31,507295435,404019793,103275642,태국,2015-05
2015-05-31,504259512,653201967,-148942455,아랍에미리트 연합,2015-05
2015-05-31,482305560,1654668488,-1172362928,독일,2015-05
2015-05-31,443404666,267576399,175828267,네덜란드,2015-05
2015-05-31,422086372,100019693,322066679,덴마크,2015-05
2015-05-31,414899925,5214,414894711,마샬군도,2015-05
2015-05-31,413912061,341736239,72175822,브라질,2015-05
2015-05-31,384276672,390464237,-6187565,캐나다,2015-05
2015-05-31,381015548,809130479,-428114931,러시아 연방,2015-05
2015-05-31,356011082,231672283,124338799,이란,2015-05
2015-05-31,332562015,424919386,-92357371,이탈리아,2015-05
2015-05-31,320574425,700623575,-380049150,프랑스,2015-05
2015-05-31,284875770,23177917,261697853,슬로바키아,2015-05
2015-05-31,220360612,43763381,176597231,체코공화국,2015-05
2015-05-31,213020272,30790016,182230256,이집트,2015-05
2015-05-31,177837647,54931014,122906633,폴란드,2015-05
2015-05-31,172013139,187377909,-15364770,스페인,2015-05
2015-05-31,157993619,130894989,27098630,벨기에,2015-05
2015-05-31,146115311,169959807,-23844496,파나마,2015-05
2015-05-31,145358026,362869762,-217511736,칠레,2015-05
2015-05-31,133110795,493585755,-360474960,이라크,2015-05
2015-05-31,131900091,11293023,120607068,슬로베니아,2015-05
2015-05-31,120142558,1434629,118707929,우즈베키스탄,2015-05
2015-05-31,119751132,134917261,-15166129,남아프리카공화국,2015-05
2015-05-31,108367780,52442348,55925432,이스라엘,2015-05
2015-05-31,100610171,18054235,82555936,방글라데시,2015-05
2015-05-31,90395029,110585474,-20190445,뉴질랜드,2015-05
2015-05-31,87982393,95811222,-7828829,페루,2015-05
2015-05-31,82421481,13313630,69107851,포루투갈,2015-05
2015-05-31,81853819,27026717,54827102,아르헨티나,2015-05
2015-05-31,81726814,791455495,-709728681,쿠웨이트,2015-05
2015-05-31,81193360,141857774,-60664414,오만,2015-05
2015-05-31,78941102,50171531,28769571,헝가리,2015-05
2015-05-31,78726131,17800513,60925618,콜롬비아,2015-05
2015-05-31,77914803,225337151,-147422348,노르웨이,2015-05
2015-05-31,64194852,22276072,41918780,파키스탄,2015-05
2015-05-31,62368137,111663168,-49295031,오스트리아,2015-05
2015-05-31,62169695,4438165,57731530,세네갈,2015-05
2015-05-31,61874165,5708089,56166076,요르단,2015-05
2015-05-31,58384051,14699187,43684864,미얀마,2015-05
2015-05-31,58116257,113796372,-55680115,스웨덴,2015-05
2015-05-31,52492311,49362919,3129392,리비아,2015-05
2015-05-31,52004420,12601320,39403100,캄보디아,2015-05
2015-05-31,49444736,45768905,3675831,알제리,2015-05
2015-05-31,47371577,107044237,-59672660,나이지리아,2015-05
2015-05-31,44497376,1658668085,-1614170709,카타르,2015-05
2015-05-31,43596912,44748538,-1151626,루마니아,2015-05
2015-05-31,39264579,56916381,-17651802,카자흐스탄,2015-05
2015-05-31,38190192,44940296,-6750104,에쿠아도르,2015-05
2015-05-31,33147894,92366712,-59218818,핀란드,2015-05
2015-05-31,31741209,183395355,-151654146,스위스,2015-05
2015-05-31,31045522,130639,30914883,라이베리아,2015-05
2015-05-31,30433186,30,30433156,맨섬,2015-05
2015-05-31,28671340,170915,28500425,베네주엘라,2015-05
2015-05-31,26819998,4766960,22053038,과테말라,2015-05
2015-05-31,26715640,18925027,7790613,모로코,2015-05
2015-05-31,26294377,11340970,14953407,몽골,2015-05
2015-05-31,22736679,2174859,20561820,레바논,2015-05
2015-05-31,22644799,12221340,10423459,코스타리카,2015-05
2015-05-31,22586251,35236541,-12650290,그리스,2015-05
2015-05-31,21710285,1785035,19925250,파라과이,2015-05
2015-05-31,20807767,67501345,-46693578,아일랜드,2015-05
2015-05-31,20323687,10121222,10202465,우루과이,2015-05
2015-05-31,20062095,13819260,6242835,뉴 칼레도니아,2015-05
2015-05-31,19797062,5080564,14716498,스리랑카,2015-05
2015-05-31,19757299,496773,19260526,피지,2015-05
2015-05-31,19651556,14449531,5202025,푸에르토리코,2015-05
2015-05-31,19527668,12858709,6668959,앙골라,2015-05
2015-05-31,18833581,2084418,16749163,튀니지,2015-05
2015-05-31,17436474,3137529,14298945,라오스,2015-05
2015-05-31,16874133,4900864,11973269,리투아니아,2015-05
2015-05-31,16858360,3355058,13503302,가나,2015-05
2015-05-31,16702928,7404163,9298765,도미니카 공화국,2015-05
2015-05-31,16141076,2408384,13732692,케냐,2015-05
2015-05-31,13942037,41610317,-27668280,바레인,2015-05
2015-05-31,12248084,955679,11292405,엘살바도르,2015-05
2015-05-31,11670974,973041,10697933,니카라과,2015-05
2015-05-31,11529059,6537,11522522,팔레스타인 해방기구,2015-05
2015-05-31,11039186,0,11039186,시리아,2015-05
2015-05-31,10796026,51083657,-40287631,우크라이나,2015-05
2015-05-31,10206881,2791,10204090,투르크멘,2015-05
2015-05-31,9791372,5249347,4542025,라트비아,2015-05
2015-05-31,8954756,9678719,-723963,불가리아,2015-05
2015-05-31,8807932,9623839,-815907,탄자니아,2015-05
2015-05-31,8797316,3399193,5398123,수단,2015-05
2015-05-31,8104701,12099715,-3995014,볼리비아,2015-05
2015-05-31,7984045,5827262,2156783,온두라스,2015-05
2015-05-31,7940327,500,7939827,아제르바이잔,2015-05
2015-05-31,7537657,32576068,-25038411,파푸아 뉴기니,2015-05
2015-05-31,7032580,4335,7028245,마이크로네시아,2015-05
2015-05-31,6902125,94906411,-88004286,브루나이,2015-05
2015-05-31,6294927,102729,6192198,괌,2015-05
2015-05-31,6105227,173197,5932030,사모아,2015-05
2015-05-31,6066680,23,6066657,불령 폴리네시아,2015-05
2015-05-31,6026727,120,6026607,아프카니스탄,2015-05
2015-05-31,5994705,5887201,107504,벨라루스,2015-05
2015-05-31,5606009,4865665,740344,트리니다드 토바고,2015-05
2015-05-31,5600843,4861764,739079,에스토니아,2015-05
2015-05-31,5519320,1487255,4032065,조지아,2015-05
2015-05-31,5366422,187141,5179281,모잠비크,2015-05
2015-05-31,5212547,4630089,582458,에티오피아,2015-05
2015-05-31,5209891,1853521,3356370,코트디봐르,2015-05
2015-05-31,5123598,7348965,-2225367,세르비아,2015-05
2015-05-31,5119908,78080,5041828,키르기스스탄,2015-05
2015-05-31,4671370,652433,4018937,크로아티아,2015-05
2015-05-31,4316812,3542123,774689,기니,2015-05
2015-05-31,4138140,26649385,-22511245,몰타,2015-05
2015-05-31,3825460,169972,3655488,아이티,2015-05
2015-05-31,3674170,578732,3095438,쿠바,2015-05
2015-05-31,3476206,119650,3356556,마카오,2015-05
2015-05-31,3438093,0,3438093,지부티,2015-05
2015-05-31,3432838,558477,2874361,모리셔스,2015-05
2015-05-31,3209939,1723060,1486879,아이슬란드,2015-05
2015-05-31,3180959,827623,2353336,베닝,2015-05
2015-05-31,2951647,125048,2826599,카메룬,2015-05
2015-05-31,2457582,936397,1521185,예맨,2015-05
2015-05-31,2364241,5113819,-2749578,마다카스카르,2015-05
2015-05-31,2310137,34558811,-32248674,콩고민주공화국,2015-05
2015-05-31,2208154,23527,2184627,르완다,2015-05
2015-05-31,2169176,374888,1794288,자마이카,2015-05
2015-05-31,2101628,0,2101628,아루바,2015-05
2015-05-31,2076703,22513517,-20436814,기타국,2015-05
2015-05-31,2022920,21504,2001416,네덜란드 열도,2015-05
2015-05-31,2011160,45735638,-43724478,가봉,2015-05
2015-05-31,1996262,33740,1962522,마세도니아,2015-05
2015-05-31,1948220,700382,1247838,사이프러스,2015-05
2015-05-31,1882399,3992039,-2109640,룩셈부르그,2015-05
2015-05-31,1870283,402842,1467441,네팔,2015-05
2015-05-31,1733112,398696,1334416,토고,2015-05
2015-05-31,1685367,44193643,-42508276,잠비아,2015-05
2015-05-31,1423445,6877,1416568,말라위,2015-05
2015-05-31,1306990,131479,1175511,가이아나,2015-05
2015-05-31,1288716,2159,1286557,바하마,2015-05
2015-05-31,1202726,279,1202447,타지크,2015-05
2015-05-31,1162476,60,1162416,버뮤다,2015-05
2015-05-31,1155383,2116490,-961107,콩고,2015-05
2015-05-31,1132004,38446,1093558,아르메니아,2015-05
2015-05-31,1116762,0,1116762,불령 리유니온 코모도 제도,2015-05
2015-05-31,1071624,504906,566718,부르키나 파소,2015-05
2015-05-31,1049237,85705,963532,북마리아나 군도,2015-05
2015-05-31,1006180,218754,787426,알바니아,2015-05
2015-05-31,989692,188640,801052,세이쉘,2015-05
2015-05-31,828590,1107,827483,티모르,2015-05
2015-05-31,797294,2430742,-1633448,키리바티,2015-05
2015-05-31,767265,201544,565721,짐바브웨,2015-05
2015-05-31,635240,565071,70169,우간다,2015-05
2015-05-31,588998,912597,-323599,시에라 리온,2015-05
2015-05-31,550385,741970,-191585,안티가 바부다,2015-05
2015-05-31,541145,0,541145,챠드,2015-05
2015-05-31,519701,1053325,-533624,리히텐슈타인,2015-05
2015-05-31,463636,337,463299,보츠와나,2015-05
2015-05-31,462119,92419,369700,바베이도스,2015-05
2015-05-31,459105,1220,457885,벨리제,2015-05
2015-05-31,454706,141,454565,부탄,2015-05
2015-05-31,448522,72036,376486,말리,2015-05
2015-05-31,431402,138,431264,아메리칸 사모아,2015-05
2015-05-31,426771,38,426733,과델로프,2015-05
2015-05-31,379446,63064,316382,바누아투,2015-05
2015-05-31,351918,1372541,-1020623,나미비아,2015-05
2015-05-31,317863,0,317863,그레나다,2015-05
2015-05-31,315028,533204,-218176,몰도바,2015-05
2015-05-31,308759,8017,300742,몰디브,2015-05
2015-05-31,307527,0,307527,마티니크,2015-05
2015-05-31,303278,173,303105,도미니카,2015-05
2015-05-31,260949,74,260875,팔라우,2015-05
2015-05-31,256769,198394,58375,수리남,2015-05
2015-05-31,238594,0,238594,니제르,2015-05
2015-05-31,237816,0,237816,에리트리아,2015-05
2015-05-31,222117,0,222117,소말리아,2015-05
2015-05-31,218515,3658569,-3440054,모리타니,2015-05
2015-05-31,216202,936746,-720544,보스니아-헤르체고비나,2015-05
2015-05-31,207515,577,206938,세인트 루시아,2015-05
2015-05-31,164639,468405,-303766,솔로몬 군도,2015-05
2015-05-31,163111,80335,82776,감비아,2015-05
2015-05-31,154923,1442,153481,세인트 키츠 네비스,2015-05
2015-05-31,148841,0,148841,지브랄타,2015-05
2015-05-31,131951,0,131951,영령 캐이맨 군도,2015-05
2015-05-31,105490,123,105367,불령 가이아나,2015-05
2015-05-31,87115,0,87115,큐라소,2015-05
2015-05-31,64768,73226740,-73161972,적도 기니,2015-05
2015-05-31,53793,21933,31860,부룬디,2015-05
2015-05-31,52913,80422,-27509,스와질랜드,2015-05
2015-05-31,49410,481,48929,세인트 빈센트 그레나딘,2015-05
2015-05-31,44924,142712,-97788,영령 버진군도,2015-05
2015-05-31,31499,0,31499,메요트,2015-05
2015-05-31,28124,47684,-19560,통가,2015-05
2015-05-31,24435,0,24435,투발루,2015-05
2015-05-31,13964,0,13964,국제통화기금,2015-05
2015-05-31,11593,0,11593,상토메 프린스페,2015-05
2015-05-31,10716,193,10523,몬테네그로,2015-05
2015-05-31,9368,7940,1428,앙귈라,2015-05
2015-05-31,7697,358793,-351096,모나코,2015-05
2015-05-31,5102,0,5102,쿡 아일랜드,2015-05
2015-05-31,3742,0,3742,서사하라,2015-05
2015-05-31,2700,0,2700,레소토,2015-05
2015-05-31,1923,413,1510,남조지아 & 남샌드위치 군도,2015-05
2015-05-31,955,34021,-33066,안도라,2015-05
2015-05-31,177,6330,-6153,미령 버진군도,2015-05
2015-05-31,127,282765,-282638,그린랜드,2015-05
2015-05-31,39,6780,-6741,카보 베르데,2015-05
2015-05-31,0,323,-323,몬트세라트,2015-05
2015-05-31,0,107,-107,건지,2015-05
2015-05-31,0,3123,-3123,토켈라우,2015-05
2015-05-31,0,8296,-8296,투르크 & 카이코스 군도,2015-05
2015-05-31,0,1051,-1051,중앙아프리카공화국,2015-05
2015-05-31,0,20177,-20177,세인트 바르탤르미,2015-05
2015-05-31,0,145,-145,저어지,2015-05
2015-05-31,0,126,-126,허드 앤 맥도날드 군도,2015-05
2015-05-31,0,1432,-1432,산마리노,2015-05
2015-05-31,0,35312,-35312,기네비소,2015-05
2015-05-31,0,76,-76,스발비드 군도,2015-05
2015-05-31,0,5325,-5325,교황청,2015-05
2015-05-31,0,4640,-4640,니우에,2015-05
2015-05-31,0,13,-13,피트카이른,2015-05
2015-05-31,0,9897,-9897,코스 군도,2015-05
2015-06-30,11348693390,7398755282,3949938108,중국,2015-06
2015-06-30,6503943777,3824376376,2679567401,미국,2015-06
2015-06-30,2491014663,129615095,2361399568,홍콩,2015-06
2015-06-30,2431976418,704887311,1727089107,베트남,2015-06
2015-06-30,2230059347,4010832596,-1780773249,일본,2015-06
2015-06-30,1209595676,612086596,597509080,싱가포르,2015-06
2015-06-30,1055494230,1323485501,-267991271,대만,2015-06
2015-06-30,1021482015,615738368,405743647,말레이시아,2015-06
2015-06-30,966663931,1363192189,-396528258,호주,2015-06
2015-06-30,897573506,361626366,535947140,인도,2015-06
2015-06-30,880562533,1579573497,-699010964,사우디아라비아,2015-06
2015-06-30,833317617,328075249,505242368,멕시코,2015-06
2015-06-30,765372653,271075289,494297364,필리핀,2015-06
2015-06-30,720313806,794311307,-73997501,인도네시아,2015-06
2015-06-30,613998613,1759528415,-1145529802,독일,2015-06
2015-06-30,592280297,212745592,379534705,스위스,2015-06
2015-06-30,574740769,7174,574733595,마샬군도,2015-06
2015-06-30,571685304,201193620,370491684,노르웨이,2015-06
2015-06-30,569434131,649727927,-80293796,아랍에미리트 연합,2015-06
2015-06-30,562612854,433374947,129237907,태국,2015-06
2015-06-30,558817922,77686377,481131545,튀르키예,2015-06
2015-06-30,480163152,388848042,91315110,네덜란드,2015-06
2015-06-30,471300544,325061761,146238783,캐나다,2015-06
2015-06-30,447862999,671977178,-224114179,영국,2015-06
2015-06-30,446693099,820230743,-373537644,러시아 연방,2015-06
2015-06-30,381836913,251687147,130149766,브라질,2015-06
2015-06-30,347210862,548945082,-201734220,이탈리아,2015-06
2015-06-30,300524149,43083926,257440223,그리스,2015-06
2015-06-30,275779532,38840471,236939061,몰타,2015-06
2015-06-30,247365521,58186293,189179228,파나마,2015-06
2015-06-30,239446276,17561980,221884296,슬로바키아,2015-06
2015-06-30,226414842,230514759,-4099917,이란,2015-06
2015-06-30,214921041,34997658,179923383,이집트,2015-06
2015-06-30,209787152,78980140,130807012,덴마크,2015-06
2015-06-30,203735153,60415785,143319368,폴란드,2015-06
2015-06-30,203025175,44901382,158123793,브루나이,2015-06
2015-06-30,193429233,0,193429233,버뮤다,2015-06
2015-06-30,184589505,190188373,-5598868,스페인,2015-06
2015-06-30,179451293,72237,179379056,바하마,2015-06
2015-06-30,177652394,46722292,130930102,체코공화국,2015-06
2015-06-30,176460516,103685185,72775331,벨기에,2015-06
2015-06-30,171145027,845183923,-674038896,프랑스,2015-06
2015-06-30,154793845,320964715,-166170870,칠레,2015-06
2015-06-30,146046561,9799915,136246646,슬로베니아,2015-06
2015-06-30,137893520,127834331,10059189,오만,2015-06
2015-06-30,135936321,1967121,133969200,우즈베키스탄,2015-06
2015-06-30,134157525,771798008,-637640483,이라크,2015-06
2015-06-30,127905783,97921444,29984339,남아프리카공화국,2015-06
2015-06-30,114952134,96890193,18061941,페루,2015-06
2015-06-30,111273878,45626394,65647484,아르헨티나,2015-06
2015-06-30,98610208,21453976,77156232,방글라데시,2015-06
2015-06-30,97856520,107811061,-9954541,뉴질랜드,2015-06
2015-06-30,93192090,20958658,72233432,콜롬비아,2015-06
2015-06-30,91213751,78138885,13074866,이스라엘,2015-06
2015-06-30,89007681,27941,88979740,라이베리아,2015-06
2015-06-30,88331755,6553477,81778278,요르단,2015-06
2015-06-30,77955739,102005286,-24049547,오스트리아,2015-06
2015-06-30,77189316,39131283,38058033,파키스탄,2015-06
2015-06-30,67454142,662960095,-595505953,쿠웨이트,2015-06
2015-06-30,65938695,89812561,-23873866,나이지리아,2015-06
2015-06-30,65248833,126659780,-61410947,스웨덴,2015-06
2015-06-30,64164444,1345129189,-1280964745,카타르,2015-06
2015-06-30,63334799,60435937,2898862,헝가리,2015-06
2015-06-30,60290119,26012143,34277976,미얀마,2015-06
2015-06-30,55468637,3559325,51909312,가나,2015-06
2015-06-30,51791499,5687922,46103577,에쿠아도르,2015-06
2015-06-30,50314282,14853534,35460748,캄보디아,2015-06
2015-06-30,50285867,15520080,34765787,포루투갈,2015-06
2015-06-30,43595494,5311531,38283963,카자흐스탄,2015-06
2015-06-30,43444423,59144056,-15699633,루마니아,2015-06
2015-06-30,43416436,47217725,-3801289,리비아,2015-06
2015-06-30,43057675,80115268,-37057593,알제리,2015-06
2015-06-30,42273627,17999792,24273835,모로코,2015-06
2015-06-30,38793058,583107,38209951,피지,2015-06
2015-06-30,33667725,4858699,28809026,과테말라,2015-06
2015-06-30,27615562,46477015,-18861453,파푸아 뉴기니,2015-06
2015-06-30,27114945,15117172,11997773,푸에르토리코,2015-06
2015-06-30,25550256,2234306,23315950,탄자니아,2015-06
2015-06-30,24602478,5130814,19471664,리투아니아,2015-06
2015-06-30,24046846,8536617,15510229,스리랑카,2015-06
2015-06-30,23895254,1907850,21987404,레바논,2015-06
2015-06-30,23478487,6847328,16631159,도미니카 공화국,2015-06
2015-06-30,22690715,632049,22058666,파라과이,2015-06
2015-06-30,22099647,2456900,19642747,몽골,2015-06
2015-06-30,21862617,79126206,-57263589,핀란드,2015-06
2015-06-30,18705871,3682021,15023850,케냐,2015-06
2015-06-30,18445988,15207422,3238566,코스타리카,2015-06
2015-06-30,17340974,6320817,11020157,우루과이,2015-06
2015-06-30,16520898,3176762,13344136,튀니지,2015-06
2015-06-30,15749112,0,15749112,시리아,2015-06
2015-06-30,15714729,1585774,14128955,베네주엘라,2015-06
2015-06-30,14590768,95812030,-81221262,아일랜드,2015-06
2015-06-30,14323802,28207363,-13883561,바레인,2015-06
2015-06-30,14112439,48932888,-34820449,우크라이나,2015-06
2015-06-30,14104938,3893098,10211840,라오스,2015-06
2015-06-30,14093428,13600460,492968,앙골라,2015-06
2015-06-30,13116644,1578080,11538564,수단,2015-06
2015-06-30,12844234,1210569,11633665,코트디봐르,2015-06
2015-06-30,12683835,798748,11885087,니카라과,2015-06
2015-06-30,11994359,828286,11166073,엘살바도르,2015-06
2015-06-30,11934720,6572337,5362383,온두라스,2015-06
2015-06-30,9898307,12637933,-2739626,뉴 칼레도니아,2015-06
2015-06-30,8978407,3484,8974923,투르크멘,2015-06
2015-06-30,8854903,11809927,-2955024,불가리아,2015-06
2015-06-30,8800257,65821,8734436,키르기스스탄,2015-06
2015-06-30,8532216,23154,8509062,팔레스타인 해방기구,2015-06
2015-06-30,8392700,216497,8176203,볼리비아,2015-06
2015-06-30,8104998,7163438,941560,에티오피아,2015-06
2015-06-30,7908755,2736867,5171888,아제르바이잔,2015-06
2015-06-30,6896924,4382067,2514857,트리니다드 토바고,2015-06
2015-06-30,6843128,5364426,1478702,라트비아,2015-06
2015-06-30,6458113,2589286,3868827,조지아,2015-06
2015-06-30,5982799,1951939,4030860,모잠비크,2015-06
2015-06-30,5857077,105415,5751662,네팔,2015-06
2015-06-30,5687287,1985225,3702062,베닝,2015-06
2015-06-30,5277570,141578,5135992,아이티,2015-06
2015-06-30,5225087,7976908,-2751821,에스토니아,2015-06
2015-06-30,5180750,2639932,2540818,벨라루스,2015-06
2015-06-30,5033328,18585,5014743,마이크로네시아,2015-06
2015-06-30,4979564,126977,4852587,괌,2015-06
2015-06-30,4926582,4913755,12827,세르비아,2015-06
2015-06-30,4406990,728779,3678211,예맨,2015-06
2015-06-30,4049312,451274,3598038,모리셔스,2015-06
2015-06-30,3914902,533,3914369,지부티,2015-06
2015-06-30,3811944,1350754,2461190,크로아티아,2015-06
2015-06-30,3674298,5722377,-2048079,세네갈,2015-06
2015-06-30,3428113,283704,3144409,쿠바,2015-06
2015-06-30,3252758,2313528,939230,기니,2015-06
2015-06-30,3185930,72093,3113837,마카오,2015-06
2015-06-30,2922341,26411431,-23489090,콩고민주공화국,2015-06
2015-06-30,2763842,95356,2668486,가봉,2015-06
2015-06-30,2650192,1518947,1131245,콩고,2015-06
2015-06-30,2629206,1791687,837519,아이슬란드,2015-06
2015-06-30,2594129,34051068,-31456939,잠비아,2015-06
2015-06-30,2520212,17087,2503125,아프카니스탄,2015-06
2015-06-30,2494947,63600,2431347,마세도니아,2015-06
2015-06-30,2352208,113677,2238531,카메룬,2015-06
2015-06-30,2346443,20229873,-17883430,기타국,2015-06
2015-06-30,2248307,92308,2155999,짐바브웨,2015-06
2015-06-30,2130148,720419,1409729,부르키나 파소,2015-06
2015-06-30,1972831,103710,1869121,사모아,2015-06
2015-06-30,1811956,684569,1127387,가이아나,2015-06
2015-06-30,1792534,5328,1787206,타지크,2015-06
2015-06-30,1755387,11576,1743811,네덜란드 열도,2015-06
2015-06-30,1753999,13506,1740493,불령 폴리네시아,2015-06
2015-06-30,1627027,123519,1503508,세이쉘,2015-06
2015-06-30,1590123,7997266,-6407143,토고,2015-06
2015-06-30,1544232,147,1544085,불령 리유니온 코모도 제도,2015-06
2015-06-30,1540970,9557721,-8016751,마다카스카르,2015-06
2015-06-30,1389132,404634,984498,시에라 리온,2015-06
2015-06-30,1306060,65317,1240743,알바니아,2015-06
2015-06-30,1245591,3716941,-2471350,룩셈부르그,2015-06
2015-06-30,1179267,742363,436904,사이프러스,2015-06
2015-06-30,1118529,1197218,-78689,자마이카,2015-06
2015-06-30,1057853,970411,87442,수리남,2015-06
2015-06-30,1048712,125683,923029,북마리아나 군도,2015-06
2015-06-30,1000862,74,1000788,부탄,2015-06
2015-06-30,908714,2387033,-1478319,우간다,2015-06
2015-06-30,866779,125,866654,챠드,2015-06
2015-06-30,866769,0,866769,아루바,2015-06
2015-06-30,863631,0,863631,마티니크,2015-06
2015-06-30,792491,2223,790268,벨리제,2015-06
2015-06-30,781156,3684669,-2903513,모리타니,2015-06
2015-06-30,769047,36492,732555,감비아,2015-06
2015-06-30,766800,2707309,-1940509,키리바티,2015-06
2015-06-30,714992,310,714682,말라위,2015-06
2015-06-30,711757,0,711757,과델로프,2015-06
2015-06-30,658058,308,657750,바베이도스,2015-06
2015-06-30,636222,1745,634477,몰디브,2015-06
2015-06-30,594876,691187,-96311,보스니아-헤르체고비나,2015-06
2015-06-30,583967,374658,209309,아메리칸 사모아,2015-06
2015-06-30,571616,0,571616,영령 버진군도,2015-06
2015-06-30,480391,399215,81176,몰도바,2015-06
2015-06-30,453421,187482,265939,안티가 바부다,2015-06
2015-06-30,449777,448506,1271,아르메니아,2015-06
2015-06-30,440675,331579,109096,나미비아,2015-06
2015-06-30,437550,0,437550,소말리아,2015-06
2015-06-30,436941,376883,60058,리히텐슈타인,2015-06
2015-06-30,403799,49566,354233,보츠와나,2015-06
2015-06-30,354453,0,354453,팔라우,2015-06
2015-06-30,346089,13135,332954,티모르,2015-06
2015-06-30,341203,184878,156325,바누아투,2015-06
2015-06-30,320577,15501,305076,르완다,2015-06
2015-06-30,314413,0,314413,국제통화기금,2015-06
2015-06-30,265794,0,265794,세인트 빈센트 그레나딘,2015-06
2015-06-30,210024,8165,201859,세인트 키츠 네비스,2015-06
2015-06-30,206340,330,206010,지브랄타,2015-06
2015-06-30,204858,261279,-56421,스와질랜드,2015-06
2015-06-30,144128,0,144128,영령 캐이맨 군도,2015-06
2015-06-30,118325,1980,116345,도미니카,2015-06
2015-06-30,116965,6107,110858,니제르,2015-06
2015-06-30,102351,6615,95736,카보 베르데,2015-06
2015-06-30,102052,0,102052,그레나다,2015-06
2015-06-30,94007,0,94007,말리,2015-06
2015-06-30,87053,1362035,-1274982,솔로몬 군도,2015-06
2015-06-30,68266,0,68266,세인트 루시아,2015-06
2015-06-30,61350,106,61244,남수단,2015-06
2015-06-30,55250,4109,51141,안도라,2015-06
2015-06-30,50674,1132,49542,몬테네그로,2015-06
2015-06-30,47221,132,47089,세인트 마틴,2015-06
2015-06-30,43110,24,43086,불령 가이아나,2015-06
2015-06-30,35950,53396,-17446,산마리노,2015-06
2015-06-30,31670,130,31540,코스 군도,2015-06
2015-06-30,31428,0,31428,기네비소,2015-06
2015-06-30,28366,442,27924,투르크 & 카이코스 군도,2015-06
2015-06-30,18637,0,18637,나우루,2015-06
2015-06-30,17955,242,17713,레소토,2015-06
2015-06-30,14963,138928,-123965,앙귈라,2015-06
2015-06-30,14148,102,14046,안타티카,2015-06
2015-06-30,9631,0,9631,남조지아 & 남샌드위치 군도,2015-06
2015-06-30,6136,355502,-349366,모나코,2015-06
2015-06-30,3260,87584,-84324,통가,2015-06
2015-06-30,3090,0,3090,스발비드 군도,2015-06
2015-06-30,2714,0,2714,서사하라,2015-06
2015-06-30,1853,0,1853,파로에 군도,2015-06
2015-06-30,116,155390,-155274,그린랜드,2015-06
2015-06-30,0,30757,-30757,중앙아프리카공화국,2015-06
2015-06-30,0,128701380,-128701380,적도 기니,2015-06
2015-06-30,0,1224,-1224,토켈라우,2015-06
2015-06-30,0,1558,-1558,세인트 헬레나,2015-06
2015-06-30,0,88,-88,맨섬,2015-06
2015-06-30,0,249,-249,보빗군도,2015-06
2015-06-30,0,332,-332,마이너 아우틀링 합중국 군도,2015-06
2015-06-30,0,101166,-101166,코모로스,2015-06
2015-06-30,0,9988,-9988,미령 버진군도,2015-06
2015-06-30,0,8724,-8724,니우에,2015-06
2015-06-30,0,8229,-8229,세인트 바르탤르미,2015-06
2015-06-30,0,25,-25,포클랜드 군도,2015-06
2015-07-31,11180020902,7626086780,3553934122,중국,2015-07
2015-07-31,6184651985,4098110981,2086541004,미국,2015-07
2015-07-31,2633166079,774975236,1858190843,베트남,2015-07
2015-07-31,2630865243,123803606,2507061637,홍콩,2015-07
2015-07-31,2126238228,3945784891,-1819546663,일본,2015-07
2015-07-31,1228479350,96302,1228383048,마샬군도,2015-07
2015-07-31,1088547952,374198638,714349314,멕시코,2015-07
2015-07-31,1022558509,1445564735,-423006226,호주,2015-07
2015-07-31,1009742530,787595387,222147143,싱가포르,2015-07
2015-07-31,998497434,1431709189,-433211755,대만,2015-07
2015-07-31,981759739,301699186,680060553,인도,2015-07
2015-07-31,880788997,2021784342,-1140995345,사우디아라비아,2015-07
2015-07-31,828032703,647562850,180469853,말레이시아,2015-07
2015-07-31,766708920,732484406,34224514,인도네시아,2015-07
2015-07-31,715440410,301998002,413442408,필리핀,2015-07
2015-07-31,639066345,79154850,559911495,튀르키예,2015-07
2015-07-31,637132716,211349650,425783066,노르웨이,2015-07
2015-07-31,620878887,1722660193,-1101781306,독일,2015-07
2015-07-31,573178401,441750364,131428037,태국,2015-07
2015-07-31,506549749,1059026275,-552476526,러시아 연방,2015-07
2015-07-31,474273846,959752511,-485478665,아랍에미리트 연합,2015-07
2015-07-31,473123820,390264261,82859559,영국,2015-07
2015-07-31,466561129,371182062,95379067,브라질,2015-07
2015-07-31,423829563,525707560,-101877997,네덜란드,2015-07
2015-07-31,411440626,325311560,86129066,캐나다,2015-07
2015-07-31,338809267,25421294,313387973,슬로바키아,2015-07
2015-07-31,293894258,510316896,-216422638,이탈리아,2015-07
2015-07-31,251556181,24165329,227390852,그리스,2015-07
2015-07-31,240616091,0,240616091,버뮤다,2015-07
2015-07-31,234015324,65643980,168371344,폴란드,2015-07
2015-07-31,227460979,127753292,99707687,이란,2015-07
2015-07-31,210765652,59273071,151492581,체코공화국,2015-07
2015-07-31,207434311,469334947,-261900636,프랑스,2015-07
2015-07-31,200007203,250853689,-50846486,스페인,2015-07
2015-07-31,186995616,10180901,176814715,슬로베니아,2015-07
2015-07-31,182305933,5525493,176780440,이집트,2015-07
2015-07-31,174021141,62643090,111378051,파나마,2015-07
2015-07-31,172495954,352190819,-179694865,칠레,2015-07
2015-07-31,169519969,121734051,47785918,벨기에,2015-07
2015-07-31,121347756,115650598,5697158,남아프리카공화국,2015-07
2015-07-31,113182426,72704770,40477656,페루,2015-07
2015-07-31,110193986,20595278,89598708,콜롬비아,2015-07
2015-07-31,107448031,27231059,80216972,방글라데시,2015-07
2015-07-31,107412465,83392735,24019730,아르헨티나,2015-07
2015-07-31,106865219,108822633,-1957414,뉴질랜드,2015-07
2015-07-31,92828398,130099709,-37271311,오만,2015-07
2015-07-31,87399989,86831565,568424,헝가리,2015-07
2015-07-31,84345514,763060833,-678715319,이라크,2015-07
2015-07-31,82837349,1380087,81457262,우즈베키스탄,2015-07
2015-07-31,82027923,88871679,-6843756,이스라엘,2015-07
2015-07-31,74911068,1020715413,-945804345,쿠웨이트,2015-07
2015-07-31,65961628,128728147,-62766519,스웨덴,2015-07
2015-07-31,63057688,5320253,57737435,요르단,2015-07
2015-07-31,61541693,19936675,41605018,파키스탄,2015-07
2015-07-31,60513931,108030433,-47516502,오스트리아,2015-07
2015-07-31,60493369,6741210,53752159,과테말라,2015-07
2015-07-31,59847799,1409336544,-1349488745,카타르,2015-07
2015-07-31,58706963,19392343,39314620,캄보디아,2015-07
2015-07-31,58244060,62268281,-4024221,루마니아,2015-07
2015-07-31,55827407,2224060,53603347,리비아,2015-07
2015-07-31,51752536,102355304,-50602768,나이지리아,2015-07
2015-07-31,50908192,84250188,-33341996,카자흐스탄,2015-07
2015-07-31,49636393,7207255,42429138,에쿠아도르,2015-07
2015-07-31,48298316,8650,48289666,바하마,2015-07
2015-07-31,46041930,39264116,6777814,미얀마,2015-07
2015-07-31,45018131,94804471,-49786340,알제리,2015-07
2015-07-31,41143000,233181,40909819,피지,2015-07
2015-07-31,40654268,18184022,22470246,포루투갈,2015-07
2015-07-31,40289047,96073412,-55784365,덴마크,2015-07
2015-07-31,37585418,691968,36893450,크로아티아,2015-07
2015-07-31,35390490,15308564,20081926,뉴 칼레도니아,2015-07
2015-07-31,35343116,109411955,-74068839,아일랜드,2015-07
2015-07-31,34960964,224067554,-189106590,스위스,2015-07
2015-07-31,30605882,7055020,23550862,안티가 바부다,2015-07
2015-07-31,30190817,175586,30015231,라이베리아,2015-07
2015-07-31,29397294,12523860,16873434,코스타리카,2015-07
2015-07-31,27286578,1774931,25511647,레바논,2015-07
2015-07-31,26227130,7040928,19186202,도미니카 공화국,2015-07
2015-07-31,25549759,91580014,-66030255,핀란드,2015-07
2015-07-31,24964848,14454075,10510773,모로코,2015-07
2015-07-31,24836926,6365966,18470960,스리랑카,2015-07
2015-07-31,22982685,2018563,20964122,파푸아 뉴기니,2015-07
2015-07-31,21710661,3427628,18283033,몽골,2015-07
2015-07-31,20172280,4636741,15535539,리투아니아,2015-07
2015-07-31,20018046,3869290,16148756,가나,2015-07
2015-07-31,19638604,912341,18726263,파라과이,2015-07
2015-07-31,19142017,3237,19138780,투르크멘,2015-07
2015-07-31,18645772,8625222,10020550,에티오피아,2015-07
2015-07-31,18322246,20400607,-2078361,푸에르토리코,2015-07
2015-07-31,17536481,2327806,15208675,수단,2015-07
2015-07-31,17006365,1306321,15700044,탄자니아,2015-07
2015-07-31,16712600,42789591,-26076991,우크라이나,2015-07
2015-07-31,15649908,8246,15641662,시리아,2015-07
2015-07-31,14812928,205283,14607645,아제르바이잔,2015-07
2015-07-31,14753512,3081256,11672256,케냐,2015-07
2015-07-31,14238800,5534595,8704205,튀니지,2015-07
2015-07-31,14234928,948548,13286380,니카라과,2015-07
2015-07-31,13531470,16406706,-2875236,바레인,2015-07
2015-07-31,11826648,134419,11692229,괌,2015-07
2015-07-31,11798861,3121115,8677746,라오스,2015-07
2015-07-31,11749171,17385625,-5636454,앙골라,2015-07
2015-07-31,11627734,13682069,-2054335,베네주엘라,2015-07
2015-07-31,11370051,1527787,9842264,엘살바도르,2015-07
2015-07-31,11190574,17589784,-6399210,세르비아,2015-07
2015-07-31,11019635,2460985,8558650,트리니다드 토바고,2015-07
2015-07-31,10652518,24027212,-13374694,기타국,2015-07
2015-07-31,9839615,545488,9294127,코트디봐르,2015-07
2015-07-31,9795988,9319831,476157,우루과이,2015-07
2015-07-31,9422431,2237046,7185385,온두라스,2015-07
2015-07-31,8690777,10271179,-1580402,불가리아,2015-07
2015-07-31,8585510,39427,8546083,키르기스스탄,2015-07
2015-07-31,8066634,5631441,2435193,라트비아,2015-07
2015-07-31,7885120,157935,7727185,예맨,2015-07
2015-07-31,7718424,169889,7548535,팔레스타인 해방기구,2015-07
2015-07-31,7261181,331697,6929484,아이티,2015-07
2015-07-31,6284673,84198851,-77914178,브루나이,2015-07
2015-07-31,6140562,17387566,-11247004,볼리비아,2015-07
2015-07-31,6099029,11427613,-5328584,에스토니아,2015-07
2015-07-31,5619479,4183061,1436418,벨라루스,2015-07
2015-07-31,5551415,0,5551415,지부티,2015-07
2015-07-31,5364257,10165,5354092,불령 폴리네시아,2015-07
2015-07-31,4657496,9539624,-4882128,세네갈,2015-07
2015-07-31,4401475,503210,3898265,쿠바,2015-07
2015-07-31,4025989,139834,3886155,르완다,2015-07
2015-07-31,3980220,1792015,2188205,조지아,2015-07
2015-07-31,3949821,18450417,-14500596,몰타,2015-07
2015-07-31,3816724,737887,3078837,베닝,2015-07
2015-07-31,3638393,227978,3410415,마세도니아,2015-07
2015-07-31,3537099,246873,3290226,모리셔스,2015-07
2015-07-31,3213779,234401,2979378,모잠비크,2015-07
2015-07-31,2929166,0,2929166,에리트리아,2015-07
2015-07-31,2870798,113998,2756800,마카오,2015-07
2015-07-31,2674062,133353,2540709,알바니아,2015-07
2015-07-31,2541465,13665,2527800,불령 리유니온 코모도 제도,2015-07
2015-07-31,2512226,139497,2372729,카메룬,2015-07
2015-07-31,2277429,2429989,-152560,토고,2015-07
2015-07-31,2234158,2243200,-9042,아이슬란드,2015-07
2015-07-31,2179659,7686028,-5506369,나미비아,2015-07
2015-07-31,2177629,858543,1319086,부르키나 파소,2015-07
2015-07-31,2169765,6207239,-4037474,마다카스카르,2015-07
2015-07-31,2156456,54318,2102138,네팔,2015-07
2015-07-31,2085180,36,2085144,타지크,2015-07
2015-07-31,2067315,70170,1997145,사모아,2015-07
2015-07-31,1934849,22933100,-20998251,잠비아,2015-07
2015-07-31,1934846,34665427,-32730581,콩고민주공화국,2015-07
2015-07-31,1772129,1470082,302047,우간다,2015-07
2015-07-31,1687758,1089511,598247,짐바브웨,2015-07
2015-07-31,1685951,25902,1660049,아프카니스탄,2015-07
2015-07-31,1675714,389192,1286522,자마이카,2015-07
2015-07-31,1642453,52368476,-50726023,아루바,2015-07
2015-07-31,1595140,686226,908914,사이프러스,2015-07
2015-07-31,1586734,53704585,-52117851,가봉,2015-07
2015-07-31,1527137,1547525,-20388,콩고,2015-07
2015-07-31,1450503,330506,1119997,세이쉘,2015-07
2015-07-31,1377588,1328,1376260,북마리아나 군도,2015-07
2015-07-31,1361094,134814,1226280,네덜란드 열도,2015-07
2015-07-31,1351689,141126,1210563,마이크로네시아,2015-07
2015-07-31,1256116,532,1255584,마티니크,2015-07
2015-07-31,1233207,2,1233205,아메리칸 사모아,2015-07
2015-07-31,1068824,2877005,-1808181,기니,2015-07
2015-07-31,1060040,232763,827277,수리남,2015-07
2015-07-31,961452,0,961452,영령 캐이맨 군도,2015-07
2015-07-31,913811,41148,872663,소말리아,2015-07
2015-07-31,874495,5216968,-4342473,룩셈부르그,2015-07
2015-07-31,837707,1234314,-396607,시에라 리온,2015-07
2015-07-31,771671,698819,72852,몰도바,2015-07
2015-07-31,745514,13300,732214,보츠와나,2015-07
2015-07-31,742316,211723,530593,아르메니아,2015-07
2015-07-31,697035,1047869,-350834,리히텐슈타인,2015-07
2015-07-31,658800,0,658800,큐라소,2015-07
2015-07-31,648363,149,648214,벨리제,2015-07
2015-07-31,637693,81674,556019,말라위,2015-07
2015-07-31,627335,2340428,-1713093,모리타니,2015-07
2015-07-31,601769,263649,338120,가이아나,2015-07
2015-07-31,598421,399568,198853,키리바티,2015-07
2015-07-31,554052,3556,550496,도미니카,2015-07
2015-07-31,528504,13276,515228,세인트 키츠 네비스,2015-07
2015-07-31,523967,28,523939,과델로프,2015-07
2015-07-31,487645,0,487645,팔라우,2015-07
2015-07-31,456397,733,455664,바베이도스,2015-07
2015-07-31,396424,23899,372525,영령 버진군도,2015-07
2015-07-31,396377,514,395863,티모르,2015-07
2015-07-31,298370,74,298296,말리,2015-07
2015-07-31,288454,0,288454,세인트 루시아,2015-07
2015-07-31,254951,238096,16855,바누아투,2015-07
2015-07-31,242019,827512,-585493,보스니아-헤르체고비나,2015-07
2015-07-31,241959,40273,201686,카보 베르데,2015-07
2015-07-31,216947,113607,103340,스와질랜드,2015-07
2015-07-31,191725,31307,160418,몰디브,2015-07
2015-07-31,187346,0,187346,감비아,2015-07
2015-07-31,173013,0,173013,부탄,2015-07
2015-07-31,169011,3560,165451,그레나다,2015-07
2015-07-31,144641,350,144291,지브랄타,2015-07
2015-07-31,131936,65488326,-65356390,적도 기니,2015-07
2015-07-31,127059,23314,103745,통가,2015-07
2015-07-31,122692,149173,-26481,중앙아프리카공화국,2015-07
2015-07-31,117211,0,117211,국제통화기금,2015-07
2015-07-31,114335,0,114335,챠드,2015-07
2015-07-31,113125,0,113125,불령 가이아나,2015-07
2015-07-31,101940,35967,65973,기네비소,2015-07
2015-07-31,95152,0,95152,세인트 빈센트 그레나딘,2015-07
2015-07-31,71510,0,71510,남수단,2015-07
2015-07-31,49028,252,48776,몬테네그로,2015-07
2015-07-31,35580,1614106,-1578526,솔로몬 군도,2015-07
2015-07-31,31546,0,31546,쿡 아일랜드,2015-07
2015-07-31,23229,0,23229,니제르,2015-07
2015-07-31,19693,0,19693,앙귈라,2015-07
2015-07-31,18099,0,18099,나우루,2015-07
2015-07-31,11110,289420,-278310,모나코,2015-07
2015-07-31,4695,7247,-2552,안도라,2015-07
2015-07-31,4653,29353,-24700,남조지아 & 남샌드위치 군도,2015-07
2015-07-31,3446,266357,-262911,코모로스,2015-07
2015-07-31,3205,22483,-19278,부룬디,2015-07
2015-07-31,3172,0,3172,파로에 군도,2015-07
2015-07-31,869,31,838,투르크 & 카이코스 군도,2015-07
2015-07-31,0,35900,-35900,세인트 바르탤르미,2015-07
2015-07-31,0,2984,-2984,건지,2015-07
2015-07-31,0,242,-242,크리스마스 아일랜드,2015-07
2015-07-31,0,10139,-10139,토켈라우,2015-07
2015-07-31,0,6952,-6952,미령 버진군도,2015-07
2015-07-31,0,184,-184,니우에,2015-07
2015-07-31,0,654,-654,저어지,2015-07
2015-07-31,0,2000,-2000,맨섬,2015-07
2015-07-31,0,10982,-10982,코스 군도,2015-07
2015-07-31,0,364990,-364990,투발루,2015-07
2015-07-31,0,11,-11,세인트 헬레나,2015-07
2015-07-31,0,3060,-3060,상토메 프린스페,2015-07
2015-07-31,0,180184,-180184,그린랜드,2015-07
2015-07-31,0,1082,-1082,몬트세라트,2015-07
2015-07-31,0,96132,-96132,산마리노,2015-07
2015-07-31,0,215,-215,불령 남부지역,2015-07
2015-08-31,10883915001,7159339633,3724575368,중국,2015-08
2015-08-31,5059167395,3825994159,1233173236,미국,2015-08
2015-08-31,2487845003,107710216,2380134787,홍콩,2015-08
2015-08-31,2245105335,975845914,1269259421,베트남,2015-08
2015-08-31,1870364846,3458587751,-1588222905,일본,2015-08
2015-08-31,1307026505,640107264,666919241,싱가포르,2015-08
2015-08-31,914388518,244912222,669476296,멕시코,2015-08
2015-08-31,867711764,393572557,474139207,인도,2015-08
2015-08-31,829827012,1316599052,-486772040,대만,2015-08
2015-08-31,797824567,1227870256,-430045689,호주,2015-08
2015-08-31,675248517,1415996576,-740748059,사우디아라비아,2015-08
2015-08-31,618152676,550797796,67354880,말레이시아,2015-08
2015-08-31,607786814,226550708,381236106,필리핀,2015-08
2015-08-31,552633345,692309025,-139675680,인도네시아,2015-08
2015-08-31,510077240,59818050,450259190,튀르키예,2015-08
2015-08-31,503267065,374802314,128464751,태국,2015-08
2015-08-31,426780085,1854272747,-1427492662,독일,2015-08
2015-08-31,408689793,701973811,-293284018,아랍에미리트 연합,2015-08
2015-08-31,381280990,207288836,173992154,브라질,2015-08
2015-08-31,372236230,1029436409,-657200179,러시아 연방,2015-08
2015-08-31,346701751,288185066,58516685,캐나다,2015-08
2015-08-31,338216181,6055,338210126,마샬군도,2015-08
2015-08-31,308947506,25041432,283906074,몰타,2015-08
2015-08-31,298658702,497010586,-198351884,이탈리아,2015-08
2015-08-31,297144776,530894683,-233749907,영국,2015-08
2015-08-31,291138899,446202167,-155063268,프랑스,2015-08
2015-08-31,281414583,29188479,252226104,슬로바키아,2015-08
2015-08-31,276986574,256183859,20802715,네덜란드,2015-08
2015-08-31,251060893,261441334,-10380441,이란,2015-08
2015-08-31,226945075,76236243,150708832,폴란드,2015-08
2015-08-31,203800039,6377735,197422304,파나마,2015-08
2015-08-31,182329488,250,182329238,바하마,2015-08
2015-08-31,163289553,197554097,-34264544,스페인,2015-08
2015-08-31,156537344,104464924,52072420,벨기에,2015-08
2015-08-31,152142255,41769398,110372857,체코공화국,2015-08
2015-08-31,147257147,30425843,116831304,이집트,2015-08
2015-08-31,137977007,9885935,128091072,슬로베니아,2015-08
2015-08-31,116478489,326598963,-210120474,칠레,2015-08
2015-08-31,89951873,44317616,45634257,에쿠아도르,2015-08
2015-08-31,83564548,59301754,24262794,이스라엘,2015-08
2015-08-31,83086163,87503321,-4417158,페루,2015-08
2015-08-31,82849117,110233404,-27384287,남아프리카공화국,2015-08
2015-08-31,81443359,111174317,-29730958,뉴질랜드,2015-08
2015-08-31,81073870,56842576,24231294,아르헨티나,2015-08
2015-08-31,79886593,30216801,49669792,방글라데시,2015-08
2015-08-31,79504815,80050131,-545316,헝가리,2015-08
2015-08-31,75000000,80,74999920,맨섬,2015-08
2015-08-31,68476256,178164100,-109687844,오만,2015-08
2015-08-31,68297602,560500370,-492202768,이라크,2015-08
2015-08-31,66097053,962246,65134807,우즈베키스탄,2015-08
2015-08-31,64590752,66003370,-1412618,콜롬비아,2015-08
2015-08-31,64304846,12865861,51438985,요르단,2015-08
2015-08-31,56450781,78778288,-22327507,나이지리아,2015-08
2015-08-31,54192903,18634970,35557933,파키스탄,2015-08
2015-08-31,53655269,603733,53051536,앙골라,2015-08
2015-08-31,52355570,10327364,42028206,과테말라,2015-08
2015-08-31,51473540,104643248,-53169708,오스트리아,2015-08
2015-08-31,50213464,772489881,-722276417,쿠웨이트,2015-08
2015-08-31,47609201,2429116,45180085,토고,2015-08
2015-08-31,46084377,65784472,-19700095,알제리,2015-08
2015-08-31,45746331,21167071,24579260,캄보디아,2015-08
2015-08-31,44032889,121748677,-77715788,스웨덴,2015-08
2015-08-31,40970721,1406224,39564497,탄자니아,2015-08
2015-08-31,40361203,55428207,-15067004,미얀마,2015-08
2015-08-31,39633365,65142021,-25508656,카자흐스탄,2015-08
2015-08-31,39495042,17268184,22226858,포루투갈,2015-08
2015-08-31,33355402,69243153,-35887751,덴마크,2015-08
2015-08-31,33262031,57381418,-24119387,루마니아,2015-08
2015-08-31,30209511,1051993440,-1021783929,카타르,2015-08
2015-08-31,26993934,64204367,-37210433,아일랜드,2015-08
2015-08-31,26932646,27380005,-447359,리비아,2015-08
2015-08-31,25391174,718,25390456,지브랄타,2015-08
2015-08-31,25127935,10558954,14568981,코스타리카,2015-08
2015-08-31,24445975,54384357,-29938382,핀란드,2015-08
2015-08-31,23697083,22082611,1614472,파푸아 뉴기니,2015-08
2015-08-31,23073950,31,23073919,시리아,2015-08
2015-08-31,20479303,2032,20477271,투르크멘,2015-08
2015-08-31,20084815,11684642,8400173,푸에르토리코,2015-08
2015-08-31,20082965,8901205,11181760,스리랑카,2015-08
2015-08-31,19646705,608172,19038533,베네주엘라,2015-08
2015-08-31,19143980,12406372,6737608,모로코,2015-08
2015-08-31,19140371,150146,18990225,피지,2015-08
2015-08-31,19058575,198364274,-179305699,스위스,2015-08
2015-08-31,18717921,3943608,14774313,리투아니아,2015-08
2015-08-31,18198019,2814632,15383387,몽골,2015-08
2015-08-31,18045486,26549264,-8503778,우크라이나,2015-08
2015-08-31,17330071,618764,16711307,파라과이,2015-08
2015-08-31,16214587,5951691,10262896,도미니카 공화국,2015-08
2015-08-31,16078149,2681423,13396726,레바논,2015-08
2015-08-31,15839666,16760931,-921265,그리스,2015-08
2015-08-31,15450500,3853315,11597185,가나,2015-08
2015-08-31,14445157,838798,13606359,수단,2015-08
2015-08-31,14224018,2154189,12069829,온두라스,2015-08
2015-08-31,13184983,1979015,11205968,케냐,2015-08
2015-08-31,13113740,38739517,-25625777,바레인,2015-08
2015-08-31,12514410,6585126,5929284,우루과이,2015-08
2015-08-31,11789895,753779,11036116,니카라과,2015-08
2015-08-31,11493499,6262564,5230935,에티오피아,2015-08
2015-08-31,10843394,186505252,-175661858,노르웨이,2015-08
2015-08-31,10648451,912935,9735516,코트디봐르,2015-08
2015-08-31,10230283,1269923,8960360,엘살바도르,2015-08
2015-08-31,9354223,27177,9327046,키르기스스탄,2015-08
2015-08-31,9239852,11951267,-2711415,트리니다드 토바고,2015-08
2015-08-31,7812374,767689,7044685,크로아티아,2015-08
2015-08-31,7348719,6947664,401055,불가리아,2015-08
2015-08-31,7062500,1241536,5820964,라오스,2015-08
2015-08-31,7047443,5643433,1404010,라트비아,2015-08
2015-08-31,6823565,3483797,3339768,튀니지,2015-08
2015-08-31,6792547,0,6792547,팔레스타인 해방기구,2015-08
2015-08-31,6756490,23611,6732879,아제르바이잔,2015-08
2015-08-31,5913345,158415,5754930,예맨,2015-08
2015-08-31,4733252,43600,4689652,마이크로네시아,2015-08
2015-08-31,4730533,8730146,-3999613,볼리비아,2015-08
2015-08-31,4712252,151305,4560947,모잠비크,2015-08
2015-08-31,4705483,94182,4611301,괌,2015-08
2015-08-31,4391951,232893,4159058,쿠바,2015-08
2015-08-31,4369050,16538850,-12169800,뉴 칼레도니아,2015-08
2015-08-31,4314718,4911280,-596562,에스토니아,2015-08
2015-08-31,4022746,313170,3709576,아이티,2015-08
2015-08-31,4005827,608346,3397481,벨라루스,2015-08
2015-08-31,3978506,0,3978506,아프카니스탄,2015-08
2015-08-31,3684194,1497380,2186814,조지아,2015-08
2015-08-31,3634264,11597688,-7963424,세르비아,2015-08
2015-08-31,3428445,30666,3397779,지부티,2015-08
2015-08-31,3272170,59473,3212697,가봉,2015-08
2015-08-31,3253212,10703890,-7450678,세네갈,2015-08
2015-08-31,3153730,61265,3092465,중앙아프리카공화국,2015-08
2015-08-31,2846807,21064561,-18217754,잠비아,2015-08
2015-08-31,2762195,0,2762195,팔라우,2015-08
2015-08-31,2741421,341957,2399464,모리셔스,2015-08
2015-08-31,2701025,125252792,-122551767,기타국,2015-08
2015-08-31,2574264,181285,2392979,카메룬,2015-08
2015-08-31,2498665,193935,2304730,짐바브웨,2015-08
2015-08-31,2434717,1943434,491283,기니,2015-08
2015-08-31,2392879,6710123,-4317244,마다카스카르,2015-08
2015-08-31,2286127,5610,2280517,르완다,2015-08
2015-08-31,2235323,1065242,1170081,베닝,2015-08
2015-08-31,2214802,736211,1478591,마카오,2015-08
2015-08-31,2147810,57137221,-54989411,콩고,2015-08
2015-08-31,2077848,309669,1768179,네팔,2015-08
2015-08-31,1940880,19041086,-17100206,사이프러스,2015-08
2015-08-31,1889844,46324,1843520,사모아,2015-08
2015-08-31,1800621,375009,1425612,자마이카,2015-08
2015-08-31,1771664,0,1771664,아루바,2015-08
2015-08-31,1715256,0,1715256,타지크,2015-08
2015-08-31,1685141,20557,1664584,네덜란드 열도,2015-08
2015-08-31,1635627,21242507,-19606880,콩고민주공화국,2015-08
2015-08-31,1492505,982069,510436,부르키나 파소,2015-08
2015-08-31,1462637,84470429,-83007792,브루나이,2015-08
2015-08-31,1217320,2790,1214530,불령 리유니온 코모도 제도,2015-08
2015-08-31,1123626,1964221,-840595,아이슬란드,2015-08
2015-08-31,1022209,0,1022209,버뮤다,2015-08
2015-08-31,987713,0,987713,에리트리아,2015-08
2015-08-31,984972,84067,900905,수리남,2015-08
2015-08-31,957854,0,957854,과델로프,2015-08
2015-08-31,930035,225316,704719,알바니아,2015-08
2015-08-31,854899,406,854493,부탄,2015-08
2015-08-31,832075,8681,823394,영령 캐이맨 군도,2015-08
2015-08-31,782722,26106,756616,라이베리아,2015-08
2015-08-31,734502,2996720,-2262218,룩셈부르그,2015-08
2015-08-31,709972,6665,703307,보츠와나,2015-08
2015-08-31,706577,858973,-152396,세이쉘,2015-08
2015-08-31,695077,6744,688333,말라위,2015-08
2015-08-31,671921,214,671707,마티니크,2015-08
2015-08-31,665041,3039838,-2374797,모리타니,2015-08
2015-08-31,623032,31256,591776,가이아나,2015-08
2015-08-31,591448,59,591389,세인트 키츠 네비스,2015-08
2015-08-31,590315,0,590315,국제통화기금,2015-08
2015-08-31,556955,2867,554088,말리,2015-08
2015-08-31,548517,112,548405,북마리아나 군도,2015-08
2015-08-31,548053,0,548053,티모르,2015-08
2015-08-31,534529,0,534529,불령 폴리네시아,2015-08
2015-08-31,511129,64862,446267,바베이도스,2015-08
2015-08-31,490804,13323,477481,아메리칸 사모아,2015-08
2015-08-31,466828,843814,-376986,리히텐슈타인,2015-08
2015-08-31,440724,972275,-531551,우간다,2015-08
2015-08-31,440514,59362,381152,바누아투,2015-08
2015-08-31,412294,11815211,-11402917,스와질랜드,2015-08
2015-08-31,385774,19846,365928,몰디브,2015-08
2015-08-31,347911,292,347619,몬테네그로,2015-08
2015-08-31,336562,2440319,-2103757,몰도바,2015-08
2015-08-31,321625,192350,129275,아르메니아,2015-08
2015-08-31,298616,549825,-251209,키리바티,2015-08
2015-08-31,285094,227866,57228,세인트 루시아,2015-08
2015-08-31,281562,1807446,-1525884,보스니아-헤르체고비나,2015-08
2015-08-31,266338,341271,-74933,시에라 리온,2015-08
2015-08-31,252394,0,252394,그레나다,2015-08
2015-08-31,233729,7,233722,영령 버진군도,2015-08
2015-08-31,229435,44,229391,카보 베르데,2015-08
2015-08-31,219866,635,219231,도미니카,2015-08
2015-08-31,214130,1320,212810,벨리제,2015-08
2015-08-31,210960,0,210960,안티가 바부다,2015-08
2015-08-31,210291,71377133,-71166842,적도 기니,2015-08
2015-08-31,202744,0,202744,감비아,2015-08
2015-08-31,201809,0,201809,메요트,2015-08
2015-08-31,197028,1083030,-886002,솔로몬 군도,2015-08
2015-08-31,173544,727552,-554008,소말리아,2015-08
2015-08-31,170245,18815483,-18645238,나미비아,2015-08
2015-08-31,134753,139004,-4251,마세도니아,2015-08
2015-08-31,95799,0,95799,산마리노,2015-08
2015-08-31,81200,38049,43151,기네비소,2015-08
2015-08-31,76936,0,76936,상토메 프린스페,2015-08
2015-08-31,74666,0,74666,투르크 & 카이코스 군도,2015-08
2015-08-31,55953,8816,47137,챠드,2015-08
2015-08-31,30646,675,29971,니제르,2015-08
2015-08-31,27678,23709,3969,통가,2015-08
2015-08-31,17495,143,17352,불령 가이아나,2015-08
2015-08-31,10635,18,10617,부룬디,2015-08
2015-08-31,9961,37,9924,영령 인도양,2015-08
2015-08-31,5400,0,5400,남수단,2015-08
2015-08-31,4800,247,4553,세인트 빈센트 그레나딘,2015-08
2015-08-31,3899,229919,-226020,모나코,2015-08
2015-08-31,1195,13,1182,앙귈라,2015-08
2015-08-31,1148,1419,-271,나우루,2015-08
2015-08-31,1078,0,1078,세인트 마틴,2015-08
2015-08-31,94,331084,-330990,그린랜드,2015-08
2015-08-31,23,0,23,파로에 군도,2015-08
2015-08-31,0,91,-91,세인트 헬레나,2015-08
2015-08-31,0,162,-162,토켈라우,2015-08
2015-08-31,0,4387,-4387,미령 버진군도,2015-08
2015-08-31,0,10016,-10016,코모로스,2015-08
2015-08-31,0,36888,-36888,큐라소,2015-08
2015-08-31,0,12500,-12500,세인트 바르탤르미,2015-08
2015-08-31,0,86,-86,코스 군도,2015-08
2015-08-31,0,2668,-2668,몬트세라트,2015-08
2015-08-31,0,15656,-15656,니우에,2015-08
2015-08-31,0,188,-188,크리스마스 아일랜드,2015-08
2015-08-31,0,199,-199,안도라,2015-08
2015-09-30,12045381267,7584837284,4460543983,중국,2015-09
2015-09-30,5464307094,3278478366,2185828728,미국,2015-09
2015-09-30,2739692229,113788679,2625903550,홍콩,2015-09
2015-09-30,2391607104,1069799749,1321807355,베트남,2015-09
2015-09-30,2037366882,3708138864,-1670771982,일본,2015-09
2015-09-30,1518495715,632232345,886263370,싱가포르,2015-09
2015-09-30,1058603805,307760097,750843708,인도,2015-09
2015-09-30,965200919,276142906,689058013,멕시코,2015-09
2015-09-30,889161665,1293468804,-404307139,대만,2015-09
2015-09-30,836198944,1568813371,-732614427,호주,2015-09
2015-09-30,817647249,1194387171,-376739922,사우디아라비아,2015-09
2015-09-30,633830724,271081570,362749154,필리핀,2015-09
2015-09-30,625798950,700425547,-74626597,인도네시아,2015-09
2015-09-30,610287479,1791354691,-1181067212,독일,2015-09
2015-09-30,592156635,736280240,-144123605,말레이시아,2015-09
2015-09-30,540569657,22286143,518283514,마샬군도,2015-09
2015-09-30,504101940,368099752,136002188,태국,2015-09
2015-09-30,499766783,74655657,425111126,튀르키예,2015-09
2015-09-30,437315665,2225077,435090588,그리스,2015-09
2015-09-30,429821984,679381461,-249559477,아랍에미리트 연합,2015-09
2015-09-30,414652189,424789618,-10137429,영국,2015-09
2015-09-30,402040992,4726543,397314449,몰타,2015-09
2015-09-30,398342485,249083224,149259261,브라질,2015-09
2015-09-30,395499610,827227127,-431727517,러시아 연방,2015-09
2015-09-30,383865587,229860036,154005551,네덜란드,2015-09
2015-09-30,377075084,326636144,50438940,캐나다,2015-09
2015-09-30,363132477,16328773,346803704,슬로바키아,2015-09
2015-09-30,332711211,333673286,-962075,이란,2015-09
2015-09-30,262202289,46660504,215541785,폴란드,2015-09
2015-09-30,261090861,1404,261089457,라이베리아,2015-09
2015-09-30,242486756,437383511,-194896755,이탈리아,2015-09
2015-09-30,210193495,510247431,-300053936,프랑스,2015-09
2015-09-30,175281718,132884844,42396874,스페인,2015-09
2015-09-30,169482759,8630554,160852205,슬로베니아,2015-09
2015-09-30,162677992,96329045,66348947,벨기에,2015-09
2015-09-30,162478853,45989395,116489458,체코공화국,2015-09
2015-09-30,162244878,4426783,157818095,이집트,2015-09
2015-09-30,113720963,291939660,-178218697,칠레,2015-09
2015-09-30,113076429,67977974,45098455,아르헨티나,2015-09
2015-09-30,101701879,247920165,-146218286,이라크,2015-09
2015-09-30,100659917,60462411,40197506,이스라엘,2015-09
2015-09-30,96388508,115786452,-19397944,남아프리카공화국,2015-09
2015-09-30,93751160,88761200,4989960,뉴질랜드,2015-09
2015-09-30,93390040,41544481,51845559,방글라데시,2015-09
2015-09-30,89536720,665036,88871684,우즈베키스탄,2015-09
2015-09-30,81636244,105813453,-24177209,페루,2015-09
2015-09-30,80014134,67589345,12424789,헝가리,2015-09
2015-09-30,75955922,18545773,57410149,콜롬비아,2015-09
2015-09-30,75000000,500,74999500,맨섬,2015-09
2015-09-30,74807924,170,74807754,바하마,2015-09
2015-09-30,68231581,85358968,-17127387,오스트리아,2015-09
2015-09-30,65871171,19768020,46103151,파키스탄,2015-09
2015-09-30,61322902,71548773,-10225871,나이지리아,2015-09
2015-09-30,60756892,229382460,-168625568,오만,2015-09
2015-09-30,55560916,51441732,4119184,덴마크,2015-09
2015-09-30,52103220,128520287,-76417067,스웨덴,2015-09
2015-09-30,50898272,4749443,46148829,요르단,2015-09
2015-09-30,50882250,634356587,-583474337,쿠웨이트,2015-09
2015-09-30,48788132,6904703,41883429,에쿠아도르,2015-09
2015-09-30,46864248,28455536,18408712,알제리,2015-09
2015-09-30,44101024,20709288,23391736,캄보디아,2015-09
2015-09-30,43277563,1205762290,-1162484727,카타르,2015-09
2015-09-30,42526089,64715145,-22189056,미얀마,2015-09
2015-09-30,36857448,10380935,26476513,파나마,2015-09
2015-09-30,36376076,44202310,-7826234,루마니아,2015-09
2015-09-30,35046439,954300,34092139,리비아,2015-09
2015-09-30,34649784,12097288,22552496,카자흐스탄,2015-09
2015-09-30,32312347,16471283,15841064,포루투갈,2015-09
2015-09-30,31614340,186925511,-155311171,스위스,2015-09
2015-09-30,28404210,7370641,21033569,스리랑카,2015-09
2015-09-30,28096070,76195519,-48099449,아일랜드,2015-09
2015-09-30,27170226,84214473,-57044247,파푸아 뉴기니,2015-09
2015-09-30,26390729,15859472,10531257,과테말라,2015-09
2015-09-30,25927680,74108434,-48180754,핀란드,2015-09
2015-09-30,25368526,9209991,16158535,모로코,2015-09
2015-09-30,24070737,5427500,18643237,도미니카 공화국,2015-09
2015-09-30,23856199,4718607,19137592,리투아니아,2015-09
2015-09-30,23479494,2567,23476927,투르크멘,2015-09
2015-09-30,23085827,2728,23083099,시리아,2015-09
2015-09-30,22144858,1099398,21045460,몽골,2015-09
2015-09-30,21967508,15874468,6093040,푸에르토리코,2015-09
2015-09-30,20823932,7798449,13025483,코스타리카,2015-09
2015-09-30,20571912,15097902,5474010,뉴 칼레도니아,2015-09
2015-09-30,20044837,59808312,-39763475,바레인,2015-09
2015-09-30,19132218,7911027,11221191,우루과이,2015-09
2015-09-30,18761766,2319763,16442003,가나,2015-09
2015-09-30,16684660,1530878,15153782,레바논,2015-09
2015-09-30,15753104,39319718,-23566614,우크라이나,2015-09
2015-09-30,15576345,1781926,13794419,케냐,2015-09
2015-09-30,15142300,1571362,13570938,니카라과,2015-09
2015-09-30,14119329,2727943,11391386,튀니지,2015-09
2015-09-30,13658262,268600,13389662,피지,2015-09
2015-09-30,13579903,959931,12619972,파라과이,2015-09
2015-09-30,13399402,200055,13199347,예맨,2015-09
2015-09-30,13330822,648637,12682185,탄자니아,2015-09
2015-09-30,12352317,950150,11402167,라오스,2015-09
2015-09-30,11777645,378058,11399587,수단,2015-09
2015-09-30,11450330,656402,10793928,베네주엘라,2015-09
2015-09-30,11219412,8956295,2263117,트리니다드 토바고,2015-09
2015-09-30,10384456,1316007,9068449,코트디봐르,2015-09
2015-09-30,10075624,251686229,-241610605,노르웨이,2015-09
2015-09-30,8954247,5917675,3036572,에티오피아,2015-09
2015-09-30,8530885,2179473,6351412,엘살바도르,2015-09
2015-09-30,8417129,45956801,-37539672,앙골라,2015-09
2015-09-30,8186596,1619261,6567335,온두라스,2015-09
2015-09-30,8160368,20379209,-12218841,불가리아,2015-09
2015-09-30,7842308,1838563,6003745,크로아티아,2015-09
2015-09-30,7698543,6782613,915930,세르비아,2015-09
2015-09-30,7093155,151890,6941265,모잠비크,2015-09
2015-09-30,6580738,2728,6578010,세인트 키츠 네비스,2015-09
2015-09-30,6384492,1298,6383194,키르기스스탄,2015-09
2015-09-30,6252822,4840260,1412562,에스토니아,2015-09
2015-09-30,6155388,768892,5386496,벨라루스,2015-09
2015-09-30,6025412,0,6025412,불령 폴리네시아,2015-09
2015-09-30,5698689,187537,5511152,아제르바이잔,2015-09
2015-09-30,5486314,4340170,1146144,라트비아,2015-09
2015-09-30,5216685,8862083,-3645398,세네갈,2015-09
2015-09-30,5206213,77845703,-72639490,브루나이,2015-09
2015-09-30,5193488,0,5193488,팔레스타인 해방기구,2015-09
2015-09-30,4473528,4045489,428039,볼리비아,2015-09
2015-09-30,4376445,58291,4318154,마이크로네시아,2015-09
2015-09-30,4273567,1412837,2860730,베닝,2015-09
2015-09-30,4167409,731247,3436162,조지아,2015-09
2015-09-30,3906927,32067,3874860,괌,2015-09
2015-09-30,3820124,38,3820086,지부티,2015-09
2015-09-30,3692670,37260863,-33568193,잠비아,2015-09
2015-09-30,3273357,23604712,-20331355,콩고민주공화국,2015-09
2015-09-30,3252760,246455,3006305,아이티,2015-09
2015-09-30,3220178,31011,3189167,쿠바,2015-09
2015-09-30,3070389,28,3070361,키리바티,2015-09
2015-09-30,2965568,2841604,123964,아이슬란드,2015-09
2015-09-30,2898368,332232,2566136,모리셔스,2015-09
2015-09-30,2885562,0,2885562,에리트리아,2015-09
2015-09-30,2484298,199141,2285157,마카오,2015-09
2015-09-30,2475866,59347286,-56871420,기타국,2015-09
2015-09-30,2383707,13065117,-10681410,사이프러스,2015-09
2015-09-30,2347887,827588,1520299,부르키나 파소,2015-09
2015-09-30,2089915,189309,1900606,짐바브웨,2015-09
2015-09-30,2020232,575661,1444571,세이쉘,2015-09
2015-09-30,1930612,120752,1809860,사모아,2015-09
2015-09-30,1857061,109268,1747793,네덜란드 열도,2015-09
2015-09-30,1846840,1397517,449323,토고,2015-09
2015-09-30,1801762,113863,1687899,네팔,2015-09
2015-09-30,1724257,1521514,202743,기니,2015-09
2015-09-30,1664105,221042,1443063,카메룬,2015-09
2015-09-30,1608691,311486,1297205,알바니아,2015-09
2015-09-30,1560627,161,1560466,아프카니스탄,2015-09
2015-09-30,1553588,2026767,-473179,콩고,2015-09
2015-09-30,1495288,3645792,-2150504,자마이카,2015-09
2015-09-30,1470686,5973163,-4502477,마다카스카르,2015-09
2015-09-30,1352508,1772,1350736,타지크,2015-09
2015-09-30,1247006,26343,1220663,말라위,2015-09
2015-09-30,1227082,76789784,-75562702,가봉,2015-09
2015-09-30,1199418,0,1199418,불령 리유니온 코모도 제도,2015-09
2015-09-30,1195128,27854,1167274,바누아투,2015-09
2015-09-30,1178083,851444,326639,소말리아,2015-09
2015-09-30,1103685,4094826,-2991141,모리타니,2015-09
2015-09-30,1045295,0,1045295,영령 캐이맨 군도,2015-09
2015-09-30,895523,479967,415556,수리남,2015-09
2015-09-30,887053,0,887053,마티니크,2015-09
2015-09-30,875026,50325,824701,말리,2015-09
2015-09-30,832903,0,832903,과델로프,2015-09
2015-09-30,830685,112,830573,북마리아나 군도,2015-09
2015-09-30,781492,0,781492,아루바,2015-09
2015-09-30,747470,4658219,-3910749,룩셈부르그,2015-09
2015-09-30,722992,184,722808,챠드,2015-09
2015-09-30,720717,86802,633915,르완다,2015-09
2015-09-30,704708,304710,399998,아르메니아,2015-09
2015-09-30,671526,361310,310216,리히텐슈타인,2015-09
2015-09-30,655739,102569757,-101914018,적도 기니,2015-09
2015-09-30,633931,0,633931,부탄,2015-09
2015-09-30,616221,869218,-252997,보스니아-헤르체고비나,2015-09
2015-09-30,587812,12600,575212,아메리칸 사모아,2015-09
2015-09-30,573110,839374,-266264,우간다,2015-09
2015-09-30,554002,1164642,-610640,몰도바,2015-09
2015-09-30,517621,691423,-173802,시에라 리온,2015-09
2015-09-30,507906,33694,474212,안티가 바부다,2015-09
2015-09-30,507240,36013,471227,몰디브,2015-09
2015-09-30,450375,15695,434680,보츠와나,2015-09
2015-09-30,421195,101,421094,티모르,2015-09
2015-09-30,392529,5355,387174,벨리제,2015-09
2015-09-30,366608,110097,256511,마세도니아,2015-09
2015-09-30,358540,738,357802,바베이도스,2015-09
2015-09-30,349052,0,349052,도미니카,2015-09
2015-09-30,312296,0,312296,지브랄타,2015-09
2015-09-30,260026,174779,85247,가이아나,2015-09
2015-09-30,212972,0,212972,팔라우,2015-09
2015-09-30,200477,306,200171,영령 버진군도,2015-09
2015-09-30,188366,3120792,-2932426,나미비아,2015-09
2015-09-30,145643,0,145643,세인트 빈센트 그레나딘,2015-09
2015-09-30,145346,0,145346,국제통화기금,2015-09
2015-09-30,141735,274,141461,몬테네그로,2015-09
2015-09-30,122214,1174070,-1051856,스와질랜드,2015-09
2015-09-30,111784,0,111784,버뮤다,2015-09
2015-09-30,95076,0,95076,세인트 루시아,2015-09
2015-09-30,94192,525686,-431494,솔로몬 군도,2015-09
2015-09-30,86872,0,86872,그레나다,2015-09
2015-09-30,85781,0,85781,안타티카,2015-09
2015-09-30,83029,220567,-137538,미령 버진군도,2015-09
2015-09-30,67210,74733,-7523,감비아,2015-09
2015-09-30,61720,28034,33686,안도라,2015-09
2015-09-30,51472,0,51472,남수단,2015-09
2015-09-30,50944,2618,48326,불령 가이아나,2015-09
2015-09-30,35798,2233,33565,카보 베르데,2015-09
2015-09-30,28896,0,28896,투발루,2015-09
2015-09-30,19800,7845,11955,부룬디,2015-09
2015-09-30,18775,96707,-77932,산마리노,2015-09
2015-09-30,18677,545871,-527194,모나코,2015-09
2015-09-30,16370,465,15905,나우루,2015-09
2015-09-30,5228,0,5228,앙귈라,2015-09
2015-09-30,2662,701,1961,니제르,2015-09
2015-09-30,2263,0,2263,쿡 아일랜드,2015-09
2015-09-30,2142,0,2142,건지,2015-09
2015-09-30,2044,0,2044,파로에 군도,2015-09
2015-09-30,1031,33458,-32427,중앙아프리카공화국,2015-09
2015-09-30,1014,0,1014,큐라소,2015-09
2015-09-30,885,0,885,투르크 & 카이코스 군도,2015-09
2015-09-30,215,0,215,세인트 마틴,2015-09
2015-09-30,205,104603,-104398,그린랜드,2015-09
2015-09-30,170,0,170,포클랜드 군도,2015-09
2015-09-30,0,62730,-62730,토켈라우,2015-09
2015-09-30,0,43525,-43525,통가,2015-09
2015-09-30,0,730,-730,교황청,2015-09
2015-09-30,0,2849,-2849,세인트 헬레나,2015-09
2015-09-30,0,17,-17,마이너 아우틀링 합중국 군도,2015-09
2015-09-30,0,24907,-24907,기네비소,2015-09
2015-09-30,0,200,-200,몬트세라트,2015-09
2015-09-30,0,15858,-15858,코모로스,2015-09
2015-09-30,0,40004,-40004,니우에,2015-09
2015-09-30,0,1508,-1508,상토메 프린스페,2015-09
2015-09-30,0,13,-13,피트카이른,2015-09
2015-10-31,12493015151,8388052104,4104963047,중국,2015-10
2015-10-31,6011443155,3997751948,2013691207,미국,2015-10
2015-10-31,2607539279,105670235,2501869044,홍콩,2015-10
2015-10-31,2403076655,1210187366,1192889289,베트남,2015-10
2015-10-31,2138398052,3852568898,-1714170846,일본,2015-10
2015-10-31,1178101362,426975679,751125683,인도,2015-10
2015-10-31,1112316686,593590458,518726228,싱가포르,2015-10
2015-10-31,863267261,1714386979,-851119718,대만,2015-10
2015-10-31,796157142,304778962,491378180,멕시코,2015-10
2015-10-31,771400171,1303589146,-532188975,사우디아라비아,2015-10
2015-10-31,683140369,871112395,-187972026,말레이시아,2015-10
2015-10-31,669526091,1250118477,-580592386,호주,2015-10
2015-10-31,657929321,268107339,389821982,필리핀,2015-10
2015-10-31,600562285,672612878,-72050593,인도네시아,2015-10
2015-10-31,549991839,54706554,495285285,튀르키예,2015-10
2015-10-31,541736876,1562510145,-1020773269,독일,2015-10
2015-10-31,530509758,405610235,124899523,태국,2015-10
2015-10-31,491016164,1211495,489804669,파나마,2015-10
2015-10-31,472201919,779352626,-307150707,아랍에미리트 연합,2015-10
2015-10-31,449810334,909593693,-459783359,러시아 연방,2015-10
2015-10-31,436531735,1127,436530608,마샬군도,2015-10
2015-10-31,424731856,463665605,-38933749,영국,2015-10
2015-10-31,402886178,380999959,21886219,캐나다,2015-10
2015-10-31,378172056,180852273,197319783,네덜란드,2015-10
2015-10-31,317903881,17093722,300810159,슬로바키아,2015-10
2015-10-31,308973292,399248016,-90274724,브라질,2015-10
2015-10-31,279871676,56075441,223796235,폴란드,2015-10
2015-10-31,258090965,418988189,-160897224,이탈리아,2015-10
2015-10-31,239437274,176108163,63329111,이란,2015-10
2015-10-31,186615798,376624467,-190008669,프랑스,2015-10
2015-10-31,181346602,151089157,30257445,스페인,2015-10
2015-10-31,180324234,51344617,128979617,체코공화국,2015-10
2015-10-31,170577519,88810173,81767346,벨기에,2015-10
2015-10-31,155470799,17115839,138354960,몰타,2015-10
2015-10-31,152483085,530,152482555,바하마,2015-10
2015-10-31,145739059,14029768,131709291,이집트,2015-10
2015-10-31,143960967,8973252,134987715,슬로베니아,2015-10
2015-10-31,125423320,78586091,46837229,뉴질랜드,2015-10
2015-10-31,124192583,1676287,122516296,우즈베키스탄,2015-10
2015-10-31,122379840,315056202,-192676362,칠레,2015-10
2015-10-31,98411595,137448494,-39036899,남아프리카공화국,2015-10
2015-10-31,97068567,69532768,27535799,이스라엘,2015-10
2015-10-31,96401706,19123528,77278178,콜롬비아,2015-10
2015-10-31,96086229,422456251,-326370022,이라크,2015-10
2015-10-31,91229791,61531538,29698253,헝가리,2015-10
2015-10-31,90211613,71487999,18723614,아르헨티나,2015-10
2015-10-31,89260396,32379957,56880439,방글라데시,2015-10
2015-10-31,78321449,82661537,-4340088,오스트리아,2015-10
2015-10-31,76064297,96956463,-20892166,페루,2015-10
2015-10-31,74932424,136635396,-61702972,스웨덴,2015-10
2015-10-31,71106799,22433029,48673770,파키스탄,2015-10
2015-10-31,66572110,653669291,-587097181,쿠웨이트,2015-10
2015-10-31,62114052,35940,62078112,알제리,2015-10
2015-10-31,61724612,239935519,-178210907,오만,2015-10
2015-10-31,61343391,3889504,57453887,요르단,2015-10
2015-10-31,60465594,18457607,42007987,그리스,2015-10
2015-10-31,59999242,111114629,-51115387,나이지리아,2015-10
2015-10-31,57755613,1605884,56149729,리비아,2015-10
2015-10-31,55258648,5636540,49622108,에쿠아도르,2015-10
2015-10-31,54456399,49338876,5117523,루마니아,2015-10
2015-10-31,54376431,17154907,37221524,캄보디아,2015-10
2015-10-31,51991401,15747482,36243919,과테말라,2015-10
2015-10-31,47469504,1187183916,-1139714412,카타르,2015-10
2015-10-31,44182124,72727078,-28544954,미얀마,2015-10
2015-10-31,43098799,285820,42812979,피지,2015-10
2015-10-31,34337721,15956315,18381406,포루투갈,2015-10
2015-10-31,34100014,110823669,-76723655,덴마크,2015-10
2015-10-31,32896594,91045770,-58149176,아일랜드,2015-10
2015-10-31,32112655,216283027,-184170372,스위스,2015-10
2015-10-31,31053316,9056507,21996809,카자흐스탄,2015-10
2015-10-31,27981434,5313886,22667548,도미니카 공화국,2015-10
2015-10-31,25734226,15374047,10360179,푸에르토리코,2015-10
2015-10-31,23793382,6531563,17261819,스리랑카,2015-10
2015-10-31,22615213,6278534,16336679,리투아니아,2015-10
2015-10-31,22604367,19643647,2960720,뉴 칼레도니아,2015-10
2015-10-31,22066676,1686314,20380362,레바논,2015-10
2015-10-31,21226437,7735983,13490454,모로코,2015-10
2015-10-31,20737073,87731654,-66994581,핀란드,2015-10
2015-10-31,19901824,99813,19802011,베네주엘라,2015-10
2015-10-31,18506365,1665,18504700,투르크멘,2015-10
2015-10-31,17557651,4051258,13506393,몽골,2015-10
2015-10-31,16845421,11284750,5560671,코스타리카,2015-10
2015-10-31,16767673,2388125,14379548,튀니지,2015-10
2015-10-31,16242736,3079286,13163450,가나,2015-10
2015-10-31,15931217,979172,14952045,라오스,2015-10
2015-10-31,15885956,50646592,-34760636,우크라이나,2015-10
2015-10-31,14415904,446743,13969161,파라과이,2015-10
2015-10-31,14059412,57816819,-43757407,바레인,2015-10
2015-10-31,13922189,19,13922170,시리아,2015-10
2015-10-31,13329473,3072770,10256703,케냐,2015-10
2015-10-31,12050368,1088834,10961534,니카라과,2015-10
2015-10-31,11642745,162885,11479860,수단,2015-10
2015-10-31,11488446,368170,11120276,모잠비크,2015-10
2015-10-31,10903436,615123,10288313,코트디봐르,2015-10
2015-10-31,10863708,349529,10514179,탄자니아,2015-10
2015-10-31,9808465,17327165,-7518700,트리니다드 토바고,2015-10
2015-10-31,9525571,2180751,7344820,온두라스,2015-10
2015-10-31,9444628,6691375,2753253,불가리아,2015-10
2015-10-31,8897443,5043463,3853980,세르비아,2015-10
2015-10-31,8265579,6116852,2148727,우루과이,2015-10
2015-10-31,7996994,19695792,-11698798,볼리비아,2015-10
2015-10-31,7812367,1183823,6628544,엘살바도르,2015-10
2015-10-31,7797837,202866214,-195068377,노르웨이,2015-10
2015-10-31,7575743,121339,7454404,예맨,2015-10
2015-10-31,7233562,73240,7160322,아제르바이잔,2015-10
2015-10-31,7227170,31407755,-24180585,브루나이,2015-10
2015-10-31,6944898,3440305,3504593,에티오피아,2015-10
2015-10-31,6522666,442,6522224,지부티,2015-10
2015-10-31,6115498,0,6115498,팔레스타인 해방기구,2015-10
2015-10-31,6063045,525197,5537848,앙골라,2015-10
2015-10-31,5595712,5750251,-154539,세네갈,2015-10
2015-10-31,5336929,122522,5214407,키르기스스탄,2015-10
2015-10-31,5211493,5807597,-596104,라트비아,2015-10
2015-10-31,5127189,270815,4856374,괌,2015-10
2015-10-31,5094850,67626009,-62531159,파푸아 뉴기니,2015-10
2015-10-31,4538433,0,4538433,안타티카,2015-10
2015-10-31,4406848,98463,4308385,불령 폴리네시아,2015-10
2015-10-31,4276890,457565,3819325,마세도니아,2015-10
2015-10-31,4234562,11987929,-7753367,에스토니아,2015-10
2015-10-31,4153969,0,4153969,마이크로네시아,2015-10
2015-10-31,3850010,549279,3300731,크로아티아,2015-10
2015-10-31,3515140,814261,2700879,조지아,2015-10
2015-10-31,3202217,54182,3148035,보츠와나,2015-10
2015-10-31,3066991,464730,2602261,아이티,2015-10
2015-10-31,3010775,63719,2947056,마카오,2015-10
2015-10-31,2985884,4757424,-1771540,벨라루스,2015-10
2015-10-31,2874750,285391,2589359,모리셔스,2015-10
2015-10-31,2856989,948149,1908840,쿠바,2015-10
2015-10-31,2431623,452354,1979269,베닝,2015-10
2015-10-31,2357826,0,2357826,아루바,2015-10
2015-10-31,2351279,28862125,-26510846,기타국,2015-10
2015-10-31,2277223,237578,2039645,사이프러스,2015-10
2015-10-31,2188436,5527679,-3339243,마다카스카르,2015-10
2015-10-31,2046563,1986047,60516,아이슬란드,2015-10
2015-10-31,1940469,38083362,-36142893,잠비아,2015-10
2015-10-31,1803788,2614,1801174,북마리아나 군도,2015-10
2015-10-31,1759657,241574,1518083,카메룬,2015-10
2015-10-31,1589446,859885,729561,자마이카,2015-10
2015-10-31,1587595,54217,1533378,사모아,2015-10
2015-10-31,1466373,352727,1113646,네팔,2015-10
2015-10-31,1437968,18206059,-16768091,콩고민주공화국,2015-10
2015-10-31,1400644,1937108,-536464,토고,2015-10
2015-10-31,1398185,33136459,-31738274,가봉,2015-10
2015-10-31,1322026,139344,1182682,가이아나,2015-10
2015-10-31,1308925,199963,1108962,짐바브웨,2015-10
2015-10-31,1280745,1000808,279937,세이쉘,2015-10
2015-10-31,1260508,61,1260447,아프카니스탄,2015-10
2015-10-31,1239010,138523,1100487,알바니아,2015-10
2015-10-31,1168024,54406,1113618,네덜란드 열도,2015-10
2015-10-31,1154373,376,1153997,말리,2015-10
2015-10-31,1137222,3035246,-1898024,나미비아,2015-10
2015-10-31,1123631,14113047,-12989416,라이베리아,2015-10
2015-10-31,1048145,1017280,30865,보스니아-헤르체고비나,2015-10
2015-10-31,1041423,891739,149684,기니,2015-10
2015-10-31,1029548,76332,953216,티모르,2015-10
2015-10-31,1018081,4476,1013605,타지크,2015-10
2015-10-31,953131,65709048,-64755917,적도 기니,2015-10
2015-10-31,946353,4547365,-3601012,룩셈부르그,2015-10
2015-10-31,937031,915931,21100,콩고,2015-10
2015-10-31,921356,56754,864602,바베이도스,2015-10
2015-10-31,918422,349,918073,버뮤다,2015-10
2015-10-31,917726,28843,888883,르완다,2015-10
2015-10-31,820422,708306,112116,아르메니아,2015-10
2015-10-31,817611,306,817305,불령 리유니온 코모도 제도,2015-10
2015-10-31,812204,3159,809045,몰디브,2015-10
2015-10-31,772832,0,772832,영령 캐이맨 군도,2015-10
2015-10-31,761252,427218,334034,리히텐슈타인,2015-10
2015-10-31,747383,908869,-161486,우간다,2015-10
2015-10-31,737384,0,737384,마티니크,2015-10
2015-10-31,735229,1487153,-751924,소말리아,2015-10
2015-10-31,633849,401922,231927,안티가 바부다,2015-10
2015-10-31,623848,262670,361178,수리남,2015-10
2015-10-31,564809,4784331,-4219522,모리타니,2015-10
2015-10-31,475386,0,475386,세인트 루시아,2015-10
2015-10-31,452670,332617,120053,키리바티,2015-10
2015-10-31,444305,1248,443057,도미니카,2015-10
2015-10-31,418688,24,418664,카보 베르데,2015-10
2015-10-31,418112,18440,399672,말라위,2015-10
2015-10-31,400394,819,399575,과델로프,2015-10
2015-10-31,383974,22,383952,아메리칸 사모아,2015-10
2015-10-31,346596,1277441,-930845,몰도바,2015-10
2015-10-31,333921,880346,-546425,시에라 리온,2015-10
2015-10-31,297182,5411,291771,부탄,2015-10
2015-10-31,274286,0,274286,지브랄타,2015-10
2015-10-31,269303,0,269303,팔라우,2015-10
2015-10-31,251962,831841,-579879,부르키나 파소,2015-10
2015-10-31,222210,166932,55278,벨리제,2015-10
2015-10-31,167241,0,167241,투르크 & 카이코스 군도,2015-10
2015-10-31,161618,129,161489,상토메 프린스페,2015-10
2015-10-31,150199,0,150199,에리트리아,2015-10
2015-10-31,146587,30460,116127,감비아,2015-10
2015-10-31,145919,72423,73496,통가,2015-10
2015-10-31,139406,529505,-390099,바누아투,2015-10
2015-10-31,133908,690520,-556612,스와질랜드,2015-10
2015-10-31,122428,58211,64217,영령 버진군도,2015-10
2015-10-31,102320,0,102320,그레나다,2015-10
2015-10-31,101019,0,101019,세인트 키츠 네비스,2015-10
2015-10-31,87192,100,87092,부룬디,2015-10
2015-10-31,67155,262,66893,불령 가이아나,2015-10
2015-10-31,67120,0,67120,기네비소,2015-10
2015-10-31,64430,0,64430,세인트 빈센트 그레나딘,2015-10
2015-10-31,54345,386,53959,나우루,2015-10
2015-10-31,51922,1358,50564,산마리노,2015-10
2015-10-31,37331,18889,18442,큐라소,2015-10
2015-10-31,31934,3215,28719,안도라,2015-10
2015-10-31,31266,969,30297,니제르,2015-10
2015-10-31,29297,77,29220,몬테네그로,2015-10
2015-10-31,23000,150,22850,투발루,2015-10
2015-10-31,15336,0,15336,챠드,2015-10
2015-10-31,12706,0,12706,남수단,2015-10
2015-10-31,7189,0,7189,앙귈라,2015-10
2015-10-31,5919,1032869,-1026950,솔로몬 군도,2015-10
2015-10-31,5534,0,5534,중앙아프리카공화국,2015-10
2015-10-31,2855,927493,-924638,미령 버진군도,2015-10
2015-10-31,1517,0,1517,포클랜드 군도,2015-10
2015-10-31,105,795,-690,쿡 아일랜드,2015-10
2015-10-31,80,302,-222,세인트 마틴,2015-10
2015-10-31,11,3500,-3489,토켈라우,2015-10
2015-10-31,0,211,-211,몬트세라트,2015-10
2015-10-31,0,116741,-116741,그린랜드,2015-10
2015-10-31,0,2309,-2309,코스 군도,2015-10
2015-10-31,0,90,-90,맨섬,2015-10
2015-10-31,0,7691,-7691,세인트 바르탤르미,2015-10
2015-10-31,0,2993,-2993,크리스마스 아일랜드,2015-10
2015-10-31,0,2205,-2205,세인트 헬레나,2015-10
2015-10-31,0,112914,-112914,모나코,2015-10
2015-10-31,0,24,-24,레소토,2015-10
2015-10-31,0,14963,-14963,건지,2015-10
2015-10-31,0,73273,-73273,니우에,2015-10
2015-11-30,11610771237,7856046740,3754724497,중국,2015-11
2015-11-30,5519654833,3357783569,2161871264,미국,2015-11
2015-11-30,2839574119,119844982,2719729137,홍콩,2015-11
2015-11-30,2294135172,683227791,1610907381,영국,2015-11
2015-11-30,2179078681,924347335,1254731346,베트남,2015-11
2015-11-30,2022536098,3340139750,-1317603652,일본,2015-11
2015-11-30,1397685389,496656555,901028834,싱가포르,2015-11
2015-11-30,1046592066,1300094335,-253502269,대만,2015-11
2015-11-30,999056832,5523045,993533787,마샬군도,2015-11
2015-11-30,934335554,297390682,636944872,인도,2015-11
2015-11-30,793513362,1032805585,-239292223,호주,2015-11
2015-11-30,759970469,1278831844,-518861375,사우디아라비아,2015-11
2015-11-30,673914254,277653119,396261135,필리핀,2015-11
2015-11-30,602604303,675764597,-73160294,말레이시아,2015-11
2015-11-30,572037033,254452381,317584652,멕시코,2015-11
2015-11-30,543530520,668243594,-124713074,인도네시아,2015-11
2015-11-30,534790392,11735,534778657,영령 캐이맨 군도,2015-11
2015-11-30,481073465,545957638,-64884173,아랍에미리트 연합,2015-11
2015-11-30,477944796,1773927591,-1295982795,독일,2015-11
2015-11-30,476885729,1781868,475103861,콩고,2015-11
2015-11-30,469644419,374923851,94720568,태국,2015-11
2015-11-30,450260813,0,450260813,버뮤다,2015-11
2015-11-30,431979245,52738683,379240562,튀르키예,2015-11
2015-11-30,311978348,1061514671,-749536323,러시아 연방,2015-11
2015-11-30,308964098,534994071,-226029973,이탈리아,2015-11
2015-11-30,285670928,410441728,-124770800,네덜란드,2015-11
2015-11-30,285153653,274295796,10857857,캐나다,2015-11
2015-11-30,280149911,441792210,-161642299,브라질,2015-11
2015-11-30,240314301,130332252,109982049,이란,2015-11
2015-11-30,230158693,12671824,217486869,슬로바키아,2015-11
2015-11-30,229534672,43927961,185606711,폴란드,2015-11
2015-11-30,161098436,4359511,156738925,이집트,2015-11
2015-11-30,160659222,138209488,22449734,스페인,2015-11
2015-11-30,158512682,50404004,108108678,체코공화국,2015-11
2015-11-30,149250700,322062419,-172811719,칠레,2015-11
2015-11-30,147246431,430681089,-283434658,프랑스,2015-11
2015-11-30,139974266,94326891,45647375,벨기에,2015-11
2015-11-30,133614763,583,133614180,바하마,2015-11
2015-11-30,119225774,8859204,110366570,슬로베니아,2015-11
2015-11-30,114559361,526074639,-411515278,이라크,2015-11
2015-11-30,100337543,19909987,80427556,방글라데시,2015-11
2015-11-30,95190727,701529379,-606338652,쿠웨이트,2015-11
2015-11-30,94940475,78564911,16375564,뉴질랜드,2015-11
2015-11-30,94528177,69309065,25219112,이스라엘,2015-11
2015-11-30,89646795,174754517,-85107722,오만,2015-11
2015-11-30,88796241,21224028,67572213,콜롬비아,2015-11
2015-11-30,87269653,102501206,-15231553,남아프리카공화국,2015-11
2015-11-30,83764669,77149409,6615260,페루,2015-11
2015-11-30,81049007,43545610,37503397,몰타,2015-11
2015-11-30,77783143,62367759,15415384,헝가리,2015-11
2015-11-30,69863035,42623809,27239226,아르헨티나,2015-11
2015-11-30,69421241,1322397,68098844,우즈베키스탄,2015-11
2015-11-30,67311768,115113369,-47801601,스웨덴,2015-11
2015-11-30,65763998,585450,65178548,크로아티아,2015-11
2015-11-30,62064629,79990383,-17925754,오스트리아,2015-11
2015-11-30,61675922,23218147,38457775,파키스탄,2015-11
2015-11-30,58835098,96850487,-38015389,알제리,2015-11
2015-11-30,58122825,20701161,37421664,그리스,2015-11
2015-11-30,54586847,11027563,43559284,캄보디아,2015-11
2015-11-30,53610030,3394323,50215707,요르단,2015-11
2015-11-30,47555639,1034903219,-987347580,카타르,2015-11
2015-11-30,45435083,37249620,8185463,미얀마,2015-11
2015-11-30,45400368,106920,45293448,피지,2015-11
2015-11-30,40844615,4728389,36116226,에쿠아도르,2015-11
2015-11-30,40313171,82388358,-42075187,나이지리아,2015-11
2015-11-30,37634705,15421461,22213244,포루투갈,2015-11
2015-11-30,33841750,43892998,-10051248,루마니아,2015-11
2015-11-30,33138192,61951965,-28813773,덴마크,2015-11
2015-11-30,31487348,8846994,22640354,카자흐스탄,2015-11
2015-11-30,31269316,75072965,-43803649,아일랜드,2015-11
2015-11-30,30049191,201608732,-171559541,스위스,2015-11
2015-11-30,29342865,1093623,28249242,리비아,2015-11
2015-11-30,28858368,3226330,25632038,라오스,2015-11
2015-11-30,28811957,50851696,-22039739,파나마,2015-11
2015-11-30,28298043,3845906,24452137,도미니카 공화국,2015-11
2015-11-30,27504179,1731915,25772264,레바논,2015-11
2015-11-30,25180926,22378,25158548,시리아,2015-11
2015-11-30,23637107,566735,23070372,베네주엘라,2015-11
2015-11-30,23370585,15408383,7962202,모로코,2015-11
2015-11-30,23315834,6482759,16833075,스리랑카,2015-11
2015-11-30,21950003,7399608,14550395,과테말라,2015-11
2015-11-30,21725963,2581594,19144369,가나,2015-11
2015-11-30,20296270,4325533,15970737,리투아니아,2015-11
2015-11-30,18928498,14616685,4311813,푸에르토리코,2015-11
2015-11-30,18422604,1632475,16790129,몽골,2015-11
2015-11-30,17996836,110520285,-92523449,핀란드,2015-11
2015-11-30,17883408,384898,17498510,탄자니아,2015-11
2015-11-30,17638797,2247294,15391503,튀니지,2015-11
2015-11-30,16775234,183451400,-166676166,노르웨이,2015-11
2015-11-30,16742547,18180229,-1437682,뉴 칼레도니아,2015-11
2015-11-30,15497875,1808366,13689509,케냐,2015-11
2015-11-30,15311348,49313869,-34002521,우크라이나,2015-11
2015-11-30,14816451,28625488,-13809037,바레인,2015-11
2015-11-30,14253041,6360165,7892876,우루과이,2015-11
2015-11-30,13871647,168,13871479,투르크멘,2015-11
2015-11-30,13302036,1030007,12272029,조지아,2015-11
2015-11-30,13083589,321167,12762422,예맨,2015-11
2015-11-30,12900293,1044765,11855528,니카라과,2015-11
2015-11-30,12869505,409061,12460444,파라과이,2015-11
2015-11-30,11776807,74981,11701826,팔레스타인 해방기구,2015-11
2015-11-30,9971004,10457652,-486648,코스타리카,2015-11
2015-11-30,8905349,15522564,-6617215,트리니다드 토바고,2015-11
2015-11-30,8872202,28834,8843368,아제르바이잔,2015-11
2015-11-30,8850477,2040973,6809504,수단,2015-11
2015-11-30,8767270,1669511,7097759,온두라스,2015-11
2015-11-30,8442165,689953,7752212,엘살바도르,2015-11
2015-11-30,8377568,4846007,3531561,불가리아,2015-11
2015-11-30,7879395,3286670,4592725,라트비아,2015-11
2015-11-30,7195497,46875303,-39679806,앙골라,2015-11
2015-11-30,7167588,1362919,5804669,코트디봐르,2015-11
2015-11-30,5632715,1036722,4595993,세르비아,2015-11
2015-11-30,4931807,4375074,556733,에티오피아,2015-11
2015-11-30,4888357,52291633,-47403276,볼리비아,2015-11
2015-11-30,4822408,55251,4767157,괌,2015-11
2015-11-30,4748085,563640,4184445,솔로몬 군도,2015-11
2015-11-30,4563155,288614,4274541,마이크로네시아,2015-11
2015-11-30,4478348,78211,4400137,키르기스스탄,2015-11
2015-11-30,4396126,21148816,-16752690,에스토니아,2015-11
2015-11-30,4265092,51543318,-47278226,브루나이,2015-11
2015-11-30,3945746,716866,3228880,쿠바,2015-11
2015-11-30,3117873,116886,3000987,마세도니아,2015-11
2015-11-30,3055982,3176146,-120164,가봉,2015-11
2015-11-30,3034108,4148297,-1114189,세네갈,2015-11
2015-11-30,2947224,167347,2779877,마카오,2015-11
2015-11-30,2643052,255564,2387488,카메룬,2015-11
2015-11-30,2603923,2292706,311217,아이슬란드,2015-11
2015-11-30,2564281,42732,2521549,라이베리아,2015-11
2015-11-30,2444564,25164703,-22720139,기타국,2015-11
2015-11-30,2329766,171285,2158481,르완다,2015-11
2015-11-30,2225067,964580,1260487,아이티,2015-11
2015-11-30,2218448,158890,2059558,알바니아,2015-11
2015-11-30,2187227,637805,1549422,부르키나 파소,2015-11
2015-11-30,2144756,884,2143872,아루바,2015-11
2015-11-30,2105750,943250,1162500,베닝,2015-11
2015-11-30,2050595,1386311,664284,토고,2015-11
2015-11-30,1942309,168320,1773989,사이프러스,2015-11
2015-11-30,1917308,346616,1570692,모리셔스,2015-11
2015-11-30,1887268,5560,1881708,아프카니스탄,2015-11
2015-11-30,1867853,41024,1826829,사모아,2015-11
2015-11-30,1859661,0,1859661,타지크,2015-11
2015-11-30,1849574,7819871,-5970297,모잠비크,2015-11
2015-11-30,1825133,12096813,-10271680,파푸아 뉴기니,2015-11
2015-11-30,1799952,63963489,-62163537,적도 기니,2015-11
2015-11-30,1628347,2014270,-385923,벨라루스,2015-11
2015-11-30,1539644,0,1539644,불령 폴리네시아,2015-11
2015-11-30,1522416,4977974,-3455558,마다카스카르,2015-11
2015-11-30,1521261,0,1521261,불령 리유니온 코모도 제도,2015-11
2015-11-30,1515454,6569,1508885,말리,2015-11
2015-11-30,1496457,1174,1495283,지부티,2015-11
2015-11-30,1489596,260013,1229583,자마이카,2015-11
2015-11-30,1485071,114,1484957,아메리칸 사모아,2015-11
2015-11-30,1415673,102226,1313447,짐바브웨,2015-11
2015-11-30,1358956,1886834,-527878,기니,2015-11
2015-11-30,1202218,77480,1124738,티모르,2015-11
2015-11-30,1110515,12382283,-11271768,잠비아,2015-11
2015-11-30,1080434,90016,990418,네팔,2015-11
2015-11-30,1059386,34500,1024886,가이아나,2015-11
2015-11-30,854757,4004,850753,벨리제,2015-11
2015-11-30,851712,17988,833724,북마리아나 군도,2015-11
2015-11-30,812895,338181,474714,세이쉘,2015-11
2015-11-30,739185,50,739135,세인트 키츠 네비스,2015-11
2015-11-30,700095,4891749,-4191654,룩셈부르그,2015-11
2015-11-30,673720,220987,452733,말라위,2015-11
2015-11-30,662040,1044154,-382114,우간다,2015-11
2015-11-30,659689,19262770,-18603081,콩고민주공화국,2015-11
2015-11-30,612154,50255,561899,바베이도스,2015-11
2015-11-30,609712,6742,602970,보츠와나,2015-11
2015-11-30,608090,118148,489942,수리남,2015-11
2015-11-30,598372,0,598372,마티니크,2015-11
2015-11-30,584999,1141401,-556402,보스니아-헤르체고비나,2015-11
2015-11-30,544287,54392,489895,네덜란드 열도,2015-11
2015-11-30,543838,0,543838,과델로프,2015-11
2015-11-30,504339,1384,502955,안티가 바부다,2015-11
2015-11-30,497455,3556667,-3059212,모리타니,2015-11
2015-11-30,489971,439972,49999,아르메니아,2015-11
2015-11-30,487928,605862,-117934,리히텐슈타인,2015-11
2015-11-30,419638,1438167,-1018529,키리바티,2015-11
2015-11-30,391416,1016,390400,몰디브,2015-11
2015-11-30,384138,755116,-370978,소말리아,2015-11
2015-11-30,364873,2072,362801,부탄,2015-11
2015-11-30,328860,646609,-317749,몰도바,2015-11
2015-11-30,296606,0,296606,영령 버진군도,2015-11
2015-11-30,293144,478850,-185706,바누아투,2015-11
2015-11-30,289386,0,289386,그레나다,2015-11
2015-11-30,289071,14,289057,감비아,2015-11
2015-11-30,288229,0,288229,팔라우,2015-11
2015-11-30,273728,0,273728,남수단,2015-11
2015-11-30,238985,762491,-523506,시에라 리온,2015-11
2015-11-30,231980,76,231904,도미니카,2015-11
2015-11-30,227000,0,227000,피트카이른,2015-11
2015-11-30,214114,0,214114,챠드,2015-11
2015-11-30,183001,969016,-786015,나미비아,2015-11
2015-11-30,183000,50105,132895,스와질랜드,2015-11
2015-11-30,182862,123,182739,니제르,2015-11
2015-11-30,145295,13859586,-13714291,지브랄타,2015-11
2015-11-30,124815,0,124815,국제통화기금,2015-11
2015-11-30,114762,24,114738,불령 가이아나,2015-11
2015-11-30,113950,0,113950,파로에 군도,2015-11
2015-11-30,102303,0,102303,큐라소,2015-11
2015-11-30,85103,708,84395,몬테네그로,2015-11
2015-11-30,84590,0,84590,투발루,2015-11
2015-11-30,75800,0,75800,에리트리아,2015-11
2015-11-30,56960,496,56464,투르크 & 카이코스 군도,2015-11
2015-11-30,52988,0,52988,세인트 빈센트 그레나딘,2015-11
2015-11-30,48189,0,48189,상토메 프린스페,2015-11
2015-11-30,47496,0,47496,세인트 루시아,2015-11
2015-11-30,37551,1043045,-1005494,통가,2015-11
2015-11-30,37209,4715,32494,안도라,2015-11
2015-11-30,32486,9681,22805,산마리노,2015-11
2015-11-30,32483,366831,-334348,모나코,2015-11
2015-11-30,27984,3557,24427,쿡 아일랜드,2015-11
2015-11-30,20322,1575,18747,나우루,2015-11
2015-11-30,8127,0,8127,카보 베르데,2015-11
2015-11-30,7107,0,7107,안타티카,2015-11
2015-11-30,2264,14690,-12426,부룬디,2015-11
2015-11-30,1999,0,1999,세인트 마틴,2015-11
2015-11-30,305,17727,-17422,중앙아프리카공화국,2015-11
2015-11-30,122,57737,-57615,그린랜드,2015-11
2015-11-30,3,5849,-5846,미령 버진군도,2015-11
2015-11-30,0,63274,-63274,코모로스,2015-11
2015-11-30,0,24,-24,세인트 헬레나,2015-11
2015-11-30,0,5860,-5860,몬트세라트,2015-11
2015-11-30,0,725,-725,남조지아 & 남샌드위치 군도,2015-11
2015-11-30,0,551,-551,토켈라우,2015-11
2015-11-30,0,77379,-77379,니우에,2015-11
2015-11-30,0,446,-446,크리스마스 아일랜드,2015-11
2015-12-31,10989746843,7244470352,3745276491,중국,2015-12
2015-12-31,5882444203,3591751233,2290692970,미국,2015-12
2015-12-31,2885669933,117640047,2768029886,홍콩,2015-12
2015-12-31,2206982022,763618184,1443363838,베트남,2015-12
2015-12-31,2060240639,3709283297,-1649042658,일본,2015-12
2015-12-31,1089123653,555421819,533701834,싱가포르,2015-12
2015-12-31,1045908472,1224948236,-179039764,대만,2015-12
2015-12-31,1022664702,299858766,722805936,인도,2015-12
2015-12-31,762147065,1526741364,-764594299,호주,2015-12
2015-12-31,724929237,1386501441,-661572204,사우디아라비아,2015-12
2015-12-31,684553813,342513163,342040650,멕시코,2015-12
2015-12-31,635490469,726936265,-91445796,말레이시아,2015-12
2015-12-31,589518692,5150,589513542,마샬군도,2015-12
2015-12-31,563158596,194992543,368166053,노르웨이,2015-12
2015-12-31,563015632,284834831,278180801,필리핀,2015-12
2015-12-31,557344485,92804958,464539527,튀르키예,2015-12
2015-12-31,548237596,733328892,-185091296,인도네시아,2015-12
2015-12-31,522982108,1994124390,-1471142282,독일,2015-12
2015-12-31,520876957,660768472,-139891515,아랍에미리트 연합,2015-12
2015-12-31,481925178,371130333,110794845,태국,2015-12
2015-12-31,394985158,569999408,-175014250,영국,2015-12
2015-12-31,382036370,41755155,340281215,몰타,2015-12
2015-12-31,379804326,1012840964,-633036638,러시아 연방,2015-12
2015-12-31,342856219,235296692,107559527,캐나다,2015-12
2015-12-31,300597716,75424278,225173438,이란,2015-12
2015-12-31,278497077,428265177,-149768100,브라질,2015-12
2015-12-31,263452972,46300405,217152567,폴란드,2015-12
2015-12-31,260678559,557616597,-296938038,이탈리아,2015-12
2015-12-31,258261182,14544575,243716607,슬로바키아,2015-12
2015-12-31,256137411,43377,256094034,라이베리아,2015-12
2015-12-31,245133822,457611231,-212477409,네덜란드,2015-12
2015-12-31,226199071,0,226199071,버뮤다,2015-12
2015-12-31,204647765,250626948,-45979183,스페인,2015-12
2015-12-31,195736676,467526707,-271790031,프랑스,2015-12
2015-12-31,184493412,92063441,92429971,벨기에,2015-12
2015-12-31,179143201,57391964,121751237,체코공화국,2015-12
2015-12-31,175226546,620992197,-445765651,이라크,2015-12
2015-12-31,170279121,14173172,156105949,이집트,2015-12
2015-12-31,132279190,9747077,122532113,슬로베니아,2015-12
2015-12-31,127834272,674685144,-546850872,쿠웨이트,2015-12
2015-12-31,127345558,322639087,-195293529,칠레,2015-12
2015-12-31,125359701,63730115,61629586,알제리,2015-12
2015-12-31,123059048,76881715,46177333,이스라엘,2015-12
2015-12-31,120459764,90654924,29804840,뉴질랜드,2015-12
2015-12-31,114219503,128541318,-14321815,페루,2015-12
2015-12-31,105166998,115868432,-10701434,남아프리카공화국,2015-12
2015-12-31,102554424,20102484,82451940,콜롬비아,2015-12
2015-12-31,89434237,24405721,65028516,방글라데시,2015-12
2015-12-31,83310860,7442127,75868733,요르단,2015-12
2015-12-31,77306385,1676202,75630183,우즈베키스탄,2015-12
2015-12-31,75326119,77979605,-2653486,아르헨티나,2015-12
2015-12-31,74704570,18905148,55799422,파키스탄,2015-12
2015-12-31,73194774,183258310,-110063536,스위스,2015-12
2015-12-31,70105371,27792307,42313064,미얀마,2015-12
2015-12-31,68317804,52760973,15556831,나이지리아,2015-12
2015-12-31,68164881,774641,67390240,크로아티아,2015-12
2015-12-31,66301245,149996592,-83695347,스웨덴,2015-12
2015-12-31,65629517,67320847,-1691330,헝가리,2015-12
2015-12-31,63270401,111783815,-48513414,오스트리아,2015-12
2015-12-31,62236739,1701856,60534883,케냐,2015-12
2015-12-31,58846482,226333212,-167486730,오만,2015-12
2015-12-31,54379894,15604634,38775260,캄보디아,2015-12
2015-12-31,51593985,46017266,5576719,루마니아,2015-12
2015-12-31,44299474,11319483,32979991,파나마,2015-12
2015-12-31,41906752,10538691,31368061,모로코,2015-12
2015-12-31,41430909,1170493076,-1129062167,카타르,2015-12
2015-12-31,41062754,17434668,23628086,포루투갈,2015-12
2015-12-31,40629815,1426639,39203176,리비아,2015-12
2015-12-31,40250253,4619035,35631218,에쿠아도르,2015-12
2015-12-31,36053193,72561028,-36507835,핀란드,2015-12
2015-12-31,32122544,2498809,29623735,베네주엘라,2015-12
2015-12-31,31818355,11629571,20188784,푸에르토리코,2015-12
2015-12-31,31278079,102642193,-71364114,아일랜드,2015-12
2015-12-31,31237529,5244813,25992716,리투아니아,2015-12
2015-12-31,26412528,61232401,-34819873,덴마크,2015-12
2015-12-31,25786827,10028875,15757952,과테말라,2015-12
2015-12-31,25711105,11316480,14394625,코스타리카,2015-12
2015-12-31,24720327,3812768,20907559,튀니지,2015-12
2015-12-31,24240274,3454170,20786104,그리스,2015-12
2015-12-31,24149474,6211332,17938142,스리랑카,2015-12
2015-12-31,22993784,0,22993784,시리아,2015-12
2015-12-31,22593633,498,22593135,투르크멘,2015-12
2015-12-31,22533592,7118308,15415284,도미니카 공화국,2015-12
2015-12-31,22459759,11200913,11258846,파라과이,2015-12
2015-12-31,22056187,1393662,20662525,레바논,2015-12
2015-12-31,20791114,33192810,-12401696,우크라이나,2015-12
2015-12-31,20098998,8159627,11939371,카자흐스탄,2015-12
2015-12-31,17539239,2701071,14838168,가나,2015-12
2015-12-31,17244484,39165128,-21920644,바레인,2015-12
2015-12-31,16358438,1415039,14943399,몽골,2015-12
2015-12-31,15712816,892618,14820198,니카라과,2015-12
2015-12-31,15456339,134159,15322180,앙골라,2015-12
2015-12-31,15275883,6731171,8544712,불가리아,2015-12
2015-12-31,13719696,396382,13323314,쿠바,2015-12
2015-12-31,13167010,99991,13067019,아제르바이잔,2015-12
2015-12-31,12756552,7116433,5640119,우루과이,2015-12
2015-12-31,11799106,372232,11426874,코트디봐르,2015-12
2015-12-31,11726096,10060032,1666064,트리니다드 토바고,2015-12
2015-12-31,11466789,22522569,-11055780,뉴 칼레도니아,2015-12
2015-12-31,11021781,161097406,-150075625,브루나이,2015-12
2015-12-31,10923705,1073402,9850303,예맨,2015-12
2015-12-31,10763093,1490388,9272705,탄자니아,2015-12
2015-12-31,10538526,1241118,9297408,수단,2015-12
2015-12-31,10282922,704851,9578071,우간다,2015-12
2015-12-31,10202918,6605895,3597023,온두라스,2015-12
2015-12-31,10094548,1134293,8960255,엘살바도르,2015-12
2015-12-31,9632914,3859479,5773435,에티오피아,2015-12
2015-12-31,9302981,46,9302935,팔레스타인 해방기구,2015-12
2015-12-31,8482523,2432303,6050220,세네갈,2015-12
2015-12-31,7456589,7759030,-302441,에스토니아,2015-12
2015-12-31,7198916,5938072,1260844,라트비아,2015-12
2015-12-31,6481063,26226197,-19745134,볼리비아,2015-12
2015-12-31,6293086,1290718,5002368,라오스,2015-12
2015-12-31,6258491,249845,6008646,피지,2015-12
2015-12-31,6165630,2114570,4051060,세르비아,2015-12
2015-12-31,5313214,236161,5077053,모잠비크,2015-12
2015-12-31,5166618,20411311,-15244693,잠비아,2015-12
2015-12-31,4955644,559810,4395834,아이티,2015-12
2015-12-31,4572594,976662,3595932,조지아,2015-12
2015-12-31,4381915,653384,3728531,콩고,2015-12
2015-12-31,4341871,19643848,-15301977,콩고민주공화국,2015-12
2015-12-31,4139099,42658,4096441,키르기스스탄,2015-12
2015-12-31,4084619,232,4084387,마이크로네시아,2015-12
2015-12-31,3971804,16011068,-12039264,기타국,2015-12
2015-12-31,3792884,0,3792884,불령 폴리네시아,2015-12
2015-12-31,3617222,6577,3610645,괌,2015-12
2015-12-31,3420775,222695,3198080,마카오,2015-12
2015-12-31,3409981,4024,3405957,사모아,2015-12
2015-12-31,3124899,260046,2864853,베닝,2015-12
2015-12-31,3084556,57145,3027411,가봉,2015-12
2015-12-31,2859453,106697,2752756,마세도니아,2015-12
2015-12-31,2803291,167382,2635909,사이프러스,2015-12
2015-12-31,2642457,11566863,-8924406,파푸아 뉴기니,2015-12
2015-12-31,2527624,60000,2467624,지부티,2015-12
2015-12-31,2493243,40335293,-37842050,카메룬,2015-12
2015-12-31,2359636,2442417,-82781,아이슬란드,2015-12
2015-12-31,2335659,5173087,-2837428,마다카스카르,2015-12
2015-12-31,2104150,15,2104135,부르키나 파소,2015-12
2015-12-31,2101129,504589,1596540,모리셔스,2015-12
2015-12-31,1973601,1207,1972394,타지크,2015-12
2015-12-31,1928437,25296,1903141,아루바,2015-12
2015-12-31,1911130,2200670,-289540,기니,2015-12
2015-12-31,1719512,24,1719488,말리,2015-12
2015-12-31,1698072,440558,1257514,짐바브웨,2015-12
2015-12-31,1690087,0,1690087,북마리아나 군도,2015-12
2015-12-31,1647397,10919288,-9271891,토고,2015-12
2015-12-31,1641227,2020,1639207,아프카니스탄,2015-12
2015-12-31,1631770,3699833,-2068063,벨라루스,2015-12
2015-12-31,1610843,14175,1596668,바베이도스,2015-12
2015-12-31,1603741,108781,1494960,네팔,2015-12
2015-12-31,1433976,440126,993850,자마이카,2015-12
2015-12-31,1404400,545210,859190,세이쉘,2015-12
2015-12-31,1396883,40763,1356120,키리바티,2015-12
2015-12-31,1395533,264801,1130732,말라위,2015-12
2015-12-31,1353270,0,1353270,불령 리유니온 코모도 제도,2015-12
2015-12-31,1244787,2240,1242547,바하마,2015-12
2015-12-31,1209615,44387,1165228,보츠와나,2015-12
2015-12-31,1196803,158103,1038700,아메리칸 사모아,2015-12
2015-12-31,1109756,82568,1027188,알바니아,2015-12
2015-12-31,1015316,9202,1006114,영령 캐이맨 군도,2015-12
2015-12-31,1014161,6453168,-5439007,룩셈부르그,2015-12
2015-12-31,977455,107487,869968,가이아나,2015-12
2015-12-31,889675,21848,867827,네덜란드 열도,2015-12
2015-12-31,889199,0,889199,마티니크,2015-12
2015-12-31,793279,110719271,-109925992,적도 기니,2015-12
2015-12-31,749614,1948,747666,메요트,2015-12
2015-12-31,720924,5916,715008,안도라,2015-12
2015-12-31,720212,243565,476647,아르메니아,2015-12
2015-12-31,697161,3162,693999,벨리제,2015-12
2015-12-31,680486,0,680486,영령 버진군도,2015-12
2015-12-31,662970,137951,525019,티모르,2015-12
2015-12-31,662637,2150971,-1488334,소말리아,2015-12
2015-12-31,647850,19733,628117,르완다,2015-12
2015-12-31,637056,0,637056,과델로프,2015-12
2015-12-31,603532,570652,32880,리히텐슈타인,2015-12
2015-12-31,595611,91627,503984,몰디브,2015-12
2015-12-31,511626,57055,454571,몬테네그로,2015-12
2015-12-31,484689,3541155,-3056466,모리타니,2015-12
2015-12-31,466463,226333,240130,스와질랜드,2015-12
2015-12-31,420163,485,419678,도미니카,2015-12
2015-12-31,401502,464772,-63270,몰도바,2015-12
2015-12-31,393485,0,393485,국제통화기금,2015-12
2015-12-31,369765,60470,309295,안티가 바부다,2015-12
2015-12-31,361647,0,361647,그레나다,2015-12
2015-12-31,353835,142,353693,세인트 키츠 네비스,2015-12
2015-12-31,318449,311525,6924,수리남,2015-12
2015-12-31,277935,7,277928,세인트 루시아,2015-12
2015-12-31,255268,946930,-691662,바누아투,2015-12
2015-12-31,241967,0,241967,감비아,2015-12
2015-12-31,219469,349,219120,투르크 & 카이코스 군도,2015-12
2015-12-31,219141,1643784,-1424643,보스니아-헤르체고비나,2015-12
2015-12-31,213970,23,213947,불령 가이아나,2015-12
2015-12-31,202036,0,202036,팔라우,2015-12
2015-12-31,200701,0,200701,부탄,2015-12
2015-12-31,197942,1148,196794,카보 베르데,2015-12
2015-12-31,188912,1563796,-1374884,시에라 리온,2015-12
2015-12-31,169032,0,169032,지브랄타,2015-12
2015-12-31,126024,29256841,-29130817,나미비아,2015-12
2015-12-31,85730,0,85730,챠드,2015-12
2015-12-31,49460,670857,-621397,솔로몬 군도,2015-12
2015-12-31,48060,0,48060,세인트 마틴,2015-12
2015-12-31,38827,5375,33452,미령 버진군도,2015-12
2015-12-31,35922,17626,18296,니제르,2015-12
2015-12-31,34212,0,34212,세인트 빈센트 그레나딘,2015-12
2015-12-31,21516,0,21516,큐라소,2015-12
2015-12-31,19110,76,19034,부룬디,2015-12
2015-12-31,17524,119281,-101757,나우루,2015-12
2015-12-31,14088,0,14088,쿡 아일랜드,2015-12
2015-12-31,13795,9782,4013,코모로스,2015-12
2015-12-31,8293,334374,-326081,모나코,2015-12
2015-12-31,6578,0,6578,남수단,2015-12
2015-12-31,4504,259,4245,에리트리아,2015-12
2015-12-31,537,0,537,앙귈라,2015-12
2015-12-31,210,311808,-311598,그린랜드,2015-12
2015-12-31,90,199248,-199158,중앙아프리카공화국,2015-12
2015-12-31,0,42935,-42935,산마리노,2015-12
2015-12-31,0,182,-182,레소토,2015-12
2015-12-31,0,2602,-2602,크리스마스 아일랜드,2015-12
2015-12-31,0,2552,-2552,마이너 아우틀링 합중국 군도,2015-12
2015-12-31,0,296006,-296006,통가,2015-12
2015-12-31,0,80,-80,맨섬,2015-12
2015-12-31,0,33744,-33744,니우에,2015-12
2015-12-31,0,93000,-93000,파로에 군도,2015-12
2015-12-31,0,356,-356,코스 군도,2015-12
2015-12-31,0,8106,-8106,스발비드 군도,2015-12
2015-12-31,0,125,-125,피트카이른,2015-12
2015-12-31,0,15568,-15568,토켈라우,2015-12
2016-01-31,9480539843,6895585186,2584954657,중국,2016-01
2016-01-31,5040734289,3328090880,1712643409,미국,2016-01
2016-01-31,2113289285,102009675,2011279610,홍콩,2016-01
2016-01-31,1984725205,835091515,1149633690,베트남,2016-01
2016-01-31,1792002099,3088240601,-1296238502,일본,2016-01
2016-01-31,1014088717,506745765,507342952,싱가포르,2016-01
2016-01-31,876748886,316513576,560235310,인도,2016-01
2016-01-31,819716244,1210150144,-390433900,대만,2016-01
2016-01-31,661465875,1318055132,-656589257,호주,2016-01
2016-01-31,649845574,43132803,606712771,마샬군도,2016-01
2016-01-31,626734903,288582340,338152563,멕시코,2016-01
2016-01-31,552897306,728361780,-175464474,인도네시아,2016-01
2016-01-31,524063939,210686123,313377816,필리핀,2016-01
2016-01-31,458372510,323203794,135168716,태국,2016-01
2016-01-31,451720100,1638596145,-1186876045,독일,2016-01
2016-01-31,450150744,18579,450132165,라이베리아,2016-01
2016-01-31,446614367,49222869,397391498,튀르키예,2016-01
2016-01-31,431855074,629218331,-197363257,말레이시아,2016-01
2016-01-31,413489337,490741529,-77252192,아랍에미리트 연합,2016-01
2016-01-31,395575780,909656881,-514081101,사우디아라비아,2016-01
2016-01-31,390382012,434666415,-44284403,영국,2016-01
2016-01-31,325051841,391030554,-65978713,캐나다,2016-01
2016-01-31,288870078,361538415,-72668337,브라질,2016-01
2016-01-31,287031249,771796997,-484765748,러시아 연방,2016-01
2016-01-31,286779763,80159174,206620589,벨기에,2016-01
2016-01-31,282581565,13775196,268806369,슬로바키아,2016-01
2016-01-31,270494715,556038896,-285544181,이탈리아,2016-01
2016-01-31,246550282,46156211,200394071,폴란드,2016-01
2016-01-31,245331510,424317677,-178986167,프랑스,2016-01
2016-01-31,235413981,526984331,-291570350,네덜란드,2016-01
2016-01-31,225800632,28586398,197214234,파나마,2016-01
2016-01-31,218344861,0,218344861,버뮤다,2016-01
2016-01-31,200727995,7458,200720537,바하마,2016-01
2016-01-31,177484317,159042102,18442215,스페인,2016-01
2016-01-31,163519246,216574156,-53054910,이란,2016-01
2016-01-31,159134821,18839323,140295498,그리스,2016-01
2016-01-31,158645181,44939241,113705940,체코공화국,2016-01
2016-01-31,157113227,17010786,140102441,몰타,2016-01
2016-01-31,138563436,301898255,-163334819,이라크,2016-01
2016-01-31,137086425,17112598,119973827,이집트,2016-01
2016-01-31,131013834,6689356,124324478,슬로베니아,2016-01
2016-01-31,120821717,104249066,16572651,이스라엘,2016-01
2016-01-31,93466246,281339872,-187873626,칠레,2016-01
2016-01-31,88796104,90830157,-2034053,뉴질랜드,2016-01
2016-01-31,84605820,29616418,54989402,방글라데시,2016-01
2016-01-31,73884629,51364661,22519968,아르헨티나,2016-01
2016-01-31,73754341,117294711,-43540370,스웨덴,2016-01
2016-01-31,73604982,12725331,60879651,콜롬비아,2016-01
2016-01-31,73067896,38541494,34526402,미얀마,2016-01
2016-01-31,68741716,55985789,12755927,헝가리,2016-01
2016-01-31,67579806,100945035,-33365229,페루,2016-01
2016-01-31,61287262,19373843,41913419,파키스탄,2016-01
2016-01-31,55340000,106974254,-51634254,남아프리카공화국,2016-01
2016-01-31,53581756,1163683,52418073,우즈베키스탄,2016-01
2016-01-31,53426530,36407628,17018902,알제리,2016-01
2016-01-31,51752528,2245621,49506907,요르단,2016-01
2016-01-31,50741171,380196173,-329455002,쿠웨이트,2016-01
2016-01-31,50317043,77560003,-27242960,오스트리아,2016-01
2016-01-31,50246127,67,50246060,맨섬,2016-01
2016-01-31,49272141,19707127,29565014,캄보디아,2016-01
2016-01-31,47025754,155756427,-108730673,스위스,2016-01
2016-01-31,43096249,47884032,-4787783,루마니아,2016-01
2016-01-31,38132189,95450620,-57318431,나이지리아,2016-01
2016-01-31,36839095,16557306,20281789,포루투갈,2016-01
2016-01-31,36394325,876231809,-839837484,카타르,2016-01
2016-01-31,33280003,1336141,31943862,예맨,2016-01
2016-01-31,32716498,500499,32215999,앙골라,2016-01
2016-01-31,29601094,62770763,-33169669,덴마크,2016-01
2016-01-31,29258781,33522140,-4263359,리비아,2016-01
2016-01-31,25690000,14927326,10762674,모로코,2016-01
2016-01-31,23305212,244172088,-220866876,오만,2016-01
2016-01-31,22473492,2993570,19479922,베네주엘라,2016-01
2016-01-31,21892769,7576645,14316124,스리랑카,2016-01
2016-01-31,21399856,92670792,-71270936,핀란드,2016-01
2016-01-31,20487331,6883787,13603544,과테말라,2016-01
2016-01-31,20248605,5603989,14644616,에쿠아도르,2016-01
2016-01-31,20100055,6824334,13275721,리투아니아,2016-01
2016-01-31,19810656,323873,19486783,피지,2016-01
2016-01-31,19288193,7989188,11299005,카자흐스탄,2016-01
2016-01-31,19243185,722,19242463,투르크멘,2016-01
2016-01-31,19179492,594027,18585465,크로아티아,2016-01
2016-01-31,18846075,7866747,10979328,코스타리카,2016-01
2016-01-31,18751033,5766419,12984614,도미니카 공화국,2016-01
2016-01-31,17816262,80792346,-62976084,아일랜드,2016-01
2016-01-31,16422761,2171,16420590,시리아,2016-01
2016-01-31,15371546,18421859,-3050313,푸에르토리코,2016-01
2016-01-31,14429859,35946337,-21516478,바레인,2016-01
2016-01-31,14308069,1957253,12350816,가나,2016-01
2016-01-31,14026790,45585976,-31559186,우크라이나,2016-01
2016-01-31,12510475,898258,11612217,몽골,2016-01
2016-01-31,12460706,1730,12458976,아제르바이잔,2016-01
2016-01-31,12322370,882040,11440330,니카라과,2016-01
2016-01-31,11693285,7200289,4492996,뉴 칼레도니아,2016-01
2016-01-31,11246357,599871,10646486,조지아,2016-01
2016-01-31,10768498,5022579,5745919,불가리아,2016-01
2016-01-31,10747966,493785,10254181,수단,2016-01
2016-01-31,10014570,2027149,7987421,에티오피아,2016-01
2016-01-31,9828235,28073038,-18244803,트리니다드 토바고,2016-01
2016-01-31,9642393,1106669,8535724,레바논,2016-01
2016-01-31,9445770,761066,8684704,세르비아,2016-01
2016-01-31,9283903,11740979,-2457076,파라과이,2016-01
2016-01-31,9271134,569532,8701602,엘살바도르,2016-01
2016-01-31,9172733,373578,8799155,탄자니아,2016-01
2016-01-31,8792518,1000910,7791608,온두라스,2016-01
2016-01-31,8552640,1156340,7396300,코트디봐르,2016-01
2016-01-31,8318333,189960618,-181642285,노르웨이,2016-01
2016-01-31,8247165,1900833,6346332,케냐,2016-01
2016-01-31,7381519,9852127,-2470608,우루과이,2016-01
2016-01-31,7092092,668812,6423280,쿠바,2016-01
2016-01-31,7006199,12679528,-5673329,튀니지,2016-01
2016-01-31,6833922,0,6833922,팔레스타인 해방기구,2016-01
2016-01-31,6592204,5354267,1237937,파푸아 뉴기니,2016-01
2016-01-31,5898505,946200,4952305,라오스,2016-01
2016-01-31,5695434,30405,5665029,지부티,2016-01
2016-01-31,5680843,69491527,-63810684,브루나이,2016-01
2016-01-31,5286983,8435693,-3148710,볼리비아,2016-01
2016-01-31,5268112,4493130,774982,라트비아,2016-01
2016-01-31,5173962,67,5173895,마이크로네시아,2016-01
2016-01-31,4475887,2429899,2045988,솔로몬 군도,2016-01
2016-01-31,4170389,5428274,-1257885,에스토니아,2016-01
2016-01-31,3922564,3222153,700411,아이슬란드,2016-01
2016-01-31,3495175,2501300,993875,세네갈,2016-01
2016-01-31,3455583,0,3455583,불령 리유니온 코모도 제도,2016-01
2016-01-31,3390030,42955,3347075,괌,2016-01
2016-01-31,3331364,146293,3185071,아이티,2016-01
2016-01-31,3176938,1127,3175811,키르기스스탄,2016-01
2016-01-31,3174751,1101270,2073481,마카오,2016-01
2016-01-31,2803476,4753892,-1950416,기니,2016-01
2016-01-31,2791894,1862,2790032,사모아,2016-01
2016-01-31,2738160,184832,2553328,베닝,2016-01
2016-01-31,2513914,3689640,-1175726,벨라루스,2016-01
2016-01-31,2452127,119070,2333057,모잠비크,2016-01
2016-01-31,2441465,362336,2079129,카메룬,2016-01
2016-01-31,2302269,19445142,-17142873,사이프러스,2016-01
2016-01-31,2094142,0,2094142,아프카니스탄,2016-01
2016-01-31,1971131,39749628,-37778497,기타국,2016-01
2016-01-31,1914228,636628,1277600,모리셔스,2016-01
2016-01-31,1833187,0,1833187,아루바,2016-01
2016-01-31,1713918,35748634,-34034716,콩고민주공화국,2016-01
2016-01-31,1662511,127336,1535175,알바니아,2016-01
2016-01-31,1509471,37819,1471652,부르키나 파소,2016-01
2016-01-31,1502387,4600038,-3097651,마다카스카르,2016-01
2016-01-31,1492067,25946,1466121,네덜란드 열도,2016-01
2016-01-31,1467544,100053,1367491,네팔,2016-01
2016-01-31,1402702,53071,1349631,짐바브웨,2016-01
2016-01-31,1325262,7202538,-5877276,잠비아,2016-01
2016-01-31,1281061,239213,1041848,콩고,2016-01
2016-01-31,1238912,510576,728336,소말리아,2016-01
2016-01-31,1102051,10935,1091116,북마리아나 군도,2016-01
2016-01-31,1079461,17571,1061890,세이쉘,2016-01
2016-01-31,1072726,1278,1071448,타지크,2016-01
2016-01-31,1017930,4099911,-3081981,토고,2016-01
2016-01-31,962467,409511,552956,우간다,2016-01
2016-01-31,960907,33840,927067,티모르,2016-01
2016-01-31,892784,82305,810479,자마이카,2016-01
2016-01-31,802443,24387,778056,바베이도스,2016-01
2016-01-31,771085,56867,714218,보츠와나,2016-01
2016-01-31,737240,63356098,-62618858,적도 기니,2016-01
2016-01-31,669630,5912356,-5242726,룩셈부르그,2016-01
2016-01-31,657770,0,657770,안티가 바부다,2016-01
2016-01-31,646555,1669939,-1023384,말라위,2016-01
2016-01-31,628819,3932,624887,벨리제,2016-01
2016-01-31,587050,107077,479973,르완다,2016-01
2016-01-31,534050,0,534050,마티니크,2016-01
2016-01-31,528361,5512,522849,몰디브,2016-01
2016-01-31,490855,161748,329107,가이아나,2016-01
2016-01-31,454519,14986,439533,영령 캐이맨 군도,2016-01
2016-01-31,453629,1010749,-557120,가봉,2016-01
2016-01-31,453264,225526,227738,아메리칸 사모아,2016-01
2016-01-31,436028,0,436028,과델로프,2016-01
2016-01-31,405854,344051,61803,수리남,2016-01
2016-01-31,404844,3650632,-3245788,모리타니,2016-01
2016-01-31,383169,617075,-233906,리히텐슈타인,2016-01
2016-01-31,378767,1037665,-658898,몰도바,2016-01
2016-01-31,369433,135,369298,세인트 키츠 네비스,2016-01
2016-01-31,359138,979,358159,불령 폴리네시아,2016-01
2016-01-31,340731,0,340731,남조지아 & 남샌드위치 군도,2016-01
2016-01-31,338289,92766,245523,키리바티,2016-01
2016-01-31,334010,537940,-203930,바누아투,2016-01
2016-01-31,321684,0,321684,그레나다,2016-01
2016-01-31,304234,0,304234,국제통화기금,2016-01
2016-01-31,303591,2150730,-1847139,시에라 리온,2016-01
2016-01-31,296394,276293,20101,아르메니아,2016-01
2016-01-31,256937,175,256762,카보 베르데,2016-01
2016-01-31,254866,0,254866,팔라우,2016-01
2016-01-31,251161,2853869,-2602708,나미비아,2016-01
2016-01-31,232128,8476,223652,세인트 루시아,2016-01
2016-01-31,172283,0,172283,부탄,2016-01
2016-01-31,150254,14,150240,말리,2016-01
2016-01-31,141024,327358,-186334,스와질랜드,2016-01
2016-01-31,126398,0,126398,챠드,2016-01
2016-01-31,124462,170049,-45587,마세도니아,2016-01
2016-01-31,82238,4255,77983,나우루,2016-01
2016-01-31,77984,42096,35888,감비아,2016-01
2016-01-31,77021,9775,67246,도미니카,2016-01
2016-01-31,76248,13,76235,지브랄타,2016-01
2016-01-31,71049,166,70883,몬테네그로,2016-01
2016-01-31,56032,30,56002,불령 가이아나,2016-01
2016-01-31,45143,0,45143,영령 버진군도,2016-01
2016-01-31,35926,0,35926,에리트리아,2016-01
2016-01-31,25154,0,25154,노폴크 아일랜드,2016-01
2016-01-31,23770,36367,-12597,통가,2016-01
2016-01-31,20400,70752,-50352,산마리노,2016-01
2016-01-31,15000,714222,-699222,보스니아-헤르체고비나,2016-01
2016-01-31,14118,0,14118,큐라소,2016-01
2016-01-31,13558,0,13558,세인트 빈센트 그레나딘,2016-01
2016-01-31,13081,1943,11138,레소토,2016-01
2016-01-31,10159,220177,-210018,모나코,2016-01
2016-01-31,7425,101,7324,토켈라우,2016-01
2016-01-31,6679,34112,-27433,부룬디,2016-01
2016-01-31,6394,0,6394,파로에 군도,2016-01
2016-01-31,2331,0,2331,상토메 프린스페,2016-01
2016-01-31,1433,9058,-7625,니제르,2016-01
2016-01-31,911,0,911,남수단,2016-01
2016-01-31,690,0,690,중앙아프리카공화국,2016-01
2016-01-31,539,3486,-2947,미령 버진군도,2016-01
2016-01-31,236,277907,-277671,그린랜드,2016-01
2016-01-31,0,24,-24,건지,2016-01
2016-01-31,0,38964,-38964,니우에,2016-01
2016-01-31,0,136,-136,안도라,2016-01
2016-01-31,0,135003,-135003,기네비소,2016-01
2016-01-31,0,24049,-24049,쿡 아일랜드,2016-01
2016-01-31,0,325366,-325366,코모로스,2016-01
2016-01-31,0,167,-167,세인트 헬레나,2016-01
2016-02-29,8641814638,6028942500,2612872138,중국,2016-02
2016-02-29,5222510363,3057982463,2164527900,미국,2016-02
2016-02-29,2318556319,899092263,1419464056,베트남,2016-02
2016-02-29,2170208859,130247297,2039961562,홍콩,2016-02
2016-02-29,1696096821,3407324249,-1711227428,일본,2016-02
2016-02-29,1200842170,497090387,703751783,싱가포르,2016-02
2016-02-29,961677071,325556817,636120254,인도,2016-02
2016-02-29,766092102,1299109463,-533017361,대만,2016-02
2016-02-29,745261041,289407173,455853868,멕시코,2016-02
2016-02-29,722455418,21962948,700492470,마샬군도,2016-02
2016-02-29,582152893,1163475574,-581322681,호주,2016-02
2016-02-29,528838599,889922287,-361083688,사우디아라비아,2016-02
2016-02-29,521606987,255950220,265656767,필리핀,2016-02
2016-02-29,472538411,359136771,113401640,태국,2016-02
2016-02-29,467800439,38345820,429454619,튀르키예,2016-02
2016-02-29,453857669,22307570,431550099,리비아,2016-02
2016-02-29,434905041,628550331,-193645290,인도네시아,2016-02
2016-02-29,433496113,627262879,-193766766,말레이시아,2016-02
2016-02-29,424592923,1381158634,-956565711,독일,2016-02
2016-02-29,409714498,468438610,-58724112,아랍에미리트 연합,2016-02
2016-02-29,344828223,328752748,16075475,브라질,2016-02
2016-02-29,343869130,212474163,131394967,캐나다,2016-02
2016-02-29,324490481,398124097,-73633616,러시아 연방,2016-02
2016-02-29,317220308,461066154,-143845846,영국,2016-02
2016-02-29,288204600,291698857,-3494257,네덜란드,2016-02
2016-02-29,244573730,397018998,-152445268,이탈리아,2016-02
2016-02-29,240302548,50573283,189729265,폴란드,2016-02
2016-02-29,233082972,224097741,8985231,이란,2016-02
2016-02-29,229245475,18796174,210449301,슬로바키아,2016-02
2016-02-29,228410540,0,228410540,버뮤다,2016-02
2016-02-29,195683339,85834409,109848930,벨기에,2016-02
2016-02-29,177816451,170141036,7675415,스페인,2016-02
2016-02-29,170222966,352429768,-182206802,프랑스,2016-02
2016-02-29,154614916,28564313,126050603,그리스,2016-02
2016-02-29,148088549,49174630,98913919,체코공화국,2016-02
2016-02-29,129039722,2697100,126342622,이집트,2016-02
2016-02-29,118832319,396177878,-277345559,이라크,2016-02
2016-02-29,114786945,9265877,105521068,슬로베니아,2016-02
2016-02-29,114598931,46864592,67734339,아르헨티나,2016-02
2016-02-29,109459423,3684,109455739,바하마,2016-02
2016-02-29,107225762,54737862,52487900,파나마,2016-02
2016-02-29,103981025,305216249,-201235224,칠레,2016-02
2016-02-29,96193974,47570762,48623212,미얀마,2016-02
2016-02-29,95387322,71445123,23942199,이스라엘,2016-02
2016-02-29,91162507,0,91162507,맨섬,2016-02
2016-02-29,90348423,48032,90300391,라이베리아,2016-02
2016-02-29,80921746,87634784,-6713038,뉴질랜드,2016-02
2016-02-29,80378886,453905366,-373526480,쿠웨이트,2016-02
2016-02-29,78784199,26818867,51965332,방글라데시,2016-02
2016-02-29,76757394,21659959,55097435,알제리,2016-02
2016-02-29,70679912,123506441,-52826529,페루,2016-02
2016-02-29,67832642,11833212,55999430,콜롬비아,2016-02
2016-02-29,64502842,45812924,18689918,헝가리,2016-02
2016-02-29,62189544,2010674,60178870,우즈베키스탄,2016-02
2016-02-29,62005751,97835555,-35829804,스웨덴,2016-02
2016-02-29,59180546,18670532,40510014,파키스탄,2016-02
2016-02-29,55985532,56482,55929050,투르크멘,2016-02
2016-02-29,53736265,64405569,-10669304,남아프리카공화국,2016-02
2016-02-29,53727731,66516417,-12788686,오스트리아,2016-02
2016-02-29,51083651,162326671,-111243020,스위스,2016-02
2016-02-29,48243397,18495982,29747415,캄보디아,2016-02
2016-02-29,47621668,865243,46756425,앙골라,2016-02
2016-02-29,42751835,220188379,-177436544,오만,2016-02
2016-02-29,36777376,39889175,-3111799,루마니아,2016-02
2016-02-29,35001836,818069550,-783067714,카타르,2016-02
2016-02-29,34818986,7935642,26883344,요르단,2016-02
2016-02-29,33600280,19440473,14159807,포루투갈,2016-02
2016-02-29,32038660,11917087,20121573,모로코,2016-02
2016-02-29,30257773,74791677,-44533904,아일랜드,2016-02
2016-02-29,29653330,18184241,11469089,나이지리아,2016-02
2016-02-29,27475123,4617451,22857672,토고,2016-02
2016-02-29,26619533,49875824,-23256291,덴마크,2016-02
2016-02-29,23086866,6187840,16899026,리투아니아,2016-02
2016-02-29,21565121,7065927,14499194,에쿠아도르,2016-02
2016-02-29,21503988,4073605,17430383,도미니카 공화국,2016-02
2016-02-29,20783397,885210,19898187,베네주엘라,2016-02
2016-02-29,20496652,57148632,-36651980,핀란드,2016-02
2016-02-29,18990251,9189290,9800961,스리랑카,2016-02
2016-02-29,18918682,1386291,17532391,레바논,2016-02
2016-02-29,18064392,2576776,15487616,과테말라,2016-02
2016-02-29,17080781,1005632,16075149,가나,2016-02
2016-02-29,16617933,28731447,-12113514,우크라이나,2016-02
2016-02-29,16402467,10795129,5607338,푸에르토리코,2016-02
2016-02-29,14413626,9127676,5285950,코스타리카,2016-02
2016-02-29,14334498,1331448,13003050,수단,2016-02
2016-02-29,13540349,1196226,12344123,케냐,2016-02
2016-02-29,13308722,8592992,4715730,카자흐스탄,2016-02
2016-02-29,11938450,296449,11642001,피지,2016-02
2016-02-29,11533213,1388889,10144324,에티오피아,2016-02
2016-02-29,11037861,18279723,-7241862,바레인,2016-02
2016-02-29,10581571,150142749,-139561178,노르웨이,2016-02
2016-02-29,9951094,3133892,6817202,튀니지,2016-02
2016-02-29,9819396,767698,9051698,니카라과,2016-02
2016-02-29,9738718,19687,9719031,지부티,2016-02
2016-02-29,9319826,7633490,1686336,불가리아,2016-02
2016-02-29,9262089,334026,8928063,몽골,2016-02
2016-02-29,9074666,11493696,-2419030,탄자니아,2016-02
2016-02-29,8929982,2837009,6092973,온두라스,2016-02
2016-02-29,7746189,17828760,-10082571,파라과이,2016-02
2016-02-29,7377359,716627,6660732,엘살바도르,2016-02
2016-02-29,7283424,453198,6830226,시리아,2016-02
2016-02-29,7159585,11228808,-4069223,트리니다드 토바고,2016-02
2016-02-29,7139344,23764,7115580,아제르바이잔,2016-02
2016-02-29,7069041,714436,6354605,크로아티아,2016-02
2016-02-29,6877831,975935,5901896,코트디봐르,2016-02
2016-02-29,6756748,86589961,-79833213,브루나이,2016-02
2016-02-29,6525967,477123,6048844,예맨,2016-02
2016-02-29,5938420,23,5938397,불령 폴리네시아,2016-02
2016-02-29,5937837,6288615,-350778,우루과이,2016-02
2016-02-29,5818110,510687,5307423,세르비아,2016-02
2016-02-29,5713500,26864207,-21150707,볼리비아,2016-02
2016-02-29,5377688,6369432,-991744,뉴 칼레도니아,2016-02
2016-02-29,4883899,2517446,2366453,라오스,2016-02
2016-02-29,4762519,41037,4721482,괌,2016-02
2016-02-29,4757970,250599,4507371,르완다,2016-02
2016-02-29,4352875,3226160,1126715,에스토니아,2016-02
2016-02-29,4040856,4651604,-610748,라트비아,2016-02
2016-02-29,3681534,631,3680903,아프카니스탄,2016-02
2016-02-29,3659075,1826054,1833021,아이슬란드,2016-02
2016-02-29,3551032,338365,3212667,아이티,2016-02
2016-02-29,3207404,5074793,-1867389,파푸아 뉴기니,2016-02
2016-02-29,3145183,41717,3103466,마이크로네시아,2016-02
2016-02-29,3035066,1658015,1377051,세네갈,2016-02
2016-02-29,3031338,7194387,-4163049,콩고,2016-02
2016-02-29,2807889,5598868,-2790979,몰타,2016-02
2016-02-29,2758596,0,2758596,팔레스타인 해방기구,2016-02
2016-02-29,2518123,108884,2409239,카메룬,2016-02
2016-02-29,2502803,15349,2487454,키르기스스탄,2016-02
2016-02-29,2399214,3724,2395490,사모아,2016-02
2016-02-29,2311457,1644024,667433,조지아,2016-02
2016-02-29,2289859,5018421,-2728562,기니,2016-02
2016-02-29,2178989,516103,1662886,모잠비크,2016-02
2016-02-29,2119256,298,2118958,도미니카,2016-02
2016-02-29,2109831,1978,2107853,네덜란드 열도,2016-02
2016-02-29,1940365,23126,1917239,부르키나 파소,2016-02
2016-02-29,1928352,211739,1716613,스와질랜드,2016-02
2016-02-29,1925767,63956,1861811,마카오,2016-02
2016-02-29,1921227,211971,1709256,사이프러스,2016-02
2016-02-29,1913797,0,1913797,아루바,2016-02
2016-02-29,1841617,201689,1639928,모리셔스,2016-02
2016-02-29,1755606,5952427,-4196821,마다카스카르,2016-02
2016-02-29,1725037,26579068,-24854031,콩고민주공화국,2016-02
2016-02-29,1681499,54419829,-52738330,가봉,2016-02
2016-02-29,1610215,506953,1103262,베닝,2016-02
2016-02-29,1565421,793665,771756,우간다,2016-02
2016-02-29,1552330,171630,1380700,짐바브웨,2016-02
2016-02-29,1467371,175619,1291752,네팔,2016-02
2016-02-29,1455543,122605,1332938,마세도니아,2016-02
2016-02-29,1403716,4531686,-3127970,벨라루스,2016-02
2016-02-29,1340477,33,1340444,불령 리유니온 코모도 제도,2016-02
2016-02-29,1317361,273275,1044086,자마이카,2016-02
2016-02-29,1300419,84230,1216189,세이쉘,2016-02
2016-02-29,1143666,14369259,-13225593,잠비아,2016-02
2016-02-29,1143046,41208534,-40065488,기타국,2016-02
2016-02-29,1107388,0,1107388,티모르,2016-02
2016-02-29,1092852,430712,662140,쿠바,2016-02
2016-02-29,1012785,362,1012423,타지크,2016-02
2016-02-29,973648,735577,238071,몰도바,2016-02
2016-02-29,947284,62752,884532,북마리아나 군도,2016-02
2016-02-29,813189,30856,782333,바베이도스,2016-02
2016-02-29,744579,0,744579,마티니크,2016-02
2016-02-29,690126,220589,469537,수리남,2016-02
2016-02-29,675605,912579,-236974,리히텐슈타인,2016-02
2016-02-29,656208,1412,654796,소말리아,2016-02
2016-02-29,649695,89501,560194,아르메니아,2016-02
2016-02-29,644922,84474,560448,몰디브,2016-02
2016-02-29,573167,793,572374,벨리제,2016-02
2016-02-29,560852,2494440,-1933588,모리타니,2016-02
2016-02-29,548076,997,547079,아메리칸 사모아,2016-02
2016-02-29,544788,166787,378001,알바니아,2016-02
2016-02-29,542448,50664,491784,보츠와나,2016-02
2016-02-29,525603,9137546,-8611943,룩셈부르그,2016-02
2016-02-29,433688,0,433688,과델로프,2016-02
2016-02-29,430902,3317,427585,영령 버진군도,2016-02
2016-02-29,418697,79830,338867,가이아나,2016-02
2016-02-29,415760,67193,348567,안티가 바부다,2016-02
2016-02-29,396084,67316148,-66920064,적도 기니,2016-02
2016-02-29,379957,1800,378157,팔라우,2016-02
2016-02-29,362490,1123,361367,영령 캐이맨 군도,2016-02
2016-02-29,339190,12796820,-12457630,말라위,2016-02
2016-02-29,288581,137501,151080,키리바티,2016-02
2016-02-29,263868,0,263868,그레나다,2016-02
2016-02-29,256118,46,256072,말리,2016-02
2016-02-29,235942,714403,-478461,보스니아-헤르체고비나,2016-02
2016-02-29,229549,1317,228232,몬테네그로,2016-02
2016-02-29,193446,231,193215,카보 베르데,2016-02
2016-02-29,180630,1111547,-930917,바누아투,2016-02
2016-02-29,172304,207670,-35366,감비아,2016-02
2016-02-29,169602,913032,-743430,솔로몬 군도,2016-02
2016-02-29,153817,1182,152635,세인트 루시아,2016-02
2016-02-29,147305,7257,140048,세인트 키츠 네비스,2016-02
2016-02-29,146633,89,146544,부탄,2016-02
2016-02-29,132638,190,132448,안도라,2016-02
2016-02-29,124569,0,124569,메요트,2016-02
2016-02-29,122971,2311926,-2188955,시에라 리온,2016-02
2016-02-29,117825,0,117825,챠드,2016-02
2016-02-29,117123,0,117123,불령 가이아나,2016-02
2016-02-29,113362,0,113362,보빗군도,2016-02
2016-02-29,92476,13822742,-13730266,나미비아,2016-02
2016-02-29,64237,127,64110,상토메 프린스페,2016-02
2016-02-29,60167,0,60167,세인트 빈센트 그레나딘,2016-02
2016-02-29,58377,58029,348,산마리노,2016-02
2016-02-29,53717,89356903,-89303186,니제르,2016-02
2016-02-29,51665,50498,1167,통가,2016-02
2016-02-29,49065,164331,-115266,중앙아프리카공화국,2016-02
2016-02-29,27654,142,27512,투발루,2016-02
2016-02-29,21554,3242820,-3221266,나우루,2016-02
2016-02-29,16015,0,16015,지브랄타,2016-02
2016-02-29,9772,0,9772,큐라소,2016-02
2016-02-29,9095,59,9036,앙귈라,2016-02
2016-02-29,7129,362926,-355797,모나코,2016-02
2016-02-29,2800,0,2800,포클랜드 군도,2016-02
2016-02-29,1263,0,1263,세인트 마틴,2016-02
2016-02-29,467,7229,-6762,토켈라우,2016-02
2016-02-29,165,0,165,남수단,2016-02
2016-02-29,143,173952,-173809,그린랜드,2016-02
2016-02-29,81,10845,-10764,미령 버진군도,2016-02
2016-02-29,0,58,-58,마이너 아우틀링 합중국 군도,2016-02
2016-02-29,0,566,-566,남조지아 & 남샌드위치 군도,2016-02
2016-02-29,0,39795,-39795,레소토,2016-02
2016-02-29,0,23222,-23222,쿡 아일랜드,2016-02
2016-02-29,0,80,-80,투르크 & 카이코스 군도,2016-02
2016-02-29,0,80042,-80042,기네비소,2016-02
2016-02-29,0,307,-307,몬트세라트,2016-02
2016-02-29,0,2564,-2564,허드 앤 맥도날드 군도,2016-02
2016-02-29,0,4224,-4224,저어지,2016-02
2016-02-29,0,155299,-155299,코모로스,2016-02
2016-02-29,0,2750,-2750,피트카이른,2016-02
2016-02-29,0,33,-33,세인트 헬레나,2016-02
2016-02-29,0,50490,-50490,부룬디,2016-02
2016-02-29,0,25835,-25835,니우에,2016-02
2016-03-31,10420521589,7299073196,3121448393,중국,2016-03
2016-03-31,6544965121,3794193259,2750771862,미국,2016-03
2016-03-31,2783409035,1053972354,1729436681,베트남,2016-03
2016-03-31,2328129379,157355177,2170774202,홍콩,2016-03
2016-03-31,2050548563,4204131475,-2153582912,일본,2016-03
2016-03-31,1193619168,363236418,830382750,인도,2016-03
2016-03-31,1162551821,380021218,782530603,영국,2016-03
2016-03-31,1004231897,1420373296,-416141399,대만,2016-03
2016-03-31,962263986,12493648,949770338,마샬군도,2016-03
2016-03-31,841244597,589733806,251510791,싱가포르,2016-03
2016-03-31,771128911,238898124,532230787,멕시코,2016-03
2016-03-31,617938163,258926059,359012104,필리핀,2016-03
2016-03-31,577472911,191922864,385550047,노르웨이,2016-03
2016-03-31,570344117,1239927368,-669583251,호주,2016-03
2016-03-31,566394024,1490555848,-924161824,독일,2016-03
2016-03-31,561752805,932269161,-370516356,사우디아라비아,2016-03
2016-03-31,528495279,753382631,-224887352,인도네시아,2016-03
2016-03-31,527874760,73368266,454506494,튀르키예,2016-03
2016-03-31,518507955,396792418,121715537,태국,2016-03
2016-03-31,513469446,535766134,-22296688,아랍에미리트 연합,2016-03
2016-03-31,475631789,686272358,-210640569,말레이시아,2016-03
2016-03-31,426670087,268867931,157802156,캐나다,2016-03
2016-03-31,370675938,559715923,-189039985,러시아 연방,2016-03
2016-03-31,362395267,228051548,134343719,네덜란드,2016-03
2016-03-31,351532476,267358795,84173681,브라질,2016-03
2016-03-31,287271826,449391551,-162119725,이탈리아,2016-03
2016-03-31,274214002,456237331,-182023329,프랑스,2016-03
2016-03-31,263070806,85325172,177745634,벨기에,2016-03
2016-03-31,261323834,20018498,241305336,슬로바키아,2016-03
2016-03-31,260603616,235524428,25079188,이란,2016-03
2016-03-31,224284592,51010892,173273700,폴란드,2016-03
2016-03-31,205121972,30,205121942,버뮤다,2016-03
2016-03-31,204970001,167639385,37330616,스페인,2016-03
2016-03-31,201667796,5170087,196497709,몰타,2016-03
2016-03-31,184759200,2470554,182288646,이집트,2016-03
2016-03-31,176920515,58895499,118025016,체코공화국,2016-03
2016-03-31,152677375,273231371,-120553996,이라크,2016-03
2016-03-31,145234357,87784854,57449503,뉴질랜드,2016-03
2016-03-31,141201581,8082327,133119254,슬로베니아,2016-03
2016-03-31,134599884,343412279,-208812395,칠레,2016-03
2016-03-31,124382629,87090642,37291987,이스라엘,2016-03
2016-03-31,121189634,121313,121068321,라이베리아,2016-03
2016-03-31,107665520,31709667,75955853,방글라데시,2016-03
2016-03-31,102453884,451273260,-348819376,쿠웨이트,2016-03
2016-03-31,102418352,3949767,98468585,그리스,2016-03
2016-03-31,99659117,67170372,32488745,아르헨티나,2016-03
2016-03-31,92076529,84868801,7207728,남아프리카공화국,2016-03
2016-03-31,86935291,1031493,85903798,우즈베키스탄,2016-03
2016-03-31,83039512,160192907,-77153395,페루,2016-03
2016-03-31,78170720,20579911,57590809,파키스탄,2016-03
2016-03-31,77532353,21150220,56382133,콜롬비아,2016-03
2016-03-31,72079457,39761475,32317982,알제리,2016-03
2016-03-31,70773391,118652183,-47878792,스웨덴,2016-03
2016-03-31,68846216,61515662,7330554,헝가리,2016-03
2016-03-31,63890847,5758290,58132557,요르단,2016-03
2016-03-31,59768128,97840868,-38072740,오스트리아,2016-03
2016-03-31,57008650,6613243,50395407,파나마,2016-03
2016-03-31,53860779,17083123,36777656,모로코,2016-03
2016-03-31,53410933,45690228,7720705,루마니아,2016-03
2016-03-31,51659616,23685969,27973647,캄보디아,2016-03
2016-03-31,50621394,313989084,-263367690,오만,2016-03
2016-03-31,45746298,695091735,-649345437,카타르,2016-03
2016-03-31,44519659,197741481,-153221822,스위스,2016-03
2016-03-31,42985030,89659441,-46674411,아일랜드,2016-03
2016-03-31,42799332,5089,42794243,투르크멘,2016-03
2016-03-31,41139919,2550052,38589867,세네갈,2016-03
2016-03-31,40840272,4697397,36142875,에쿠아도르,2016-03
2016-03-31,40445974,41438570,-992596,미얀마,2016-03
2016-03-31,37805751,697937,37107814,앙골라,2016-03
2016-03-31,33049862,58680694,-25630832,덴마크,2016-03
2016-03-31,32461464,21349806,11111658,포루투갈,2016-03
2016-03-31,28687733,7376881,21310852,도미니카 공화국,2016-03
2016-03-31,26964142,39302070,-12337928,리비아,2016-03
2016-03-31,26780202,52728211,-25948009,나이지리아,2016-03
2016-03-31,26776065,13251831,13524234,푸에르토리코,2016-03
2016-03-31,25899780,6159070,19740710,리투아니아,2016-03
2016-03-31,25459747,9651404,15808343,스리랑카,2016-03
2016-03-31,25397803,13516777,11881026,과테말라,2016-03
2016-03-31,23254321,8866375,14387946,카자흐스탄,2016-03
2016-03-31,22889797,422640,22467157,탄자니아,2016-03
2016-03-31,22487347,81803773,-59316426,핀란드,2016-03
2016-03-31,21933146,1219483,20713663,몽골,2016-03
2016-03-31,20971662,44635991,-23664329,우크라이나,2016-03
2016-03-31,19702269,3056032,16646237,크로아티아,2016-03
2016-03-31,17392889,1634007,15758882,가나,2016-03
2016-03-31,16935848,2691090,14244758,케냐,2016-03
2016-03-31,16056351,147726,15908625,피지,2016-03
2016-03-31,15715107,10943507,4771600,코스타리카,2016-03
2016-03-31,15655777,808677,14847100,레바논,2016-03
2016-03-31,15134326,692184,14442142,니카라과,2016-03
2016-03-31,14478737,2353437,12125300,라오스,2016-03
2016-03-31,13475340,35979876,-22504536,바레인,2016-03
2016-03-31,13446705,3716665,9730040,튀니지,2016-03
2016-03-31,13331176,947412,12383764,엘살바도르,2016-03
2016-03-31,13316122,1108612,12207510,시리아,2016-03
2016-03-31,13109376,1447107,11662269,수단,2016-03
2016-03-31,12242657,9025818,3216839,불가리아,2016-03
2016-03-31,11399132,2384335,9014797,파라과이,2016-03
2016-03-31,11040936,1064464,9976472,예맨,2016-03
2016-03-31,10219687,157701539,-147481852,브루나이,2016-03
2016-03-31,10100149,16548,10083601,아제르바이잔,2016-03
2016-03-31,9595434,172327,9423107,팔레스타인 해방기구,2016-03
2016-03-31,9403826,9380855,22971,온두라스,2016-03
2016-03-31,8818539,706302,8112237,세르비아,2016-03
2016-03-31,8036825,1696702,6340123,코트디봐르,2016-03
2016-03-31,7766643,0,7766643,불령 폴리네시아,2016-03
2016-03-31,7694919,886703,6808216,조지아,2016-03
2016-03-31,7370118,13573856,-6203738,트리니다드 토바고,2016-03
2016-03-31,7237564,4634314,2603250,우루과이,2016-03
2016-03-31,6916939,4799522,2117417,에스토니아,2016-03
2016-03-31,6283596,58199,6225397,괌,2016-03
2016-03-31,5819780,26279,5793501,마이크로네시아,2016-03
2016-03-31,5814240,118638,5695602,키르기스스탄,2016-03
2016-03-31,5693281,27295192,-21601911,볼리비아,2016-03
2016-03-31,5640130,2149953,3490177,에티오피아,2016-03
2016-03-31,5590825,20363867,-14773042,뉴 칼레도니아,2016-03
2016-03-31,4765374,44232,4721142,지부티,2016-03
2016-03-31,4616416,240011,4376405,아이티,2016-03
2016-03-31,4439695,262,4439433,세인트 키츠 네비스,2016-03
2016-03-31,4344539,261757,4082782,자마이카,2016-03
2016-03-31,4136410,2125729,2010681,쿠바,2016-03
2016-03-31,4079011,1300721,2778290,베네주엘라,2016-03
2016-03-31,3966966,5179214,-1212248,라트비아,2016-03
2016-03-31,3697372,8282892,-4585520,파푸아 뉴기니,2016-03
2016-03-31,3634951,191537,3443414,마카오,2016-03
2016-03-31,2827583,2640975,186608,아이슬란드,2016-03
2016-03-31,2825278,23794234,-20968956,가봉,2016-03
2016-03-31,2725665,7496616,-4770951,모잠비크,2016-03
2016-03-31,2650230,43266617,-40616387,콩고민주공화국,2016-03
2016-03-31,2584677,592326,1992351,모리셔스,2016-03
2016-03-31,2451351,239668,2211683,카메룬,2016-03
2016-03-31,2378607,105249,2273358,네팔,2016-03
2016-03-31,2360685,133302,2227383,가이아나,2016-03
2016-03-31,2335686,5835274,-3499588,마다카스카르,2016-03
2016-03-31,2175544,72211563,-70036019,기타국,2016-03
2016-03-31,2097607,0,2097607,아루바,2016-03
2016-03-31,1877106,28557815,-26680709,기니,2016-03
2016-03-31,1836910,110075,1726835,사모아,2016-03
2016-03-31,1766107,41125,1724982,네덜란드 열도,2016-03
2016-03-31,1723270,230675,1492595,사이프러스,2016-03
2016-03-31,1652717,3063648,-1410931,벨라루스,2016-03
2016-03-31,1623123,217042,1406081,알바니아,2016-03
2016-03-31,1561162,0,1561162,아프카니스탄,2016-03
2016-03-31,1552651,3974511,-2421860,토고,2016-03
2016-03-31,1549802,1259,1548543,바베이도스,2016-03
2016-03-31,1508687,3486871,-1978184,말라위,2016-03
2016-03-31,1495136,214276,1280860,베닝,2016-03
2016-03-31,1420047,60998850,-59578803,적도 기니,2016-03
2016-03-31,1384053,265,1383788,타지크,2016-03
2016-03-31,1334254,280112,1054142,세이쉘,2016-03
2016-03-31,1324876,180,1324696,말리,2016-03
2016-03-31,1313552,145187,1168365,르완다,2016-03
2016-03-31,1304128,0,1304128,불령 리유니온 코모도 제도,2016-03
2016-03-31,1295176,433,1294743,북마리아나 군도,2016-03
2016-03-31,1116723,1610,1115113,부르키나 파소,2016-03
2016-03-31,1076575,54748,1021827,짐바브웨,2016-03
2016-03-31,1015438,30208551,-29193113,콩고,2016-03
2016-03-31,967392,3960926,-2993534,잠비아,2016-03
2016-03-31,960533,5471123,-4510590,룩셈부르그,2016-03
2016-03-31,918857,1490,917367,바하마,2016-03
2016-03-31,844753,33347,811406,보츠와나,2016-03
2016-03-31,808004,707812,100192,키리바티,2016-03
2016-03-31,783916,250423,533493,몰디브,2016-03
2016-03-31,780528,55486,725042,영령 캐이맨 군도,2016-03
2016-03-31,774784,11385,763399,티모르,2016-03
2016-03-31,753422,0,753422,안티가 바부다,2016-03
2016-03-31,745492,1000973,-255481,우간다,2016-03
2016-03-31,731844,0,731844,소말리아,2016-03
2016-03-31,690521,0,690521,마티니크,2016-03
2016-03-31,615548,53170,562378,안도라,2016-03
2016-03-31,607378,3493542,-2886164,모리타니,2016-03
2016-03-31,598250,785472,-187222,보스니아-헤르체고비나,2016-03
2016-03-31,577276,4313,572963,과델로프,2016-03
2016-03-31,566816,550949,15867,리히텐슈타인,2016-03
2016-03-31,533051,120137,412914,아르메니아,2016-03
2016-03-31,507931,0,507931,팔라우,2016-03
2016-03-31,437833,2000,435833,부탄,2016-03
2016-03-31,417657,288595,129062,수리남,2016-03
2016-03-31,414734,1085113,-670379,몰도바,2016-03
2016-03-31,404835,107002,297833,마세도니아,2016-03
2016-03-31,372209,61873,310336,벨리제,2016-03
2016-03-31,359665,0,359665,몬테네그로,2016-03
2016-03-31,306129,4978,301151,도미니카,2016-03
2016-03-31,303614,103865,199749,세인트 루시아,2016-03
2016-03-31,275050,0,275050,그레나다,2016-03
2016-03-31,270818,0,270818,불령 가이아나,2016-03
2016-03-31,262506,0,262506,에리트리아,2016-03
2016-03-31,239459,885,238574,아메리칸 사모아,2016-03
2016-03-31,224253,1586868,-1362615,시에라 리온,2016-03
2016-03-31,210219,81587,128632,바누아투,2016-03
2016-03-31,195402,154904,40498,스와질랜드,2016-03
2016-03-31,193792,1355551,-1161759,솔로몬 군도,2016-03
2016-03-31,182936,2790400,-2607464,나미비아,2016-03
2016-03-31,159588,61765,97823,영령 버진군도,2016-03
2016-03-31,159176,211035,-51859,세인트 빈센트 그레나딘,2016-03
2016-03-31,115067,0,115067,카보 베르데,2016-03
2016-03-31,102950,0,102950,통가,2016-03
2016-03-31,77287,330579,-253292,중앙아프리카공화국,2016-03
2016-03-31,76550,215,76335,지브랄타,2016-03
2016-03-31,45468,0,45468,메요트,2016-03
2016-03-31,38041,0,38041,앙귈라,2016-03
2016-03-31,37102,0,37102,국제통화기금,2016-03
2016-03-31,26330,0,26330,챠드,2016-03
2016-03-31,21584,0,21584,큐라소,2016-03
2016-03-31,20375,33001,-12626,감비아,2016-03
2016-03-31,19182,3102,16080,니제르,2016-03
2016-03-31,17179,20736,-3557,미령 버진군도,2016-03
2016-03-31,12598,0,12598,남수단,2016-03
2016-03-31,6363,209607,-203244,모나코,2016-03
2016-03-31,5185,24168,-18983,쿡 아일랜드,2016-03
2016-03-31,997,0,997,세인트 마틴,2016-03
2016-03-31,271,0,271,저어지,2016-03
2016-03-31,95,226122,-226027,그린랜드,2016-03
2016-03-31,46,0,46,안타티카,2016-03
2016-03-31,35,0,35,투발루,2016-03
2016-03-31,0,138359,-138359,파로에 군도,2016-03
2016-03-31,0,17,-17,투르크 & 카이코스 군도,2016-03
2016-03-31,0,79,-79,크리스마스 아일랜드,2016-03
2016-03-31,0,2196,-2196,토켈라우,2016-03
2016-03-31,0,304737,-304737,기네비소,2016-03
2016-03-31,0,421,-421,산마리노,2016-03
2016-03-31,0,896,-896,몬트세라트,2016-03
2016-03-31,0,13,-13,포클랜드 군도,2016-03
2016-03-31,0,8674,-8674,상토메 프린스페,2016-03
2016-03-31,0,11275,-11275,건지,2016-03
2016-03-31,0,103935,-103935,코모로스,2016-03
2016-03-31,0,37499,-37499,부룬디,2016-03
2016-03-31,0,273,-273,세인트 헬레나,2016-03
2016-03-31,0,1936,-1936,마이너 아우틀링 합중국 군도,2016-03
2016-03-31,0,27853,-27853,니우에,2016-03
2016-03-31,0,110,-110,맨섬,2016-03
2016-04-30,9613431316,7100674696,2512756620,중국,2016-04
2016-04-30,5823758110,3305401929,2518356181,미국,2016-04
2016-04-30,2770462931,971236640,1799226291,베트남,2016-04
2016-04-30,2431256512,154894158,2276362354,홍콩,2016-04
2016-04-30,1776555240,3825930828,-2049375588,일본,2016-04
2016-04-30,1331614278,42904746,1288709532,마샬군도,2016-04
2016-04-30,1240656310,616287934,624368376,말레이시아,2016-04
2016-04-30,1233521677,551114556,682407121,싱가포르,2016-04
2016-04-30,952081033,310780179,641300854,인도,2016-04
2016-04-30,926075175,1209229322,-283154147,대만,2016-04
2016-04-30,727665672,1112356818,-384691146,호주,2016-04
2016-04-30,706365872,343335715,363030157,멕시코,2016-04
2016-04-30,646238914,483592790,162646124,영국,2016-04
2016-04-30,637359130,422739008,214620122,아랍에미리트 연합,2016-04
2016-04-30,565847411,577685327,-11837916,인도네시아,2016-04
2016-04-30,542581784,292925875,249655909,필리핀,2016-04
2016-04-30,537623873,1283842231,-746218358,사우디아라비아,2016-04
2016-04-30,520879259,1683349963,-1162470704,독일,2016-04
2016-04-30,520506678,352934374,167572304,태국,2016-04
2016-04-30,514013598,64360991,449652607,튀르키예,2016-04
2016-04-30,382129634,329002166,53127468,캐나다,2016-04
2016-04-30,361513504,311212974,50300530,브라질,2016-04
2016-04-30,327021862,609696093,-282674231,러시아 연방,2016-04
2016-04-30,289663079,505040988,-215377909,네덜란드,2016-04
2016-04-30,269127787,478361066,-209233279,프랑스,2016-04
2016-04-30,263313503,441562949,-178249446,이탈리아,2016-04
2016-04-30,256124234,49958,256074276,라이베리아,2016-04
2016-04-30,247925004,25670872,222254132,슬로바키아,2016-04
2016-04-30,224954433,200987251,23967182,스페인,2016-04
2016-04-30,216116442,38994405,177122037,폴란드,2016-04
2016-04-30,200332296,49997869,150334427,체코공화국,2016-04
2016-04-30,195398088,17813254,177584834,그리스,2016-04
2016-04-30,192006101,250526415,-58520314,이란,2016-04
2016-04-30,173845049,88632328,85212721,벨기에,2016-04
2016-04-30,165870643,7849262,158021381,슬로베니아,2016-04
2016-04-30,144167688,4794,144162894,맨섬,2016-04
2016-04-30,140903007,85985662,54917345,뉴질랜드,2016-04
2016-04-30,139772124,460724583,-320952459,이라크,2016-04
2016-04-30,135223431,62126758,73096673,이스라엘,2016-04
2016-04-30,132385471,457213421,-324827950,쿠웨이트,2016-04
2016-04-30,130573634,3948089,126625545,이집트,2016-04
2016-04-30,119431508,76909127,42522381,페루,2016-04
2016-04-30,107772950,366696952,-258924002,칠레,2016-04
2016-04-30,102918369,142171040,-39252671,노르웨이,2016-04
2016-04-30,100309631,25177373,75132258,방글라데시,2016-04
2016-04-30,85230564,67041375,18189189,헝가리,2016-04
2016-04-30,81867540,36899654,44967886,파나마,2016-04
2016-04-30,79059575,20000514,59059061,콜롬비아,2016-04
2016-04-30,78890116,91568964,-12678848,남아프리카공화국,2016-04
2016-04-30,77571150,27766794,49804356,파키스탄,2016-04
2016-04-30,71982476,89324811,-17342335,오스트리아,2016-04
2016-04-30,64711694,103181550,-38469856,아르헨티나,2016-04
2016-04-30,62840957,124289373,-61448416,스웨덴,2016-04
2016-04-30,56905809,195107271,-138201462,스위스,2016-04
2016-04-30,56624444,47902091,8722353,루마니아,2016-04
2016-04-30,56354850,1047581,55307269,우즈베키스탄,2016-04
2016-04-30,53259868,220353732,-167093864,오만,2016-04
2016-04-30,52707007,10904405,41802602,모로코,2016-04
2016-04-30,50354796,3039324,47315472,요르단,2016-04
2016-04-30,49445342,18845916,30599426,캄보디아,2016-04
2016-04-30,48989130,89339229,-40350099,아일랜드,2016-04
2016-04-30,45253528,34223804,11029724,미얀마,2016-04
2016-04-30,39353584,28086,39325498,알제리,2016-04
2016-04-30,38441281,37817790,623491,앙골라,2016-04
2016-04-30,36992714,21133981,15858733,포루투갈,2016-04
2016-04-30,36643051,3564912,33078139,토고,2016-04
2016-04-30,34921383,6986,34914397,투르크멘,2016-04
2016-04-30,32520066,38099753,-5579687,나이지리아,2016-04
2016-04-30,28537332,678037444,-649500112,카타르,2016-04
2016-04-30,28123648,6632307,21491341,리투아니아,2016-04
2016-04-30,27174269,5522221,21652048,도미니카 공화국,2016-04
2016-04-30,27045894,16052741,10993153,푸에르토리코,2016-04
2016-04-30,26469240,60627434,-34158194,덴마크,2016-04
2016-04-30,25020644,6141243,18879401,에쿠아도르,2016-04
2016-04-30,24636213,2076716,22559497,리비아,2016-04
2016-04-30,23213306,9936038,13277268,코스타리카,2016-04
2016-04-30,22949492,15902290,7047202,과테말라,2016-04
2016-04-30,22385477,2259476,20126001,가나,2016-04
2016-04-30,20366054,142606,20223448,몽골,2016-04
2016-04-30,18780753,1069974,17710779,크로아티아,2016-04
2016-04-30,18136094,61946524,-43810430,핀란드,2016-04
2016-04-30,17536615,10904921,6631694,카자흐스탄,2016-04
2016-04-30,17502699,39662300,-22159601,바레인,2016-04
2016-04-30,17308318,34492794,-17184476,우크라이나,2016-04
2016-04-30,17124170,7633642,9490528,스리랑카,2016-04
2016-04-30,16935661,10435311,6500350,튀니지,2016-04
2016-04-30,15121646,908980,14212666,베네주엘라,2016-04
2016-04-30,14649408,1532411,13116997,레바논,2016-04
2016-04-30,14539681,4918471,9621210,온두라스,2016-04
2016-04-30,13941234,10692903,3248331,불가리아,2016-04
2016-04-30,11889320,922548,10966772,수단,2016-04
2016-04-30,11388458,2540788,8847670,에티오피아,2016-04
2016-04-30,10181089,2150235,8030854,케냐,2016-04
2016-04-30,9779177,727942,9051235,엘살바도르,2016-04
2016-04-30,9715272,3119775,6595497,라오스,2016-04
2016-04-30,9541778,1123833,8417945,니카라과,2016-04
2016-04-30,9312684,8382751,929933,우루과이,2016-04
2016-04-30,7957549,8527511,-569962,탄자니아,2016-04
2016-04-30,7872340,10626,7861714,아제르바이잔,2016-04
2016-04-30,7620624,781563,6839061,코트디봐르,2016-04
2016-04-30,7516996,1110666,6406330,시리아,2016-04
2016-04-30,7268367,1337880,5930487,파라과이,2016-04
2016-04-30,6856364,1547751,5308613,예맨,2016-04
2016-04-30,6505281,45323598,-38818317,볼리비아,2016-04
2016-04-30,5655636,934669,4720967,세르비아,2016-04
2016-04-30,5574497,497832,5076665,팔레스타인 해방기구,2016-04
2016-04-30,5425526,106391,5319135,피지,2016-04
2016-04-30,5364764,55,5364709,아프카니스탄,2016-04
2016-04-30,5298347,7973550,-2675203,트리니다드 토바고,2016-04
2016-04-30,5041258,26816208,-21774950,브루나이,2016-04
2016-04-30,4935964,77600,4858364,키르기스스탄,2016-04
2016-04-30,4514766,77202,4437564,괌,2016-04
2016-04-30,4467673,30257,4437416,지부티,2016-04
2016-04-30,4168405,7587926,-3419521,에스토니아,2016-04
2016-04-30,4070125,1926091,2144034,파푸아 뉴기니,2016-04
2016-04-30,3874488,297698,3576790,르완다,2016-04
2016-04-30,3864958,6297906,-2432948,라트비아,2016-04
2016-04-30,3822343,3935642,-113299,세네갈,2016-04
2016-04-30,3664230,143642,3520588,알바니아,2016-04
2016-04-30,3586882,195959,3390923,아이티,2016-04
2016-04-30,3552787,474988,3077799,쿠바,2016-04
2016-04-30,3352271,0,3352271,마이크로네시아,2016-04
2016-04-30,3231228,60012378,-56781150,적도 기니,2016-04
2016-04-30,3009942,590332,2419610,마카오,2016-04
2016-04-30,2884157,25096,2859061,말리,2016-04
2016-04-30,2788523,160890,2627633,모리셔스,2016-04
2016-04-30,2742224,14134271,-11392047,사이프러스,2016-04
2016-04-30,2666387,0,2666387,팔라우,2016-04
2016-04-30,2634712,2189434,445278,조지아,2016-04
2016-04-30,2619214,4468535,-1849321,몰타,2016-04
2016-04-30,2543520,58321,2485199,가봉,2016-04
2016-04-30,2493134,37859,2455275,보츠와나,2016-04
2016-04-30,2487710,45817,2441893,불령 폴리네시아,2016-04
2016-04-30,2455953,77926,2378027,사모아,2016-04
2016-04-30,2219413,73688,2145725,자마이카,2016-04
2016-04-30,2204820,155546,2049274,카메룬,2016-04
2016-04-30,2184338,36602493,-34418155,기타국,2016-04
2016-04-30,2132911,114257,2018654,마세도니아,2016-04
2016-04-30,2098164,202721,1895443,부르키나 파소,2016-04
2016-04-30,1952055,2830178,-878123,기니,2016-04
2016-04-30,1892067,56792,1835275,베닝,2016-04
2016-04-30,1837726,23145921,-21308195,뉴 칼레도니아,2016-04
2016-04-30,1780992,46243874,-44462882,콩고민주공화국,2016-04
2016-04-30,1763251,0,1763251,국제통화기금,2016-04
2016-04-30,1688525,0,1688525,아루바,2016-04
2016-04-30,1652523,1776739,-124216,아이슬란드,2016-04
2016-04-30,1601507,7217094,-5615587,마다카스카르,2016-04
2016-04-30,1590000,22139,1567861,네덜란드 열도,2016-04
2016-04-30,1547546,49100,1498446,가이아나,2016-04
2016-04-30,1449797,172303,1277494,네팔,2016-04
2016-04-30,1411000,713899,697101,세이쉘,2016-04
2016-04-30,1406621,16,1406605,타지크,2016-04
2016-04-30,1406312,0,1406312,불령 리유니온 코모도 제도,2016-04
2016-04-30,1402827,321,1402506,북마리아나 군도,2016-04
2016-04-30,1268586,5358271,-4089685,벨라루스,2016-04
2016-04-30,1154037,402799,751238,짐바브웨,2016-04
2016-04-30,1111060,0,1111060,버뮤다,2016-04
2016-04-30,993078,457022,536056,콩고,2016-04
2016-04-30,979228,5326,973902,소말리아,2016-04
2016-04-30,878612,2361242,-1482630,바누아투,2016-04
2016-04-30,862435,76,862359,영령 캐이맨 군도,2016-04
2016-04-30,853836,2454917,-1601081,모리타니,2016-04
2016-04-30,840838,5843130,-5002292,룩셈부르그,2016-04
2016-04-30,783167,272969,510198,우간다,2016-04
2016-04-30,766382,118902,647480,아메리칸 사모아,2016-04
2016-04-30,725576,79997,645579,모잠비크,2016-04
2016-04-30,723232,67226,656006,바베이도스,2016-04
2016-04-30,645196,1143794,-498598,리히텐슈타인,2016-04
2016-04-30,633296,204807,428489,수리남,2016-04
2016-04-30,624601,0,624601,마티니크,2016-04
2016-04-30,622196,6572946,-5950750,잠비아,2016-04
2016-04-30,602877,1199,601678,벨리제,2016-04
2016-04-30,597107,0,597107,과델로프,2016-04
2016-04-30,591729,519,591210,몰디브,2016-04
2016-04-30,557039,0,557039,안티가 바부다,2016-04
2016-04-30,522422,0,522422,키리바티,2016-04
2016-04-30,472207,876,471331,티모르,2016-04
2016-04-30,461947,206,461741,바하마,2016-04
2016-04-30,412587,55013,357574,아르메니아,2016-04
2016-04-30,400369,0,400369,도미니카,2016-04
2016-04-30,397678,0,397678,부탄,2016-04
2016-04-30,390256,377770,12486,몰도바,2016-04
2016-04-30,381994,3127135,-2745141,말라위,2016-04
2016-04-30,344979,682853,-337874,보스니아-헤르체고비나,2016-04
2016-04-30,340335,6096,334239,미령 버진군도,2016-04
2016-04-30,314151,0,314151,불령 가이아나,2016-04
2016-04-30,312933,1636756,-1323823,시에라 리온,2016-04
2016-04-30,295765,0,295765,세인트 루시아,2016-04
2016-04-30,282218,0,282218,지브랄타,2016-04
2016-04-30,281700,0,281700,에리트리아,2016-04
2016-04-30,255903,15,255888,세인트 키츠 네비스,2016-04
2016-04-30,255689,103178,152511,감비아,2016-04
2016-04-30,230976,155926,75050,부룬디,2016-04
2016-04-30,160424,0,160424,영령 버진군도,2016-04
2016-04-30,151217,32662,118555,나미비아,2016-04
2016-04-30,148204,1473659,-1325455,솔로몬 군도,2016-04
2016-04-30,130517,165490,-34973,세인트 빈센트 그레나딘,2016-04
2016-04-30,127200,450531,-323331,스와질랜드,2016-04
2016-04-30,107254,0,107254,그레나다,2016-04
2016-04-30,90290,0,90290,카보 베르데,2016-04
2016-04-30,78292,8707,69585,몬테네그로,2016-04
2016-04-30,77482,182497,-105015,중앙아프리카공화국,2016-04
2016-04-30,66676,0,66676,통가,2016-04
2016-04-30,48270,0,48270,세인트 마틴,2016-04
2016-04-30,24000,1129680,-1105680,안도라,2016-04
2016-04-30,9819,0,9819,챠드,2016-04
2016-04-30,8582,383720,-375138,모나코,2016-04
2016-04-30,6350,47619,-41269,산마리노,2016-04
2016-04-30,4905,2261,2644,니제르,2016-04
2016-04-30,4075,0,4075,큐라소,2016-04
2016-04-30,3289,58,3231,상토메 프린스페,2016-04
2016-04-30,2600,0,2600,남조지아 & 남샌드위치 군도,2016-04
2016-04-30,756,180,576,투르크 & 카이코스 군도,2016-04
2016-04-30,612,399,213,파로에 군도,2016-04
2016-04-30,500,0,500,남수단,2016-04
2016-04-30,475,0,475,앙귈라,2016-04
2016-04-30,241,158951,-158710,그린랜드,2016-04
2016-04-30,2,0,2,기네비소,2016-04
2016-04-30,0,618,-618,니우에,2016-04
2016-04-30,0,3791,-3791,코모로스,2016-04
2016-04-30,0,5410606,-5410606,안타티카,2016-04
2016-04-30,0,695543,-695543,나우루,2016-04
2016-04-30,0,5571,-5571,토켈라우,2016-04
2016-04-30,0,286,-286,몬트세라트,2016-04
2016-04-30,0,14172,-14172,교황청,2016-04
2016-04-30,0,13731,-13731,피트카이른,2016-04
2016-04-30,0,585,-585,코스 군도,2016-04
2016-04-30,0,1386,-1386,쿡 아일랜드,2016-04
2016-04-30,0,5,-5,레소토,2016-04
2016-05-31,9928386074,7058148519,2870237555,중국,2016-05
2016-05-31,5669349924,3887886240,1781463684,미국,2016-05
2016-05-31,2657286566,138936436,2518350130,홍콩,2016-05
2016-05-31,2647731803,915037933,1732693870,베트남,2016-05
2016-05-31,2041330727,3635640570,-1594309843,일본,2016-05
2016-05-31,961625113,516445028,445180085,싱가포르,2016-05
2016-05-31,929800020,1271020897,-341220877,대만,2016-05
2016-05-31,891460949,316897513,574563436,인도,2016-05
2016-05-31,739594818,230479033,509115785,멕시코,2016-05
2016-05-31,700440119,370313150,330126969,영국,2016-05
2016-05-31,618151655,216446026,401705629,필리핀,2016-05
2016-05-31,594981374,1155430790,-560449416,호주,2016-05
2016-05-31,549654513,579659692,-30005179,말레이시아,2016-05
2016-05-31,548080222,657243331,-109163109,인도네시아,2016-05
2016-05-31,528826468,1679991625,-1151165157,독일,2016-05
2016-05-31,515741557,369075842,146665715,태국,2016-05
2016-05-31,492334092,69091839,423242253,튀르키예,2016-05
2016-05-31,475212740,1355072471,-879859731,사우디아라비아,2016-05
2016-05-31,465097560,677,465096883,마샬군도,2016-05
2016-05-31,447706952,522150188,-74443236,아랍에미리트 연합,2016-05
2016-05-31,414921089,741373018,-326451929,러시아 연방,2016-05
2016-05-31,412260593,340546367,71714226,브라질,2016-05
2016-05-31,377611111,267998588,109612523,네덜란드,2016-05
2016-05-31,345010062,318152485,26857577,캐나다,2016-05
2016-05-31,295772701,388598359,-92825658,이란,2016-05
2016-05-31,269738703,474595112,-204856409,이탈리아,2016-05
2016-05-31,256304850,19188194,237116656,그리스,2016-05
2016-05-31,250851178,3079,250848099,바하마,2016-05
2016-05-31,248298459,125479,248172980,라이베리아,2016-05
2016-05-31,232036290,51139111,180897179,폴란드,2016-05
2016-05-31,207915956,26162189,181753767,슬로바키아,2016-05
2016-05-31,197028149,52239485,144788664,체코공화국,2016-05
2016-05-31,185987598,455646456,-269658858,프랑스,2016-05
2016-05-31,183810038,214565381,-30755343,스페인,2016-05
2016-05-31,174091835,2400698,171691137,이집트,2016-05
2016-05-31,168996058,88690155,80305903,벨기에,2016-05
2016-05-31,133347656,9184104,124163552,슬로베니아,2016-05
2016-05-31,126654673,99365458,27289215,뉴질랜드,2016-05
2016-05-31,126097539,337437600,-211340061,칠레,2016-05
2016-05-31,115996880,766712850,-650715970,쿠웨이트,2016-05
2016-05-31,115481999,70021765,45460234,이스라엘,2016-05
2016-05-31,108481226,23931642,84549584,방글라데시,2016-05
2016-05-31,102671506,45013810,57657696,페루,2016-05
2016-05-31,90609292,60896456,29712836,헝가리,2016-05
2016-05-31,88599001,54540809,34058192,파나마,2016-05
2016-05-31,80631452,109083545,-28452093,남아프리카공화국,2016-05
2016-05-31,80050105,324753777,-244703672,이라크,2016-05
2016-05-31,74302648,16694030,57608618,파키스탄,2016-05
2016-05-31,71968285,31031902,40936383,콜롬비아,2016-05
2016-05-31,69301709,85264424,-15962715,오스트리아,2016-05
2016-05-31,64829187,2863516,61965671,우즈베키스탄,2016-05
2016-05-31,60319370,96177312,-35857942,아르헨티나,2016-05
2016-05-31,56170658,171421161,-115250503,오만,2016-05
2016-05-31,55828785,130774739,-74945954,스웨덴,2016-05
2016-05-31,53978364,11400369,42577995,모로코,2016-05
2016-05-31,53377697,212950946,-159573249,스위스,2016-05
2016-05-31,50981732,19864385,31117347,알제리,2016-05
2016-05-31,50199493,2988657,47210836,요르단,2016-05
2016-05-31,49747060,766098643,-716351583,카타르,2016-05
2016-05-31,48662671,53266053,-4603382,루마니아,2016-05
2016-05-31,48099128,15007750,33091378,캄보디아,2016-05
2016-05-31,44560899,6282587,38278312,세네갈,2016-05
2016-05-31,42387363,116449262,-74061899,핀란드,2016-05
2016-05-31,42186711,14974506,27212205,미얀마,2016-05
2016-05-31,41316394,3487454,37828940,몰타,2016-05
2016-05-31,40682967,19778765,20904202,포루투갈,2016-05
2016-05-31,39213404,99702690,-60489286,아일랜드,2016-05
2016-05-31,33473858,13907684,19566174,푸에르토리코,2016-05
2016-05-31,32372519,835,32371684,투르크멘,2016-05
2016-05-31,31813961,46867673,-15053712,앙골라,2016-05
2016-05-31,31789397,3717444,28071953,파푸아 뉴기니,2016-05
2016-05-31,31716409,7887727,23828682,에쿠아도르,2016-05
2016-05-31,30854227,45306217,-14451990,나이지리아,2016-05
2016-05-31,28417243,61180126,-32762883,덴마크,2016-05
2016-05-31,27173591,665943,26507648,몽골,2016-05
2016-05-31,26280756,6281355,19999401,리투아니아,2016-05
2016-05-31,25186470,11867879,13318591,카자흐스탄,2016-05
2016-05-31,23602529,5931849,17670680,도미니카 공화국,2016-05
2016-05-31,22821410,6009546,16811864,스리랑카,2016-05
2016-05-31,22451714,29227652,-6775938,리비아,2016-05
2016-05-31,19662825,8363689,11299136,코스타리카,2016-05
2016-05-31,19232225,855951,18376274,시리아,2016-05
2016-05-31,17888430,5500934,12387496,과테말라,2016-05
2016-05-31,17219986,1269167,15950819,라오스,2016-05
2016-05-31,17029200,2175154,14854046,가나,2016-05
2016-05-31,16265981,29071892,-12805911,우크라이나,2016-05
2016-05-31,15840512,1727949,14112563,레바논,2016-05
2016-05-31,14017235,3264953,10752282,케냐,2016-05
2016-05-31,13925159,118173684,-104248525,노르웨이,2016-05
2016-05-31,13704505,12194357,1510148,불가리아,2016-05
2016-05-31,13700225,8349724,5350501,바레인,2016-05
2016-05-31,13304473,1977653,11326820,베네주엘라,2016-05
2016-05-31,12842368,3375107,9467261,탄자니아,2016-05
2016-05-31,12275409,29420,12245989,아제르바이잔,2016-05
2016-05-31,11407301,2048789,9358512,튀니지,2016-05
2016-05-31,11404088,533875,10870213,예맨,2016-05
2016-05-31,11050404,168774,10881630,피지,2016-05
2016-05-31,11048838,3736894,7311944,우루과이,2016-05
2016-05-31,10113510,1032883,9080627,니카라과,2016-05
2016-05-31,9564770,880559,8684211,수단,2016-05
2016-05-31,9316697,1310981,8005716,엘살바도르,2016-05
2016-05-31,9261871,1629459,7632412,파라과이,2016-05
2016-05-31,8982717,6697536,2285181,에티오피아,2016-05
2016-05-31,8897072,2383220,6513852,세르비아,2016-05
2016-05-31,8344240,3535806,4808434,온두라스,2016-05
2016-05-31,7999054,21228567,-13229513,뉴 칼레도니아,2016-05
2016-05-31,7879395,56121,7823274,팔레스타인 해방기구,2016-05
2016-05-31,7860308,8304600,-444292,트리니다드 토바고,2016-05
2016-05-31,7048691,1036146,6012545,코트디봐르,2016-05
2016-05-31,6373481,1960795,4412686,조지아,2016-05
2016-05-31,6243948,58917999,-52674051,브루나이,2016-05
2016-05-31,6169606,5068,6164538,말리,2016-05
2016-05-31,5635511,5483551,151960,에스토니아,2016-05
2016-05-31,5433005,150166,5282839,지부티,2016-05
2016-05-31,5096863,9589,5087274,키르기스스탄,2016-05
2016-05-31,5063377,705168,4358209,솔로몬 군도,2016-05
2016-05-31,4943453,164635,4778818,마이크로네시아,2016-05
2016-05-31,4508500,5419121,-910621,라트비아,2016-05
2016-05-31,3940547,145079,3795468,모잠비크,2016-05
2016-05-31,3839571,1495846,2343725,크로아티아,2016-05
2016-05-31,3688047,47369,3640678,보츠와나,2016-05
2016-05-31,3680340,80421,3599919,알바니아,2016-05
2016-05-31,3494551,157960,3336591,아메리칸 사모아,2016-05
2016-05-31,3340321,16122,3324199,괌,2016-05
2016-05-31,3307977,327348,2980629,마카오,2016-05
2016-05-31,3274397,145908,3128489,부르키나 파소,2016-05
2016-05-31,3153142,6186190,-3033048,마다카스카르,2016-05
2016-05-31,3053456,249275,2804181,아이티,2016-05
2016-05-31,2912222,0,2912222,아프카니스탄,2016-05
2016-05-31,2794669,29598570,-26803901,볼리비아,2016-05
2016-05-31,2485768,471182,2014586,모리셔스,2016-05
2016-05-31,2476368,168515,2307853,콩고,2016-05
2016-05-31,2326190,193419,2132771,카메룬,2016-05
2016-05-31,2196609,67474,2129135,사모아,2016-05
2016-05-31,2180235,82207,2098028,네팔,2016-05
2016-05-31,2179414,10340903,-8161489,기타국,2016-05
2016-05-31,2116899,2087159,29740,아이슬란드,2016-05
2016-05-31,2111267,0,2111267,도미니카,2016-05
2016-05-31,2086259,1573,2084686,가이아나,2016-05
2016-05-31,2008764,245878,1762886,베닝,2016-05
2016-05-31,1801972,70322364,-68520392,적도 기니,2016-05
2016-05-31,1798662,1996160,-197498,말라위,2016-05
2016-05-31,1734959,559026,1175933,짐바브웨,2016-05
2016-05-31,1733679,954,1732725,타지크,2016-05
2016-05-31,1730355,12604267,-10873912,사이프러스,2016-05
2016-05-31,1725176,6742,1718434,소말리아,2016-05
2016-05-31,1707631,41839882,-40132251,콩고민주공화국,2016-05
2016-05-31,1687157,1132,1686025,몰디브,2016-05
2016-05-31,1638990,398997,1239993,마세도니아,2016-05
2016-05-31,1579647,1741794,-162147,벨라루스,2016-05
2016-05-31,1561753,321769,1239984,자마이카,2016-05
2016-05-31,1493438,434790,1058648,쿠바,2016-05
2016-05-31,1416976,92172,1324804,북마리아나 군도,2016-05
2016-05-31,1280529,224096,1056433,세이쉘,2016-05
2016-05-31,1249444,1073,1248371,네덜란드 열도,2016-05
2016-05-31,1219240,3303,1215937,불령 리유니온 코모도 제도,2016-05
2016-05-31,1216892,0,1216892,아루바,2016-05
2016-05-31,1211034,9197,1201837,바베이도스,2016-05
2016-05-31,1125187,7221748,-6096561,룩셈부르그,2016-05
2016-05-31,1015050,415180,599870,우간다,2016-05
2016-05-31,1004164,0,1004164,버뮤다,2016-05
2016-05-31,995452,7705904,-6710452,토고,2016-05
2016-05-31,955035,3986443,-3031408,기니,2016-05
2016-05-31,861979,13995138,-13133159,잠비아,2016-05
2016-05-31,787051,0,787051,키리바티,2016-05
2016-05-31,782450,601145,181305,티모르,2016-05
2016-05-31,756383,0,756383,불령 폴리네시아,2016-05
2016-05-31,644709,1040568,-395859,시에라 리온,2016-05
2016-05-31,563838,315825,248013,몰도바,2016-05
2016-05-31,551525,72722040,-72170515,가봉,2016-05
2016-05-31,521818,60063,461755,아르메니아,2016-05
2016-05-31,508485,0,508485,마티니크,2016-05
2016-05-31,501601,3380838,-2879237,모리타니,2016-05
2016-05-31,476471,715118,-238647,리히텐슈타인,2016-05
2016-05-31,441333,17,441316,영령 캐이맨 군도,2016-05
2016-05-31,431487,0,431487,세인트 루시아,2016-05
2016-05-31,425119,817112,-391993,보스니아-헤르체고비나,2016-05
2016-05-31,420577,154260,266317,르완다,2016-05
2016-05-31,373952,60500,313452,영령 버진군도,2016-05
2016-05-31,369952,457004,-87052,나미비아,2016-05
2016-05-31,362405,0,362405,과델로프,2016-05
2016-05-31,361353,136171,225182,스와질랜드,2016-05
2016-05-31,340475,5916,334559,안티가 바부다,2016-05
2016-05-31,324191,30134,294057,벨리제,2016-05
2016-05-31,320848,79,320769,그레나다,2016-05
2016-05-31,232296,511971,-279675,바누아투,2016-05
2016-05-31,231272,2128,229144,팔라우,2016-05
2016-05-31,224411,67,224344,세인트 키츠 네비스,2016-05
2016-05-31,182627,7283,175344,부룬디,2016-05
2016-05-31,154818,319,154499,부탄,2016-05
2016-05-31,136758,322426,-185668,감비아,2016-05
2016-05-31,133798,0,133798,지브랄타,2016-05
2016-05-31,133268,7286,125982,투르크 & 카이코스 군도,2016-05
2016-05-31,119446,267477,-148031,모나코,2016-05
2016-05-31,116724,341894,-225170,수리남,2016-05
2016-05-31,104053,0,104053,챠드,2016-05
2016-05-31,102610,25296,77314,통가,2016-05
2016-05-31,87559,0,87559,불령 가이아나,2016-05
2016-05-31,83743,266370,-182627,니제르,2016-05
2016-05-31,79055,0,79055,남수단,2016-05
2016-05-31,62598,11162,51436,세인트 바르탤르미,2016-05
2016-05-31,45572,0,45572,큐라소,2016-05
2016-05-31,40659,14147,26512,중앙아프리카공화국,2016-05
2016-05-31,40467,200,40267,세인트 빈센트 그레나딘,2016-05
2016-05-31,26835,0,26835,왈라스 & 퓨투나 군도,2016-05
2016-05-31,26568,0,26568,쿡 아일랜드,2016-05
2016-05-31,25389,26,25363,카보 베르데,2016-05
2016-05-31,17237,52,17185,나우루,2016-05
2016-05-31,17171,1604,15567,상토메 프린스페,2016-05
2016-05-31,14776,0,14776,국제통화기금,2016-05
2016-05-31,8665,41551,-32886,안도라,2016-05
2016-05-31,7950,0,7950,서사하라,2016-05
2016-05-31,2757,0,2757,파로에 군도,2016-05
2016-05-31,2300,0,2300,앙귈라,2016-05
2016-05-31,1144,0,1144,세인트 마틴,2016-05
2016-05-31,306,18276,-17970,몬트세라트,2016-05
2016-05-31,280,149731,-149451,그린랜드,2016-05
2016-05-31,79,0,79,몬테네그로,2016-05
2016-05-31,15,8394,-8379,미령 버진군도,2016-05
2016-05-31,0,204166,-204166,포클랜드 군도,2016-05
2016-05-31,0,53676,-53676,토켈라우,2016-05
2016-05-31,0,425,-425,마이너 아우틀링 합중국 군도,2016-05
2016-05-31,0,590,-590,맨섬,2016-05
2016-05-31,0,35705,-35705,레소토,2016-05
2016-05-31,0,233300,-233300,기네비소,2016-05
2016-05-31,0,2794,-2794,니우에,2016-05
2016-05-31,0,2304,-2304,세인트 헬레나,2016-05
2016-05-31,0,86,-86,코스 군도,2016-05
2016-05-31,0,1123,-1123,안타티카,2016-05
2016-05-31,0,12,-12,남조지아 & 남샌드위치 군도,2016-05
2016-05-31,0,30165,-30165,코모로스,2016-05
2016-05-31,0,360,-360,크리스마스 아일랜드,2016-05
2016-06-30,10182598463,7215838801,2966759662,중국,2016-06
2016-06-30,6053158794,3834102127,2219056667,미국,2016-06
2016-06-30,3031084615,150090657,2880993958,홍콩,2016-06
2016-06-30,2668363452,963124738,1705238714,베트남,2016-06
2016-06-30,2150804229,3888941745,-1738137516,일본,2016-06
2016-06-30,1615604677,131583715,1484020962,노르웨이,2016-06
2016-06-30,1143619251,637017546,506601705,싱가포르,2016-06
2016-06-30,1073928002,2262,1073925740,마샬군도,2016-06
2016-06-30,1045558301,364398169,681160132,캐나다,2016-06
2016-06-30,1026045438,1456092458,-430047020,대만,2016-06
2016-06-30,936762371,298637759,638124612,인도,2016-06
2016-06-30,835372724,351764757,483607967,멕시코,2016-06
2016-06-30,707923485,663314554,44608931,인도네시아,2016-06
2016-06-30,612716992,71528,612645464,라이베리아,2016-06
2016-06-30,611999860,1033077273,-421077413,호주,2016-06
2016-06-30,611720462,258018489,353701973,필리핀,2016-06
2016-06-30,583131257,1690454824,-1107323567,독일,2016-06
2016-06-30,543324533,391978296,151346237,태국,2016-06
2016-06-30,526364042,570000846,-43636804,말레이시아,2016-06
2016-06-30,513082362,1270537584,-757455222,사우디아라비아,2016-06
2016-06-30,509066982,688231780,-179164798,러시아 연방,2016-06
2016-06-30,480437030,84562782,395874248,튀르키예,2016-06
2016-06-30,431581448,0,431581448,버뮤다,2016-06
2016-06-30,415365671,483969277,-68603606,아랍에미리트 연합,2016-06
2016-06-30,395378181,558582362,-163204181,영국,2016-06
2016-06-30,389582377,246711176,142871201,브라질,2016-06
2016-06-30,382002653,376659768,5342885,이란,2016-06
2016-06-30,307124532,310767538,-3643006,네덜란드,2016-06
2016-06-30,261576230,33339075,228237155,슬로바키아,2016-06
2016-06-30,258928702,454805758,-195877056,이탈리아,2016-06
2016-06-30,252805378,55283005,197522373,폴란드,2016-06
2016-06-30,219570264,443065329,-223495065,프랑스,2016-06
2016-06-30,184927580,49340546,135587034,체코공화국,2016-06
2016-06-30,183967615,150674141,33293474,스페인,2016-06
2016-06-30,178195980,100343695,77852285,벨기에,2016-06
2016-06-30,152532959,301249467,-148716508,칠레,2016-06
2016-06-30,149444724,5205654,144239070,이집트,2016-06
2016-06-30,139927743,664,139927079,바하마,2016-06
2016-06-30,138105214,644825749,-506720535,쿠웨이트,2016-06
2016-06-30,125840487,106170148,19670339,뉴질랜드,2016-06
2016-06-30,122379401,8020171,114359230,슬로베니아,2016-06
2016-06-30,105333926,5360278,99973648,그리스,2016-06
2016-06-30,102908992,58036018,44872974,헝가리,2016-06
2016-06-30,98677224,131108026,-32430802,페루,2016-06
2016-06-30,98553159,17566131,80987028,방글라데시,2016-06
2016-06-30,96337006,35453156,60883850,파나마,2016-06
2016-06-30,92449403,107391905,-14942502,남아프리카공화국,2016-06
2016-06-30,91505466,90774138,731328,이스라엘,2016-06
2016-06-30,86158968,3783978,82374990,몰타,2016-06
2016-06-30,79369527,46274148,33095379,나이지리아,2016-06
2016-06-30,75312900,163255,75149645,알제리,2016-06
2016-06-30,71928925,20074447,51854478,콜롬비아,2016-06
2016-06-30,71279416,539505263,-468225847,이라크,2016-06
2016-06-30,67295577,90778004,-23482427,오스트리아,2016-06
2016-06-30,63500549,1904163,61596386,우즈베키스탄,2016-06
2016-06-30,61196857,123935627,-62738770,아르헨티나,2016-06
2016-06-30,60919457,18866057,42053400,모로코,2016-06
2016-06-30,60822981,821310884,-760487903,카타르,2016-06
2016-06-30,59826852,3104320,56722532,베네주엘라,2016-06
2016-06-30,59176301,31270908,27905393,파키스탄,2016-06
2016-06-30,58395630,2104,58393526,투르크멘,2016-06
2016-06-30,57416421,169749678,-112333257,오만,2016-06
2016-06-30,56115007,202686655,-146571648,스위스,2016-06
2016-06-30,55581891,118467328,-62885437,스웨덴,2016-06
2016-06-30,53788180,45299512,8488668,루마니아,2016-06
2016-06-30,50904274,15055253,35849021,미얀마,2016-06
2016-06-30,50785876,53622314,-2836438,앙골라,2016-06
2016-06-30,50416886,50,50416836,맨섬,2016-06
2016-06-30,48584462,99516172,-50931710,아일랜드,2016-06
2016-06-30,46989261,4752390,42236871,요르단,2016-06
2016-06-30,44053896,21338319,22715577,캄보디아,2016-06
2016-06-30,42671288,18167478,24503810,포루투갈,2016-06
2016-06-30,42257488,3096067,39161421,토고,2016-06
2016-06-30,40511040,57260935,-16749895,핀란드,2016-06
2016-06-30,39511176,7705790,31805386,에쿠아도르,2016-06
2016-06-30,33409061,12595669,20813392,세네갈,2016-06
2016-06-30,30023376,5833807,24189569,리투아니아,2016-06
2016-06-30,29161930,75065911,-45903981,덴마크,2016-06
2016-06-30,29113735,30585424,-1471689,리비아,2016-06
2016-06-30,28169512,13262080,14907432,푸에르토리코,2016-06
2016-06-30,25952827,11991029,13961798,카자흐스탄,2016-06
2016-06-30,25853263,6664233,19189030,도미니카 공화국,2016-06
2016-06-30,22635758,6127639,16508119,스리랑카,2016-06
2016-06-30,22358791,7415555,14943236,과테말라,2016-06
2016-06-30,21851153,16571752,5279401,코스타리카,2016-06
2016-06-30,21842430,660763,21181667,몽골,2016-06
2016-06-30,21743078,2981498,18761580,가나,2016-06
2016-06-30,21049148,20028155,1020993,우크라이나,2016-06
2016-06-30,19770857,753142,19017715,크로아티아,2016-06
2016-06-30,19553378,2049635,17503743,레바논,2016-06
2016-06-30,18739800,492606,18247194,시리아,2016-06
2016-06-30,16956812,220262,16736550,피지,2016-06
2016-06-30,16205255,3239852,12965403,튀니지,2016-06
2016-06-30,15340778,3558782,11781996,탄자니아,2016-06
2016-06-30,15302971,0,15302971,불령 폴리네시아,2016-06
2016-06-30,15255613,259,15255354,아제르바이잔,2016-06
2016-06-30,14943004,2851473,12091531,케냐,2016-06
2016-06-30,13098942,21294232,-8195290,바레인,2016-06
2016-06-30,13087711,5892325,7195386,우루과이,2016-06
2016-06-30,12861544,2686387,10175157,라오스,2016-06
2016-06-30,12846816,501190,12345626,니카라과,2016-06
2016-06-30,11805414,975453,10829961,엘살바도르,2016-06
2016-06-30,11484942,12695724,-1210782,온두라스,2016-06
2016-06-30,11264779,1377975,9886804,수단,2016-06
2016-06-30,11206152,584790,10621362,파라과이,2016-06
2016-06-30,10699124,6380989,4318135,불가리아,2016-06
2016-06-30,9108690,68357,9040333,마이크로네시아,2016-06
2016-06-30,8547860,3270507,5277353,트리니다드 토바고,2016-06
2016-06-30,7877009,28196330,-20319321,뉴 칼레도니아,2016-06
2016-06-30,7535550,1455619,6079931,예맨,2016-06
2016-06-30,7492409,1571843,5920566,세르비아,2016-06
2016-06-30,6937124,453349,6483775,코트디봐르,2016-06
2016-06-30,6776332,93252,6683080,보츠와나,2016-06
2016-06-30,6618934,1335049,5283885,조지아,2016-06
2016-06-30,6595770,116705,6479065,지부티,2016-06
2016-06-30,6477561,319745,6157816,모잠비크,2016-06
2016-06-30,6357813,5787957,569856,에티오피아,2016-06
2016-06-30,6356122,37266,6318856,팔레스타인 해방기구,2016-06
2016-06-30,6342058,30295850,-23953792,브루나이,2016-06
2016-06-30,5752284,59654,5692630,영령 버진군도,2016-06
2016-06-30,5495731,1955,5493776,아프카니스탄,2016-06
2016-06-30,5338983,48166347,-42827364,볼리비아,2016-06
2016-06-30,5288806,8244415,-2955609,에스토니아,2016-06
2016-06-30,4998347,15421573,-10423226,라트비아,2016-06
2016-06-30,4831023,14490,4816533,키르기스스탄,2016-06
2016-06-30,4823096,59028,4764068,쿠바,2016-06
2016-06-30,4762678,206202,4556476,아이티,2016-06
2016-06-30,4434710,22626,4412084,괌,2016-06
2016-06-30,4243194,39109270,-34866076,콩고민주공화국,2016-06
2016-06-30,3851644,124722,3726922,마카오,2016-06
2016-06-30,3350998,137706,3213292,알바니아,2016-06
2016-06-30,3131821,81991,3049830,사모아,2016-06
2016-06-30,3101030,141042,2959988,카메룬,2016-06
2016-06-30,2915928,76122,2839806,가이아나,2016-06
2016-06-30,2776629,736064,2040565,콩고,2016-06
2016-06-30,2633091,369066,2264025,모리셔스,2016-06
2016-06-30,2558647,3486477,-927830,벨라루스,2016-06
2016-06-30,2532856,1959148,573708,베닝,2016-06
2016-06-30,2521144,155256,2365888,르완다,2016-06
2016-06-30,2335920,6002529,-3666609,마다카스카르,2016-06
2016-06-30,2149926,116861,2033065,짐바브웨,2016-06
2016-06-30,2123856,30037800,-27913944,파푸아 뉴기니,2016-06
2016-06-30,2120732,95836,2024896,네팔,2016-06
2016-06-30,2113326,3156751,-1043425,기니,2016-06
2016-06-30,2042350,2940984,-898634,아이슬란드,2016-06
2016-06-30,2033728,367721,1666007,사이프러스,2016-06
2016-06-30,2022026,18009309,-15987283,기타국,2016-06
2016-06-30,1904585,16468993,-14564408,잠비아,2016-06
2016-06-30,1679219,123905,1555314,세이쉘,2016-06
2016-06-30,1550702,389516,1161186,자마이카,2016-06
2016-06-30,1543803,937,1542866,아루바,2016-06
2016-06-30,1495765,59928939,-58433174,적도 기니,2016-06
2016-06-30,1463380,59895,1403485,북마리아나 군도,2016-06
2016-06-30,1453280,648582,804698,우간다,2016-06
2016-06-30,1359660,1312,1358348,네덜란드 열도,2016-06
2016-06-30,1302556,299885,1002671,부르키나 파소,2016-06
2016-06-30,1193602,224233,969369,니제르,2016-06
2016-06-30,1130499,6701771,-5571272,룩셈부르그,2016-06
2016-06-30,1070614,302840,767774,아르메니아,2016-06
2016-06-30,1041295,47,1041248,타지크,2016-06
2016-06-30,904376,490073,414303,몰도바,2016-06
2016-06-30,892273,0,892273,불령 리유니온 코모도 제도,2016-06
2016-06-30,891228,33527026,-32635798,가봉,2016-06
2016-06-30,869478,0,869478,마티니크,2016-06
2016-06-30,842917,614798,228119,리히텐슈타인,2016-06
2016-06-30,620693,40452,580241,바베이도스,2016-06
2016-06-30,607929,93048,514881,스와질랜드,2016-06
2016-06-30,562600,5739,556861,말리,2016-06
2016-06-30,546585,0,546585,안티가 바부다,2016-06
2016-06-30,510350,1007180,-496830,말라위,2016-06
2016-06-30,464696,0,464696,세인트 루시아,2016-06
2016-06-30,461602,405383,56219,수리남,2016-06
2016-06-30,438083,922130,-484047,바누아투,2016-06
2016-06-30,431465,47123,384342,몰디브,2016-06
2016-06-30,416812,119983,296829,아메리칸 사모아,2016-06
2016-06-30,380708,654146,-273438,마세도니아,2016-06
2016-06-30,358091,353,357738,부탄,2016-06
2016-06-30,344157,115145,229012,티모르,2016-06
2016-06-30,335219,0,335219,도미니카,2016-06
2016-06-30,312827,0,312827,팔라우,2016-06
2016-06-30,299684,200662,99022,솔로몬 군도,2016-06
2016-06-30,292242,55243,236999,소말리아,2016-06
2016-06-30,278925,23,278902,세인트 키츠 네비스,2016-06
2016-06-30,269099,389,268710,키리바티,2016-06
2016-06-30,233737,0,233737,그레나다,2016-06
2016-06-30,230286,185282,45004,나미비아,2016-06
2016-06-30,226931,0,226931,과델로프,2016-06
2016-06-30,221152,741414,-520262,보스니아-헤르체고비나,2016-06
2016-06-30,210661,703,209958,몬테네그로,2016-06
2016-06-30,204376,0,204376,카보 베르데,2016-06
2016-06-30,203619,9010,194609,영령 캐이맨 군도,2016-06
2016-06-30,190808,61813,128995,감비아,2016-06
2016-06-30,181896,1488621,-1306725,모리타니,2016-06
2016-06-30,159973,0,159973,챠드,2016-06
2016-06-30,158680,0,158680,불령 가이아나,2016-06
2016-06-30,136882,13729,123153,통가,2016-06
2016-06-30,120392,0,120392,벨리제,2016-06
2016-06-30,108387,74,108313,투르크 & 카이코스 군도,2016-06
2016-06-30,104351,0,104351,에리트리아,2016-06
2016-06-30,81039,513,80526,세인트 빈센트 그레나딘,2016-06
2016-06-30,78897,191,78706,지브랄타,2016-06
2016-06-30,78832,0,78832,국제통화기금,2016-06
2016-06-30,45822,410461,-364639,중앙아프리카공화국,2016-06
2016-06-30,34477,0,34477,남수단,2016-06
2016-06-30,28452,0,28452,투발루,2016-06
2016-06-30,27249,66125,-38876,쿡 아일랜드,2016-06
2016-06-30,26756,1024415,-997659,시에라 리온,2016-06
2016-06-30,25910,62235,-36325,산마리노,2016-06
2016-06-30,17162,38,17124,부룬디,2016-06
2016-06-30,16828,37009,-20181,안도라,2016-06
2016-06-30,15340,0,15340,메요트,2016-06
2016-06-30,14190,14338,-148,나우루,2016-06
2016-06-30,11058,427770,-416712,모나코,2016-06
2016-06-30,7884,30,7854,레소토,2016-06
2016-06-30,4567,0,4567,큐라소,2016-06
2016-06-30,3475,0,3475,세인트 헬레나,2016-06
2016-06-30,1740,3199,-1459,토켈라우,2016-06
2016-06-30,715,332,383,파로에 군도,2016-06
2016-06-30,362,15525,-15163,미령 버진군도,2016-06
2016-06-30,360,0,360,세인트 마틴,2016-06
2016-06-30,338,76042,-75704,그린랜드,2016-06
2016-06-30,301,396,-95,앙귈라,2016-06
2016-06-30,91,27866,-27775,코모로스,2016-06
2016-06-30,2,146744,-146742,기네비소,2016-06
2016-06-30,0,161,-161,건지,2016-06
2016-06-30,0,830,-830,코스 군도,2016-06
2016-06-30,0,316,-316,영령 인도양,2016-06
2016-06-30,0,966,-966,니우에,2016-06
2016-06-30,0,86489,-86489,상토메 프린스페,2016-06
2016-07-31,10133979815,7006369855,3127609960,중국,2016-07
2016-07-31,5290588215,3452904885,1837683330,미국,2016-07
2016-07-31,2817810509,979834282,1837976227,베트남,2016-07
2016-07-31,2774938756,140526962,2634411794,홍콩,2016-07
2016-07-31,2067444554,3977492457,-1910047903,일본,2016-07
2016-07-31,973516861,1398263340,-424746479,대만,2016-07
2016-07-31,963683280,535068168,428615112,싱가포르,2016-07
2016-07-31,905206937,268062261,637144676,멕시코,2016-07
2016-07-31,881134786,380434453,500700333,인도,2016-07
2016-07-31,730531868,1128181645,-397649777,호주,2016-07
2016-07-31,655768033,237701758,418066275,필리핀,2016-07
2016-07-31,612236438,610501052,1735386,말레이시아,2016-07
2016-07-31,612056725,608202288,3854437,인도네시아,2016-07
2016-07-31,602381058,1416736681,-814355623,독일,2016-07
2016-07-31,596981195,362370229,234610966,태국,2016-07
2016-07-31,481245393,1380,481244013,마샬군도,2016-07
2016-07-31,475884488,739098727,-263214239,러시아 연방,2016-07
2016-07-31,455021160,48849543,406171617,튀르키예,2016-07
2016-07-31,415485256,259766653,155718603,브라질,2016-07
2016-07-31,414390690,323321488,91069202,네덜란드,2016-07
2016-07-31,407374811,351855105,55519706,영국,2016-07
2016-07-31,405115503,1576219845,-1171104342,사우디아라비아,2016-07
2016-07-31,381733135,664011735,-282278600,아랍에미리트 연합,2016-07
2016-07-31,375916692,424246380,-48329688,이란,2016-07
2016-07-31,356074767,16480,356058287,라이베리아,2016-07
2016-07-31,348559235,360659995,-12100760,캐나다,2016-07
2016-07-31,256621300,17296550,239324750,슬로바키아,2016-07
2016-07-31,256413782,15932736,240481046,그리스,2016-07
2016-07-31,250913026,35645290,215267736,폴란드,2016-07
2016-07-31,246637042,442369924,-195732882,이탈리아,2016-07
2016-07-31,210483130,172551884,37931246,스페인,2016-07
2016-07-31,193596985,0,193596985,바하마,2016-07
2016-07-31,188988066,98675616,90312450,벨기에,2016-07
2016-07-31,178453747,56749056,121704691,체코공화국,2016-07
2016-07-31,174617942,413178670,-238560728,프랑스,2016-07
2016-07-31,162459520,108929461,53530059,노르웨이,2016-07
2016-07-31,151931688,6837646,145094042,슬로베니아,2016-07
2016-07-31,151266478,340334083,-189067605,칠레,2016-07
2016-07-31,139769247,3772634,135996613,이집트,2016-07
2016-07-31,132386815,810480760,-678093945,쿠웨이트,2016-07
2016-07-31,129399973,1328642,128071331,베네주엘라,2016-07
2016-07-31,129273131,102886748,26386383,파나마,2016-07
2016-07-31,117323327,80675139,36648188,뉴질랜드,2016-07
2016-07-31,112189488,48088126,64101362,페루,2016-07
2016-07-31,101600604,418022892,-316422288,이라크,2016-07
2016-07-31,95278093,9089407,86188686,세네갈,2016-07
2016-07-31,90489685,23786346,66703339,방글라데시,2016-07
2016-07-31,87108607,898714,86209893,우즈베키스탄,2016-07
2016-07-31,85771698,51402,85720296,알제리,2016-07
2016-07-31,79528420,124099119,-44570699,남아프리카공화국,2016-07
2016-07-31,78503973,35064271,43439702,콜롬비아,2016-07
2016-07-31,77476834,61378189,16098645,이스라엘,2016-07
2016-07-31,76925712,176433177,-99507465,스웨덴,2016-07
2016-07-31,75421874,4448306,70973568,몰타,2016-07
2016-07-31,70076269,9297382,60778887,카자흐스탄,2016-07
2016-07-31,69166237,44500058,24666179,헝가리,2016-07
2016-07-31,67556423,27780093,39776330,파키스탄,2016-07
2016-07-31,65935200,98577852,-32642652,오스트리아,2016-07
2016-07-31,62008715,47325363,14683352,루마니아,2016-07
2016-07-31,61037289,10312549,50724740,모로코,2016-07
2016-07-31,60048921,20550053,39498868,앙골라,2016-07
2016-07-31,50231109,193486240,-143255131,스위스,2016-07
2016-07-31,46694880,19397258,27297622,캄보디아,2016-07
2016-07-31,45813661,107887455,-62073794,아르헨티나,2016-07
2016-07-31,45143853,8286149,36857704,에쿠아도르,2016-07
2016-07-31,44172092,122038522,-77866430,아일랜드,2016-07
2016-07-31,42768316,31951984,10816332,미얀마,2016-07
2016-07-31,41328338,30048703,11279635,나이지리아,2016-07
2016-07-31,39029146,4344580,34684566,요르단,2016-07
2016-07-31,38701662,189252909,-150551247,오만,2016-07
2016-07-31,36318801,1589,36317212,투르크멘,2016-07
2016-07-31,36134298,854106629,-817972331,카타르,2016-07
2016-07-31,34990968,2493933,32497035,토고,2016-07
2016-07-31,31891389,67583362,-35691973,덴마크,2016-07
2016-07-31,31291994,15897414,15394580,포루투갈,2016-07
2016-07-31,30176368,5526303,24650065,리투아니아,2016-07
2016-07-31,29541907,1060142,28481765,크로아티아,2016-07
2016-07-31,28537510,92422296,-63884786,핀란드,2016-07
2016-07-31,27489058,3368921,24120137,리비아,2016-07
2016-07-31,25934417,10931682,15002735,도미니카 공화국,2016-07
2016-07-31,20314483,142082,20172401,괌,2016-07
2016-07-31,20025514,8698475,11327039,스리랑카,2016-07
2016-07-31,19898873,27086148,-7187275,푸에르토리코,2016-07
2016-07-31,19791589,19853549,-61960,우크라이나,2016-07
2016-07-31,17993797,23365242,-5371445,과테말라,2016-07
2016-07-31,17883309,1447908,16435401,몽골,2016-07
2016-07-31,17471405,3021446,14449959,파푸아 뉴기니,2016-07
2016-07-31,16166123,2738392,13427731,가나,2016-07
2016-07-31,15858602,1461601,14397001,레바논,2016-07
2016-07-31,15264006,5856927,9407079,탄자니아,2016-07
2016-07-31,14024539,14061445,-36906,코스타리카,2016-07
2016-07-31,13179164,3092349,10086815,튀니지,2016-07
2016-07-31,12398692,130,12398562,불령 폴리네시아,2016-07
2016-07-31,12224403,37028624,-24804221,케냐,2016-07
2016-07-31,12203567,60770,12142797,팔레스타인 해방기구,2016-07
2016-07-31,11983285,10360142,1623143,불가리아,2016-07
2016-07-31,11840565,1052228,10788337,예맨,2016-07
2016-07-31,11775479,1177206,10598273,엘살바도르,2016-07
2016-07-31,11105895,2957769,8148126,온두라스,2016-07
2016-07-31,10342160,16532550,-6190390,파라과이,2016-07
2016-07-31,10238403,1148025,9090378,니카라과,2016-07
2016-07-31,9985974,5202722,4783252,에티오피아,2016-07
2016-07-31,9947975,362589,9585386,시리아,2016-07
2016-07-31,9582565,11447761,-1865196,바레인,2016-07
2016-07-31,9440044,247351,9192693,피지,2016-07
2016-07-31,9374981,0,9374981,영령 버진군도,2016-07
2016-07-31,9131706,1235663,7896043,조지아,2016-07
2016-07-31,8589904,1230130,7359774,수단,2016-07
2016-07-31,8272464,6820866,1451598,우루과이,2016-07
2016-07-31,7936446,8222088,-285642,트리니다드 토바고,2016-07
2016-07-31,7891907,2676267,5215640,세르비아,2016-07
2016-07-31,7870070,0,7870070,지부티,2016-07
2016-07-31,6637113,57111,6580002,보츠와나,2016-07
2016-07-31,5785585,4830172,955413,라트비아,2016-07
2016-07-31,5675065,10028254,-4353189,기타국,2016-07
2016-07-31,5354097,47646,5306451,키르기스스탄,2016-07
2016-07-31,5009350,833783,4175567,라오스,2016-07
2016-07-31,4981597,4149177,832420,에스토니아,2016-07
2016-07-31,4686836,1190952,3495884,코트디봐르,2016-07
2016-07-31,4622265,56980,4565285,마이크로네시아,2016-07
2016-07-31,4600121,90,4600031,아제르바이잔,2016-07
2016-07-31,4372054,21729315,-17357261,브루나이,2016-07
2016-07-31,4294088,38515041,-34220953,볼리비아,2016-07
2016-07-31,4084293,290465,3793828,아이티,2016-07
2016-07-31,3909182,97476,3811706,쿠바,2016-07
2016-07-31,3750573,2873353,877220,마다카스카르,2016-07
2016-07-31,3043766,2705391,338375,아이슬란드,2016-07
2016-07-31,2730009,133492,2596517,사모아,2016-07
2016-07-31,2673764,26927,2646837,가이아나,2016-07
2016-07-31,2630935,2248409,382526,기니,2016-07
2016-07-31,2574096,424478,2149618,콩고,2016-07
2016-07-31,2515135,2496034,19101,벨라루스,2016-07
2016-07-31,2445212,8445517,-6000305,베닝,2016-07
2016-07-31,2393992,95750,2298242,마카오,2016-07
2016-07-31,2387268,339785,2047483,사이프러스,2016-07
2016-07-31,2208086,363948,1844138,모잠비크,2016-07
2016-07-31,2182910,542825,1640085,모리셔스,2016-07
2016-07-31,2166436,39,2166397,키리바티,2016-07
2016-07-31,2145201,4321,2140880,아프카니스탄,2016-07
2016-07-31,2128584,200154,1928430,마세도니아,2016-07
2016-07-31,1916215,17342679,-15426464,뉴 칼레도니아,2016-07
2016-07-31,1912848,12716,1900132,네덜란드 열도,2016-07
2016-07-31,1912595,0,1912595,타지크,2016-07
2016-07-31,1903786,246995,1656791,부르키나 파소,2016-07
2016-07-31,1903301,8097,1895204,북마리아나 군도,2016-07
2016-07-31,1869185,141757,1727428,짐바브웨,2016-07
2016-07-31,1771960,138256,1633704,네팔,2016-07
2016-07-31,1599546,32239284,-30639738,잠비아,2016-07
2016-07-31,1473570,397,1473173,아루바,2016-07
2016-07-31,1404792,95,1404697,불령 리유니온 코모도 제도,2016-07
2016-07-31,1235370,416088,819282,자마이카,2016-07
2016-07-31,1152180,455865,696315,카메룬,2016-07
2016-07-31,1152088,370662,781426,말라위,2016-07
2016-07-31,1080936,298087,782849,세이쉘,2016-07
2016-07-31,1001408,0,1001408,마티니크,2016-07
2016-07-31,941655,410,941245,과델로프,2016-07
2016-07-31,914154,78408,835746,바베이도스,2016-07
2016-07-31,913040,5700750,-4787710,룩셈부르그,2016-07
2016-07-31,823445,13234,810211,도미니카,2016-07
2016-07-31,790463,559998,230465,리히텐슈타인,2016-07
2016-07-31,763011,1526505,-763494,보스니아-헤르체고비나,2016-07
2016-07-31,736877,0,736877,말리,2016-07
2016-07-31,721267,107907,613360,아메리칸 사모아,2016-07
2016-07-31,675653,31059403,-30383750,가봉,2016-07
2016-07-31,662092,27159,634933,영령 캐이맨 군도,2016-07
2016-07-31,631976,363,631613,몰디브,2016-07
2016-07-31,625387,42821738,-42196351,콩고민주공화국,2016-07
2016-07-31,570468,1824191,-1253723,알바니아,2016-07
2016-07-31,553483,1130384,-576901,우간다,2016-07
2016-07-31,478410,6175,472235,팔라우,2016-07
2016-07-31,461313,1528,459785,버뮤다,2016-07
2016-07-31,461204,0,461204,소말리아,2016-07
2016-07-31,441440,338458,102982,몰도바,2016-07
2016-07-31,392726,68444,324282,바누아투,2016-07
2016-07-31,390580,17820,372760,벨리제,2016-07
2016-07-31,379292,1566,377726,티모르,2016-07
2016-07-31,375252,160821,214431,감비아,2016-07
2016-07-31,357977,512735,-154758,아르메니아,2016-07
2016-07-31,345125,88,345037,부룬디,2016-07
2016-07-31,317381,0,317381,안티가 바부다,2016-07
2016-07-31,317223,1387638,-1070415,모리타니,2016-07
2016-07-31,301359,181,301178,지브랄타,2016-07
2016-07-31,295174,0,295174,부탄,2016-07
2016-07-31,273773,1252,272521,세인트 키츠 네비스,2016-07
2016-07-31,270080,46793,223287,수리남,2016-07
2016-07-31,257666,3821092,-3563426,솔로몬 군도,2016-07
2016-07-31,243129,2762,240367,몬테네그로,2016-07
2016-07-31,224147,0,224147,세인트 루시아,2016-07
2016-07-31,208414,24911380,-24702966,적도 기니,2016-07
2016-07-31,175338,65706,109632,르완다,2016-07
2016-07-31,139908,177,139731,그레나다,2016-07
2016-07-31,130443,0,130443,국제통화기금,2016-07
2016-07-31,111222,882575,-771353,시에라 리온,2016-07
2016-07-31,94704,1192075,-1097371,나미비아,2016-07
2016-07-31,93734,28497,65237,중앙아프리카공화국,2016-07
2016-07-31,86020,0,86020,불령 가이아나,2016-07
2016-07-31,85982,0,85982,큐라소,2016-07
2016-07-31,65486,1461,64025,투르크 & 카이코스 군도,2016-07
2016-07-31,65061,24815,40246,나우루,2016-07
2016-07-31,63989,416594,-352605,스와질랜드,2016-07
2016-07-31,47404,0,47404,세인트 마틴,2016-07
2016-07-31,47350,0,47350,메요트,2016-07
2016-07-31,40728,0,40728,세인트 빈센트 그레나딘,2016-07
2016-07-31,29602,0,29602,챠드,2016-07
2016-07-31,24217,0,24217,상토메 프린스페,2016-07
2016-07-31,23559,26337,-2778,코모로스,2016-07
2016-07-31,16250,56304,-40054,기네비소,2016-07
2016-07-31,13167,0,13167,카보 베르데,2016-07
2016-07-31,11880,17,11863,산마리노,2016-07
2016-07-31,8725,453,8272,니제르,2016-07
2016-07-31,4300,0,4300,앙귈라,2016-07
2016-07-31,3739,276758,-273019,모나코,2016-07
2016-07-31,3512,51414,-47902,통가,2016-07
2016-07-31,2367,14168,-11801,몬트세라트,2016-07
2016-07-31,1250,4068,-2818,토켈라우,2016-07
2016-07-31,495,1528,-1033,안도라,2016-07
2016-07-31,430,0,430,에리트리아,2016-07
2016-07-31,167,0,167,포클랜드 군도,2016-07
2016-07-31,98,576767,-576669,파로에 군도,2016-07
2016-07-31,0,805529,-805529,쿡 아일랜드,2016-07
2016-07-31,0,2213,-2213,코스 군도,2016-07
2016-07-31,0,1023,-1023,세인트 바르탤르미,2016-07
2016-07-31,0,45029,-45029,니우에,2016-07
2016-07-31,0,33,-33,안타티카,2016-07
2016-07-31,0,45002,-45002,그린랜드,2016-07
2016-07-31,0,5925,-5925,미령 버진군도,2016-07
2016-07-31,0,640,-640,세인트 헬레나,2016-07
2016-07-31,0,224,-224,크리스마스 아일랜드,2016-07
2016-07-31,0,29199,-29199,남조지아 & 남샌드위치 군도,2016-07
2016-07-31,0,43,-43,레소토,2016-07
2016-08-31,10304261781,7376119211,2928142570,중국,2016-08
2016-08-31,4818513003,3642083992,1176429011,미국,2016-08
2016-08-31,3230570357,133755753,3096814604,홍콩,2016-08
2016-08-31,2750599586,1262938597,1487660989,베트남,2016-08
2016-08-31,2010573951,4163665219,-2153091268,일본,2016-08
2016-08-31,1159332728,1639129,1157693599,콩고,2016-08
2016-08-31,1008756958,1515044203,-506287245,대만,2016-08
2016-08-31,960680433,497258634,463421799,싱가포르,2016-08
2016-08-31,922838365,279680102,643158263,멕시코,2016-08
2016-08-31,865148849,374692414,490456435,인도,2016-08
2016-08-31,649112630,588035137,61077493,말레이시아,2016-08
2016-08-31,588006486,431374647,156631839,태국,2016-08
2016-08-31,564839762,261629400,303210362,필리핀,2016-08
2016-08-31,481626003,727401149,-245775146,인도네시아,2016-08
2016-08-31,476711781,1759030695,-1282318914,독일,2016-08
2016-08-31,464109492,1242459151,-778349659,호주,2016-08
2016-08-31,452931420,83898,452847522,라이베리아,2016-08
2016-08-31,432173260,1406324485,-974151225,사우디아라비아,2016-08
2016-08-31,409924865,86090482,323834383,튀르키예,2016-08
2016-08-31,388288626,762083475,-373794849,러시아 연방,2016-08
2016-08-31,381190337,1520,381188817,마샬군도,2016-08
2016-08-31,380271454,253495899,126775555,브라질,2016-08
2016-08-31,329588382,732648025,-403059643,아랍에미리트 연합,2016-08
2016-08-31,317842593,392619950,-74777357,이란,2016-08
2016-08-31,299264220,318395823,-19131603,캐나다,2016-08
2016-08-31,298646613,301959837,-3313224,영국,2016-08
2016-08-31,288018870,127706876,160311994,노르웨이,2016-08
2016-08-31,251809599,46259467,205550132,폴란드,2016-08
2016-08-31,246856815,490008385,-243151570,이탈리아,2016-08
2016-08-31,239686936,635910796,-396223860,네덜란드,2016-08
2016-08-31,233441877,15644006,217797871,슬로바키아,2016-08
2016-08-31,182127438,142560835,39566603,스페인,2016-08
2016-08-31,167271101,621714561,-454443460,쿠웨이트,2016-08
2016-08-31,160459346,456445947,-295986601,프랑스,2016-08
2016-08-31,149439756,159023,149280733,사이프러스,2016-08
2016-08-31,145650634,44916643,100733991,체코공화국,2016-08
2016-08-31,140761067,2214100,138546967,파나마,2016-08
2016-08-31,139663484,84077762,55585722,벨기에,2016-08
2016-08-31,129273071,4509780,124763291,이집트,2016-08
2016-08-31,118202954,7052942,111150012,슬로베니아,2016-08
2016-08-31,106080958,402343007,-296262049,이라크,2016-08
2016-08-31,106067039,57369063,48697976,이스라엘,2016-08
2016-08-31,104093083,213372324,-109279241,페루,2016-08
2016-08-31,100028956,267562434,-167533478,칠레,2016-08
2016-08-31,88386170,10243204,78142966,그리스,2016-08
2016-08-31,84730319,104709940,-19979621,뉴질랜드,2016-08
2016-08-31,75920826,25044427,50876399,방글라데시,2016-08
2016-08-31,75887677,96770852,-20883175,남아프리카공화국,2016-08
2016-08-31,74237450,44411345,29826105,헝가리,2016-08
2016-08-31,72821246,101330538,-28509292,오스트리아,2016-08
2016-08-31,68429588,116268956,-47839368,스웨덴,2016-08
2016-08-31,66386134,18576764,47809370,파키스탄,2016-08
2016-08-31,59211612,1395038,57816574,우즈베키스탄,2016-08
2016-08-31,58940762,44462366,14478396,콜롬비아,2016-08
2016-08-31,56129831,84608181,-28478350,아르헨티나,2016-08
2016-08-31,55923920,190867198,-134943278,아일랜드,2016-08
2016-08-31,52927276,23566218,29361058,포루투갈,2016-08
2016-08-31,50724874,4694172,46030702,요르단,2016-08
2016-08-31,50173915,490315,49683600,크로아티아,2016-08
2016-08-31,48785877,65253,48720624,앙골라,2016-08
2016-08-31,48682805,25723481,22959324,캄보디아,2016-08
2016-08-31,43426953,14331711,29095242,알제리,2016-08
2016-08-31,42252450,684389172,-642136722,카타르,2016-08
2016-08-31,40907930,206213669,-165305739,스위스,2016-08
2016-08-31,40791346,12418422,28372924,에쿠아도르,2016-08
2016-08-31,40518716,38104021,2414695,루마니아,2016-08
2016-08-31,38639058,3357160,35281898,토고,2016-08
2016-08-31,36176834,17892755,18284079,나이지리아,2016-08
2016-08-31,34746367,56531862,-21785495,미얀마,2016-08
2016-08-31,31459303,9226820,22232483,과테말라,2016-08
2016-08-31,28705333,200370548,-171665215,오만,2016-08
2016-08-31,28618875,1345,28617530,투르크멘,2016-08
2016-08-31,28548778,65716251,-37167473,핀란드,2016-08
2016-08-31,28308641,54079798,-25771157,카자흐스탄,2016-08
2016-08-31,28180485,198257,27982228,피지,2016-08
2016-08-31,27699470,5770951,21928519,리투아니아,2016-08
2016-08-31,27511066,58075189,-30564123,덴마크,2016-08
2016-08-31,26014180,11845616,14168564,모로코,2016-08
2016-08-31,25335564,8477855,16857709,스리랑카,2016-08
2016-08-31,22389440,8200056,14189384,도미니카 공화국,2016-08
2016-08-31,19049202,900786,18148416,몽골,2016-08
2016-08-31,17260099,40478485,-23218386,우크라이나,2016-08
2016-08-31,16706690,14174201,2532489,코스타리카,2016-08
2016-08-31,15701336,44183266,-28481930,케냐,2016-08
2016-08-31,15628456,4719486,10908970,가나,2016-08
2016-08-31,15449840,1633783,13816057,레바논,2016-08
2016-08-31,14954271,1779626,13174645,조지아,2016-08
2016-08-31,13988646,27214875,-13226229,리비아,2016-08
2016-08-31,13248784,14896163,-1647379,뉴 칼레도니아,2016-08
2016-08-31,11952828,1309520,10643308,수단,2016-08
2016-08-31,11906706,2995016,8911690,베네주엘라,2016-08
2016-08-31,11838912,1152421,10686491,니카라과,2016-08
2016-08-31,11258760,3775139,7483621,튀니지,2016-08
2016-08-31,10460906,9523748,937158,불가리아,2016-08
2016-08-31,10404673,1170443,9234230,라오스,2016-08
2016-08-31,9937027,15801246,-5864219,푸에르토리코,2016-08
2016-08-31,9455817,90852,9364965,시리아,2016-08
2016-08-31,9366527,16663437,-7296910,바레인,2016-08
2016-08-31,8826741,90665,8736076,지부티,2016-08
2016-08-31,8664199,2645693,6018506,세르비아,2016-08
2016-08-31,8183628,1527818,6655810,엘살바도르,2016-08
2016-08-31,8072061,2776680,5295381,온두라스,2016-08
2016-08-31,7943019,6615,7936404,아제르바이잔,2016-08
2016-08-31,7391149,981829,6409320,예맨,2016-08
2016-08-31,7034497,20144383,-13109886,파라과이,2016-08
2016-08-31,6889682,6937859,-48177,우루과이,2016-08
2016-08-31,5965559,308724,5656835,팔레스타인 해방기구,2016-08
2016-08-31,5931122,792902,5138220,우간다,2016-08
2016-08-31,5914053,8243701,-2329648,에티오피아,2016-08
2016-08-31,5905903,10346341,-4440438,트리니다드 토바고,2016-08
2016-08-31,5480689,77215,5403474,키르기스스탄,2016-08
2016-08-31,5432583,252356,5180227,탄자니아,2016-08
2016-08-31,4910990,4997750,-86760,라트비아,2016-08
2016-08-31,4856737,1953701,2903036,코트디봐르,2016-08
2016-08-31,4749379,41142821,-36393442,볼리비아,2016-08
2016-08-31,4745606,196078,4549528,아이티,2016-08
2016-08-31,4502870,19285145,-14782275,세네갈,2016-08
2016-08-31,4404599,6684816,-2280217,모잠비크,2016-08
2016-08-31,4324457,86655,4237802,괌,2016-08
2016-08-31,4106278,5380570,-1274292,에스토니아,2016-08
2016-08-31,3412760,15707948,-12295188,몰타,2016-08
2016-08-31,3358213,303069,3055144,마이크로네시아,2016-08
2016-08-31,3330882,9611566,-6280684,기타국,2016-08
2016-08-31,3176225,0,3176225,솔로몬 군도,2016-08
2016-08-31,3112574,2517280,595294,파푸아 뉴기니,2016-08
2016-08-31,2709394,164647,2544747,네팔,2016-08
2016-08-31,2563046,3591027,-1027981,벨라루스,2016-08
2016-08-31,2442651,568128,1874523,부르키나 파소,2016-08
2016-08-31,2410834,6865766,-4454932,마다카스카르,2016-08
2016-08-31,2306577,38143587,-35837010,브루나이,2016-08
2016-08-31,2299879,431986,1867893,마카오,2016-08
2016-08-31,2156350,65801,2090549,사모아,2016-08
2016-08-31,2149539,5913304,-3763765,베닝,2016-08
2016-08-31,2149155,2837101,-687946,기니,2016-08
2016-08-31,2134317,133165,2001152,카메룬,2016-08
2016-08-31,2123665,157132,1966533,쿠바,2016-08
2016-08-31,2031163,537070,1494093,모리셔스,2016-08
2016-08-31,1975628,82254,1893374,보츠와나,2016-08
2016-08-31,1947241,35559860,-33612619,콩고민주공화국,2016-08
2016-08-31,1931613,2790573,-858960,아이슬란드,2016-08
2016-08-31,1886197,27,1886170,팔라우,2016-08
2016-08-31,1853720,32730387,-30876667,잠비아,2016-08
2016-08-31,1831775,317839,1513936,자마이카,2016-08
2016-08-31,1651673,0,1651673,네덜란드 열도,2016-08
2016-08-31,1416595,1360,1415235,불령 리유니온 코모도 제도,2016-08
2016-08-31,1381014,117796,1263218,세이쉘,2016-08
2016-08-31,1372910,0,1372910,불령 폴리네시아,2016-08
2016-08-31,1342925,630777,712148,짐바브웨,2016-08
2016-08-31,1243448,0,1243448,타지크,2016-08
2016-08-31,1243045,114488,1128557,가이아나,2016-08
2016-08-31,1199512,5102,1194410,벨리제,2016-08
2016-08-31,1181649,214346,967303,마세도니아,2016-08
2016-08-31,1073805,1747,1072058,아프카니스탄,2016-08
2016-08-31,1009977,1131194,-121217,알바니아,2016-08
2016-08-31,933370,9027,924343,영령 캐이맨 군도,2016-08
2016-08-31,922277,45917,876360,북마리아나 군도,2016-08
2016-08-31,825772,237,825535,바하마,2016-08
2016-08-31,736233,1583481,-847248,몰도바,2016-08
2016-08-31,708967,156773,552194,바베이도스,2016-08
2016-08-31,693214,0,693214,안티가 바부다,2016-08
2016-08-31,683620,9996389,-9312769,룩셈부르그,2016-08
2016-08-31,673661,461,673200,말리,2016-08
2016-08-31,659362,500,658862,버뮤다,2016-08
2016-08-31,653798,65,653733,아루바,2016-08
2016-08-31,651316,800718,-149402,리히텐슈타인,2016-08
2016-08-31,631679,1891151,-1259472,모리타니,2016-08
2016-08-31,623874,319933,303941,말라위,2016-08
2016-08-31,622296,162473,459823,가봉,2016-08
2016-08-31,609610,71,609539,티모르,2016-08
2016-08-31,581903,0,581903,몰디브,2016-08
2016-08-31,570029,91073797,-90503768,적도 기니,2016-08
2016-08-31,542852,963,541889,도미니카,2016-08
2016-08-31,508088,7500,500588,아메리칸 사모아,2016-08
2016-08-31,479009,197280,281729,수리남,2016-08
2016-08-31,472859,1126973,-654114,보스니아-헤르체고비나,2016-08
2016-08-31,442678,52668,390010,소말리아,2016-08
2016-08-31,403501,567514,-164013,아르메니아,2016-08
2016-08-31,387794,107,387687,부탄,2016-08
2016-08-31,387702,18802,368900,키리바티,2016-08
2016-08-31,385404,236714,148690,감비아,2016-08
2016-08-31,381034,0,381034,마티니크,2016-08
2016-08-31,301942,313,301629,세인트 키츠 네비스,2016-08
2016-08-31,297456,933,296523,세인트 루시아,2016-08
2016-08-31,244572,0,244572,세인트 빈센트 그레나딘,2016-08
2016-08-31,241356,0,241356,지브랄타,2016-08
2016-08-31,228455,28165,200290,바누아투,2016-08
2016-08-31,221035,4250,216785,부룬디,2016-08
2016-08-31,191477,0,191477,세인트 마틴,2016-08
2016-08-31,185992,2416496,-2230504,스와질랜드,2016-08
2016-08-31,158644,150,158494,몬테네그로,2016-08
2016-08-31,142906,0,142906,과델로프,2016-08
2016-08-31,128102,51179,76923,르완다,2016-08
2016-08-31,88018,0,88018,불령 가이아나,2016-08
2016-08-31,85154,0,85154,카보 베르데,2016-08
2016-08-31,72883,0,72883,영령 버진군도,2016-08
2016-08-31,71351,0,71351,에리트리아,2016-08
2016-08-31,66957,9980582,-9913625,나미비아,2016-08
2016-08-31,64690,14422,50268,통가,2016-08
2016-08-31,64080,0,64080,챠드,2016-08
2016-08-31,60823,345134,-284311,시에라 리온,2016-08
2016-08-31,44902,0,44902,큐라소,2016-08
2016-08-31,42525,34268,8257,중앙아프리카공화국,2016-08
2016-08-31,26732,0,26732,그레나다,2016-08
2016-08-31,24037,8015,16022,미령 버진군도,2016-08
2016-08-31,22654,14560,8094,코모로스,2016-08
2016-08-31,20000,0,20000,노폴크 아일랜드,2016-08
2016-08-31,17200,552037,-534837,모나코,2016-08
2016-08-31,7250,59,7191,레소토,2016-08
2016-08-31,6745,2260,4485,남수단,2016-08
2016-08-31,4213,3395370,-3391157,니제르,2016-08
2016-08-31,2352,0,2352,상토메 프린스페,2016-08
2016-08-31,1338,323,1015,앙귈라,2016-08
2016-08-31,166,250750,-250584,그린랜드,2016-08
2016-08-31,0,2084,-2084,쿡 아일랜드,2016-08
2016-08-31,0,209448,-209448,파로에 군도,2016-08
2016-08-31,0,426,-426,건지,2016-08
2016-08-31,0,11818,-11818,니우에,2016-08
2016-08-31,0,21,-21,투르크 & 카이코스 군도,2016-08
2016-08-31,0,31064,-31064,맨섬,2016-08
2016-08-31,0,85624,-85624,기네비소,2016-08
2016-08-31,0,1156,-1156,저어지,2016-08
2016-08-31,0,1037,-1037,안도라,2016-08
2016-08-31,0,3572,-3572,세인트 바르탤르미,2016-08
2016-08-31,0,410,-410,코스 군도,2016-08
2016-08-31,0,407238,-407238,포클랜드 군도,2016-08
2016-08-31,0,170151,-170151,토켈라우,2016-08
2016-08-31,0,268,-268,메요트,2016-08
2016-09-30,10953271210,7233249853,3720021357,중국,2016-09
2016-09-30,5132437801,3415792933,1716644868,미국,2016-09
2016-09-30,2865856800,116255063,2749601737,홍콩,2016-09
2016-09-30,2796647436,1259791891,1536855545,베트남,2016-09
2016-09-30,2168024802,4233798404,-2065773602,일본,2016-09
2016-09-30,1078074282,1414091803,-336017521,대만,2016-09
2016-09-30,953790223,375635007,578155216,인도,2016-09
2016-09-30,902718168,593634464,309083704,싱가포르,2016-09
2016-09-30,881129251,335120175,546009076,멕시코,2016-09
2016-09-30,772149891,575834319,196315572,말레이시아,2016-09
2016-09-30,608525449,230594441,377931008,필리핀,2016-09
2016-09-30,586099349,377662059,208437290,태국,2016-09
2016-09-30,553087271,10122,553077149,마샬군도,2016-09
2016-09-30,524079771,1310972452,-786892681,호주,2016-09
2016-09-30,514743487,741399381,-226655894,인도네시아,2016-09
2016-09-30,512070647,1533445116,-1021374469,독일,2016-09
2016-09-30,404201004,1460193226,-1055992222,사우디아라비아,2016-09
2016-09-30,390821713,60390115,330431598,튀르키예,2016-09
2016-09-30,383068770,190204495,192864275,네덜란드,2016-09
2016-09-30,380491457,722840148,-342348691,러시아 연방,2016-09
2016-09-30,374540677,247485233,127055444,브라질,2016-09
2016-09-30,351247138,562510502,-211263364,아랍에미리트 연합,2016-09
2016-09-30,347520489,537774191,-190253702,이란,2016-09
2016-09-30,332476303,5803413,326672890,그리스,2016-09
2016-09-30,308970891,314704206,-5733315,영국,2016-09
2016-09-30,290211669,339847966,-49636297,캐나다,2016-09
2016-09-30,264409501,91433729,172975772,노르웨이,2016-09
2016-09-30,263544365,13125319,250419046,슬로바키아,2016-09
2016-09-30,249705562,414400221,-164694659,이탈리아,2016-09
2016-09-30,235319446,36089639,199229807,폴란드,2016-09
2016-09-30,200143940,0,200143940,버뮤다,2016-09
2016-09-30,186944464,43061485,143882979,체코공화국,2016-09
2016-09-30,179050538,3842033,175208505,이집트,2016-09
2016-09-30,166853246,415167648,-248314402,프랑스,2016-09
2016-09-30,160175626,10050486,150125140,슬로베니아,2016-09
2016-09-30,158972447,127378689,31593758,스페인,2016-09
2016-09-30,154371572,96836960,57534612,벨기에,2016-09
2016-09-30,148509541,9729444,138780097,사이프러스,2016-09
2016-09-30,117357955,329181342,-211823387,칠레,2016-09
2016-09-30,102825317,64065851,38759466,이스라엘,2016-09
2016-09-30,98426804,35972066,62454738,방글라데시,2016-09
2016-09-30,96117683,92329,96025354,라이베리아,2016-09
2016-09-30,93394056,19636,93374420,맨섬,2016-09
2016-09-30,93191061,1533130,91657931,우즈베키스탄,2016-09
2016-09-30,88197993,101514223,-13316230,페루,2016-09
2016-09-30,87691904,645906203,-558214299,쿠웨이트,2016-09
2016-09-30,86934782,51262142,35672640,헝가리,2016-09
2016-09-30,86584984,99189398,-12604414,오스트리아,2016-09
2016-09-30,85654570,84297254,1357316,뉴질랜드,2016-09
2016-09-30,74034704,38981982,35052722,콜롬비아,2016-09
2016-09-30,73965350,102137341,-28171991,남아프리카공화국,2016-09
2016-09-30,72681121,4315520,68365601,몰타,2016-09
2016-09-30,70675988,23284079,47391909,알제리,2016-09
2016-09-30,66440617,111443320,-45002703,스웨덴,2016-09
2016-09-30,66015180,466114838,-400099658,이라크,2016-09
2016-09-30,65216622,19,65216603,영령 캐이맨 군도,2016-09
2016-09-30,63713576,28887414,34826162,파키스탄,2016-09
2016-09-30,60127345,1167347,58959998,앙골라,2016-09
2016-09-30,58874917,34532359,24342558,나이지리아,2016-09
2016-09-30,58305935,16779707,41526228,모로코,2016-09
2016-09-30,57425136,36037946,21387190,아르헨티나,2016-09
2016-09-30,51846770,851713512,-799866742,카타르,2016-09
2016-09-30,49867455,55846524,-5979069,미얀마,2016-09
2016-09-30,48559899,14669336,33890563,과테말라,2016-09
2016-09-30,48398620,107129343,-58730723,오만,2016-09
2016-09-30,47507252,24239004,23268248,캄보디아,2016-09
2016-09-30,45776608,4421914,41354694,토고,2016-09
2016-09-30,44071324,1368526,42702798,요르단,2016-09
2016-09-30,43980466,1686952,42293514,기니,2016-09
2016-09-30,43383336,60404223,-17020887,루마니아,2016-09
2016-09-30,41068551,9478486,31590065,에쿠아도르,2016-09
2016-09-30,39599235,82386934,-42787699,아일랜드,2016-09
2016-09-30,31487700,196579861,-165092161,스위스,2016-09
2016-09-30,29582659,55202626,-25619967,카자흐스탄,2016-09
2016-09-30,26749345,17793055,8956290,포루투갈,2016-09
2016-09-30,25578176,5447171,20131005,리투아니아,2016-09
2016-09-30,24393046,1866446,22526600,파나마,2016-09
2016-09-30,24236228,47192568,-22956340,덴마크,2016-09
2016-09-30,23366932,5772840,17594092,스리랑카,2016-09
2016-09-30,22977509,8032278,14945231,도미니카 공화국,2016-09
2016-09-30,20855917,915599,19940318,크로아티아,2016-09
2016-09-30,18584740,14259928,4324812,푸에르토리코,2016-09
2016-09-30,17055297,493,17054804,투르크멘,2016-09
2016-09-30,16709499,77617433,-60907934,리비아,2016-09
2016-09-30,16703584,420406,16283178,시리아,2016-09
2016-09-30,16581684,2736355,13845329,가나,2016-09
2016-09-30,15705632,38048185,-22342553,우크라이나,2016-09
2016-09-30,15629250,282936,15346314,피지,2016-09
2016-09-30,15429901,87190528,-71760627,핀란드,2016-09
2016-09-30,15267485,615204,14652281,수단,2016-09
2016-09-30,15250981,6196798,9054183,바레인,2016-09
2016-09-30,15206887,825665,14381222,탄자니아,2016-09
2016-09-30,15158608,1265922,13892686,몽골,2016-09
2016-09-30,14755505,2916586,11838919,케냐,2016-09
2016-09-30,12823473,4017877,8805596,튀니지,2016-09
2016-09-30,12382515,1832945,10549570,레바논,2016-09
2016-09-30,11975411,11701836,273575,코스타리카,2016-09
2016-09-30,10489999,1182434,9307565,엘살바도르,2016-09
2016-09-30,10315014,18794995,-8479981,파라과이,2016-09
2016-09-30,9962699,94869,9867830,불령 폴리네시아,2016-09
2016-09-30,9954105,16125,9937980,아제르바이잔,2016-09
2016-09-30,9627811,2701514,6926297,라오스,2016-09
2016-09-30,9323432,1515219,7808213,니카라과,2016-09
2016-09-30,9322225,8729087,593138,불가리아,2016-09
2016-09-30,9024632,27000,8997632,지부티,2016-09
2016-09-30,9006313,16637234,-7630921,트리니다드 토바고,2016-09
2016-09-30,8995225,241731,8753494,베네주엘라,2016-09
2016-09-30,8892482,18133618,-9241136,뉴 칼레도니아,2016-09
2016-09-30,8558416,4663913,3894503,에티오피아,2016-09
2016-09-30,8515403,902,8514501,아프카니스탄,2016-09
2016-09-30,7806724,2719670,5087054,온두라스,2016-09
2016-09-30,7171398,789363,6382035,예맨,2016-09
2016-09-30,6919510,208597,6710913,마이크로네시아,2016-09
2016-09-30,6560109,21647281,-15087172,세르비아,2016-09
2016-09-30,6423061,123624,6299437,키르기스스탄,2016-09
2016-09-30,6018196,7441804,-1423608,우루과이,2016-09
2016-09-30,5976420,26874163,-20897743,기타국,2016-09
2016-09-30,5692906,21283476,-15590570,볼리비아,2016-09
2016-09-30,5667842,1061561,4606281,코트디봐르,2016-09
2016-09-30,5345963,75889,5270074,팔레스타인 해방기구,2016-09
2016-09-30,5308958,6391522,-1082564,에스토니아,2016-09
2016-09-30,4728084,130876,4597208,아이티,2016-09
2016-09-30,4631655,3558207,1073448,조지아,2016-09
2016-09-30,4457479,657652,3799827,콩고,2016-09
2016-09-30,4244359,5255691,-1011332,라트비아,2016-09
2016-09-30,4165850,27635331,-23469481,파푸아 뉴기니,2016-09
2016-09-30,3874260,29203676,-25329416,브루나이,2016-09
2016-09-30,3861643,133363,3728280,사모아,2016-09
2016-09-30,3736240,3088326,647914,아메리칸 사모아,2016-09
2016-09-30,3609791,12783,3597008,보츠와나,2016-09
2016-09-30,3311561,1662754,1648807,베닝,2016-09
2016-09-30,3238534,237940,3000594,네팔,2016-09
2016-09-30,3232876,156953,3075923,괌,2016-09
2016-09-30,3104447,8029264,-4924817,세네갈,2016-09
2016-09-30,3018628,227738,2790890,마카오,2016-09
2016-09-30,3003738,166,3003572,영령 버진군도,2016-09
2016-09-30,2898167,105258,2792909,르완다,2016-09
2016-09-30,2651384,11602,2639782,부르키나 파소,2016-09
2016-09-30,2478469,158,2478311,솔로몬 군도,2016-09
2016-09-30,2467849,4695667,-2227818,마다카스카르,2016-09
2016-09-30,2335942,578703,1757239,모리셔스,2016-09
2016-09-30,2320604,62872,2257732,가이아나,2016-09
2016-09-30,2165396,1010,2164386,네덜란드 열도,2016-09
2016-09-30,1943197,0,1943197,큐라소,2016-09
2016-09-30,1876269,414478,1461791,말라위,2016-09
2016-09-30,1848418,1455069,393349,아이슬란드,2016-09
2016-09-30,1742288,504096,1238192,모잠비크,2016-09
2016-09-30,1725178,3617011,-1891833,벨라루스,2016-09
2016-09-30,1716712,336,1716376,타지크,2016-09
2016-09-30,1685951,270225,1415726,스와질랜드,2016-09
2016-09-30,1680132,1800,1678332,불령 리유니온 코모도 제도,2016-09
2016-09-30,1531569,182785,1348784,자마이카,2016-09
2016-09-30,1515403,56262283,-54746880,잠비아,2016-09
2016-09-30,1480933,290251,1190682,세이쉘,2016-09
2016-09-30,1469423,766720,702703,마세도니아,2016-09
2016-09-30,1456281,84484,1371797,카메룬,2016-09
2016-09-30,1366110,238499,1127611,우간다,2016-09
2016-09-30,1338490,533,1337957,말리,2016-09
2016-09-30,1310323,0,1310323,국제통화기금,2016-09
2016-09-30,1295090,553330,741760,짐바브웨,2016-09
2016-09-30,1114380,174122,940258,키리바티,2016-09
2016-09-30,1098559,345638,752921,쿠바,2016-09
2016-09-30,1046929,424337,622592,리히텐슈타인,2016-09
2016-09-30,1043774,0,1043774,마티니크,2016-09
2016-09-30,943965,56336,887629,북마리아나 군도,2016-09
2016-09-30,891577,0,891577,몰디브,2016-09
2016-09-30,828750,28559,800191,바베이도스,2016-09
2016-09-30,825535,5809625,-4984090,룩셈부르그,2016-09
2016-09-30,796487,0,796487,아루바,2016-09
2016-09-30,765611,46013823,-45248212,가봉,2016-09
2016-09-30,698510,302034,396476,알바니아,2016-09
2016-09-30,524855,30929827,-30404972,콩고민주공화국,2016-09
2016-09-30,506457,944685,-438228,아르메니아,2016-09
2016-09-30,467441,3921606,-3454165,모리타니,2016-09
2016-09-30,466920,150,466770,부탄,2016-09
2016-09-30,452261,711928,-259667,바누아투,2016-09
2016-09-30,440003,652138,-212135,소말리아,2016-09
2016-09-30,410007,977963,-567956,몰도바,2016-09
2016-09-30,407234,452,406782,티모르,2016-09
2016-09-30,387740,412,387328,과델로프,2016-09
2016-09-30,386954,0,386954,팔라우,2016-09
2016-09-30,385578,0,385578,벨리제,2016-09
2016-09-30,375740,0,375740,바하마,2016-09
2016-09-30,354839,339291,15548,수리남,2016-09
2016-09-30,350077,0,350077,도미니카,2016-09
2016-09-30,233788,12389,221399,나미비아,2016-09
2016-09-30,219535,0,219535,세인트 루시아,2016-09
2016-09-30,177452,1285439,-1107987,시에라 리온,2016-09
2016-09-30,176657,0,176657,그레나다,2016-09
2016-09-30,174312,5140,169172,지브랄타,2016-09
2016-09-30,144954,0,144954,세인트 키츠 네비스,2016-09
2016-09-30,134563,1769864,-1635301,보스니아-헤르체고비나,2016-09
2016-09-30,130584,31938066,-31807482,적도 기니,2016-09
2016-09-30,108914,0,108914,투르크 & 카이코스 군도,2016-09
2016-09-30,107695,29,107666,부룬디,2016-09
2016-09-30,103777,0,103777,불령 가이아나,2016-09
2016-09-30,94619,19751255,-19656636,챠드,2016-09
2016-09-30,58942,0,58942,안티가 바부다,2016-09
2016-09-30,56810,0,56810,상토메 프린스페,2016-09
2016-09-30,49968,9467,40501,산마리노,2016-09
2016-09-30,48877,95444,-46567,감비아,2016-09
2016-09-30,44800,0,44800,에리트리아,2016-09
2016-09-30,39353,0,39353,몬테네그로,2016-09
2016-09-30,34840,0,34840,카보 베르데,2016-09
2016-09-30,29315,88492,-59177,기네비소,2016-09
2016-09-30,23137,49,23088,통가,2016-09
2016-09-30,22019,0,22019,중앙아프리카공화국,2016-09
2016-09-30,20110,0,20110,세인트 빈센트 그레나딘,2016-09
2016-09-30,17675,39600,-21925,안도라,2016-09
2016-09-30,5287,580047,-574760,모나코,2016-09
2016-09-30,4150,554321,-550171,쿡 아일랜드,2016-09
2016-09-30,2148,0,2148,토켈라우,2016-09
2016-09-30,1900,0,1900,세인트 마틴,2016-09
2016-09-30,446,37374,-36928,그린랜드,2016-09
2016-09-30,132,0,132,앙귈라,2016-09
2016-09-30,100,0,100,세인트 헬레나,2016-09
2016-09-30,32,0,32,파로에 군도,2016-09
2016-09-30,0,239,-239,불령 남부지역,2016-09
2016-09-30,0,507,-507,세인트 바르탤르미,2016-09
2016-09-30,0,111144,-111144,안타티카,2016-09
2016-09-30,0,444,-444,포클랜드 군도,2016-09
2016-09-30,0,204,-204,건지,2016-09
2016-09-30,0,2518,-2518,저어지,2016-09
2016-09-30,0,39361,-39361,마이너 아우틀링 합중국 군도,2016-09
2016-09-30,0,7800,-7800,미령 버진군도,2016-09
2016-09-30,0,36590,-36590,코모로스,2016-09
2016-09-30,0,363,-363,레소토,2016-09
2016-09-30,0,1947,-1947,코스 군도,2016-09
2016-09-30,0,2346,-2346,몬트세라트,2016-09
2016-09-30,0,43002,-43002,니우에,2016-09
2016-09-30,0,114,-114,세인트 피레 미켈론,2016-09
2016-09-30,0,4487,-4487,니제르,2016-09
2016-10-31,11088002164,7708725723,3379276441,중국,2016-10
2016-10-31,5401982445,3557050138,1844932307,미국,2016-10
2016-10-31,2961774667,109777796,2851996871,홍콩,2016-10
2016-10-31,2886439219,1225828440,1660610779,베트남,2016-10
2016-10-31,2103254471,4220758259,-2117503788,일본,2016-10
2016-10-31,1236789611,1428872238,-192082627,대만,2016-10
2016-10-31,1037710064,497139913,540570151,싱가포르,2016-10
2016-10-31,953147649,345796588,607351061,인도,2016-10
2016-10-31,907772915,293238826,614534089,멕시코,2016-10
2016-10-31,825275986,708625495,116650491,아랍에미리트 연합,2016-10
2016-10-31,654735696,1316647993,-661912297,호주,2016-10
2016-10-31,642707743,326105055,316602688,필리핀,2016-10
2016-10-31,603169983,1532212766,-929042783,독일,2016-10
2016-10-31,563718662,660842353,-97123691,말레이시아,2016-10
2016-10-31,557502128,391840562,165661566,태국,2016-10
2016-10-31,482337254,696140490,-213803236,인도네시아,2016-10
2016-10-31,472880288,426621707,46258581,영국,2016-10
2016-10-31,454943806,1513599257,-1058655451,사우디아라비아,2016-10
2016-10-31,432792500,834309571,-401517071,러시아 연방,2016-10
2016-10-31,431117036,319021956,112095080,이란,2016-10
2016-10-31,398146961,58200812,339946149,튀르키예,2016-10
2016-10-31,363147065,251899065,111248000,브라질,2016-10
2016-10-31,331510612,324141589,7369023,캐나다,2016-10
2016-10-31,322971051,12373797,310597254,마샬군도,2016-10
2016-10-31,319982228,236202,319746026,사이프러스,2016-10
2016-10-31,295022955,40033488,254989467,폴란드,2016-10
2016-10-31,264599141,402385361,-137786220,이탈리아,2016-10
2016-10-31,253342035,199772,253142263,라이베리아,2016-10
2016-10-31,251946181,218512197,33433984,네덜란드,2016-10
2016-10-31,236211097,10375787,225835310,슬로바키아,2016-10
2016-10-31,199979710,15,199979695,버뮤다,2016-10
2016-10-31,184410902,764294844,-579883942,프랑스,2016-10
2016-10-31,183283415,53998910,129284505,체코공화국,2016-10
2016-10-31,180979113,87479398,93499715,벨기에,2016-10
2016-10-31,177955857,141892516,36063341,스페인,2016-10
2016-10-31,147269363,12334753,134934610,슬로베니아,2016-10
2016-10-31,146518864,239762549,-93243685,칠레,2016-10
2016-10-31,135920388,6170186,129750202,이집트,2016-10
2016-10-31,118408310,60901236,57507074,이스라엘,2016-10
2016-10-31,116873957,88534992,28338965,뉴질랜드,2016-10
2016-10-31,104033778,371225804,-267192026,이라크,2016-10
2016-10-31,103757548,2030564,101726984,우즈베키스탄,2016-10
2016-10-31,97961227,23151090,74810137,방글라데시,2016-10
2016-10-31,97183012,103746806,-6563794,페루,2016-10
2016-10-31,83735676,4312860,79422816,그리스,2016-10
2016-10-31,83459846,100084603,-16624757,남아프리카공화국,2016-10
2016-10-31,81386374,90790652,-9404278,오스트리아,2016-10
2016-10-31,81061202,34893943,46167259,알제리,2016-10
2016-10-31,80644192,44883981,35760211,헝가리,2016-10
2016-10-31,79570753,662428606,-582857853,쿠웨이트,2016-10
2016-10-31,78340810,121680765,-43339955,스웨덴,2016-10
2016-10-31,67947682,7577825,60369857,파나마,2016-10
2016-10-31,64047208,38967676,25079532,파키스탄,2016-10
2016-10-31,63795407,46859683,16935724,아르헨티나,2016-10
2016-10-31,62887077,54873628,8013449,콜롬비아,2016-10
2016-10-31,57358235,112836572,-55478337,아일랜드,2016-10
2016-10-31,52006611,55495979,-3489368,미얀마,2016-10
2016-10-31,51712587,1698356,50014231,요르단,2016-10
2016-10-31,50673520,952687401,-902013881,카타르,2016-10
2016-10-31,44220183,2728,44217455,맨섬,2016-10
2016-10-31,43494266,144216658,-100722392,오만,2016-10
2016-10-31,43363707,11435293,31928414,모로코,2016-10
2016-10-31,43269428,19988986,23280442,캄보디아,2016-10
2016-10-31,42227735,2162201,40065534,토고,2016-10
2016-10-31,42198099,13529974,28668125,푸에르토리코,2016-10
2016-10-31,39914580,8715462,31199118,에쿠아도르,2016-10
2016-10-31,38999775,862945,38136830,크로아티아,2016-10
2016-10-31,38437013,14747804,23689209,카자흐스탄,2016-10
2016-10-31,34367968,36861564,-2493596,루마니아,2016-10
2016-10-31,31778517,184496122,-152717605,스위스,2016-10
2016-10-31,31239163,1886923,29352240,기니,2016-10
2016-10-31,27190781,45863564,-18672783,덴마크,2016-10
2016-10-31,26068390,6975317,19093073,도미니카 공화국,2016-10
2016-10-31,25136081,10376029,14760052,나이지리아,2016-10
2016-10-31,24174403,122237434,-98063031,노르웨이,2016-10
2016-10-31,23999022,6842388,17156634,스리랑카,2016-10
2016-10-31,21918884,52657600,-30738716,핀란드,2016-10
2016-10-31,21621595,21940074,-318479,포루투갈,2016-10
2016-10-31,20534050,414233,20119817,수단,2016-10
2016-10-31,20000737,4189721,15811016,리투아니아,2016-10
2016-10-31,19965541,25906957,-5941416,리비아,2016-10
2016-10-31,19627051,9434287,10192764,코스타리카,2016-10
2016-10-31,19310789,2134653,17176136,베네주엘라,2016-10
2016-10-31,18170000,2388590,15781410,가나,2016-10
2016-10-31,17042721,746435,16296286,몽골,2016-10
2016-10-31,17018120,14333201,2684919,과테말라,2016-10
2016-10-31,16412963,12358655,4054308,파라과이,2016-10
2016-10-31,15428203,254108,15174095,시리아,2016-10
2016-10-31,15006129,15455998,-449869,바레인,2016-10
2016-10-31,13862700,2744685,11118015,튀니지,2016-10
2016-10-31,13841758,71261937,-57420179,우크라이나,2016-10
2016-10-31,13738253,4212635,9525618,조지아,2016-10
2016-10-31,13576638,2258982,11317656,레바논,2016-10
2016-10-31,12493370,3020529,9472841,케냐,2016-10
2016-10-31,11719548,15215,11704333,투르크멘,2016-10
2016-10-31,11372823,54000,11318823,팔레스타인 해방기구,2016-10
2016-10-31,10869054,7738650,3130404,불가리아,2016-10
2016-10-31,9736675,17779,9718896,아제르바이잔,2016-10
2016-10-31,9724508,1718930,8005578,엘살바도르,2016-10
2016-10-31,9096938,1537572,7559366,라오스,2016-10
2016-10-31,8185527,6718804,1466723,우루과이,2016-10
2016-10-31,8163061,4796239,3366822,트리니다드 토바고,2016-10
2016-10-31,8035233,865690,7169543,니카라과,2016-10
2016-10-31,7936529,25084,7911445,키르기스스탄,2016-10
2016-10-31,7885309,2341,7882968,세인트 키츠 네비스,2016-10
2016-10-31,7879329,3598603,4280726,세네갈,2016-10
2016-10-31,7831437,553669,7277768,탄자니아,2016-10
2016-10-31,7381467,34518,7346949,지부티,2016-10
2016-10-31,7377588,4762946,2614642,에스토니아,2016-10
2016-10-31,7211396,7329211,-117815,세르비아,2016-10
2016-10-31,6979384,318867,6660517,감비아,2016-10
2016-10-31,6954072,1870966,5083106,온두라스,2016-10
2016-10-31,6830075,7674766,-844691,모잠비크,2016-10
2016-10-31,6646948,343281,6303667,피지,2016-10
2016-10-31,6524859,4202801,2322058,예맨,2016-10
2016-10-31,5688394,736823,4951571,앙골라,2016-10
2016-10-31,5638089,5202368,435721,라트비아,2016-10
2016-10-31,5632849,43350325,-37717476,볼리비아,2016-10
2016-10-31,5427562,116026,5311536,아이티,2016-10
2016-10-31,5186654,67074,5119580,괌,2016-10
2016-10-31,5025523,4098132,927391,에티오피아,2016-10
2016-10-31,4931996,81919134,-76987138,브루나이,2016-10
2016-10-31,4447979,471158,3976821,쿠바,2016-10
2016-10-31,4255414,1307768,2947646,코트디봐르,2016-10
2016-10-31,4103379,19463,4083916,마이크로네시아,2016-10
2016-10-31,4030246,266885,3763361,마카오,2016-10
2016-10-31,3723080,5384182,-1661102,마다카스카르,2016-10
2016-10-31,3072959,131606,2941353,사모아,2016-10
2016-10-31,2742735,2112277,630458,아이슬란드,2016-10
2016-10-31,2721603,468266,2253337,모리셔스,2016-10
2016-10-31,2535167,21114112,-18578945,파푸아 뉴기니,2016-10
2016-10-31,2527581,55277,2472304,가이아나,2016-10
2016-10-31,2440080,4702720,-2262640,몰타,2016-10
2016-10-31,2370175,195692,2174483,네팔,2016-10
2016-10-31,2336841,8121,2328720,아프카니스탄,2016-10
2016-10-31,2140421,35525562,-33385141,콩고민주공화국,2016-10
2016-10-31,2130202,43357960,-41227758,기타국,2016-10
2016-10-31,2090309,1301974,788335,벨라루스,2016-10
2016-10-31,2030069,2307760,-277691,세이쉘,2016-10
2016-10-31,1870494,331779,1538715,타지크,2016-10
2016-10-31,1862669,354403,1508266,자마이카,2016-10
2016-10-31,1654645,262800,1391845,부르키나 파소,2016-10
2016-10-31,1633348,59710,1573638,보츠와나,2016-10
2016-10-31,1591897,2649622,-1057725,베닝,2016-10
2016-10-31,1562024,314793,1247231,짐바브웨,2016-10
2016-10-31,1483768,31137676,-29653908,뉴 칼레도니아,2016-10
2016-10-31,1445224,411308,1033916,카메룬,2016-10
2016-10-31,1429074,3362,1425712,아루바,2016-10
2016-10-31,1427520,9023,1418497,네덜란드 열도,2016-10
2016-10-31,1385623,36409,1349214,불령 폴리네시아,2016-10
2016-10-31,1374775,137242,1237533,알바니아,2016-10
2016-10-31,1227276,1306926,-79650,우간다,2016-10
2016-10-31,1221397,21417723,-20196326,잠비아,2016-10
2016-10-31,1148833,1148,1147685,안티가 바부다,2016-10
2016-10-31,1118856,656937,461919,콩고,2016-10
2016-10-31,1049616,0,1049616,바하마,2016-10
2016-10-31,907989,0,907989,몰디브,2016-10
2016-10-31,899262,4405,894857,벨리제,2016-10
2016-10-31,895933,49832,846101,바베이도스,2016-10
2016-10-31,889888,200800,689088,마세도니아,2016-10
2016-10-31,882572,218993,663579,아르메니아,2016-10
2016-10-31,882185,1231440,-349255,리히텐슈타인,2016-10
2016-10-31,875575,27071,848504,북마리아나 군도,2016-10
2016-10-31,859105,628435,230670,몰도바,2016-10
2016-10-31,837060,0,837060,불령 리유니온 코모도 제도,2016-10
2016-10-31,791925,4198898,-3406973,모리타니,2016-10
2016-10-31,790881,65740,725141,티모르,2016-10
2016-10-31,773756,849701,-75945,말라위,2016-10
2016-10-31,721273,6369492,-5648219,룩셈부르그,2016-10
2016-10-31,662251,69046,593205,수리남,2016-10
2016-10-31,648510,147223,501287,키리바티,2016-10
2016-10-31,529188,1869,527319,말리,2016-10
2016-10-31,491636,560677,-69041,시에라 리온,2016-10
2016-10-31,469554,34856757,-34387203,가봉,2016-10
2016-10-31,457796,324,457472,영령 캐이맨 군도,2016-10
2016-10-31,367571,0,367571,마티니크,2016-10
2016-10-31,360652,15,360637,소말리아,2016-10
2016-10-31,354394,15962,338432,아메리칸 사모아,2016-10
2016-10-31,336847,576,336271,과델로프,2016-10
2016-10-31,314682,82,314600,부탄,2016-10
2016-10-31,267735,1389254,-1121519,솔로몬 군도,2016-10
2016-10-31,256819,20198,236621,나미비아,2016-10
2016-10-31,242988,19552,223436,스와질랜드,2016-10
2016-10-31,238141,225175,12966,바누아투,2016-10
2016-10-31,231056,0,231056,팔라우,2016-10
2016-10-31,230302,1575713,-1345411,보스니아-헤르체고비나,2016-10
2016-10-31,182127,7304,174823,도미니카,2016-10
2016-10-31,160937,34244069,-34083132,적도 기니,2016-10
2016-10-31,158194,135,158059,지브랄타,2016-10
2016-10-31,148630,12265,136365,세인트 루시아,2016-10
2016-10-31,147246,0,147246,불령 가이아나,2016-10
2016-10-31,121547,480066,-358519,통가,2016-10
2016-10-31,121307,26270,95037,니제르,2016-10
2016-10-31,119465,3841,115624,상토메 프린스페,2016-10
2016-10-31,100352,3589,96763,르완다,2016-10
2016-10-31,88026,0,88026,카보 베르데,2016-10
2016-10-31,85350,0,85350,세인트 빈센트 그레나딘,2016-10
2016-10-31,80952,16712,64240,그레나다,2016-10
2016-10-31,80925,0,80925,챠드,2016-10
2016-10-31,75959,0,75959,영령 버진군도,2016-10
2016-10-31,71082,15,71067,투발루,2016-10
2016-10-31,68434,619,67815,안도라,2016-10
2016-10-31,55881,12592,43289,미령 버진군도,2016-10
2016-10-31,38772,0,38772,국제통화기금,2016-10
2016-10-31,37599,383,37216,나우루,2016-10
2016-10-31,34081,132779,-98698,중앙아프리카공화국,2016-10
2016-10-31,31397,1293,30104,투르크 & 카이코스 군도,2016-10
2016-10-31,20679,13145,7534,부룬디,2016-10
2016-10-31,11820,0,11820,남수단,2016-10
2016-10-31,6524,797,5727,몬테네그로,2016-10
2016-10-31,4265,18780,-14515,큐라소,2016-10
2016-10-31,2416,27286,-24870,쿡 아일랜드,2016-10
2016-10-31,1320,0,1320,앙귈라,2016-10
2016-10-31,1210,0,1210,세인트 헬레나,2016-10
2016-10-31,900,75165,-74265,기네비소,2016-10
2016-10-31,845,0,845,세인트 마틴,2016-10
2016-10-31,500,21,479,레소토,2016-10
2016-10-31,59,89493,-89434,모나코,2016-10
2016-10-31,0,22917,-22917,니우에,2016-10
2016-10-31,0,393903,-393903,코모로스,2016-10
2016-10-31,0,1068,-1068,저어지,2016-10
2016-10-31,0,30330,-30330,파로에 군도,2016-10
2016-10-31,0,124105,-124105,그린랜드,2016-10
2016-10-31,0,235,-235,몬트세라트,2016-10
2016-10-31,0,56555,-56555,토켈라우,2016-10
2016-10-31,0,71260,-71260,산마리노,2016-10
2016-10-31,0,693,-693,건지,2016-10
2016-10-31,0,1220,-1220,마이너 아우틀링 합중국 군도,2016-10
2016-11-30,11632780853,8105534036,3527246817,중국,2016-11
2016-11-30,5723085819,3752768251,1970317568,미국,2016-11
2016-11-30,3015087934,1107519233,1907568701,베트남,2016-11
2016-11-30,2954781070,137319382,2817461688,홍콩,2016-11
2016-11-30,2275226906,4291367588,-2016140682,일본,2016-11
2016-11-30,1412225922,538642572,873583350,싱가포르,2016-11
2016-11-30,1304055995,1443325012,-139269017,대만,2016-11
2016-11-30,1046367064,405712432,640654632,인도,2016-11
2016-11-30,818698935,333205942,485492993,멕시코,2016-11
2016-11-30,733904442,392085361,341819081,필리핀,2016-11
2016-11-30,725085424,623321583,101763841,말레이시아,2016-11
2016-11-30,705940928,1619105813,-913164885,호주,2016-11
2016-11-30,655422102,777228287,-121806185,아랍에미리트 연합,2016-11
2016-11-30,619026852,1624339505,-1005312653,독일,2016-11
2016-11-30,586286464,689888963,-103602499,인도네시아,2016-11
2016-11-30,581575787,388740966,192834821,태국,2016-11
2016-11-30,520217850,550252341,-30034491,영국,2016-11
2016-11-30,504954256,1981,504952275,마샬군도,2016-11
2016-11-30,491188148,1599269788,-1108081640,사우디아라비아,2016-11
2016-11-30,490773848,320,490773528,라이베리아,2016-11
2016-11-30,433820540,915172522,-481351982,러시아 연방,2016-11
2016-11-30,410275438,287332014,122943424,브라질,2016-11
2016-11-30,382804037,57440520,325363517,튀르키예,2016-11
2016-11-30,365306680,335840678,29466002,캐나다,2016-11
2016-11-30,358902376,130057609,228844767,노르웨이,2016-11
2016-11-30,319088220,695622937,-376534717,이란,2016-11
2016-11-30,316962819,2981981,313980838,그리스,2016-11
2016-11-30,314109566,364428711,-50319145,네덜란드,2016-11
2016-11-30,297129098,9479292,287649806,알제리,2016-11
2016-11-30,272736781,474037591,-201300810,이탈리아,2016-11
2016-11-30,252241926,1591312,250650614,파나마,2016-11
2016-11-30,251797075,43918002,207879073,폴란드,2016-11
2016-11-30,213616279,437721632,-224105353,프랑스,2016-11
2016-11-30,206269557,12432783,193836774,슬로바키아,2016-11
2016-11-30,199118733,54039757,145078976,체코공화국,2016-11
2016-11-30,192658115,80611960,112046155,벨기에,2016-11
2016-11-30,189122736,164705646,24417090,스페인,2016-11
2016-11-30,185684545,341187469,-155502924,칠레,2016-11
2016-11-30,185491753,459750853,-274259100,이라크,2016-11
2016-11-30,173815777,36366452,137449325,미얀마,2016-11
2016-11-30,125880883,7682216,118198667,슬로베니아,2016-11
2016-11-30,124196042,3947457,120248585,이집트,2016-11
2016-11-30,116785610,129768823,-12983213,페루,2016-11
2016-11-30,116574792,3091381,113483411,우즈베키스탄,2016-11
2016-11-30,103215765,134185350,-30969585,남아프리카공화국,2016-11
2016-11-30,103084001,14147421,88936580,방글라데시,2016-11
2016-11-30,102550086,88845321,13704765,뉴질랜드,2016-11
2016-11-30,101829777,713840120,-612010343,쿠웨이트,2016-11
2016-11-30,95965487,68303223,27662264,이스라엘,2016-11
2016-11-30,90158282,104001212,-13842930,오스트리아,2016-11
2016-11-30,80243920,58894837,21349083,헝가리,2016-11
2016-11-30,74016952,17678908,56338044,파키스탄,2016-11
2016-11-30,71903381,6435808,65467573,요르단,2016-11
2016-11-30,68810590,143325034,-74514444,스웨덴,2016-11
2016-11-30,68139061,158741823,-90602762,오만,2016-11
2016-11-30,65282742,74974449,-9691707,아일랜드,2016-11
2016-11-30,64527628,45878925,18648703,콜롬비아,2016-11
2016-11-30,54166726,6040,54160686,바하마,2016-11
2016-11-30,53912805,39145608,14767197,아르헨티나,2016-11
2016-11-30,53688930,234305755,-180616825,스위스,2016-11
2016-11-30,48332527,13874931,34457596,캄보디아,2016-11
2016-11-30,45320487,1019349688,-974029201,카타르,2016-11
2016-11-30,43302706,106885645,-63582939,핀란드,2016-11
2016-11-30,42869306,0,42869306,맨섬,2016-11
2016-11-30,42002277,45003714,-3001437,루마니아,2016-11
2016-11-30,41592898,20477611,21115287,포루투갈,2016-11
2016-11-30,39553787,3959419,35594368,토고,2016-11
2016-11-30,39208210,7775769,31432441,에쿠아도르,2016-11
2016-11-30,35102396,1560486,33541910,크로아티아,2016-11
2016-11-30,33683163,5977559,27705604,도미니카 공화국,2016-11
2016-11-30,33253152,23541953,9711199,카자흐스탄,2016-11
2016-11-30,32463152,10257300,22205852,모로코,2016-11
2016-11-30,30918244,463266,30454978,시리아,2016-11
2016-11-30,28854547,54757988,-25903441,나이지리아,2016-11
2016-11-30,27905240,58595031,-30689791,덴마크,2016-11
2016-11-30,27532952,6054464,21478488,리투아니아,2016-11
2016-11-30,25112512,2423391,22689121,리비아,2016-11
2016-11-30,24329170,695329,23633841,콩고,2016-11
2016-11-30,23607303,5079520,18527783,스리랑카,2016-11
2016-11-30,23599002,9980260,13618742,과테말라,2016-11
2016-11-30,20428323,45625890,-25197567,우크라이나,2016-11
2016-11-30,20075955,4245023,15830932,가나,2016-11
2016-11-30,19689746,14264292,5425454,푸에르토리코,2016-11
2016-11-30,18954518,23945409,-4990891,바레인,2016-11
2016-11-30,18474199,343038,18131161,피지,2016-11
2016-11-30,18310904,1371032,16939872,레바논,2016-11
2016-11-30,18105687,11554271,6551416,코스타리카,2016-11
2016-11-30,15971560,136,15971424,투르크멘,2016-11
2016-11-30,15559838,2548966,13010872,라오스,2016-11
2016-11-30,14707410,1057624,13649786,엘살바도르,2016-11
2016-11-30,13646833,217,13646616,불령 폴리네시아,2016-11
2016-11-30,13486146,1411115,12075031,몽골,2016-11
2016-11-30,13007482,176072,12831410,아제르바이잔,2016-11
2016-11-30,12756207,1185641,11570566,케냐,2016-11
2016-11-30,12591350,702520,11888830,수단,2016-11
2016-11-30,12533051,2463697,10069354,튀니지,2016-11
2016-11-30,11697554,1673746,10023808,온두라스,2016-11
2016-11-30,11466887,2848376,8618511,베네주엘라,2016-11
2016-11-30,11223729,30951452,-19727723,뉴 칼레도니아,2016-11
2016-11-30,10966448,235549,10730899,파라과이,2016-11
2016-11-30,10205621,15760848,-5555227,트리니다드 토바고,2016-11
2016-11-30,9883065,7742570,2140495,불가리아,2016-11
2016-11-30,9486081,1278402,8207679,니카라과,2016-11
2016-11-30,8928842,967014,7961828,세르비아,2016-11
2016-11-30,8880563,2191121,6689442,조지아,2016-11
2016-11-30,8680459,473359,8207100,예맨,2016-11
2016-11-30,8649412,19477861,-10828449,볼리비아,2016-11
2016-11-30,8616223,571232,8044991,탄자니아,2016-11
2016-11-30,8076042,8993641,-917599,우루과이,2016-11
2016-11-30,7403086,212256,7190830,팔레스타인 해방기구,2016-11
2016-11-30,7342238,5204171,2138067,에티오피아,2016-11
2016-11-30,6896515,75017994,-68121479,브루나이,2016-11
2016-11-30,6874813,180081,6694732,쿠바,2016-11
2016-11-30,6821924,3155834,3666090,세네갈,2016-11
2016-11-30,6568544,5145920,1422624,라트비아,2016-11
2016-11-30,6511450,9869031,-3357581,앙골라,2016-11
2016-11-30,6324598,167,6324431,아프카니스탄,2016-11
2016-11-30,5903713,1586207,4317506,코트디봐르,2016-11
2016-11-30,5704984,10214,5694770,키르기스스탄,2016-11
2016-11-30,5265310,4398374,866936,에스토니아,2016-11
2016-11-30,5170805,159698,5011107,괌,2016-11
2016-11-30,4768783,2624638,2144145,기니,2016-11
2016-11-30,4567815,56657,4511158,아이티,2016-11
2016-11-30,3926764,564670,3362094,모잠비크,2016-11
2016-11-30,3876408,29592,3846816,지부티,2016-11
2016-11-30,3790414,62096,3728318,보츠와나,2016-11
2016-11-30,3617587,2803897,813690,파푸아 뉴기니,2016-11
2016-11-30,3003984,299873,2704111,사이프러스,2016-11
2016-11-30,2971695,570846,2400849,모리셔스,2016-11
2016-11-30,2949440,348398,2601042,베닝,2016-11
2016-11-30,2932160,6151899,-3219739,몰타,2016-11
2016-11-30,2869921,5357325,-2487404,마다카스카르,2016-11
2016-11-30,2744722,68867057,-66122335,콩고민주공화국,2016-11
2016-11-30,2647672,122910,2524762,가이아나,2016-11
2016-11-30,2601596,886561,1715035,벨라루스,2016-11
2016-11-30,2536695,21683026,-19146331,기타국,2016-11
2016-11-30,2485048,2058746,426302,아이슬란드,2016-11
2016-11-30,2291876,0,2291876,말리,2016-11
2016-11-30,2162583,127029,2035554,세이쉘,2016-11
2016-11-30,2150902,31987863,-29836961,잠비아,2016-11
2016-11-30,2031984,106135,1925849,마카오,2016-11
2016-11-30,2026081,3213211,-1187130,타지크,2016-11
2016-11-30,2007614,476497,1531117,솔로몬 군도,2016-11
2016-11-30,1823026,13740,1809286,마이크로네시아,2016-11
2016-11-30,1674102,74755,1599347,북마리아나 군도,2016-11
2016-11-30,1605126,228533,1376593,네팔,2016-11
2016-11-30,1571190,247039,1324151,말라위,2016-11
2016-11-30,1534306,864131,670175,시에라 리온,2016-11
2016-11-30,1526738,100541,1426197,짐바브웨,2016-11
2016-11-30,1523078,357831,1165247,자마이카,2016-11
2016-11-30,1431168,600,1430568,불령 리유니온 코모도 제도,2016-11
2016-11-30,1412701,1862,1410839,사모아,2016-11
2016-11-30,1372550,78327,1294223,우간다,2016-11
2016-11-30,1330869,51195,1279674,바베이도스,2016-11
2016-11-30,1262442,553441,709001,카메룬,2016-11
2016-11-30,1213841,521490,692351,부르키나 파소,2016-11
2016-11-30,1194766,231704,963062,벨리제,2016-11
2016-11-30,1187344,485889,701455,알바니아,2016-11
2016-11-30,1147473,35,1147438,아루바,2016-11
2016-11-30,1120299,7362642,-6242343,룩셈부르그,2016-11
2016-11-30,1109618,26837,1082781,가봉,2016-11
2016-11-30,1059346,589,1058757,몰디브,2016-11
2016-11-30,916812,109,916703,네덜란드 열도,2016-11
2016-11-30,836576,1070284,-233708,리히텐슈타인,2016-11
2016-11-30,815834,225765,590069,소말리아,2016-11
2016-11-30,810901,899660,-88759,몰도바,2016-11
2016-11-30,678480,133531,544949,마세도니아,2016-11
2016-11-30,649214,29,649185,키리바티,2016-11
2016-11-30,636763,0,636763,버뮤다,2016-11
2016-11-30,584662,0,584662,마티니크,2016-11
2016-11-30,505672,131214,374458,수리남,2016-11
2016-11-30,496883,9750,487133,안티가 바부다,2016-11
2016-11-30,477519,29378,448141,아메리칸 사모아,2016-11
2016-11-30,460678,29,460649,티모르,2016-11
2016-11-30,439067,19768,419299,르완다,2016-11
2016-11-30,431656,2995216,-2563560,모리타니,2016-11
2016-11-30,414257,113619,300638,감비아,2016-11
2016-11-30,401994,1111716,-709722,보스니아-헤르체고비나,2016-11
2016-11-30,371584,0,371584,영령 캐이맨 군도,2016-11
2016-11-30,360064,31,360033,과델로프,2016-11
2016-11-30,357327,754,356573,팔라우,2016-11
2016-11-30,342390,627,341763,도미니카,2016-11
2016-11-30,339657,6764341,-6424684,에리트리아,2016-11
2016-11-30,333520,430687,-97167,바누아투,2016-11
2016-11-30,314930,0,314930,세인트 루시아,2016-11
2016-11-30,267742,0,267742,그레나다,2016-11
2016-11-30,256660,360308,-103648,나미비아,2016-11
2016-11-30,247857,42534,205323,스와질랜드,2016-11
2016-11-30,230494,0,230494,세인트 빈센트 그레나딘,2016-11
2016-11-30,226234,797000,-570766,통가,2016-11
2016-11-30,202030,0,202030,국제통화기금,2016-11
2016-11-30,201688,331,201357,투르크 & 카이코스 군도,2016-11
2016-11-30,182850,464,182386,지브랄타,2016-11
2016-11-30,171506,348607,-177101,아르메니아,2016-11
2016-11-30,146146,0,146146,부탄,2016-11
2016-11-30,135080,7660,127420,미령 버진군도,2016-11
2016-11-30,132500,0,132500,기네비소,2016-11
2016-11-30,118204,0,118204,세인트 키츠 네비스,2016-11
2016-11-30,105508,0,105508,챠드,2016-11
2016-11-30,94727,26342402,-26247675,적도 기니,2016-11
2016-11-30,81392,1473,79919,몬테네그로,2016-11
2016-11-30,64340,68123,-3783,영령 버진군도,2016-11
2016-11-30,56304,16500,39804,카보 베르데,2016-11
2016-11-30,49816,52902,-3086,중앙아프리카공화국,2016-11
2016-11-30,32056,0,32056,불령 가이아나,2016-11
2016-11-30,29111,83240,-54129,산마리노,2016-11
2016-11-30,27463,0,27463,투발루,2016-11
2016-11-30,21576,19260,2316,큐라소,2016-11
2016-11-30,20293,755463,-735170,모나코,2016-11
2016-11-30,19181,4803,14378,니제르,2016-11
2016-11-30,10666,114,10552,쿡 아일랜드,2016-11
2016-11-30,2562,0,2562,남수단,2016-11
2016-11-30,2113,6091,-3978,안도라,2016-11
2016-11-30,1491,361,1130,앙귈라,2016-11
2016-11-30,589,0,589,세인트 마틴,2016-11
2016-11-30,542,0,542,파로에 군도,2016-11
2016-11-30,468,0,468,건지,2016-11
2016-11-30,159,33,126,레소토,2016-11
2016-11-30,68,135080,-135012,그린랜드,2016-11
2016-11-30,0,2031,-2031,토켈라우,2016-11
2016-11-30,0,434580,-434580,포클랜드 군도,2016-11
2016-11-30,0,14529,-14529,나우루,2016-11
2016-11-30,0,919,-919,코스 군도,2016-11
2016-11-30,0,440,-440,크리스마스 아일랜드,2016-11
2016-11-30,0,175,-175,스발비드 군도,2016-11
2016-11-30,0,51,-51,니우에,2016-11
2016-11-30,0,72,-72,부룬디,2016-11
2016-11-30,0,562720,-562720,코모로스,2016-11
2016-11-30,0,930,-930,저어지,2016-11
2016-12-31,12053353493,7951898000,4101455493,중국,2016-12
2016-12-31,5741228102,4187673169,1553554933,미국,2016-12
2016-12-31,3263272175,143676816,3119595359,홍콩,2016-12
2016-12-31,3190623874,1021686486,2168937388,베트남,2016-12
2016-12-31,2223174096,4529300235,-2306126139,일본,2016-12
2016-12-31,1147300671,1337628829,-190328158,대만,2016-12
2016-12-31,1084347775,375390882,708956893,인도,2016-12
2016-12-31,860698990,443596325,417102665,멕시코,2016-12
2016-12-31,786934822,846457653,-59522831,싱가포르,2016-12
2016-12-31,672735269,1536179952,-863444683,호주,2016-12
2016-12-31,668101367,578985887,89115480,영국,2016-12
2016-12-31,666335119,42098224,624236895,그리스,2016-12
2016-12-31,636611221,287472787,349138434,필리핀,2016-12
2016-12-31,593331626,813772596,-220440970,인도네시아,2016-12
2016-12-31,554059120,1487413510,-933354390,독일,2016-12
2016-12-31,553386105,740536925,-187150820,말레이시아,2016-12
2016-12-31,542374218,417698346,124675872,태국,2016-12
2016-12-31,489590514,572224583,-82634069,아랍에미리트 연합,2016-12
2016-12-31,444158800,1544765341,-1100606541,사우디아라비아,2016-12
2016-12-31,424265432,898170191,-473904759,러시아 연방,2016-12
2016-12-31,419217387,52480863,366736524,튀르키예,2016-12
2016-12-31,398094221,586392741,-188298520,이란,2016-12
2016-12-31,381775741,379729541,2046200,캐나다,2016-12
2016-12-31,364235878,288623543,75612335,브라질,2016-12
2016-12-31,357286390,366626055,-9339665,네덜란드,2016-12
2016-12-31,303259603,96696020,206563583,벨기에,2016-12
2016-12-31,288576207,428132228,-139556021,이탈리아,2016-12
2016-12-31,279737983,12340,279725643,마샬군도,2016-12
2016-12-31,256979662,192481067,64498595,스페인,2016-12
2016-12-31,239708571,12614216,227094355,슬로바키아,2016-12
2016-12-31,217004133,653773101,-436768968,쿠웨이트,2016-12
2016-12-31,216438069,61892396,154545673,체코공화국,2016-12
2016-12-31,215162776,46271690,168891086,폴란드,2016-12
2016-12-31,203722901,747186450,-543463549,프랑스,2016-12
2016-12-31,202325615,121264,202204351,라이베리아,2016-12
2016-12-31,191998823,250918217,-58919394,칠레,2016-12
2016-12-31,185396753,872331,184524422,크로아티아,2016-12
2016-12-31,175222466,622467630,-447245164,이라크,2016-12
2016-12-31,169531455,6290042,163241413,파나마,2016-12
2016-12-31,155776651,6389237,149387414,이집트,2016-12
2016-12-31,148124940,26410660,121714280,사이프러스,2016-12
2016-12-31,144112088,5036433,139075655,슬로베니아,2016-12
2016-12-31,132177601,1098286,131079315,앙골라,2016-12
2016-12-31,120272415,44881,120227534,알제리,2016-12
2016-12-31,117546683,0,117546683,맨섬,2016-12
2016-12-31,114139211,16190496,97948715,방글라데시,2016-12
2016-12-31,104607580,228260044,-123652464,오만,2016-12
2016-12-31,94460038,60220010,34240028,페루,2016-12
2016-12-31,91197502,67061692,24135810,이스라엘,2016-12
2016-12-31,89637016,93431210,-3794194,뉴질랜드,2016-12
2016-12-31,83263562,16763182,66500380,파키스탄,2016-12
2016-12-31,82513246,152139555,-69626309,노르웨이,2016-12
2016-12-31,81133020,57773196,23359824,헝가리,2016-12
2016-12-31,80999517,210106919,-129107402,남아프리카공화국,2016-12
2016-12-31,80436488,1807262,78629226,우즈베키스탄,2016-12
2016-12-31,74919173,93867575,-18948402,아일랜드,2016-12
2016-12-31,72375509,96651850,-24276341,콜롬비아,2016-12
2016-12-31,70767050,90677847,-19910797,오스트리아,2016-12
2016-12-31,64538041,4045078,60492963,요르단,2016-12
2016-12-31,64516694,216354064,-151837370,스웨덴,2016-12
2016-12-31,59460124,30669201,28790923,미얀마,2016-12
2016-12-31,53224580,1064222344,-1010997764,카타르,2016-12
2016-12-31,49212479,8469524,40742955,에쿠아도르,2016-12
2016-12-31,47595993,19468287,28127706,캄보디아,2016-12
2016-12-31,45764183,2551114,43213069,토고,2016-12
2016-12-31,44325296,30984859,13340437,루마니아,2016-12
2016-12-31,44203842,29344193,14859649,아르헨티나,2016-12
2016-12-31,43192411,12805624,30386787,모로코,2016-12
2016-12-31,40637254,209083434,-168446180,스위스,2016-12
2016-12-31,39944436,68213356,-28268920,카자흐스탄,2016-12
2016-12-31,38564081,16868291,21695790,포루투갈,2016-12
2016-12-31,33132463,81209219,-48076756,나이지리아,2016-12
2016-12-31,31589541,7909456,23680085,도미니카 공화국,2016-12
2016-12-31,30253502,7484279,22769223,스리랑카,2016-12
2016-12-31,30010622,1796666,28213956,레바논,2016-12
2016-12-31,28979649,54543186,-25563537,우크라이나,2016-12
2016-12-31,28838337,540436,28297901,시리아,2016-12
2016-12-31,28319038,14991416,13327622,바레인,2016-12
2016-12-31,27887955,13733687,14154268,푸에르토리코,2016-12
2016-12-31,27666804,28102296,-435492,리비아,2016-12
2016-12-31,26477414,47667025,-21189611,핀란드,2016-12
2016-12-31,23171617,5235424,17936193,리투아니아,2016-12
2016-12-31,23021578,9357430,13664148,코스타리카,2016-12
2016-12-31,22518627,15874720,6643907,과테말라,2016-12
2016-12-31,21374061,90954178,-69580117,덴마크,2016-12
2016-12-31,19473002,226059,19246943,피지,2016-12
2016-12-31,18765840,1973234,16792606,가나,2016-12
2016-12-31,16526327,2087372,14438955,케냐,2016-12
2016-12-31,14389438,2643915,11745523,튀니지,2016-12
2016-12-31,13001759,661773,12339986,몽골,2016-12
2016-12-31,12724164,326876,12397288,파라과이,2016-12
2016-12-31,12686000,1012613,11673387,엘살바도르,2016-12
2016-12-31,11657582,1056812,10600770,라오스,2016-12
2016-12-31,11457717,7081612,4376105,불가리아,2016-12
2016-12-31,10110148,3996891,6113257,트리니다드 토바고,2016-12
2016-12-31,9917669,1104754,8812915,온두라스,2016-12
2016-12-31,9488574,945914,8542660,니카라과,2016-12
2016-12-31,9353622,5838547,3515075,탄자니아,2016-12
2016-12-31,9336191,862945,8473246,수단,2016-12
2016-12-31,9173912,2797028,6376884,예맨,2016-12
2016-12-31,9096069,2284908,6811161,조지아,2016-12
2016-12-31,9007018,235756,8771262,팔레스타인 해방기구,2016-12
2016-12-31,8936216,5624091,3312125,우루과이,2016-12
2016-12-31,8908965,5254552,3654413,라트비아,2016-12
2016-12-31,8877070,1619788,7257282,세르비아,2016-12
2016-12-31,8371577,683,8370894,투르크멘,2016-12
2016-12-31,8334844,21353707,-13018863,뉴 칼레도니아,2016-12
2016-12-31,7944049,37546,7906503,아제르바이잔,2016-12
2016-12-31,7769601,899353,6870248,모잠비크,2016-12
2016-12-31,7354310,10991021,-3636711,베네주엘라,2016-12
2016-12-31,6633537,2388470,4245067,아이슬란드,2016-12
2016-12-31,6505641,35342,6470299,키르기스스탄,2016-12
2016-12-31,6242506,1669102,4573404,코트디봐르,2016-12
2016-12-31,6186296,228383,5957913,괌,2016-12
2016-12-31,6158368,5492082,666286,에티오피아,2016-12
2016-12-31,5998507,3398510,2599997,벨라루스,2016-12
2016-12-31,5987755,44452190,-38464435,볼리비아,2016-12
2016-12-31,5851923,413966,5437957,알바니아,2016-12
2016-12-31,5816093,876664,4939429,마카오,2016-12
2016-12-31,5768986,30437738,-24668752,파푸아 뉴기니,2016-12
2016-12-31,5522135,156200,5365935,아이티,2016-12
2016-12-31,4968109,1383,4966726,말리,2016-12
2016-12-31,4817007,5304112,-487105,기니,2016-12
2016-12-31,4570291,2465,4567826,지부티,2016-12
2016-12-31,4560830,7497275,-2936445,에스토니아,2016-12
2016-12-31,4190542,4016138,174404,몰타,2016-12
2016-12-31,3990106,36156341,-32166235,브루나이,2016-12
2016-12-31,3508077,10570173,-7062096,마다카스카르,2016-12
2016-12-31,3373831,513,3373318,불령 리유니온 코모도 제도,2016-12
2016-12-31,3163361,1686,3161675,팔라우,2016-12
2016-12-31,3100385,1609923,1490462,세네갈,2016-12
2016-12-31,2987126,234901,2752225,모리셔스,2016-12
2016-12-31,2854549,115208,2739341,르완다,2016-12
2016-12-31,2748496,89278,2659218,네팔,2016-12
2016-12-31,2615090,133212,2481878,마세도니아,2016-12
2016-12-31,2155607,0,2155607,아루바,2016-12
2016-12-31,2079935,188287,1891648,부르키나 파소,2016-12
2016-12-31,1985037,29424,1955613,가봉,2016-12
2016-12-31,1963472,1748030,215442,콩고,2016-12
2016-12-31,1954053,35536626,-33582573,기타국,2016-12
2016-12-31,1931341,3519,1927822,몰디브,2016-12
2016-12-31,1901023,227800,1673223,자마이카,2016-12
2016-12-31,1801038,495,1800543,아프카니스탄,2016-12
2016-12-31,1728862,0,1728862,사모아,2016-12
2016-12-31,1650511,237107,1413404,아르메니아,2016-12
2016-12-31,1645084,103968,1541116,가이아나,2016-12
2016-12-31,1594541,1160328,434213,베닝,2016-12
2016-12-31,1592902,328706,1264196,말라위,2016-12
2016-12-31,1544534,2435989,-891455,시에라 리온,2016-12
2016-12-31,1493968,271399,1222569,쿠바,2016-12
2016-12-31,1483290,52970845,-51487555,잠비아,2016-12
2016-12-31,1479419,853702,625717,세이쉘,2016-12
2016-12-31,1383116,1609014,-225898,타지크,2016-12
2016-12-31,1349259,91892,1257367,카메룬,2016-12
2016-12-31,1344253,97706,1246547,바베이도스,2016-12
2016-12-31,1261489,892,1260597,네덜란드 열도,2016-12
2016-12-31,1193311,226369,966942,북마리아나 군도,2016-12
2016-12-31,1188833,6558357,-5369524,룩셈부르그,2016-12
2016-12-31,1143667,61,1143606,버뮤다,2016-12
2016-12-31,1106824,148439,958385,짐바브웨,2016-12
2016-12-31,1082801,89062,993739,보츠와나,2016-12
2016-12-31,1069093,32709585,-31640492,콩고민주공화국,2016-12
2016-12-31,1019949,738459,281490,리히텐슈타인,2016-12
2016-12-31,1018060,3926264,-2908204,모리타니,2016-12
2016-12-31,952847,31744,921103,불령 폴리네시아,2016-12
2016-12-31,870212,533527,336685,몰도바,2016-12
2016-12-31,818012,46,817966,벨리제,2016-12
2016-12-31,766514,0,766514,세인트 마틴,2016-12
2016-12-31,739007,230,738777,바하마,2016-12
2016-12-31,670894,0,670894,영령 캐이맨 군도,2016-12
2016-12-31,625326,25881,599445,챠드,2016-12
2016-12-31,571289,412831,158458,소말리아,2016-12
2016-12-31,543477,0,543477,마이크로네시아,2016-12
2016-12-31,512962,0,512962,큐라소,2016-12
2016-12-31,509422,0,509422,마티니크,2016-12
2016-12-31,501631,204744,296887,통가,2016-12
2016-12-31,456287,15592,440695,키리바티,2016-12
2016-12-31,454751,53147,401604,티모르,2016-12
2016-12-31,408276,22333,385943,과델로프,2016-12
2016-12-31,406991,0,406991,부탄,2016-12
2016-12-31,405060,1694,403366,니제르,2016-12
2016-12-31,398601,710793,-312192,우간다,2016-12
2016-12-31,370501,3294397,-2923896,안티가 바부다,2016-12
2016-12-31,348305,0,348305,세인트 루시아,2016-12
2016-12-31,320841,2900,317941,세인트 키츠 네비스,2016-12
2016-12-31,295035,1420474,-1125439,보스니아-헤르체고비나,2016-12
2016-12-31,291699,230,291469,도미니카,2016-12
2016-12-31,287241,9147047,-8859806,바누아투,2016-12
2016-12-31,283253,0,283253,그레나다,2016-12
2016-12-31,280452,149583,130869,스와질랜드,2016-12
2016-12-31,267084,306,266778,카보 베르데,2016-12
2016-12-31,258285,126427,131858,수리남,2016-12
2016-12-31,235392,42518,192874,아메리칸 사모아,2016-12
2016-12-31,227735,0,227735,불령 가이아나,2016-12
2016-12-31,203333,0,203333,세인트 빈센트 그레나딘,2016-12
2016-12-31,166218,26550695,-26384477,적도 기니,2016-12
2016-12-31,154926,12776547,-12621621,나미비아,2016-12
2016-12-31,149216,306,148910,투르크 & 카이코스 군도,2016-12
2016-12-31,125640,0,125640,투발루,2016-12
2016-12-31,122277,1039358,-917081,솔로몬 군도,2016-12
2016-12-31,88216,20829,67387,산마리노,2016-12
2016-12-31,70115,9300,60815,미령 버진군도,2016-12
2016-12-31,67322,60505,6817,영령 버진군도,2016-12
2016-12-31,49919,186932,-137013,감비아,2016-12
2016-12-31,47068,300,46768,지브랄타,2016-12
2016-12-31,41996,347,41649,몬테네그로,2016-12
2016-12-31,28311,19,28292,나우루,2016-12
2016-12-31,26250,617,25633,레소토,2016-12
2016-12-31,17814,101,17713,앙귈라,2016-12
2016-12-31,17160,564643,-547483,모나코,2016-12
2016-12-31,17117,0,17117,국제통화기금,2016-12
2016-12-31,15782,10282,5500,몬트세라트,2016-12
2016-12-31,9800,0,9800,왈라스 & 퓨투나 군도,2016-12
2016-12-31,9420,454705,-445285,코모로스,2016-12
2016-12-31,6289,7675,-1386,부룬디,2016-12
2016-12-31,1638,1613,25,파로에 군도,2016-12
2016-12-31,1287,0,1287,에리트리아,2016-12
2016-12-31,922,7057,-6135,안도라,2016-12
2016-12-31,214,276,-62,건지,2016-12
2016-12-31,143,0,143,남수단,2016-12
2016-12-31,41,0,41,저어지,2016-12
2016-12-31,0,18414,-18414,니우에,2016-12
2016-12-31,0,34052,-34052,세인트 헬레나,2016-12
2016-12-31,0,2642,-2642,상토메 프린스페,2016-12
2016-12-31,0,612,-612,영령 인도양,2016-12
2016-12-31,0,17819,-17819,중앙아프리카공화국,2016-12
2016-12-31,0,380,-380,코스 군도,2016-12
2016-12-31,0,401369,-401369,포클랜드 군도,2016-12
2016-12-31,0,3466,-3466,토켈라우,2016-12
2016-12-31,0,251199,-251199,그린랜드,2016-12
2016-12-31,0,229656,-229656,기네비소,2016-12
2017-01-31,10754709285,7962488755,2792220530,중국,2017-01
2017-01-31,4940100924,3969131898,970969026,미국,2017-01
2017-01-31,2791265431,1188064902,1603200529,베트남,2017-01
2017-01-31,2721286087,173533847,2547752240,홍콩,2017-01
2017-01-31,2130047971,3759195779,-1629147808,일본,2017-01
2017-01-31,1113441388,385229809,728211579,인도,2017-01
2017-01-31,1028381585,1451174291,-422792706,대만,2017-01
2017-01-31,861095082,336138839,524956243,멕시코,2017-01
2017-01-31,820450858,1354979672,-534528814,독일,2017-01
2017-01-31,801622769,717073531,84549238,싱가포르,2017-01
2017-01-31,672080919,1758901517,-1086820598,호주,2017-01
2017-01-31,650813677,346314309,304499368,필리핀,2017-01
2017-01-31,576674947,373837210,202837737,태국,2017-01
2017-01-31,567530748,721080363,-153549615,인도네시아,2017-01
2017-01-31,564290557,601840448,-37549891,말레이시아,2017-01
2017-01-31,457305246,724511163,-267205917,아랍에미리트 연합,2017-01
2017-01-31,449005461,286100893,162904568,브라질,2017-01
2017-01-31,413461634,600,413461034,마샬군도,2017-01
2017-01-31,376388797,914805070,-538416273,러시아 연방,2017-01
2017-01-31,373781692,1421908771,-1048127079,사우디아라비아,2017-01
2017-01-31,364788366,112211826,252576540,벨기에,2017-01
2017-01-31,357438208,35847868,321590340,그리스,2017-01
2017-01-31,356207755,38973194,317234561,튀르키예,2017-01
2017-01-31,352512895,87007,352425888,라이베리아,2017-01
2017-01-31,344458160,465104141,-120645981,캐나다,2017-01
2017-01-31,327842205,785219792,-457377587,이란,2017-01
2017-01-31,313259696,564236446,-250976750,영국,2017-01
2017-01-31,273484669,396437316,-122952647,네덜란드,2017-01
2017-01-31,259894844,391642315,-131747471,이탈리아,2017-01
2017-01-31,247022028,42686887,204335141,폴란드,2017-01
2017-01-31,242258685,12038050,230220635,슬로바키아,2017-01
2017-01-31,233088932,113204768,119884164,노르웨이,2017-01
2017-01-31,213005807,184255044,28750763,스페인,2017-01
2017-01-31,183099697,423533794,-240434097,프랑스,2017-01
2017-01-31,165922906,51632532,114290374,체코공화국,2017-01
2017-01-31,155380623,11079622,144301001,파나마,2017-01
2017-01-31,132022836,271097319,-139074483,칠레,2017-01
2017-01-31,129089927,6837196,122252731,슬로베니아,2017-01
2017-01-31,122871390,4527785,118343605,이집트,2017-01
2017-01-31,115539018,55650116,59888902,헝가리,2017-01
2017-01-31,103483108,21271893,82211215,방글라데시,2017-01
2017-01-31,102196936,82299742,19897194,이스라엘,2017-01
2017-01-31,101049333,623112238,-522062905,이라크,2017-01
2017-01-31,97669480,747968122,-650298642,쿠웨이트,2017-01
2017-01-31,91131969,414,91131555,맨섬,2017-01
2017-01-31,82983244,89069823,-6086579,뉴질랜드,2017-01
2017-01-31,81963481,99871027,-17907546,오스트리아,2017-01
2017-01-31,71726188,108898005,-37171817,콜롬비아,2017-01
2017-01-31,69373581,33882496,35491085,앙골라,2017-01
2017-01-31,66679856,15106644,51573212,파키스탄,2017-01
2017-01-31,63826212,2084454,61741758,우즈베키스탄,2017-01
2017-01-31,62335145,126026560,-63691415,스웨덴,2017-01
2017-01-31,60072754,32014993,28057761,알제리,2017-01
2017-01-31,55071506,4697093,50374413,요르단,2017-01
2017-01-31,52382763,182296196,-129913433,남아프리카공화국,2017-01
2017-01-31,50252941,33153910,17099031,미얀마,2017-01
2017-01-31,46778160,23611506,23166654,캄보디아,2017-01
2017-01-31,46537852,207334762,-160796910,페루,2017-01
2017-01-31,45557898,68051751,-22493853,아르헨티나,2017-01
2017-01-31,37786926,97788645,-60001719,아일랜드,2017-01
2017-01-31,35780024,1085605786,-1049825762,카타르,2017-01
2017-01-31,35424363,5359031,30065332,몰타,2017-01
2017-01-31,34434835,8712760,25722075,에쿠아도르,2017-01
2017-01-31,33196790,20529344,12667446,포루투갈,2017-01
2017-01-31,30754752,53265934,-22511182,루마니아,2017-01
2017-01-31,28938282,53126003,-24187721,덴마크,2017-01
2017-01-31,27649217,240020023,-212370806,오만,2017-01
2017-01-31,27605956,186306470,-158700514,스위스,2017-01
2017-01-31,26442481,67896035,-41453554,핀란드,2017-01
2017-01-31,23760478,5880125,17880353,리투아니아,2017-01
2017-01-31,21151864,7743741,13408123,도미니카 공화국,2017-01
2017-01-31,21102624,72898868,-51796244,나이지리아,2017-01
2017-01-31,20299773,114310124,-94010351,리비아,2017-01
2017-01-31,19296218,13949194,5347024,카자흐스탄,2017-01
2017-01-31,19267506,6003589,13263917,스리랑카,2017-01
2017-01-31,19170957,6189620,12981337,바레인,2017-01
2017-01-31,18434911,68957410,-50522499,우크라이나,2017-01
2017-01-31,18042771,6867720,11175051,과테말라,2017-01
2017-01-31,17844855,12042435,5802420,모로코,2017-01
2017-01-31,15858834,2097057,13761777,가나,2017-01
2017-01-31,15748279,0,15748279,마이크로네시아,2017-01
2017-01-31,14425260,44607,14380653,불령 폴리네시아,2017-01
2017-01-31,13894596,2843759,11050837,케냐,2017-01
2017-01-31,12822835,11276335,1546500,코스타리카,2017-01
2017-01-31,12782324,1837207,10945117,레바논,2017-01
2017-01-31,12215291,1031823,11183468,엘살바도르,2017-01
2017-01-31,12045547,15830520,-3784973,탄자니아,2017-01
2017-01-31,11880133,692833,11187300,라오스,2017-01
2017-01-31,11634535,11610795,23740,푸에르토리코,2017-01
2017-01-31,11069869,3818832,7251037,예맨,2017-01
2017-01-31,10993063,2901954,8091109,세르비아,2017-01
2017-01-31,10878619,3685579,7193040,튀니지,2017-01
2017-01-31,10631090,1224725,9406365,수단,2017-01
2017-01-31,10194587,358770,9835817,몽골,2017-01
2017-01-31,10185027,812416,9372611,피지,2017-01
2017-01-31,9107378,33469,9073909,투르크멘,2017-01
2017-01-31,9016209,38891949,-29875740,트리니다드 토바고,2017-01
2017-01-31,8752323,483524,8268799,파라과이,2017-01
2017-01-31,8708074,2072,8706002,시리아,2017-01
2017-01-31,8365634,18415024,-10049390,불가리아,2017-01
2017-01-31,8137559,1660977,6476582,온두라스,2017-01
2017-01-31,7949545,33428,7916117,지부티,2017-01
2017-01-31,7822058,2354493,5467565,베네주엘라,2017-01
2017-01-31,7373001,7574358,-201357,우루과이,2017-01
2017-01-31,7246744,708095,6538649,코트디봐르,2017-01
2017-01-31,6264218,558763,5705455,니카라과,2017-01
2017-01-31,6263838,5559870,703968,에스토니아,2017-01
2017-01-31,6175591,2608517,3567074,세네갈,2017-01
2017-01-31,6125927,6854943,-729016,에티오피아,2017-01
2017-01-31,5748658,16645874,-10897216,볼리비아,2017-01
2017-01-31,5640865,44517,5596348,말리,2017-01
2017-01-31,5366678,11077,5355601,아프카니스탄,2017-01
2017-01-31,5181738,1575979,3605759,조지아,2017-01
2017-01-31,5178636,94641,5083995,팔레스타인 해방기구,2017-01
2017-01-31,5104961,0,5104961,사모아,2017-01
2017-01-31,4706145,135262,4570883,아이티,2017-01
2017-01-31,4674459,9022,4665437,키르기스스탄,2017-01
2017-01-31,4327110,5705263,-1378153,기니,2017-01
2017-01-31,3953372,69923008,-65969636,브루나이,2017-01
2017-01-31,3901410,273277,3628133,괌,2017-01
2017-01-31,3898509,681527,3216982,크로아티아,2017-01
2017-01-31,3489937,45646252,-42156315,파푸아 뉴기니,2017-01
2017-01-31,3098962,21725,3077237,아제르바이잔,2017-01
2017-01-31,3023585,488852,2534733,마카오,2017-01
2017-01-31,2954383,6198065,-3243682,마다카스카르,2017-01
2017-01-31,2880394,6477451,-3597057,라트비아,2017-01
2017-01-31,2783442,2107333,676109,아이슬란드,2017-01
2017-01-31,2631946,14762045,-12130099,사이프러스,2017-01
2017-01-31,2447102,16495773,-14048671,모잠비크,2017-01
2017-01-31,2366475,1596748,769727,베닝,2017-01
2017-01-31,2259981,6334509,-4074528,말라위,2017-01
2017-01-31,2191573,315339,1876234,쿠바,2017-01
2017-01-31,1923106,96472,1826634,네팔,2017-01
2017-01-31,1780946,116742,1664204,세이쉘,2017-01
2017-01-31,1764750,1314701,450049,콩고,2017-01
2017-01-31,1683635,0,1683635,몰디브,2017-01
2017-01-31,1633993,277942,1356051,르완다,2017-01
2017-01-31,1600590,434913,1165677,모리셔스,2017-01
2017-01-31,1559615,5314442,-3754827,뉴 칼레도니아,2017-01
2017-01-31,1506419,33760,1472659,부르키나 파소,2017-01
2017-01-31,1403202,63940,1339262,벨리제,2017-01
2017-01-31,1301814,40163,1261651,가이아나,2017-01
2017-01-31,1269224,770729,498495,벨라루스,2017-01
2017-01-31,1234723,607094,627629,자마이카,2017-01
2017-01-31,1210638,74284,1136354,북마리아나 군도,2017-01
2017-01-31,1157506,224432,933074,카메룬,2017-01
2017-01-31,1152567,188751,963816,마세도니아,2017-01
2017-01-31,1126061,65218033,-64091972,콩고민주공화국,2017-01
2017-01-31,1070306,30668,1039638,보츠와나,2017-01
2017-01-31,1020357,38201793,-37181436,잠비아,2017-01
2017-01-31,1013185,1659895,-646710,타지크,2017-01
2017-01-31,878336,1195607,-317271,짐바브웨,2017-01
2017-01-31,827288,7036348,-6209060,룩셈부르그,2017-01
2017-01-31,825188,2562696,-1737508,토고,2017-01
2017-01-31,783654,41247342,-40463688,기타국,2017-01
2017-01-31,758395,94928,663467,소말리아,2017-01
2017-01-31,723009,12680,710329,불령 리유니온 코모도 제도,2017-01
2017-01-31,717657,37522123,-36804466,가봉,2017-01
2017-01-31,625943,0,625943,아루바,2017-01
2017-01-31,579967,431,579536,바하마,2017-01
2017-01-31,564563,810634,-246071,리히텐슈타인,2017-01
2017-01-31,559888,3064452,-2504564,모리타니,2017-01
2017-01-31,530284,43,530241,부룬디,2017-01
2017-01-31,522883,75582,447301,알바니아,2017-01
2017-01-31,508652,6974,501678,네덜란드 열도,2017-01
2017-01-31,434887,3527248,-3092361,스와질랜드,2017-01
2017-01-31,416529,1781758,-1365229,우간다,2017-01
2017-01-31,404372,9976,394396,도미니카,2017-01
2017-01-31,383173,0,383173,지브랄타,2017-01
2017-01-31,379984,65142,314842,아메리칸 사모아,2017-01
2017-01-31,378532,0,378532,세인트 루시아,2017-01
2017-01-31,377300,1284570,-907270,보스니아-헤르체고비나,2017-01
2017-01-31,347686,4233,343453,영령 캐이맨 군도,2017-01
2017-01-31,337198,289850,47348,아르메니아,2017-01
2017-01-31,296970,615325,-318355,키리바티,2017-01
2017-01-31,291353,302259,-10906,수리남,2017-01
2017-01-31,285874,454927,-169053,몰도바,2017-01
2017-01-31,274412,0,274412,세인트 마틴,2017-01
2017-01-31,259180,176169,83011,솔로몬 군도,2017-01
2017-01-31,249338,608,248730,레소토,2017-01
2017-01-31,237720,1384486,-1146766,시에라 리온,2017-01
2017-01-31,228499,53061,175438,바누아투,2017-01
2017-01-31,225946,0,225946,버뮤다,2017-01
2017-01-31,225060,182435,42625,티모르,2017-01
2017-01-31,215957,5367,210590,나미비아,2017-01
2017-01-31,209005,0,209005,영령 버진군도,2017-01
2017-01-31,185412,0,185412,팔라우,2017-01
2017-01-31,184181,40414,143767,바베이도스,2017-01
2017-01-31,181088,0,181088,과델로프,2017-01
2017-01-31,176305,0,176305,마티니크,2017-01
2017-01-31,147270,614,146656,몬테네그로,2017-01
2017-01-31,142753,0,142753,그레나다,2017-01
2017-01-31,132640,0,132640,투르크 & 카이코스 군도,2017-01
2017-01-31,130915,855000,-724085,안티가 바부다,2017-01
2017-01-31,118308,20700,97608,큐라소,2017-01
2017-01-31,115314,88,115226,카보 베르데,2017-01
2017-01-31,96590,215,96375,부탄,2017-01
2017-01-31,76544,0,76544,챠드,2017-01
2017-01-31,51826,0,51826,상토메 프린스페,2017-01
2017-01-31,47250,40550,6700,중앙아프리카공화국,2017-01
2017-01-31,31579,0,31579,나우루,2017-01
2017-01-31,25298,0,25298,세인트 키츠 네비스,2017-01
2017-01-31,22672,0,22672,불령 가이아나,2017-01
2017-01-31,22056,76688,-54632,통가,2017-01
2017-01-31,20166,10313,9853,니제르,2017-01
2017-01-31,14506,14425,81,안도라,2017-01
2017-01-31,10574,0,10574,세인트 빈센트 그레나딘,2017-01
2017-01-31,6374,0,6374,앙귈라,2017-01
2017-01-31,5370,402473,-397103,코모로스,2017-01
2017-01-31,5357,226672,-221315,감비아,2017-01
2017-01-31,4905,24934,-20029,산마리노,2017-01
2017-01-31,2993,3319,-326,미령 버진군도,2017-01
2017-01-31,2547,36315871,-36313324,적도 기니,2017-01
2017-01-31,1800,105068,-103268,그린랜드,2017-01
2017-01-31,0,5407,-5407,마이너 아우틀링 합중국 군도,2017-01
2017-01-31,0,438521,-438521,모나코,2017-01
2017-01-31,0,74247,-74247,기네비소,2017-01
2017-01-31,0,32980,-32980,코스 군도,2017-01
2017-01-31,0,99519,-99519,토켈라우,2017-01
2017-01-31,0,483,-483,니우에,2017-01
2017-01-31,0,291,-291,세인트 헬레나,2017-01
2017-01-31,0,1733,-1733,남조지아 & 남샌드위치 군도,2017-01
2017-01-31,0,4812,-4812,세인트 바르탤르미,2017-01
2017-01-31,0,440,-440,몬트세라트,2017-01
2017-01-31,0,1655,-1655,세인트 피레 미켈론,2017-01
2017-02-28,11118131308,6600636728,4517494580,중국,2017-02
2017-02-28,5312452585,3754032783,1558419802,미국,2017-02
2017-02-28,3181296752,1016678129,2164618623,베트남,2017-02
2017-02-28,2854472744,112829551,2741643193,홍콩,2017-02
2017-02-28,2044853150,4468456344,-2423603194,일본,2017-02
2017-02-28,1132744306,1413593665,-280849359,대만,2017-02
2017-02-28,1126628731,394702329,731926402,인도,2017-02
2017-02-28,1089829066,677411478,412417588,말레이시아,2017-02
2017-02-28,913615810,360739732,552876078,멕시코,2017-02
2017-02-28,839079501,578759750,260319751,싱가포르,2017-02
2017-02-28,775712568,305726000,469986568,필리핀,2017-02
2017-02-28,690584842,801250565,-110665723,인도네시아,2017-02
2017-02-28,667960434,1428354128,-760393694,호주,2017-02
2017-02-28,664360094,1353843878,-689483784,독일,2017-02
2017-02-28,613475258,949764469,-336289211,러시아 연방,2017-02
2017-02-28,585724045,405876155,179847890,태국,2017-02
2017-02-28,539538488,7104445,532434043,마샬군도,2017-02
2017-02-28,456670596,53618877,403051719,튀르키예,2017-02
2017-02-28,447630483,205842715,241787768,브라질,2017-02
2017-02-28,403050303,609136210,-206085907,아랍에미리트 연합,2017-02
2017-02-28,401531668,306390116,95141552,네덜란드,2017-02
2017-02-28,391273953,454889862,-63615909,이라크,2017-02
2017-02-28,381351641,321576062,59775579,캐나다,2017-02
2017-02-28,369717170,1676770047,-1307052877,사우디아라비아,2017-02
2017-02-28,366905256,550240480,-183335224,영국,2017-02
2017-02-28,296578280,740799389,-444221109,이란,2017-02
2017-02-28,281958147,447199736,-165241589,이탈리아,2017-02
2017-02-28,250461024,49511403,200949621,폴란드,2017-02
2017-02-28,235624825,16189512,219435313,슬로바키아,2017-02
2017-02-28,222679849,428886398,-206206549,프랑스,2017-02
2017-02-28,215869452,122875952,92993500,스페인,2017-02
2017-02-28,204187566,119799620,84387946,벨기에,2017-02
2017-02-28,197081245,0,197081245,버뮤다,2017-02
2017-02-28,193230060,4245,193225815,바하마,2017-02
2017-02-28,162719384,50591281,112128103,체코공화국,2017-02
2017-02-28,158116428,32479437,125636991,그리스,2017-02
2017-02-28,150344830,111991,150232839,라이베리아,2017-02
2017-02-28,139006829,48249329,90757500,헝가리,2017-02
2017-02-28,130002039,7567840,122434199,슬로베니아,2017-02
2017-02-28,127521720,103794085,23727635,뉴질랜드,2017-02
2017-02-28,126963479,327224069,-200260590,칠레,2017-02
2017-02-28,117045882,11168746,105877136,파나마,2017-02
2017-02-28,113720794,3754026,109966768,이집트,2017-02
2017-02-28,100947256,28948234,71999022,사이프러스,2017-02
2017-02-28,99543065,73898420,25644645,이스라엘,2017-02
2017-02-28,95239048,65557049,29681999,알제리,2017-02
2017-02-28,91688706,24331585,67357121,방글라데시,2017-02
2017-02-28,82308309,89451827,-7143518,오스트리아,2017-02
2017-02-28,80615122,807118919,-726503797,쿠웨이트,2017-02
2017-02-28,79068260,68455038,10613222,아르헨티나,2017-02
2017-02-28,77999029,1495776,76503253,우즈베키스탄,2017-02
2017-02-28,76469841,158665030,-82195189,스웨덴,2017-02
2017-02-28,75924728,50962,75873766,앙골라,2017-02
2017-02-28,74873034,31666692,43206342,파키스탄,2017-02
2017-02-28,72064294,179191473,-107127179,페루,2017-02
2017-02-28,69131652,71426593,-2294941,콜롬비아,2017-02
2017-02-28,65906549,279841271,-213934722,남아프리카공화국,2017-02
2017-02-28,64560412,2994,64557418,영령 캐이맨 군도,2017-02
2017-02-28,55804866,6091940,49712926,요르단,2017-02
2017-02-28,52755312,73022474,-20267162,아일랜드,2017-02
2017-02-28,51020100,1168542493,-1117522393,카타르,2017-02
2017-02-28,47491495,22592403,24899092,캄보디아,2017-02
2017-02-28,46941490,31476359,15465131,루마니아,2017-02
2017-02-28,45495450,39337565,6157885,미얀마,2017-02
2017-02-28,44080486,150,44080336,맨섬,2017-02
2017-02-28,38871725,9709857,29161868,에쿠아도르,2017-02
2017-02-28,38516975,73358710,-34841735,카자흐스탄,2017-02
2017-02-28,37032484,20870764,16161720,포루투갈,2017-02
2017-02-28,36581099,87625333,-51044234,나이지리아,2017-02
2017-02-28,32282565,58062117,-25779552,덴마크,2017-02
2017-02-28,30935189,201238019,-170302830,스위스,2017-02
2017-02-28,26604426,245200826,-218596400,오만,2017-02
2017-02-28,25910760,88182809,-62272049,우크라이나,2017-02
2017-02-28,25300817,4925615,20375202,리투아니아,2017-02
2017-02-28,25128846,8032278,17096568,도미니카 공화국,2017-02
2017-02-28,22153175,12265678,9887497,바레인,2017-02
2017-02-28,21002636,10750313,10252323,과테말라,2017-02
2017-02-28,20187216,7253534,12933682,스리랑카,2017-02
2017-02-28,20177715,86968249,-66790534,리비아,2017-02
2017-02-28,20169501,129340973,-109171472,노르웨이,2017-02
2017-02-28,20004777,10852804,9151973,모로코,2017-02
2017-02-28,18265333,15362287,2903046,코스타리카,2017-02
2017-02-28,17437525,86307218,-68869693,핀란드,2017-02
2017-02-28,16361561,3867241,12494320,가나,2017-02
2017-02-28,15427036,540879,14886157,탄자니아,2017-02
2017-02-28,14982122,1405226,13576896,케냐,2017-02
2017-02-28,14788242,49827,14738415,불령 폴리네시아,2017-02
2017-02-28,14450523,342045,14108478,몽골,2017-02
2017-02-28,14114956,302014,13812942,피지,2017-02
2017-02-28,13346765,13731977,-385212,푸에르토리코,2017-02
2017-02-28,12786511,3158167,9628344,세네갈,2017-02
2017-02-28,12425794,973344,11452450,엘살바도르,2017-02
2017-02-28,12238797,1135,12237662,투르크멘,2017-02
2017-02-28,12120578,3218602,8901976,튀니지,2017-02
2017-02-28,12009506,1651,12007855,시리아,2017-02
2017-02-28,11381237,1848279,9532958,수단,2017-02
2017-02-28,11025040,3856083,7168957,트리니다드 토바고,2017-02
2017-02-28,10207490,6144128,4063362,레바논,2017-02
2017-02-28,9485241,2375710,7109531,에티오피아,2017-02
2017-02-28,9324311,227,9324084,지부티,2017-02
2017-02-28,8985640,705781,8279859,라오스,2017-02
2017-02-28,8833429,15451188,-6617759,불가리아,2017-02
2017-02-28,8490890,521632,7969258,파라과이,2017-02
2017-02-28,8403815,13587178,-5183363,뉴 칼레도니아,2017-02
2017-02-28,8095034,795493,7299541,니카라과,2017-02
2017-02-28,7851544,2915753,4935791,온두라스,2017-02
2017-02-28,7559473,1404459,6155014,코트디봐르,2017-02
2017-02-28,6933034,4300199,2632835,에스토니아,2017-02
2017-02-28,6779531,107397,6672134,팔레스타인 해방기구,2017-02
2017-02-28,6608791,5772180,836611,우루과이,2017-02
2017-02-28,6569154,55986,6513168,키르기스스탄,2017-02
2017-02-28,6195406,152848,6042558,아이티,2017-02
2017-02-28,6132772,455766,5677006,솔로몬 군도,2017-02
2017-02-28,5447245,445588,5001657,마카오,2017-02
2017-02-28,5203855,2420160,2783695,예맨,2017-02
2017-02-28,5050055,1337424,3712631,세르비아,2017-02
2017-02-28,4960465,208746,4751719,아제르바이잔,2017-02
2017-02-28,4632533,33079777,-28447244,볼리비아,2017-02
2017-02-28,4326163,1853032,2473131,아이슬란드,2017-02
2017-02-28,4313417,197323,4116094,네팔,2017-02
2017-02-28,3880338,6583454,-2703116,기니,2017-02
2017-02-28,3843575,852630,2990945,크로아티아,2017-02
2017-02-28,3778197,839085,2939112,베네주엘라,2017-02
2017-02-28,3697643,5408016,-1710373,라트비아,2017-02
2017-02-28,3547901,58546383,-54998482,몰타,2017-02
2017-02-28,3439224,6531337,-3092113,마다카스카르,2017-02
2017-02-28,3381142,72172068,-68790926,브루나이,2017-02
2017-02-28,3374188,360510,3013678,괌,2017-02
2017-02-28,3356666,2651465,705201,베닝,2017-02
2017-02-28,3173805,5574185,-2400380,조지아,2017-02
2017-02-28,2888425,0,2888425,사모아,2017-02
2017-02-28,2843291,22236502,-19393211,모잠비크,2017-02
2017-02-28,2838546,448079,2390467,모리셔스,2017-02
2017-02-28,2693247,0,2693247,네덜란드 열도,2017-02
2017-02-28,2624899,0,2624899,아프카니스탄,2017-02
2017-02-28,2594475,33957,2560518,자마이카,2017-02
2017-02-28,2428178,1354465,1073713,파푸아 뉴기니,2017-02
2017-02-28,2335538,22488403,-20152865,잠비아,2017-02
2017-02-28,2170024,224392,1945632,가이아나,2017-02
2017-02-28,2125149,37497,2087652,쿠바,2017-02
2017-02-28,2121447,2683669,-562222,타지크,2017-02
2017-02-28,1956341,221729,1734612,짐바브웨,2017-02
2017-02-28,1925513,476509,1449004,콩고,2017-02
2017-02-28,1703127,54631,1648496,부르키나 파소,2017-02
2017-02-28,1678448,98329,1580119,카메룬,2017-02
2017-02-28,1614439,6187082,-4572643,벨라루스,2017-02
2017-02-28,1528947,143040,1385907,마세도니아,2017-02
2017-02-28,1440389,2938918,-1498529,토고,2017-02
2017-02-28,1398297,249608,1148689,세이쉘,2017-02
2017-02-28,1353220,39727670,-38374450,콩고민주공화국,2017-02
2017-02-28,1070079,0,1070079,아루바,2017-02
2017-02-28,1025835,128998,896837,북마리아나 군도,2017-02
2017-02-28,1002600,1278,1001322,말리,2017-02
2017-02-28,967151,5138787,-4171636,룩셈부르그,2017-02
2017-02-28,949160,0,949160,불령 리유니온 코모도 제도,2017-02
2017-02-28,813017,41679507,-40866490,니제르,2017-02
2017-02-28,760613,1862,758751,세인트 키츠 네비스,2017-02
2017-02-28,748862,82031,666831,벨리제,2017-02
2017-02-28,686815,1217486,-530671,리히텐슈타인,2017-02
2017-02-28,681622,218396,463226,키리바티,2017-02
2017-02-28,670530,205461,465069,알바니아,2017-02
2017-02-28,660703,178439,482264,소말리아,2017-02
2017-02-28,627329,833,626496,몰디브,2017-02
2017-02-28,621409,2027,619382,가봉,2017-02
2017-02-28,613825,0,613825,마이크로네시아,2017-02
2017-02-28,574660,807616,-232956,몰도바,2017-02
2017-02-28,573008,331,572677,과델로프,2017-02
2017-02-28,563250,55910,507340,보츠와나,2017-02
2017-02-28,548540,52929078,-52380538,기타국,2017-02
2017-02-28,517736,0,517736,큐라소,2017-02
2017-02-28,497474,196424,301050,스와질랜드,2017-02
2017-02-28,489536,77547,411989,우간다,2017-02
2017-02-28,484095,7497231,-7013136,말라위,2017-02
2017-02-28,458962,0,458962,세인트 마틴,2017-02
2017-02-28,454014,450,453564,티모르,2017-02
2017-02-28,414999,168479,246520,수리남,2017-02
2017-02-28,365016,0,365016,마티니크,2017-02
2017-02-28,312684,590254,-277570,바누아투,2017-02
2017-02-28,292230,0,292230,남조지아 & 남샌드위치 군도,2017-02
2017-02-28,291465,180335,111130,아르메니아,2017-02
2017-02-28,263040,0,263040,안티가 바부다,2017-02
2017-02-28,249651,2512,247139,팔라우,2017-02
2017-02-28,249531,21372,228159,바베이도스,2017-02
2017-02-28,249230,72898,176332,르완다,2017-02
2017-02-28,239538,46920,192618,감비아,2017-02
2017-02-28,232970,0,232970,부탄,2017-02
2017-02-28,225424,0,225424,세인트 루시아,2017-02
2017-02-28,221030,766113,-545083,보스니아-헤르체고비나,2017-02
2017-02-28,219973,273243,-53270,아메리칸 사모아,2017-02
2017-02-28,216925,23586,193339,도미니카,2017-02
2017-02-28,208380,0,208380,불령 가이아나,2017-02
2017-02-28,198688,0,198688,영령 버진군도,2017-02
2017-02-28,194346,317,194029,세인트 빈센트 그레나딘,2017-02
2017-02-28,176974,951383,-774409,모리타니,2017-02
2017-02-28,176608,1282334,-1105726,나미비아,2017-02
2017-02-28,122856,34,122822,몬테네그로,2017-02
2017-02-28,115107,1361788,-1246681,시에라 리온,2017-02
2017-02-28,84724,0,84724,그레나다,2017-02
2017-02-28,73088,2497018,-2423930,지브랄타,2017-02
2017-02-28,57291,208274,-150983,중앙아프리카공화국,2017-02
2017-02-28,49244,23620,25624,나우루,2017-02
2017-02-28,42103,0,42103,카보 베르데,2017-02
2017-02-28,40650,9738,30912,미령 버진군도,2017-02
2017-02-28,32900,74136,-41236,적도 기니,2017-02
2017-02-28,28087,0,28087,챠드,2017-02
2017-02-28,22526,378309,-355783,기네비소,2017-02
2017-02-28,11969,97840,-85871,산마리노,2017-02
2017-02-28,8427,119,8308,포클랜드 군도,2017-02
2017-02-28,4000,110072,-106072,부룬디,2017-02
2017-02-28,2634,128775,-126141,쿡 아일랜드,2017-02
2017-02-28,2119,4153,-2034,토켈라우,2017-02
2017-02-28,1509,0,1509,남수단,2017-02
2017-02-28,731,0,731,앙귈라,2017-02
2017-02-28,107,201,-94,에리트리아,2017-02
2017-02-28,15,1944,-1929,파로에 군도,2017-02
2017-02-28,0,3559,-3559,니우에,2017-02
2017-02-28,0,163,-163,코스 군도,2017-02
2017-02-28,0,7,-7,교황청,2017-02
2017-02-28,0,711,-711,투르크 & 카이코스 군도,2017-02
2017-02-28,0,196,-196,스발비드 군도,2017-02
2017-02-28,0,14250,-14250,안도라,2017-02
2017-02-28,0,191633,-191633,안타티카,2017-02
2017-02-28,0,8000,-8000,세인트 헬레나,2017-02
2017-02-28,0,93,-93,저어지,2017-02
2017-02-28,0,7499,-7499,코모로스,2017-02
2017-02-28,0,90110,-90110,그린랜드,2017-02
2017-02-28,0,658171,-658171,모나코,2017-02
2017-03-31,11655510517,8825357418,2830153099,중국,2017-03
2017-03-31,6200928199,4411901024,1789027175,미국,2017-03
2017-03-31,4330456598,1336028689,2994427909,베트남,2017-03
2017-03-31,3223394812,182018102,3041376710,홍콩,2017-03
2017-03-31,2395932082,5157588800,-2761656718,일본,2017-03
2017-03-31,1362189827,441163372,921026455,인도,2017-03
2017-03-31,1314244633,1580644080,-266399447,대만,2017-03
2017-03-31,1027147723,797055992,230091731,싱가포르,2017-03
2017-03-31,986178204,370002,985808202,마샬군도,2017-03
2017-03-31,911482907,346686319,564796588,멕시코,2017-03
2017-03-31,877485669,336503224,540982445,필리핀,2017-03
2017-03-31,818004262,856436695,-38432433,인도네시아,2017-03
2017-03-31,802005999,1761164264,-959158265,호주,2017-03
2017-03-31,749056897,1833983019,-1084926122,독일,2017-03
2017-03-31,684175026,939751457,-255576431,아랍에미리트 연합,2017-03
2017-03-31,670437718,827735652,-157297934,러시아 연방,2017-03
2017-03-31,622207582,461702146,160505436,태국,2017-03
2017-03-31,571301957,732692841,-161390884,말레이시아,2017-03
2017-03-31,521356024,504756878,16599146,영국,2017-03
2017-03-31,514490842,294512605,219978237,브라질,2017-03
2017-03-31,458506144,1641909136,-1183402992,사우디아라비아,2017-03
2017-03-31,457725065,464768785,-7043720,캐나다,2017-03
2017-03-31,456508734,74253138,382255596,튀르키예,2017-03
2017-03-31,377160934,504876524,-127715590,네덜란드,2017-03
2017-03-31,309804682,600021,309204661,알제리,2017-03
2017-03-31,301688007,1023745816,-722057809,이란,2017-03
2017-03-31,292410122,462877390,-170467268,이탈리아,2017-03
2017-03-31,270164150,527308692,-257144542,프랑스,2017-03
2017-03-31,260550221,75517,260474704,라이베리아,2017-03
2017-03-31,256299864,13970174,242329690,슬로바키아,2017-03
2017-03-31,251894167,54141087,197753080,폴란드,2017-03
2017-03-31,245891008,108,245890900,버뮤다,2017-03
2017-03-31,244384774,225413167,18971607,스페인,2017-03
2017-03-31,219451281,98148227,121303054,벨기에,2017-03
2017-03-31,197178118,61308435,135869683,덴마크,2017-03
2017-03-31,187120840,7640693,179480147,슬로베니아,2017-03
2017-03-31,164120520,47985484,116135036,체코공화국,2017-03
2017-03-31,146308609,331299655,-184991046,칠레,2017-03
2017-03-31,138501190,4184837,134316353,이집트,2017-03
2017-03-31,126526964,67901546,58625418,헝가리,2017-03
2017-03-31,125134633,103239388,21895245,뉴질랜드,2017-03
2017-03-31,121774253,31167734,90606519,방글라데시,2017-03
2017-03-31,120945347,115544064,5401283,이스라엘,2017-03
2017-03-31,111602065,71223221,40378844,파나마,2017-03
2017-03-31,101423522,884040096,-782616574,쿠웨이트,2017-03
2017-03-31,96602570,1399734,95202836,우즈베키스탄,2017-03
2017-03-31,88053845,36236892,51816953,파키스탄,2017-03
2017-03-31,87168136,213788533,-126620397,남아프리카공화국,2017-03
2017-03-31,86617855,102619031,-16001176,오스트리아,2017-03
2017-03-31,86468659,121,86468538,맨섬,2017-03
2017-03-31,86235167,538408022,-452172855,이라크,2017-03
2017-03-31,82631363,137895288,-55263925,노르웨이,2017-03
2017-03-31,74825664,98586788,-23761124,아일랜드,2017-03
2017-03-31,72232490,8163703,64068787,요르단,2017-03
2017-03-31,71700470,47948832,23751638,콜롬비아,2017-03
2017-03-31,71315877,24983958,46331919,앙골라,2017-03
2017-03-31,70081020,4015,70077005,바하마,2017-03
2017-03-31,69377397,32971622,36405775,아르헨티나,2017-03
2017-03-31,69225447,165563257,-96337810,페루,2017-03
2017-03-31,66869299,160742080,-93872781,스웨덴,2017-03
2017-03-31,63648228,43821830,19826398,미얀마,2017-03
2017-03-31,55525707,25683814,29841893,캄보디아,2017-03
2017-03-31,49210615,80337538,-31126923,카자흐스탄,2017-03
2017-03-31,44451308,13698195,30753113,에쿠아도르,2017-03
2017-03-31,42962924,828733568,-785770644,카타르,2017-03
2017-03-31,39248318,225007143,-185758825,스위스,2017-03
2017-03-31,38258708,42680694,-4421986,루마니아,2017-03
2017-03-31,35657235,37281750,-1624515,나이지리아,2017-03
2017-03-31,35017467,14481570,20535897,모로코,2017-03
2017-03-31,33463778,59505043,-26041265,그리스,2017-03
2017-03-31,32183838,22830272,9353566,포루투갈,2017-03
2017-03-31,30849502,609,30848893,투르크멘,2017-03
2017-03-31,28799414,36216927,-7417513,바레인,2017-03
2017-03-31,28198190,13572311,14625879,도미니카 공화국,2017-03
2017-03-31,28157826,8744175,19413651,스리랑카,2017-03
2017-03-31,27136162,294339634,-267203472,오만,2017-03
2017-03-31,26119518,4723307,21396211,튀니지,2017-03
2017-03-31,25610142,3536297,22073845,리비아,2017-03
2017-03-31,25070506,76747224,-51676718,핀란드,2017-03
2017-03-31,22990502,16606919,6383583,푸에르토리코,2017-03
2017-03-31,21251326,6300950,14950376,리투아니아,2017-03
2017-03-31,21070696,1725,21068971,시리아,2017-03
2017-03-31,21070402,13082660,7987742,코스타리카,2017-03
2017-03-31,18388781,34155606,-15766825,우크라이나,2017-03
2017-03-31,17927185,284003,17643182,몽골,2017-03
2017-03-31,17885273,2954512,14930761,가나,2017-03
2017-03-31,17699787,2783901,14915886,케냐,2017-03
2017-03-31,17044530,317912,16726618,파라과이,2017-03
2017-03-31,16928294,15441935,1486359,과테말라,2017-03
2017-03-31,16252042,5208526,11043516,레바논,2017-03
2017-03-31,15812706,1174940,14637766,수단,2017-03
2017-03-31,14839468,719895,14119573,팔레스타인 해방기구,2017-03
2017-03-31,13730889,1783076,11947813,엘살바도르,2017-03
2017-03-31,12410503,4134643,8275860,라오스,2017-03
2017-03-31,11987232,613,11986619,키르기스스탄,2017-03
2017-03-31,11162288,2653415,8508873,니카라과,2017-03
2017-03-31,10992534,14719594,-3727060,불가리아,2017-03
2017-03-31,10371545,1182945,9188600,베네주엘라,2017-03
2017-03-31,10351663,19358863,-9007200,뉴 칼레도니아,2017-03
2017-03-31,9731378,61485880,-51754502,브루나이,2017-03
2017-03-31,9528335,9880701,-352366,우루과이,2017-03
2017-03-31,9469084,750846,8718238,코트디봐르,2017-03
2017-03-31,9127903,1888390,7239513,세르비아,2017-03
2017-03-31,8645924,56325279,-47679355,볼리비아,2017-03
2017-03-31,8504472,168409,8336063,피지,2017-03
2017-03-31,8349461,29886547,-21537086,트리니다드 토바고,2017-03
2017-03-31,8121300,315096,7806204,탄자니아,2017-03
2017-03-31,8000131,2460800,5539331,에티오피아,2017-03
2017-03-31,7698547,5796488,1902059,라트비아,2017-03
2017-03-31,7435385,283216,7152169,아이티,2017-03
2017-03-31,7097110,1264831,5832279,솔로몬 군도,2017-03
2017-03-31,7027223,5312008,1715215,온두라스,2017-03
2017-03-31,7002333,108456,6893877,지부티,2017-03
2017-03-31,6730397,2910805,3819592,세네갈,2017-03
2017-03-31,6104472,3050283,3054189,예맨,2017-03
2017-03-31,6063997,5660760,403237,모잠비크,2017-03
2017-03-31,5315257,16974233,-11658976,에스토니아,2017-03
2017-03-31,4872966,1380463,3492503,크로아티아,2017-03
2017-03-31,4597616,2091833,2505783,아이슬란드,2017-03
2017-03-31,4426403,3545149,881254,조지아,2017-03
2017-03-31,4354467,0,4354467,말리,2017-03
2017-03-31,4198523,274733,3923790,괌,2017-03
2017-03-31,4120473,1634,4118839,아프카니스탄,2017-03
2017-03-31,4028384,38124,3990260,마이크로네시아,2017-03
2017-03-31,4009056,5291564,-1282508,기니,2017-03
2017-03-31,3749972,2012,3747960,사모아,2017-03
2017-03-31,3515821,54344,3461477,카메룬,2017-03
2017-03-31,3468467,3745585,-277118,몰타,2017-03
2017-03-31,3454483,225586,3228897,쿠바,2017-03
2017-03-31,3218182,588919,2629263,마카오,2017-03
2017-03-31,3001914,257769,2744145,모리셔스,2017-03
2017-03-31,2770155,14280279,-11510124,파푸아 뉴기니,2017-03
2017-03-31,2740539,356380,2384159,콩고,2017-03
2017-03-31,2676682,9902694,-7226012,마다카스카르,2017-03
2017-03-31,2644199,1833880,810319,벨라루스,2017-03
2017-03-31,2504110,53346479,-50842369,콩고민주공화국,2017-03
2017-03-31,2501018,281434,2219584,소말리아,2017-03
2017-03-31,2471527,0,2471527,불령 리유니온 코모도 제도,2017-03
2017-03-31,2401234,2287,2398947,아루바,2017-03
2017-03-31,2263925,131569,2132356,가이아나,2017-03
2017-03-31,2222163,189110,2033053,네팔,2017-03
2017-03-31,2149792,800537,1349255,베닝,2017-03
2017-03-31,2088260,2057591,30669,짐바브웨,2017-03
2017-03-31,1720743,34294,1686449,부르키나 파소,2017-03
2017-03-31,1662269,530788,1131481,세이쉘,2017-03
2017-03-31,1626858,34872302,-33245444,사이프러스,2017-03
2017-03-31,1545906,38696,1507210,북마리아나 군도,2017-03
2017-03-31,1521537,133670,1387867,아제르바이잔,2017-03
2017-03-31,1463799,588243,875556,벨리제,2017-03
2017-03-31,1432668,104948,1327720,자마이카,2017-03
2017-03-31,1407885,129438,1278447,알바니아,2017-03
2017-03-31,1367160,1936218,-569058,토고,2017-03
2017-03-31,1327463,17439,1310024,불령 폴리네시아,2017-03
2017-03-31,1280493,11447303,-10166810,잠비아,2017-03
2017-03-31,1242197,7696152,-6453955,룩셈부르그,2017-03
2017-03-31,1226373,79088204,-77861831,기타국,2017-03
2017-03-31,1207073,131,1206942,몰디브,2017-03
2017-03-31,1158790,167526,991264,마세도니아,2017-03
2017-03-31,1133685,224,1133461,네덜란드 열도,2017-03
2017-03-31,1109762,0,1109762,부탄,2017-03
2017-03-31,1103881,891941,211940,우간다,2017-03
2017-03-31,1093226,0,1093226,타지크,2017-03
2017-03-31,1046046,773003,273043,리히텐슈타인,2017-03
2017-03-31,1020738,22638118,-21617380,니제르,2017-03
2017-03-31,975679,0,975679,세인트 마틴,2017-03
2017-03-31,900481,94001,806480,르완다,2017-03
2017-03-31,824523,18259,806264,바베이도스,2017-03
2017-03-31,753736,1668,752068,팔라우,2017-03
2017-03-31,730714,0,730714,마티니크,2017-03
2017-03-31,723691,168296,555395,수리남,2017-03
2017-03-31,687161,38305626,-37618465,가봉,2017-03
2017-03-31,677465,21180,656285,큐라소,2017-03
2017-03-31,635021,14,635007,영령 캐이맨 군도,2017-03
2017-03-31,626900,1841608,-1214708,모리타니,2017-03
2017-03-31,622028,0,622028,키리바티,2017-03
2017-03-31,607453,125557,481896,보츠와나,2017-03
2017-03-31,547855,4706201,-4158346,말라위,2017-03
2017-03-31,515932,609406,-93474,몰도바,2017-03
2017-03-31,504754,0,504754,그레나다,2017-03
2017-03-31,477810,213042,264768,스와질랜드,2017-03
2017-03-31,369051,158984,210067,티모르,2017-03
2017-03-31,351386,1310099,-958713,시에라 리온,2017-03
2017-03-31,340036,105368,234668,아르메니아,2017-03
2017-03-31,333404,385100,-51696,세인트 루시아,2017-03
2017-03-31,291675,0,291675,과델로프,2017-03
2017-03-31,286644,1153724,-867080,바누아투,2017-03
2017-03-31,264833,835486,-570653,보스니아-헤르체고비나,2017-03
2017-03-31,249631,918,248713,몬테네그로,2017-03
2017-03-31,244018,13919,230099,도미니카,2017-03
2017-03-31,232629,0,232629,안티가 바부다,2017-03
2017-03-31,171366,918,170448,세인트 키츠 네비스,2017-03
2017-03-31,168958,0,168958,영령 버진군도,2017-03
2017-03-31,168130,12366,155764,아메리칸 사모아,2017-03
2017-03-31,165886,0,165886,세인트 빈센트 그레나딘,2017-03
2017-03-31,145901,1710,144191,지브랄타,2017-03
2017-03-31,144853,205,144648,투르크 & 카이코스 군도,2017-03
2017-03-31,142767,736546,-593779,중앙아프리카공화국,2017-03
2017-03-31,107059,670204,-563145,모나코,2017-03
2017-03-31,100806,0,100806,세인트 바르탤르미,2017-03
2017-03-31,94380,0,94380,불령 가이아나,2017-03
2017-03-31,74456,64,74392,챠드,2017-03
2017-03-31,55527,731,54796,나미비아,2017-03
2017-03-31,46645,0,46645,카보 베르데,2017-03
2017-03-31,45128,260296,-215168,감비아,2017-03
2017-03-31,36154,0,36154,몬트세라트,2017-03
2017-03-31,27578,0,27578,쿡 아일랜드,2017-03
2017-03-31,15907,39179,-23272,부룬디,2017-03
2017-03-31,13685,7369,6316,미령 버진군도,2017-03
2017-03-31,8800,0,8800,왈라스 & 퓨투나 군도,2017-03
2017-03-31,6619,43164,-36545,통가,2017-03
2017-03-31,3591,0,3591,파로에 군도,2017-03
2017-03-31,3264,1831,1433,안도라,2017-03
2017-03-31,1306,0,1306,앙귈라,2017-03
2017-03-31,718,68098919,-68098201,적도 기니,2017-03
2017-03-31,545,369747,-369202,코모로스,2017-03
2017-03-31,414,0,414,에리트리아,2017-03
2017-03-31,335,2936,-2601,상토메 프린스페,2017-03
2017-03-31,0,334,-334,레소토,2017-03
2017-03-31,0,3749,-3749,투발루,2017-03
2017-03-31,0,14,-14,세인트 피레 미켈론,2017-03
2017-03-31,0,60569,-60569,그린랜드,2017-03
2017-03-31,0,17,-17,저어지,2017-03
2017-03-31,0,117082,-117082,산마리노,2017-03
2017-03-31,0,10440,-10440,니우에,2017-03
2017-03-31,0,239029,-239029,기네비소,2017-03
2017-03-31,0,2657631,-2657631,나우루,2017-03
2017-03-31,0,483,-483,토켈라우,2017-03
2017-04-30,10589663918,7913343767,2676320151,중국,2017-04
2017-04-30,6035663101,4390391053,1645272048,미국,2017-04
2017-04-30,4517085112,1302700809,3214384303,베트남,2017-04
2017-04-30,4194037211,1560836311,2633200900,호주,2017-04
2017-04-30,2828098062,142797485,2685300577,홍콩,2017-04
2017-04-30,2608055554,408997371,2199058183,영국,2017-04
2017-04-30,2108329954,4566854050,-2458524096,일본,2017-04
2017-04-30,1210712720,436561197,774151523,인도,2017-04
2017-04-30,1209989477,1451341467,-241351990,대만,2017-04
2017-04-30,929092306,377544397,551547909,멕시코,2017-04
2017-04-30,912888954,771679789,141209165,싱가포르,2017-04
2017-04-30,856619358,264485712,592133646,필리핀,2017-04
2017-04-30,793622452,1514751444,-721128992,독일,2017-04
2017-04-30,777357889,761782225,15575664,인도네시아,2017-04
2017-04-30,618350737,437102158,181248579,태국,2017-04
2017-04-30,554375709,635773692,-81397983,말레이시아,2017-04
2017-04-30,548581274,93403793,455177481,노르웨이,2017-04
2017-04-30,547343602,896158890,-348815288,러시아 연방,2017-04
2017-04-30,502431805,705096345,-202664540,아랍에미리트 연합,2017-04
2017-04-30,496971210,278043224,218927986,브라질,2017-04
2017-04-30,481527477,40482915,441044562,튀르키예,2017-04
2017-04-30,475437553,370028424,105409129,캐나다,2017-04
2017-04-30,430778915,1615695234,-1184916319,사우디아라비아,2017-04
2017-04-30,375506539,376186825,-680286,네덜란드,2017-04
2017-04-30,371711058,610414015,-238702957,이란,2017-04
2017-04-30,316387999,420587160,-104199161,이탈리아,2017-04
2017-04-30,283547157,9317939,274229218,마샬군도,2017-04
2017-04-30,271623750,4438211,267185539,파나마,2017-04
2017-04-30,242093988,13786884,228307104,슬로바키아,2017-04
2017-04-30,232446104,46197906,186248198,폴란드,2017-04
2017-04-30,227061616,160224693,66836923,스페인,2017-04
2017-04-30,221851888,452850598,-230998710,프랑스,2017-04
2017-04-30,202328840,116905540,85423300,벨기에,2017-04
2017-04-30,194276354,10578965,183697389,그리스,2017-04
2017-04-30,183662391,59532462,124129929,체코공화국,2017-04
2017-04-30,164813313,2715177,162098136,몰타,2017-04
2017-04-30,157416823,17104633,140312190,슬로베니아,2017-04
2017-04-30,130538543,106061,130432482,알제리,2017-04
2017-04-30,129709195,289069972,-159360777,칠레,2017-04
2017-04-30,124832614,26829288,98003326,방글라데시,2017-04
2017-04-30,120656953,2146750,118510203,이집트,2017-04
2017-04-30,110983187,69919525,41063662,이스라엘,2017-04
2017-04-30,105968487,62036607,43931880,헝가리,2017-04
2017-04-30,105928107,118375515,-12447408,뉴질랜드,2017-04
2017-04-30,100240289,2274956,97965333,우즈베키스탄,2017-04
2017-04-30,99841680,28261724,71579956,파키스탄,2017-04
2017-04-30,99077925,174294114,-75216189,남아프리카공화국,2017-04
2017-04-30,95691055,751413872,-655722817,쿠웨이트,2017-04
2017-04-30,79700662,108304821,-28604159,오스트리아,2017-04
2017-04-30,75973874,123176418,-47202544,스웨덴,2017-04
2017-04-30,73744755,22548075,51196680,콜롬비아,2017-04
2017-04-30,73654683,427123925,-353469242,이라크,2017-04
2017-04-30,73198467,6511447,66687020,요르단,2017-04
2017-04-30,72333189,143324844,-70991655,페루,2017-04
2017-04-30,57774759,106789793,-49015034,아일랜드,2017-04
2017-04-30,57615319,23659023,33956296,나이지리아,2017-04
2017-04-30,57523245,11572827,45950418,앙골라,2017-04
2017-04-30,53996366,14596127,39400239,에쿠아도르,2017-04
2017-04-30,52107307,7367113,44740194,라이베리아,2017-04
2017-04-30,51228418,18811018,32417400,아르헨티나,2017-04
2017-04-30,48726448,28815226,19911222,미얀마,2017-04
2017-04-30,47015966,251211358,-204195392,오만,2017-04
2017-04-30,46202519,0,46202519,서사하라,2017-04
2017-04-30,45575326,20951826,24623500,캄보디아,2017-04
2017-04-30,44041501,0,44041501,맨섬,2017-04
2017-04-30,37620632,18191591,19429041,포루투갈,2017-04
2017-04-30,33198377,28566433,4631944,루마니아,2017-04
2017-04-30,32539549,86866765,-54327216,카자흐스탄,2017-04
2017-04-30,32130952,17996874,14134078,모로코,2017-04
2017-04-30,31507960,784173307,-752665347,카타르,2017-04
2017-04-30,30977301,6580819,24396482,리투아니아,2017-04
2017-04-30,28491446,13045393,15446053,푸에르토리코,2017-04
2017-04-30,27604433,182520361,-154915928,스위스,2017-04
2017-04-30,25433646,52879948,-27446302,덴마크,2017-04
2017-04-30,25291658,58297117,-33005459,리비아,2017-04
2017-04-30,24795338,696,24794642,투르크멘,2017-04
2017-04-30,24268164,78086232,-53818068,핀란드,2017-04
2017-04-30,23166108,23153448,12660,바레인,2017-04
2017-04-30,21770020,7861922,13908098,스리랑카,2017-04
2017-04-30,19968925,8520241,11448684,도미니카 공화국,2017-04
2017-04-30,18448379,58209430,-39761051,우크라이나,2017-04
2017-04-30,18429287,400461,18028826,몽골,2017-04
2017-04-30,18008466,1458719,16549747,수단,2017-04
2017-04-30,17999643,7495378,10504265,과테말라,2017-04
2017-04-30,17685982,3813200,13872782,케냐,2017-04
2017-04-30,16198743,0,16198743,불령 폴리네시아,2017-04
2017-04-30,16147168,11121718,5025450,코스타리카,2017-04
2017-04-30,15996872,3121789,12875083,에티오피아,2017-04
2017-04-30,14865269,1527575,13337694,엘살바도르,2017-04
2017-04-30,14845566,3874366,10971200,레바논,2017-04
2017-04-30,14830806,2739872,12090934,가나,2017-04
2017-04-30,12757189,71556,12685633,코트디봐르,2017-04
2017-04-30,12230582,7456032,4774550,트리니다드 토바고,2017-04
2017-04-30,11584141,1486,11582655,시리아,2017-04
2017-04-30,11504563,7812440,3692123,우루과이,2017-04
2017-04-30,11487052,1188980,10298072,니카라과,2017-04
2017-04-30,11360684,3915076,7445608,온두라스,2017-04
2017-04-30,11031591,751417,10280174,파라과이,2017-04
2017-04-30,10491749,24967925,-14476176,볼리비아,2017-04
2017-04-30,10001567,7799267,2202300,불가리아,2017-04
2017-04-30,9146241,4748,9141493,지부티,2017-04
2017-04-30,8953855,2126188,6827667,세르비아,2017-04
2017-04-30,8347267,4018587,4328680,튀니지,2017-04
2017-04-30,8271688,4170364,4101324,예맨,2017-04
2017-04-30,7652455,273639,7378816,피지,2017-04
2017-04-30,7519836,28252102,-20732266,브루나이,2017-04
2017-04-30,7349966,50904,7299062,팔레스타인 해방기구,2017-04
2017-04-30,7241470,170002,7071468,아이티,2017-04
2017-04-30,7006506,3841696,3164810,라오스,2017-04
2017-04-30,6720106,483783,6236323,베네주엘라,2017-04
2017-04-30,6525312,10756855,-4231543,탄자니아,2017-04
2017-04-30,6179965,826395,5353570,조지아,2017-04
2017-04-30,6166391,1740549,4425842,세네갈,2017-04
2017-04-30,6128760,71408,6057352,키르기스스탄,2017-04
2017-04-30,5462782,3090992,2371790,에스토니아,2017-04
2017-04-30,5459132,29838,5429294,아제르바이잔,2017-04
2017-04-30,5294307,5610968,-316661,라트비아,2017-04
2017-04-30,5276446,1423906,3852540,크로아티아,2017-04
2017-04-30,4645039,2001722,2643317,아이슬란드,2017-04
2017-04-30,3956666,2268084,1688582,베닝,2017-04
2017-04-30,3920999,23295854,-19374855,기니,2017-04
2017-04-30,3884938,67824,3817114,사모아,2017-04
2017-04-30,3560447,139538,3420909,괌,2017-04
2017-04-30,3272969,5366843,-2093874,모잠비크,2017-04
2017-04-30,3128824,858089,2270735,사이프러스,2017-04
2017-04-30,3068782,19416886,-16348104,뉴 칼레도니아,2017-04
2017-04-30,3015419,1960,3013459,아프카니스탄,2017-04
2017-04-30,2923982,84368,2839614,네팔,2017-04
2017-04-30,2646390,402133,2244257,쿠바,2017-04
2017-04-30,2643205,1323662,1319543,파푸아 뉴기니,2017-04
2017-04-30,2611937,321177,2290760,모리셔스,2017-04
2017-04-30,2588868,97522,2491346,르완다,2017-04
2017-04-30,2437614,455955,1981659,짐바브웨,2017-04
2017-04-30,2324824,67696411,-65371587,기타국,2017-04
2017-04-30,2307974,204548,2103426,카메룬,2017-04
2017-04-30,2215561,5644658,-3429097,마다카스카르,2017-04
2017-04-30,2213170,284540,1928630,자마이카,2017-04
2017-04-30,2094181,5366,2088815,말리,2017-04
2017-04-30,1966199,67847723,-65881524,콩고민주공화국,2017-04
2017-04-30,1880114,7805929,-5925815,벨라루스,2017-04
2017-04-30,1865296,243832,1621464,마카오,2017-04
2017-04-30,1796056,787,1795269,불령 리유니온 코모도 제도,2017-04
2017-04-30,1687123,13258021,-11570898,잠비아,2017-04
2017-04-30,1685472,88,1685384,가봉,2017-04
2017-04-30,1673380,1494082,179298,토고,2017-04
2017-04-30,1576680,64939,1511741,마세도니아,2017-04
2017-04-30,1540417,54765,1485652,소말리아,2017-04
2017-04-30,1539760,564272,975488,콩고,2017-04
2017-04-30,1470163,314197,1155966,북마리아나 군도,2017-04
2017-04-30,1469783,4599901,-3130118,룩셈부르그,2017-04
2017-04-30,1229523,325056,904467,세이쉘,2017-04
2017-04-30,1216621,44,1216577,타지크,2017-04
2017-04-30,1191635,154980,1036655,부르키나 파소,2017-04
2017-04-30,1179400,159191,1020209,가이아나,2017-04
2017-04-30,1155817,3491,1152326,네덜란드 열도,2017-04
2017-04-30,1026229,68095,958134,몰디브,2017-04
2017-04-30,993553,11348125,-10354572,아루바,2017-04
2017-04-30,943662,1605,942057,팔라우,2017-04
2017-04-30,938045,107681,830364,알바니아,2017-04
2017-04-30,916340,4243135,-3326795,말라위,2017-04
2017-04-30,765687,1543,764144,버뮤다,2017-04
2017-04-30,726905,699169,27736,우간다,2017-04
2017-04-30,721222,28495,692727,바베이도스,2017-04
2017-04-30,720053,1192396,-472343,리히텐슈타인,2017-04
2017-04-30,704695,525257,179438,시에라 리온,2017-04
2017-04-30,684618,346028,338590,몰도바,2017-04
2017-04-30,647972,0,647972,세인트 마틴,2017-04
2017-04-30,644228,12149,632079,부룬디,2017-04
2017-04-30,631801,0,631801,큐라소,2017-04
2017-04-30,620571,94908,525663,아르메니아,2017-04
2017-04-30,578373,75054,503319,스와질랜드,2017-04
2017-04-30,575317,0,575317,키리바티,2017-04
2017-04-30,567080,578,566502,마티니크,2017-04
2017-04-30,550405,0,550405,마이크로네시아,2017-04
2017-04-30,540313,815075,-274762,바누아투,2017-04
2017-04-30,534194,230802,303392,감비아,2017-04
2017-04-30,529527,33762,495765,보츠와나,2017-04
2017-04-30,523887,11183,512704,바하마,2017-04
2017-04-30,510179,898,509281,아메리칸 사모아,2017-04
2017-04-30,483878,0,483878,영령 버진군도,2017-04
2017-04-30,473852,4242320,-3768468,모리타니,2017-04
2017-04-30,445338,711426,-266088,보스니아-헤르체고비나,2017-04
2017-04-30,433152,0,433152,영령 캐이맨 군도,2017-04
2017-04-30,428867,573710,-144843,수리남,2017-04
2017-04-30,420699,20196,400503,벨리제,2017-04
2017-04-30,417760,0,417760,세인트 키츠 네비스,2017-04
2017-04-30,412261,1688000,-1275739,안티가 바부다,2017-04
2017-04-30,329582,3176,326406,과델로프,2017-04
2017-04-30,282169,50026,232143,몬테네그로,2017-04
2017-04-30,279848,29,279819,티모르,2017-04
2017-04-30,251132,184,250948,카보 베르데,2017-04
2017-04-30,244224,1644,242580,도미니카,2017-04
2017-04-30,198629,773009,-574380,나미비아,2017-04
2017-04-30,186833,13991,172842,세인트 루시아,2017-04
2017-04-30,182357,1063,181294,부탄,2017-04
2017-04-30,144530,37,144493,그레나다,2017-04
2017-04-30,133350,0,133350,남수단,2017-04
2017-04-30,121507,0,121507,지브랄타,2017-04
2017-04-30,115270,0,115270,세인트 빈센트 그레나딘,2017-04
2017-04-30,102295,13480,88815,투르크 & 카이코스 군도,2017-04
2017-04-30,100064,0,100064,불령 가이아나,2017-04
2017-04-30,94021,1204170,-1110149,중앙아프리카공화국,2017-04
2017-04-30,92300,469771,-377471,솔로몬 군도,2017-04
2017-04-30,64932,0,64932,통가,2017-04
2017-04-30,42176,464959,-422783,모나코,2017-04
2017-04-30,25200,0,25200,메요트,2017-04
2017-04-30,24130,36590243,-36566113,적도 기니,2017-04
2017-04-30,22876,820,22056,안도라,2017-04
2017-04-30,21745,39574,-17829,산마리노,2017-04
2017-04-30,19346,223606,-204260,기네비소,2017-04
2017-04-30,9102,0,9102,상토메 프린스페,2017-04
2017-04-30,8874,2417,6457,니제르,2017-04
2017-04-30,7719,0,7719,챠드,2017-04
2017-04-30,3168,43,3125,몬트세라트,2017-04
2017-04-30,236,38443,-38207,쿡 아일랜드,2017-04
2017-04-30,145,0,145,저어지,2017-04
2017-04-30,60,0,60,앙귈라,2017-04
2017-04-30,0,7922798,-7922798,에리트리아,2017-04
2017-04-30,0,508,-508,토켈라우,2017-04
2017-04-30,0,89,-89,마이너 아우틀링 합중국 군도,2017-04
2017-04-30,0,4209,-4209,미령 버진군도,2017-04
2017-04-30,0,240,-240,코스 군도,2017-04
2017-04-30,0,409,-409,건지,2017-04
2017-04-30,0,876,-876,레소토,2017-04
2017-04-30,0,15538,-15538,니우에,2017-04
2017-04-30,0,54,-54,세인트 피레 미켈론,2017-04
2017-04-30,0,84,-84,세인트 헬레나,2017-04
2017-04-30,0,60073,-60073,그린랜드,2017-04
2017-05-31,10652551536,8091620851,2560930685,중국,2017-05
2017-05-31,5523901512,4703318963,820582549,미국,2017-05
2017-05-31,4153353121,1245958652,2907394469,베트남,2017-05
2017-05-31,2873922510,129528252,2744394258,홍콩,2017-05
2017-05-31,2182625743,4380630210,-2198004467,일본,2017-05
2017-05-31,1331457911,1570044528,-238586617,대만,2017-05
2017-05-31,1148698200,444213560,704484640,인도,2017-05
2017-05-31,1033028622,380791845,652236777,영국,2017-05
2017-05-31,982974743,711404403,271570340,말레이시아,2017-05
2017-05-31,966892597,315323055,651569542,필리핀,2017-05
2017-05-31,910430816,262443338,647987478,멕시코,2017-05
2017-05-31,787739649,1523843017,-736103368,호주,2017-05
2017-05-31,739647123,681192612,58454511,싱가포르,2017-05
2017-05-31,633525499,1612900747,-979375248,독일,2017-05
2017-05-31,609218389,467291233,141927156,태국,2017-05
2017-05-31,587244399,3796831,583447568,마샬군도,2017-05
2017-05-31,572377181,966309449,-393932268,러시아 연방,2017-05
2017-05-31,551372459,779063811,-227691352,인도네시아,2017-05
2017-05-31,527277458,1895848581,-1368571123,사우디아라비아,2017-05
2017-05-31,517860805,492591108,25269697,네덜란드,2017-05
2017-05-31,499592203,51492106,448100097,튀르키예,2017-05
2017-05-31,440710025,777347623,-336637598,아랍에미리트 연합,2017-05
2017-05-31,432066195,229089581,202976614,브라질,2017-05
2017-05-31,427890116,473871512,-45981396,캐나다,2017-05
2017-05-31,370263461,450133083,-79869622,이란,2017-05
2017-05-31,314872062,486887870,-172015808,이탈리아,2017-05
2017-05-31,249780379,55037762,194742617,폴란드,2017-05
2017-05-31,235822579,15838211,219984368,슬로바키아,2017-05
2017-05-31,230063278,171048730,59014548,스페인,2017-05
2017-05-31,224746692,512149898,-287403206,프랑스,2017-05
2017-05-31,219308913,104793159,114515754,노르웨이,2017-05
2017-05-31,199039748,68890684,130149064,덴마크,2017-05
2017-05-31,198161494,96345426,101816068,벨기에,2017-05
2017-05-31,188829083,42546823,146282260,그리스,2017-05
2017-05-31,183129923,60076779,123053144,체코공화국,2017-05
2017-05-31,166287558,1240,166286318,바하마,2017-05
2017-05-31,142078791,8234000,133844791,슬로베니아,2017-05
2017-05-31,120006121,333461635,-213455514,칠레,2017-05
2017-05-31,112957244,91177113,21780131,이스라엘,2017-05
2017-05-31,111990327,6151736,105838591,이집트,2017-05
2017-05-31,111119149,127259373,-16140224,남아프리카공화국,2017-05
2017-05-31,106780750,106859852,-79102,뉴질랜드,2017-05
2017-05-31,105612381,865661174,-760048793,쿠웨이트,2017-05
2017-05-31,104449876,18018380,86431496,방글라데시,2017-05
2017-05-31,104259446,1368399,102891047,우즈베키스탄,2017-05
2017-05-31,85944319,34344086,51600233,아르헨티나,2017-05
2017-05-31,83941855,66110975,17830880,헝가리,2017-05
2017-05-31,80490419,122750575,-42260156,스웨덴,2017-05
2017-05-31,74131404,27536975,46594429,파키스탄,2017-05
2017-05-31,65507280,135507000,-69999720,오스트리아,2017-05
2017-05-31,64936834,169522616,-104585782,페루,2017-05
2017-05-31,62791744,168845,62622899,르완다,2017-05
2017-05-31,59323036,454578185,-395255149,이라크,2017-05
2017-05-31,56712160,37554273,19157887,콜롬비아,2017-05
2017-05-31,52461467,109151966,-56690499,아일랜드,2017-05
2017-05-31,51468418,12213406,39255012,에쿠아도르,2017-05
2017-05-31,50225485,17011152,33214333,캄보디아,2017-05
2017-05-31,50094429,37756174,12338255,알제리,2017-05
2017-05-31,50062578,19875234,30187344,미얀마,2017-05
2017-05-31,42401962,4873076,37528886,요르단,2017-05
2017-05-31,39071317,21349607,17721710,포루투갈,2017-05
2017-05-31,38591424,27148324,11443100,나이지리아,2017-05
2017-05-31,37981271,12175343,25805928,푸에르토리코,2017-05
2017-05-31,36153256,164713456,-128560200,오만,2017-05
2017-05-31,35614206,35074846,539360,루마니아,2017-05
2017-05-31,34217444,83871057,-49653613,카자흐스탄,2017-05
2017-05-31,33835881,18221,33817660,맨섬,2017-05
2017-05-31,32782849,5620664,27162185,리투아니아,2017-05
2017-05-31,31242411,84736306,-53493895,핀란드,2017-05
2017-05-31,29746198,247189547,-217443349,스위스,2017-05
2017-05-31,29202446,8051599,21150847,도미니카 공화국,2017-05
2017-05-31,27107557,1901828,25205729,파나마,2017-05
2017-05-31,26152216,49920743,-23768527,바레인,2017-05
2017-05-31,23998531,13154115,10844416,모로코,2017-05
2017-05-31,21032300,788480835,-767448535,카타르,2017-05
2017-05-31,20548561,75,20548486,투르크멘,2017-05
2017-05-31,20448910,2899668,17549242,토고,2017-05
2017-05-31,20222002,43369292,-23147290,우크라이나,2017-05
2017-05-31,19550355,483394,19066961,몽골,2017-05
2017-05-31,19126723,343930,18782793,피지,2017-05
2017-05-31,18009379,4972783,13036596,스리랑카,2017-05
2017-05-31,17959262,3362130,14597132,케냐,2017-05
2017-05-31,17822280,686770,17135510,크로아티아,2017-05
2017-05-31,17542317,1158549,16383768,탄자니아,2017-05
2017-05-31,17317741,11396454,5921287,코스타리카,2017-05
2017-05-31,16225774,2491671,13734103,가나,2017-05
2017-05-31,16056008,3188759,12867249,레바논,2017-05
2017-05-31,15727246,101361483,-85634237,리비아,2017-05
2017-05-31,15427825,17625205,-2197380,과테말라,2017-05
2017-05-31,14494874,9661,14485213,시리아,2017-05
2017-05-31,13840593,1137602,12702991,엘살바도르,2017-05
2017-05-31,13531037,24063776,-10532739,뉴 칼레도니아,2017-05
2017-05-31,13187913,14269856,-1081943,파라과이,2017-05
2017-05-31,13181130,13212294,-31164,우루과이,2017-05
2017-05-31,12111674,2161154,9950520,수단,2017-05
2017-05-31,11795561,6289642,5505919,에티오피아,2017-05
2017-05-31,11556534,241446,11315088,팔레스타인 해방기구,2017-05
2017-05-31,11386373,7319456,4066917,불가리아,2017-05
2017-05-31,10208711,1213089,8995622,니카라과,2017-05
2017-05-31,9670445,351935,9318510,코트디봐르,2017-05
2017-05-31,9454551,1925528,7529023,라오스,2017-05
2017-05-31,7850511,51376,7799135,지부티,2017-05
2017-05-31,7500120,3999235,3500885,예맨,2017-05
2017-05-31,7467328,22946135,-15478807,앙골라,2017-05
2017-05-31,7304209,7561807,-257598,라트비아,2017-05
2017-05-31,7275025,4642009,2633016,온두라스,2017-05
2017-05-31,6821361,102288,6719073,아제르바이잔,2017-05
2017-05-31,6630524,374608,6255916,아메리칸 사모아,2017-05
2017-05-31,6552585,150227,6402358,아이티,2017-05
2017-05-31,6512729,3647757,2864972,튀니지,2017-05
2017-05-31,6324993,5969284,355709,세르비아,2017-05
2017-05-31,6116955,3262050,2854905,세네갈,2017-05
2017-05-31,6057563,4248873,1808690,에스토니아,2017-05
2017-05-31,6020126,4089,6016037,쿠바,2017-05
2017-05-31,5906137,10143,5895994,키르기스스탄,2017-05
2017-05-31,5863441,2297164,3566277,조지아,2017-05
2017-05-31,5507659,33510798,-28003139,브루나이,2017-05
2017-05-31,5091337,1618975,3472362,트리니다드 토바고,2017-05
2017-05-31,4531324,84610,4446714,괌,2017-05
2017-05-31,4513282,48208325,-43695043,볼리비아,2017-05
2017-05-31,4264960,1984,4262976,사모아,2017-05
2017-05-31,4248646,281565,3967081,마이크로네시아,2017-05
2017-05-31,3814336,68843,3745493,세이쉘,2017-05
2017-05-31,3809070,19231569,-15422499,모잠비크,2017-05
2017-05-31,3797766,389103,3408663,모리셔스,2017-05
2017-05-31,3675050,2027765,1647285,아이슬란드,2017-05
2017-05-31,3521789,25080083,-21558294,파푸아 뉴기니,2017-05
2017-05-31,3468751,435878,3032873,마카오,2017-05
2017-05-31,3201035,3332910,-131875,몰타,2017-05
2017-05-31,3194374,1409,3192965,말리,2017-05
2017-05-31,3178742,221973,2956769,아프카니스탄,2017-05
2017-05-31,3177220,2643773,533447,바누아투,2017-05
2017-05-31,3150177,417873,2732304,베네주엘라,2017-05
2017-05-31,3010777,86972,2923805,부르키나 파소,2017-05
2017-05-31,2927331,8015433,-5088102,마다카스카르,2017-05
2017-05-31,2886883,167961,2718922,카메룬,2017-05
2017-05-31,2877570,39223197,-36345627,기타국,2017-05
2017-05-31,2846676,292544,2554132,베닝,2017-05
2017-05-31,2617695,0,2617695,아루바,2017-05
2017-05-31,2613186,5070288,-2457102,기니,2017-05
2017-05-31,2613098,2247892,365206,짐바브웨,2017-05
2017-05-31,2269438,79769,2189669,네팔,2017-05
2017-05-31,2198298,879731,1318567,사이프러스,2017-05
2017-05-31,2180142,1422394,757748,우간다,2017-05
2017-05-31,2105717,5022697,-2916980,룩셈부르그,2017-05
2017-05-31,2079792,0,2079792,불령 리유니온 코모도 제도,2017-05
2017-05-31,1946239,0,1946239,불령 폴리네시아,2017-05
2017-05-31,1902635,5390545,-3487910,벨라루스,2017-05
2017-05-31,1749464,30957,1718507,자마이카,2017-05
2017-05-31,1436143,44009618,-42573475,콩고민주공화국,2017-05
2017-05-31,1391865,80135,1311730,가이아나,2017-05
2017-05-31,1314103,299867,1014236,콩고,2017-05
2017-05-31,1267141,1015920,251221,말라위,2017-05
2017-05-31,1208394,1112429,95965,리히텐슈타인,2017-05
2017-05-31,1161184,64677,1096507,북마리아나 군도,2017-05
2017-05-31,1133703,54,1133649,소말리아,2017-05
2017-05-31,1098005,0,1098005,네덜란드 열도,2017-05
2017-05-31,1088781,125109,963672,알바니아,2017-05
2017-05-31,1064010,94858,969152,키리바티,2017-05
2017-05-31,1038796,258396,780400,마세도니아,2017-05
2017-05-31,1013337,0,1013337,마티니크,2017-05
2017-05-31,993410,8637800,-7644390,잠비아,2017-05
2017-05-31,893846,14543,879303,바베이도스,2017-05
2017-05-31,878221,452803,425418,몰도바,2017-05
2017-05-31,858603,117223,741380,가봉,2017-05
2017-05-31,827482,450,827032,버뮤다,2017-05
2017-05-31,777845,0,777845,세인트 마틴,2017-05
2017-05-31,763038,0,763038,타지크,2017-05
2017-05-31,761238,59722,701516,보츠와나,2017-05
2017-05-31,737250,10380,726870,부룬디,2017-05
2017-05-31,736479,200705,535774,수리남,2017-05
2017-05-31,672007,7194,664813,티모르,2017-05
2017-05-31,633767,1547421,-913654,아르메니아,2017-05
2017-05-31,630439,2047,628392,영령 캐이맨 군도,2017-05
2017-05-31,627828,135577,492251,라이베리아,2017-05
2017-05-31,619223,2171070,-1551847,시에라 리온,2017-05
2017-05-31,585406,0,585406,과델로프,2017-05
2017-05-31,554303,2457103,-1902800,모리타니,2017-05
2017-05-31,520173,122160,398013,스와질랜드,2017-05
2017-05-31,516039,9132,506907,몰디브,2017-05
2017-05-31,373024,3680,369344,벨리제,2017-05
2017-05-31,362563,0,362563,세인트 빈센트 그레나딘,2017-05
2017-05-31,355488,21224,334264,큐라소,2017-05
2017-05-31,329764,0,329764,세인트 루시아,2017-05
2017-05-31,255580,1368481,-1112901,보스니아-헤르체고비나,2017-05
2017-05-31,243718,381,243337,몬테네그로,2017-05
2017-05-31,241672,350,241322,그레나다,2017-05
2017-05-31,228555,0,228555,남조지아 & 남샌드위치 군도,2017-05
2017-05-31,219336,0,219336,카보 베르데,2017-05
2017-05-31,217657,590151,-372494,감비아,2017-05
2017-05-31,196001,0,196001,안티가 바부다,2017-05
2017-05-31,162113,14,162099,부탄,2017-05
2017-05-31,158008,1140928,-982920,나미비아,2017-05
2017-05-31,155878,5779,150099,팔라우,2017-05
2017-05-31,151552,277072,-125520,기네비소,2017-05
2017-05-31,91420,748,90672,레소토,2017-05
2017-05-31,76312,0,76312,불령 가이아나,2017-05
2017-05-31,72055,0,72055,챠드,2017-05
2017-05-31,66241,24,66217,상토메 프린스페,2017-05
2017-05-31,57550,458466,-400916,솔로몬 군도,2017-05
2017-05-31,57290,14608,42682,도미니카,2017-05
2017-05-31,55001,200,54801,지브랄타,2017-05
2017-05-31,54819,0,54819,통가,2017-05
2017-05-31,51700,0,51700,세인트 키츠 네비스,2017-05
2017-05-31,39282,81207139,-81167857,적도 기니,2017-05
2017-05-31,35620,390610,-354990,중앙아프리카공화국,2017-05
2017-05-31,30787,1010,29777,니제르,2017-05
2017-05-31,29529,819,28710,몬트세라트,2017-05
2017-05-31,21317,7,21310,코스 군도,2017-05
2017-05-31,19611,153,19458,투르크 & 카이코스 군도,2017-05
2017-05-31,15694,102794,-87100,산마리노,2017-05
2017-05-31,14888,29,14859,메요트,2017-05
2017-05-31,4690,0,4690,파로에 군도,2017-05
2017-05-31,4199,46120,-41921,쿡 아일랜드,2017-05
2017-05-31,3085,2291,794,토켈라우,2017-05
2017-05-31,2658,0,2658,투발루,2017-05
2017-05-31,1881,273,1608,남수단,2017-05
2017-05-31,1441,737130,-735689,모나코,2017-05
2017-05-31,303,0,303,영령 버진군도,2017-05
2017-05-31,129,87,42,앙귈라,2017-05
2017-05-31,89,8689,-8600,미령 버진군도,2017-05
2017-05-31,0,19940,-19940,안도라,2017-05
2017-05-31,0,2945,-2945,포클랜드 군도,2017-05
2017-05-31,0,7685,-7685,니우에,2017-05
2017-05-31,0,48965,-48965,세인트 헬레나,2017-05
2017-05-31,0,1579876,-1579876,안타티카,2017-05
2017-05-31,0,1398,-1398,세인트 바르탤르미,2017-05
2017-05-31,0,2043336,-2043336,나우루,2017-05
2017-05-31,0,164641,-164641,그린랜드,2017-05
2017-05-31,0,1007,-1007,마이너 아우틀링 합중국 군도,2017-05
2017-06-30,10675442357,8351749724,2323692633,중국,2017-06
2017-06-30,5980992263,4806053868,1174938395,미국,2017-06
2017-06-30,4945446630,1689536662,3255909968,호주,2017-06
2017-06-30,4318913195,1178727420,3140185775,베트남,2017-06
2017-06-30,3198026020,129483873,3068542147,홍콩,2017-06
2017-06-30,2350968919,4773363730,-2422394811,일본,2017-06
2017-06-30,1230753774,1436599973,-205846199,대만,2017-06
2017-06-30,1169454559,435336037,734118522,인도,2017-06
2017-06-30,977966034,781990878,195975156,싱가포르,2017-06
2017-06-30,966387724,979958267,-13570543,러시아 연방,2017-06
2017-06-30,938810680,241946749,696863931,멕시코,2017-06
2017-06-30,929073595,12428,929061167,마샬군도,2017-06
2017-06-30,839884634,288389796,551494838,필리핀,2017-06
2017-06-30,681387691,1781209153,-1099821462,독일,2017-06
2017-06-30,666342573,566496017,99846556,영국,2017-06
2017-06-30,639088472,456402569,182685903,태국,2017-06
2017-06-30,631869979,77923998,553945981,노르웨이,2017-06
2017-06-30,585276008,74195427,511080581,튀르키예,2017-06
2017-06-30,577418327,715026395,-137608068,말레이시아,2017-06
2017-06-30,537530336,920814816,-383284480,인도네시아,2017-06
2017-06-30,468122602,513512028,-45389426,캐나다,2017-06
2017-06-30,465511736,375578770,89932966,브라질,2017-06
2017-06-30,463163862,535384578,-72220716,아랍에미리트 연합,2017-06
2017-06-30,457705237,712622619,-254917382,네덜란드,2017-06
2017-06-30,421666490,1581203222,-1159536732,사우디아라비아,2017-06
2017-06-30,366342253,491416397,-125074144,이란,2017-06
2017-06-30,259798984,509561123,-249762139,이탈리아,2017-06
2017-06-30,238679879,49580432,189099447,폴란드,2017-06
2017-06-30,223067695,150785598,72282097,스페인,2017-06
2017-06-30,215772490,90871927,124900563,벨기에,2017-06
2017-06-30,214996797,16657674,198339123,슬로바키아,2017-06
2017-06-30,197561034,0,197561034,버뮤다,2017-06
2017-06-30,194573155,510,194572645,바하마,2017-06
2017-06-30,194021786,55593318,138428468,덴마크,2017-06
2017-06-30,186989638,535264426,-348274788,프랑스,2017-06
2017-06-30,182841657,2377662,180463995,몰타,2017-06
2017-06-30,179918800,9647618,170271182,슬로베니아,2017-06
2017-06-30,167956831,77850187,90106644,체코공화국,2017-06
2017-06-30,126416198,348250162,-221833964,칠레,2017-06
2017-06-30,123991733,2156010,121835723,우즈베키스탄,2017-06
2017-06-30,112551659,116280808,-3729149,뉴질랜드,2017-06
2017-06-30,112018039,121752799,-9734760,이스라엘,2017-06
2017-06-30,108689357,21139324,87550033,방글라데시,2017-06
2017-06-30,108460732,2544435,105916297,토고,2017-06
2017-06-30,106962234,593844407,-486882173,쿠웨이트,2017-06
2017-06-30,104213330,4764421,99448909,이집트,2017-06
2017-06-30,100601209,9334566,91266643,알제리,2017-06
2017-06-30,90358351,205611859,-115253508,남아프리카공화국,2017-06
2017-06-30,90271750,164218915,-73947165,오스트리아,2017-06
2017-06-30,87065831,607873138,-520807307,이라크,2017-06
2017-06-30,85230626,72643406,12587220,헝가리,2017-06
2017-06-30,83257480,162411383,-79153903,스웨덴,2017-06
2017-06-30,75945795,21807856,54137939,파키스탄,2017-06
2017-06-30,71456886,92898481,-21441595,콜롬비아,2017-06
2017-06-30,71364396,164359181,-92994785,페루,2017-06
2017-06-30,70977054,30672450,40304604,아르헨티나,2017-06
2017-06-30,66450509,15078057,51372452,카자흐스탄,2017-06
2017-06-30,60461114,23821985,36639129,미얀마,2017-06
2017-06-30,57441726,104270330,-46828604,아일랜드,2017-06
2017-06-30,57321436,6566788,50754648,요르단,2017-06
2017-06-30,55722037,108281,55613756,라이베리아,2017-06
2017-06-30,55012362,21861006,33151356,캄보디아,2017-06
2017-06-30,53421965,9758103,43663862,에쿠아도르,2017-06
2017-06-30,48452212,10997076,37455136,나이지리아,2017-06
2017-06-30,46078793,11592925,34485868,파나마,2017-06
2017-06-30,44038481,43604,43994877,맨섬,2017-06
2017-06-30,40960473,140127156,-99166683,오만,2017-06
2017-06-30,38119990,23971339,14148651,포루투갈,2017-06
2017-06-30,36218634,1090449,35128185,크로아티아,2017-06
2017-06-30,35558418,37264051,-1705633,루마니아,2017-06
2017-06-30,35549283,53038490,-17489207,바레인,2017-06
2017-06-30,35373678,205984853,-170611175,스위스,2017-06
2017-06-30,30660804,980787970,-950127166,카타르,2017-06
2017-06-30,29709395,4730457,24978938,마다카스카르,2017-06
2017-06-30,27749799,17581563,10168236,푸에르토리코,2017-06
2017-06-30,27393245,9772220,17621025,리투아니아,2017-06
2017-06-30,25702234,66696551,-40994317,핀란드,2017-06
2017-06-30,24980074,309547,24670527,피지,2017-06
2017-06-30,24858290,15780470,9077820,우크라이나,2017-06
2017-06-30,23827984,207,23827777,시리아,2017-06
2017-06-30,23419572,14535033,8884539,모로코,2017-06
2017-06-30,23333953,584151,22749802,몽골,2017-06
2017-06-30,23180715,44116909,-20936194,그리스,2017-06
2017-06-30,21857576,4620744,17236832,케냐,2017-06
2017-06-30,19915003,17098062,2816941,과테말라,2017-06
2017-06-30,19498088,7278953,12219135,스리랑카,2017-06
2017-06-30,18908882,8129268,10779614,도미니카 공화국,2017-06
2017-06-30,17803885,25667187,-7863302,뉴 칼레도니아,2017-06
2017-06-30,17545702,5446884,12098818,가나,2017-06
2017-06-30,16302727,6702111,9600616,온두라스,2017-06
2017-06-30,15349607,54873197,-39523590,리비아,2017-06
2017-06-30,14794974,0,14794974,불령 폴리네시아,2017-06
2017-06-30,13458175,1444280,12013895,엘살바도르,2017-06
2017-06-30,13390685,1702745,11687940,수단,2017-06
2017-06-30,13145689,4715246,8430443,레바논,2017-06
2017-06-30,12089214,461428,11627786,코트디봐르,2017-06
2017-06-30,11972088,240930,11731158,파라과이,2017-06
2017-06-30,11842541,0,11842541,투르크멘,2017-06
2017-06-30,11486809,5438727,6048082,튀니지,2017-06
2017-06-30,11438018,5888784,5549234,에티오피아,2017-06
2017-06-30,11054188,45550,11008638,쿠바,2017-06
2017-06-30,10827174,4714,10822460,아프카니스탄,2017-06
2017-06-30,10777874,24951532,-14173658,불가리아,2017-06
2017-06-30,10705301,19098966,-8393665,앙골라,2017-06
2017-06-30,10540481,4040925,6499556,트리니다드 토바고,2017-06
2017-06-30,10510579,7216707,3293872,우루과이,2017-06
2017-06-30,10277374,412033,9865341,팔레스타인 해방기구,2017-06
2017-06-30,10117623,10886933,-769310,코스타리카,2017-06
2017-06-30,9549274,3125981,6423293,예맨,2017-06
2017-06-30,9343692,298622,9045070,니카라과,2017-06
2017-06-30,9296295,16736976,-7440681,세르비아,2017-06
2017-06-30,8455243,2624,8452619,키르기스스탄,2017-06
2017-06-30,8008111,1705518,6302593,탄자니아,2017-06
2017-06-30,6669901,74966,6594935,아이티,2017-06
2017-06-30,6287548,4009921,2277627,세네갈,2017-06
2017-06-30,6255529,6455012,-199483,라트비아,2017-06
2017-06-30,5465358,974423,4490935,모잠비크,2017-06
2017-06-30,5462121,4697950,764171,에스토니아,2017-06
2017-06-30,5324394,0,5324394,지부티,2017-06
2017-06-30,5195230,2193513,3001717,라오스,2017-06
2017-06-30,5022749,19627515,-14604766,볼리비아,2017-06
2017-06-30,4578636,3194209,1384427,조지아,2017-06
2017-06-30,3823466,5836647,-2013181,베네주엘라,2017-06
2017-06-30,3712903,56977879,-53264976,브루나이,2017-06
2017-06-30,3664325,92167,3572158,부르키나 파소,2017-06
2017-06-30,3577098,284403,3292695,나미비아,2017-06
2017-06-30,3463418,256916,3206502,괌,2017-06
2017-06-30,3383706,0,3383706,세인트 마틴,2017-06
2017-06-30,3325972,0,3325972,사모아,2017-06
2017-06-30,3180573,1333007,1847566,베닝,2017-06
2017-06-30,3176653,2068435,1108218,아이슬란드,2017-06
2017-06-30,3118919,577250,2541669,콩고,2017-06
2017-06-30,3069039,29435745,-26366706,파푸아 뉴기니,2017-06
2017-06-30,3052975,82453623,-79400648,기타국,2017-06
2017-06-30,2986973,576322,2410651,자마이카,2017-06
2017-06-30,2903799,190004,2713795,마세도니아,2017-06
2017-06-30,2901763,10645936,-7744173,벨라루스,2017-06
2017-06-30,2861511,157810,2703701,마카오,2017-06
2017-06-30,2748313,4668637,-1920324,짐바브웨,2017-06
2017-06-30,2707630,26700,2680930,아제르바이잔,2017-06
2017-06-30,2652632,9309053,-6656421,잠비아,2017-06
2017-06-30,2629908,3765672,-1135764,기니,2017-06
2017-06-30,2598295,345251,2253044,모리셔스,2017-06
2017-06-30,2452722,221336,2231386,네팔,2017-06
2017-06-30,2109986,94251,2015735,세이쉘,2017-06
2017-06-30,2042201,399718,1642483,우간다,2017-06
2017-06-30,2027038,483880,1543158,가이아나,2017-06
2017-06-30,1990595,318318,1672277,아루바,2017-06
2017-06-30,1889918,14631199,-12741281,사이프러스,2017-06
2017-06-30,1869447,316454,1552993,카메룬,2017-06
2017-06-30,1855782,5394741,-3538959,가봉,2017-06
2017-06-30,1652062,30647885,-28995823,콩고민주공화국,2017-06
2017-06-30,1516826,137242,1379584,알바니아,2017-06
2017-06-30,1466285,11648,1454637,말리,2017-06
2017-06-30,1339863,1343,1338520,마티니크,2017-06
2017-06-30,1278629,0,1278629,네덜란드 열도,2017-06
2017-06-30,1277552,13120,1264432,불령 리유니온 코모도 제도,2017-06
2017-06-30,1222763,0,1222763,소말리아,2017-06
2017-06-30,1216674,80086,1136588,북마리아나 군도,2017-06
2017-06-30,1206217,39896,1166321,바베이도스,2017-06
2017-06-30,1090474,253,1090221,타지크,2017-06
2017-06-30,1052752,274397,778355,몰도바,2017-06
2017-06-30,1051819,6518784,-5466965,룩셈부르그,2017-06
2017-06-30,1022233,0,1022233,과델로프,2017-06
2017-06-30,1021711,1058252,-36541,리히텐슈타인,2017-06
2017-06-30,711540,300,711240,키리바티,2017-06
2017-06-30,681965,48485,633480,몰디브,2017-06
2017-06-30,629195,1007047,-377852,시에라 리온,2017-06
2017-06-30,609917,205,609712,큐라소,2017-06
2017-06-30,553041,25,553016,안티가 바부다,2017-06
2017-06-30,522540,112112,410428,아르메니아,2017-06
2017-06-30,522481,17609,504872,보츠와나,2017-06
2017-06-30,484409,1597738,-1113329,모리타니,2017-06
2017-06-30,443225,16313,426912,몬테네그로,2017-06
2017-06-30,438266,1425109,-986843,바누아투,2017-06
2017-06-30,421445,0,421445,마이크로네시아,2017-06
2017-06-30,417589,1736461,-1318872,보스니아-헤르체고비나,2017-06
2017-06-30,416567,187,416380,티모르,2017-06
2017-06-30,407291,42853,364438,영령 캐이맨 군도,2017-06
2017-06-30,369328,341916,27412,스와질랜드,2017-06
2017-06-30,352127,370051,-17924,수리남,2017-06
2017-06-30,332638,228,332410,그레나다,2017-06
2017-06-30,301017,14,301003,팔라우,2017-06
2017-06-30,294014,111656,182358,르완다,2017-06
2017-06-30,243835,42,243793,부탄,2017-06
2017-06-30,237367,0,237367,카보 베르데,2017-06
2017-06-30,229354,829513,-600159,솔로몬 군도,2017-06
2017-06-30,226470,49545,176925,부룬디,2017-06
2017-06-30,225489,475103,-249614,감비아,2017-06
2017-06-30,224847,0,224847,세인트 루시아,2017-06
2017-06-30,221856,25954,195902,벨리제,2017-06
2017-06-30,183289,1274,182015,아메리칸 사모아,2017-06
2017-06-30,165550,398,165152,도미니카,2017-06
2017-06-30,155823,0,155823,지브랄타,2017-06
2017-06-30,143816,32834,110982,니제르,2017-06
2017-06-30,128557,0,128557,불령 가이아나,2017-06
2017-06-30,126867,189,126678,챠드,2017-06
2017-06-30,124406,19,124387,세인트 키츠 네비스,2017-06
2017-06-30,93856,0,93856,투르크 & 카이코스 군도,2017-06
2017-06-30,92135,2126,90009,남수단,2017-06
2017-06-30,85725,0,85725,영령 버진군도,2017-06
2017-06-30,71616,259071,-187455,말라위,2017-06
2017-06-30,59984,39603,20381,중앙아프리카공화국,2017-06
2017-06-30,54517,0,54517,상토메 프린스페,2017-06
2017-06-30,48216,46009,2207,산마리노,2017-06
2017-06-30,43390,28350,15040,통가,2017-06
2017-06-30,39168,0,39168,투발루,2017-06
2017-06-30,12802,9001590,-8988788,에리트리아,2017-06
2017-06-30,8800,60,8740,왈라스 & 퓨투나 군도,2017-06
2017-06-30,5535,800,4735,포클랜드 군도,2017-06
2017-06-30,5464,20344,-14880,쿡 아일랜드,2017-06
2017-06-30,4542,387705,-383163,모나코,2017-06
2017-06-30,2601,68748,-66147,그린랜드,2017-06
2017-06-30,1750,1417,333,레소토,2017-06
2017-06-30,1712,0,1712,세인트 빈센트 그레나딘,2017-06
2017-06-30,1388,0,1388,서사하라,2017-06
2017-06-30,207,0,207,나우루,2017-06
2017-06-30,100,1133,-1033,건지,2017-06
2017-06-30,0,27418567,-27418567,적도 기니,2017-06
2017-06-30,0,45,-45,안타티카,2017-06
2017-06-30,0,1034,-1034,미령 버진군도,2017-06
2017-06-30,0,583,-583,앙귈라,2017-06
2017-06-30,0,604,-604,알랜드 군도,2017-06
2017-06-30,0,197,-197,해외교포,2017-06
2017-06-30,0,1200,-1200,저어지,2017-06
2017-06-30,0,40502,-40502,안도라,2017-06
2017-06-30,0,397,-397,토켈라우,2017-06
2017-06-30,0,81354,-81354,코모로스,2017-06
2017-06-30,0,2784,-2784,코스 군도,2017-06
2017-06-30,0,2510,-2510,몬트세라트,2017-06
2017-06-30,0,2184,-2184,니우에,2017-06
2017-06-30,0,93906,-93906,기네비소,2017-06
2017-07-31,10791084082,7769041729,3022042353,중국,2017-07
2017-07-31,5660933992,4082844521,1578089471,미국,2017-07
2017-07-31,3636567276,1288424672,2348142604,베트남,2017-07
2017-07-31,3463071467,1614132215,1848939252,호주,2017-07
2017-07-31,2903504016,139129401,2764374615,홍콩,2017-07
2017-07-31,2162170436,4458762879,-2296592443,일본,2017-07
2017-07-31,1570325683,370699823,1199625860,인도,2017-07
2017-07-31,1338658094,1487198872,-148540778,대만,2017-07
2017-07-31,1239345248,790368895,448976353,싱가포르,2017-07
2017-07-31,1058864695,692491248,366373447,인도네시아,2017-07
2017-07-31,950687808,373090295,577597513,멕시코,2017-07
2017-07-31,910004904,315306153,594698751,필리핀,2017-07
2017-07-31,754676178,661875182,92800996,말레이시아,2017-07
2017-07-31,733380021,1663538534,-930158513,독일,2017-07
2017-07-31,656537027,98590826,557946201,노르웨이,2017-07
2017-07-31,654237011,439450739,214786272,태국,2017-07
2017-07-31,653021080,1322,653019758,마샬군도,2017-07
2017-07-31,606303890,996142420,-389838530,러시아 연방,2017-07
2017-07-31,596712340,473747466,122964874,영국,2017-07
2017-07-31,573879482,50569895,523309587,튀르키예,2017-07
2017-07-31,471426392,500125680,-28699288,네덜란드,2017-07
2017-07-31,467961584,242139813,225821771,브라질,2017-07
2017-07-31,436828928,1504670112,-1067841184,사우디아라비아,2017-07
2017-07-31,402232505,984338905,-582106400,아랍에미리트 연합,2017-07
2017-07-31,401591571,321708494,79883077,캐나다,2017-07
2017-07-31,288205186,578851679,-290646493,이란,2017-07
2017-07-31,285491259,500019265,-214528006,이탈리아,2017-07
2017-07-31,271353318,482409619,-211056301,프랑스,2017-07
2017-07-31,270194498,14014451,256180047,슬로바키아,2017-07
2017-07-31,259936391,55826568,204109823,폴란드,2017-07
2017-07-31,238502984,1193444,237309540,파나마,2017-07
2017-07-31,237321449,101069276,136252173,벨기에,2017-07
2017-07-31,229264630,173897167,55367463,스페인,2017-07
2017-07-31,181717690,66951629,114766061,체코공화국,2017-07
2017-07-31,156238253,21141,156217112,라이베리아,2017-07
2017-07-31,154828265,8833558,145994707,슬로베니아,2017-07
2017-07-31,124933359,741471,124191888,토고,2017-07
2017-07-31,112178542,52638192,59540350,헝가리,2017-07
2017-07-31,107710819,250264888,-142554069,칠레,2017-07
2017-07-31,105388411,1077472,104310939,우즈베키스탄,2017-07
2017-07-31,98351028,808984520,-710633492,쿠웨이트,2017-07
2017-07-31,92588888,3999351,88589537,이집트,2017-07
2017-07-31,91081055,14316770,76764285,카자흐스탄,2017-07
2017-07-31,90622570,95210068,-4587498,뉴질랜드,2017-07
2017-07-31,89770701,171907387,-82136686,스웨덴,2017-07
2017-07-31,89229943,130888124,-41658181,이스라엘,2017-07
2017-07-31,86436053,440,86435613,맨섬,2017-07
2017-07-31,85959528,180634356,-94674828,남아프리카공화국,2017-07
2017-07-31,84350017,20270662,64079355,그리스,2017-07
2017-07-31,83873635,89288092,-5414457,알제리,2017-07
2017-07-31,81150389,578333633,-497183244,이라크,2017-07
2017-07-31,81085724,20615388,60470336,방글라데시,2017-07
2017-07-31,76884873,17444627,59440246,파키스탄,2017-07
2017-07-31,71062167,155007797,-83945630,오스트리아,2017-07
2017-07-31,66556118,232245834,-165689716,페루,2017-07
2017-07-31,65198159,61335876,3862283,아르헨티나,2017-07
2017-07-31,63427961,99675961,-36248000,아일랜드,2017-07
2017-07-31,58959273,97010544,-38051271,오만,2017-07
2017-07-31,58412134,47192802,11219332,콜롬비아,2017-07
2017-07-31,52990126,21123288,31866838,캄보디아,2017-07
2017-07-31,51119893,9189210,41930683,에쿠아도르,2017-07
2017-07-31,50028705,281848665,-231819960,스위스,2017-07
2017-07-31,49146684,6857290,42289394,요르단,2017-07
2017-07-31,39169366,37111199,2058167,루마니아,2017-07
2017-07-31,35255159,33745292,1509867,미얀마,2017-07
2017-07-31,33944871,22457534,11487337,포루투갈,2017-07
2017-07-31,33230680,39605794,-6375114,바레인,2017-07
2017-07-31,32681788,14328859,18352929,나이지리아,2017-07
2017-07-31,30969104,1336017,29633087,리비아,2017-07
2017-07-31,30714969,7687209,23027760,과테말라,2017-07
2017-07-31,30442379,0,30442379,서사하라,2017-07
2017-07-31,28967416,1023015359,-994047943,카타르,2017-07
2017-07-31,27799175,71406602,-43607427,덴마크,2017-07
2017-07-31,27663196,9137775,18525421,스리랑카,2017-07
2017-07-31,26175430,22306507,3868923,우크라이나,2017-07
2017-07-31,24604991,6672028,17932963,리투아니아,2017-07
2017-07-31,23252691,14621590,8631101,모로코,2017-07
2017-07-31,19667017,80290846,-60623829,핀란드,2017-07
2017-07-31,18802554,1082304,17720250,몽골,2017-07
2017-07-31,18784829,3055938,15728891,가나,2017-07
2017-07-31,18540769,4328773,14211996,트리니다드 토바고,2017-07
2017-07-31,18412403,894987,17517416,크로아티아,2017-07
2017-07-31,18041443,10806339,7235104,도미니카 공화국,2017-07
2017-07-31,17896868,406,17896462,시리아,2017-07
2017-07-31,17180916,4448819,12732097,레바논,2017-07
2017-07-31,14314795,826238,13488557,파라과이,2017-07
2017-07-31,14050835,5753453,8297382,온두라스,2017-07
2017-07-31,12644155,3977357,8666798,케냐,2017-07
2017-07-31,11488370,13130882,-1642512,코스타리카,2017-07
2017-07-31,11398568,2450771,8947797,수단,2017-07
2017-07-31,11234586,910278,10324308,코트디봐르,2017-07
2017-07-31,11057556,2541825,8515731,엘살바도르,2017-07
2017-07-31,11043389,8817877,2225512,불가리아,2017-07
2017-07-31,10964658,30036109,-19071451,뉴 칼레도니아,2017-07
2017-07-31,10475991,4835367,5640624,튀니지,2017-07
2017-07-31,10385655,9982765,402890,푸에르토리코,2017-07
2017-07-31,10071792,487162,9584630,니카라과,2017-07
2017-07-31,9446831,11251702,-1804871,우루과이,2017-07
2017-07-31,9003297,480662,8522635,쿠바,2017-07
2017-07-31,8478303,19478875,-11000572,앙골라,2017-07
2017-07-31,8366443,0,8366443,투르크멘,2017-07
2017-07-31,8210808,2514,8208294,부탄,2017-07
2017-07-31,8115882,1062131,7053751,탄자니아,2017-07
2017-07-31,7889865,16320,7873545,아프카니스탄,2017-07
2017-07-31,7784645,4993296,2791349,에티오피아,2017-07
2017-07-31,7220814,3535862,3684952,세르비아,2017-07
2017-07-31,7211310,2051905,5159405,예맨,2017-07
2017-07-31,6906799,6979379,-72580,라트비아,2017-07
2017-07-31,6406538,0,6406538,팔레스타인 해방기구,2017-07
2017-07-31,6332185,5770846,561339,에스토니아,2017-07
2017-07-31,6249683,47335703,-41086020,볼리비아,2017-07
2017-07-31,6089506,468035,5621471,피지,2017-07
2017-07-31,5890080,11351256,-5461176,세네갈,2017-07
2017-07-31,5691440,14446998,-8755558,모잠비크,2017-07
2017-07-31,5528484,157486,5370998,아이티,2017-07
2017-07-31,5431711,1395588,4036123,솔로몬 군도,2017-07
2017-07-31,5399932,4112270,1287662,조지아,2017-07
2017-07-31,5279881,2748,5277133,키르기스스탄,2017-07
2017-07-31,5055035,44900,5010135,마이크로네시아,2017-07
2017-07-31,5009043,1950808,3058235,몰타,2017-07
2017-07-31,4852136,492014,4360122,괌,2017-07
2017-07-31,4714236,73697422,-68983186,브루나이,2017-07
2017-07-31,4679165,20,4679145,지부티,2017-07
2017-07-31,4622764,0,4622764,투발루,2017-07
2017-07-31,4213842,1698158,2515684,라오스,2017-07
2017-07-31,4178360,207931,3970429,베닝,2017-07
2017-07-31,3922796,0,3922796,세인트 마틴,2017-07
2017-07-31,3888424,37184,3851240,불령 폴리네시아,2017-07
2017-07-31,3462716,5758881,-2296165,마다카스카르,2017-07
2017-07-31,3457503,125,3457378,부르키나 파소,2017-07
2017-07-31,3408752,548903,2859849,모리셔스,2017-07
2017-07-31,3223813,4580973,-1357160,파푸아 뉴기니,2017-07
2017-07-31,3213532,5126337,-1912805,룩셈부르그,2017-07
2017-07-31,2981392,77022,2904370,아제르바이잔,2017-07
2017-07-31,2893554,348316,2545238,사이프러스,2017-07
2017-07-31,2728018,465813,2262205,가이아나,2017-07
2017-07-31,2585791,53413,2532378,마세도니아,2017-07
2017-07-31,2498533,573,2497960,불령 리유니온 코모도 제도,2017-07
2017-07-31,2403869,124422,2279447,카메룬,2017-07
2017-07-31,2258363,165063,2093300,네팔,2017-07
2017-07-31,2244447,286224,1958223,베네주엘라,2017-07
2017-07-31,2145624,556080,1589544,마카오,2017-07
2017-07-31,2104492,1430321,674171,짐바브웨,2017-07
2017-07-31,2068391,31332499,-29264108,기타국,2017-07
2017-07-31,1983823,3547071,-1563248,기니,2017-07
2017-07-31,1828889,1947353,-118464,콩고,2017-07
2017-07-31,1790346,2062462,-272116,벨라루스,2017-07
2017-07-31,1762180,477753,1284427,자마이카,2017-07
2017-07-31,1751657,2050504,-298847,타지크,2017-07
2017-07-31,1736432,0,1736432,과델로프,2017-07
2017-07-31,1678262,3303322,-1625060,세이쉘,2017-07
2017-07-31,1667912,26165668,-24497756,콩고민주공화국,2017-07
2017-07-31,1663321,480,1662841,키리바티,2017-07
2017-07-31,1661263,23576127,-21914864,잠비아,2017-07
2017-07-31,1633718,20265,1613453,사모아,2017-07
2017-07-31,1583591,123655,1459936,소말리아,2017-07
2017-07-31,1518343,313164,1205179,아루바,2017-07
2017-07-31,1485889,2368205,-882316,아이슬란드,2017-07
2017-07-31,1454240,505901,948339,알바니아,2017-07
2017-07-31,1391467,0,1391467,버뮤다,2017-07
2017-07-31,1376634,41264,1335370,보츠와나,2017-07
2017-07-31,1168016,10500,1157516,안티가 바부다,2017-07
2017-07-31,1111292,597049,514243,몰도바,2017-07
2017-07-31,973401,268675,704726,가봉,2017-07
2017-07-31,894689,0,894689,마티니크,2017-07
2017-07-31,875354,86,875268,부룬디,2017-07
2017-07-31,849918,230136,619782,북마리아나 군도,2017-07
2017-07-31,793371,728781,64590,리히텐슈타인,2017-07
2017-07-31,703917,205,703712,네덜란드 열도,2017-07
2017-07-31,642963,78819,564144,말리,2017-07
2017-07-31,636413,108490,527923,티모르,2017-07
2017-07-31,593870,67523,526347,바베이도스,2017-07
2017-07-31,562369,47546,514823,세인트 루시아,2017-07
2017-07-31,553613,50505,503108,르완다,2017-07
2017-07-31,515612,924,514688,바하마,2017-07
2017-07-31,484465,212749,271716,수리남,2017-07
2017-07-31,483214,25682,457532,아메리칸 사모아,2017-07
2017-07-31,465660,141664,323996,말라위,2017-07
2017-07-31,443437,0,443437,영령 버진군도,2017-07
2017-07-31,432179,1403980,-971801,모리타니,2017-07
2017-07-31,423177,0,423177,영령 캐이맨 군도,2017-07
2017-07-31,403618,142034,261584,몬테네그로,2017-07
2017-07-31,397547,664202,-266655,아르메니아,2017-07
2017-07-31,396193,94851,301342,바누아투,2017-07
2017-07-31,382550,0,382550,큐라소,2017-07
2017-07-31,380576,38937,341639,몰디브,2017-07
2017-07-31,379967,9370,370597,도미니카,2017-07
2017-07-31,377028,4839,372189,그레나다,2017-07
2017-07-31,356548,934110,-577562,시에라 리온,2017-07
2017-07-31,354817,27986,326831,벨리제,2017-07
2017-07-31,319491,3070,316421,지브랄타,2017-07
2017-07-31,311980,3658,308322,스와질랜드,2017-07
2017-07-31,295430,617219,-321789,우간다,2017-07
2017-07-31,269364,363719,-94355,감비아,2017-07
2017-07-31,196333,64738,131595,나미비아,2017-07
2017-07-31,190836,0,190836,세인트 빈센트 그레나딘,2017-07
2017-07-31,150611,1495170,-1344559,보스니아-헤르체고비나,2017-07
2017-07-31,126696,354,126342,세인트 바르탤르미,2017-07
2017-07-31,112174,0,112174,메요트,2017-07
2017-07-31,111088,2528,108560,팔라우,2017-07
2017-07-31,92576,26131425,-26038849,적도 기니,2017-07
2017-07-31,87283,12467,74816,니제르,2017-07
2017-07-31,86606,11652,74954,미령 버진군도,2017-07
2017-07-31,68162,6829,61333,상토메 프린스페,2017-07
2017-07-31,62511,0,62511,투르크 & 카이코스 군도,2017-07
2017-07-31,48078,0,48078,불령 가이아나,2017-07
2017-07-31,46568,112,46456,챠드,2017-07
2017-07-31,44265,17902,26363,통가,2017-07
2017-07-31,42273,14554,27719,안도라,2017-07
2017-07-31,41693,11281,30412,카보 베르데,2017-07
2017-07-31,24419,2335,22084,산마리노,2017-07
2017-07-31,23360,754,22606,세인트 키츠 네비스,2017-07
2017-07-31,16375,1834,14541,나우루,2017-07
2017-07-31,8495,279194,-270699,모나코,2017-07
2017-07-31,7380,4787,2593,레소토,2017-07
2017-07-31,4882,18843,-13961,쿡 아일랜드,2017-07
2017-07-31,4120,28818,-24698,앙귈라,2017-07
2017-07-31,3573,26262,-22689,토켈라우,2017-07
2017-07-31,2807,0,2807,포클랜드 군도,2017-07
2017-07-31,1000,2756,-1756,남수단,2017-07
2017-07-31,880,0,880,피트카이른,2017-07
2017-07-31,822,0,822,중앙아프리카공화국,2017-07
2017-07-31,0,77,-77,건지,2017-07
2017-07-31,0,332,-332,에리트리아,2017-07
2017-07-31,0,672,-672,코모로스,2017-07
2017-07-31,0,50,-50,알랜드 군도,2017-07
2017-07-31,0,2,-2,니우에,2017-07
2017-07-31,0,17,-17,저어지,2017-07
2017-07-31,0,90770,-90770,그린랜드,2017-07
2017-07-31,0,27,-27,자이르,2017-07
2017-07-31,0,1604,-1604,코스 군도,2017-07
2017-07-31,0,115,-115,세인트 헬레나,2017-07
2017-08-31,11912498857,8116607959,3795890898,중국,2017-08
2017-08-31,5952843871,4544310709,1408533162,미국,2017-08
2017-08-31,3754935066,1528712719,2226222347,베트남,2017-08
2017-08-31,3287457730,147776133,3139681597,홍콩,2017-08
2017-08-31,2107245781,4535866404,-2428620623,일본,2017-08
2017-08-31,2034431673,373107516,1661324157,인도,2017-08
2017-08-31,1301928680,1577832066,-275903386,대만,2017-08
2017-08-31,1118019391,398227765,719791626,멕시코,2017-08
2017-08-31,1030981482,768675062,262306420,싱가포르,2017-08
2017-08-31,832776463,314144150,518632313,필리핀,2017-08
2017-08-31,750313343,1471232770,-720919427,호주,2017-08
2017-08-31,691210488,1692919619,-1001709131,독일,2017-08
2017-08-31,627417672,469223791,158193881,태국,2017-08
2017-08-31,625735298,844778559,-219043261,인도네시아,2017-08
2017-08-31,624651197,68258888,556392309,튀르키예,2017-08
2017-08-31,595226877,6919825,588307052,마샬군도,2017-08
2017-08-31,571426037,708512979,-137086942,말레이시아,2017-08
2017-08-31,517029056,941613974,-424584918,러시아 연방,2017-08
2017-08-31,442170696,1299130585,-856959889,아랍에미리트 연합,2017-08
2017-08-31,439107638,334502704,104604934,브라질,2017-08
2017-08-31,391724984,1664214777,-1272489793,사우디아라비아,2017-08
2017-08-31,384917536,447823589,-62906053,영국,2017-08
2017-08-31,374104303,319244598,54859705,캐나다,2017-08
2017-08-31,340831724,452366883,-111535159,네덜란드,2017-08
2017-08-31,336699411,473013327,-136313916,이탈리아,2017-08
2017-08-31,336310739,504752112,-168441373,프랑스,2017-08
2017-08-31,335607615,626615461,-291007846,이란,2017-08
2017-08-31,319538863,172211,319366652,사이프러스,2017-08
2017-08-31,268203871,16268024,251935847,슬로바키아,2017-08
2017-08-31,262340589,58601096,203739493,폴란드,2017-08
2017-08-31,229735793,154726343,75009450,스페인,2017-08
2017-08-31,223007658,8551388,214456270,파나마,2017-08
2017-08-31,208112244,63843570,144268674,체코공화국,2017-08
2017-08-31,200910572,109726311,91184261,벨기에,2017-08
2017-08-31,197464131,1765725,195698406,토고,2017-08
2017-08-31,185311182,82016985,103294197,덴마크,2017-08
2017-08-31,157738846,95394718,62344128,그리스,2017-08
2017-08-31,153417544,2789463,150628081,몰타,2017-08
2017-08-31,152562782,9405426,143157356,슬로베니아,2017-08
2017-08-31,111919222,1365675,110553547,우즈베키스탄,2017-08
2017-08-31,103328787,27163517,76165270,방글라데시,2017-08
2017-08-31,103295315,8285540,95009775,이집트,2017-08
2017-08-31,99953027,121862527,-21909500,노르웨이,2017-08
2017-08-31,97300428,117522299,-20221871,뉴질랜드,2017-08
2017-08-31,94574810,35565652,59009158,파키스탄,2017-08
2017-08-31,92393246,354848917,-262455671,칠레,2017-08
2017-08-31,84594944,106488559,-21893615,이스라엘,2017-08
2017-08-31,83505479,519202776,-435697297,이라크,2017-08
2017-08-31,75663037,816456273,-740793236,쿠웨이트,2017-08
2017-08-31,75027966,52835730,22192236,헝가리,2017-08
2017-08-31,71555582,205411594,-133856012,오만,2017-08
2017-08-31,70887658,138090481,-67202823,오스트리아,2017-08
2017-08-31,69034868,22060475,46974393,아르헨티나,2017-08
2017-08-31,67824393,189732498,-121908105,남아프리카공화국,2017-08
2017-08-31,67187977,52537210,14650767,콜롬비아,2017-08
2017-08-31,66860310,121965620,-55105310,스웨덴,2017-08
2017-08-31,63810881,95038777,-31227896,알제리,2017-08
2017-08-31,62347509,2799845,59547664,가나,2017-08
2017-08-31,61439688,109966763,-48527075,페루,2017-08
2017-08-31,59191698,286851056,-227659358,스위스,2017-08
2017-08-31,55936636,11812521,44124115,에쿠아도르,2017-08
2017-08-31,55068447,91044533,-35976086,아일랜드,2017-08
2017-08-31,50495440,7615402,42880038,요르단,2017-08
2017-08-31,47722651,24314171,23408480,캄보디아,2017-08
2017-08-31,44000000,145,43999855,맨섬,2017-08
2017-08-31,40240617,28473769,11766848,포루투갈,2017-08
2017-08-31,39427391,48690806,-9263415,미얀마,2017-08
2017-08-31,37167691,7689554,29478137,스리랑카,2017-08
2017-08-31,34855387,11387257,23468130,나이지리아,2017-08
2017-08-31,33994122,44736887,-10742765,루마니아,2017-08
2017-08-31,32657893,8411696,24246197,리투아니아,2017-08
2017-08-31,32161691,120682022,-88520331,카자흐스탄,2017-08
2017-08-31,27611940,910079925,-882467985,카타르,2017-08
2017-08-31,23919214,8057098,15862116,도미니카 공화국,2017-08
2017-08-31,22872818,4872802,18000016,케냐,2017-08
2017-08-31,22392952,12211459,10181493,우크라이나,2017-08
2017-08-31,21683311,1660,21681651,시리아,2017-08
2017-08-31,20573222,0,20573222,불령 폴리네시아,2017-08
2017-08-31,19574448,66075157,-46500709,핀란드,2017-08
2017-08-31,19308668,2328408,16980260,몽골,2017-08
2017-08-31,19104341,28354009,-9249668,리비아,2017-08
2017-08-31,18863328,18446013,417315,바레인,2017-08
2017-08-31,18539940,19374204,-834264,모로코,2017-08
2017-08-31,17383099,9248860,8134239,과테말라,2017-08
2017-08-31,15590704,704499,14886205,피지,2017-08
2017-08-31,14948235,11643768,3304467,푸에르토리코,2017-08
2017-08-31,14595907,14718043,-122136,불가리아,2017-08
2017-08-31,13462374,1750909,11711465,엘살바도르,2017-08
2017-08-31,13326027,2138751,11187276,레바논,2017-08
2017-08-31,12085676,11228253,857423,코스타리카,2017-08
2017-08-31,11822948,537712,11285236,코트디봐르,2017-08
2017-08-31,11621621,2557774,9063847,온두라스,2017-08
2017-08-31,10941984,1790217,9151767,수단,2017-08
2017-08-31,10467580,6736135,3731445,에티오피아,2017-08
2017-08-31,10305825,10918271,-612446,우루과이,2017-08
2017-08-31,9709995,24251744,-14541749,파라과이,2017-08
2017-08-31,9612831,943108,8669723,니카라과,2017-08
2017-08-31,8914759,3759845,5154914,탄자니아,2017-08
2017-08-31,8650984,22417,8628567,아제르바이잔,2017-08
2017-08-31,8531415,5103,8526312,키르기스스탄,2017-08
2017-08-31,8029363,6754322,1275041,에스토니아,2017-08
2017-08-31,7812924,529,7812395,지부티,2017-08
2017-08-31,7694730,16270027,-8575297,트리니다드 토바고,2017-08
2017-08-31,6265711,7486032,-1220321,라트비아,2017-08
2017-08-31,6199864,18306429,-12106565,볼리비아,2017-08
2017-08-31,6061982,3711414,2350568,예맨,2017-08
2017-08-31,5895932,5008721,887211,튀니지,2017-08
2017-08-31,5874177,144279,5729898,아이티,2017-08
2017-08-31,5614115,3384,5610731,쿠바,2017-08
2017-08-31,5477851,3492233,1985618,조지아,2017-08
2017-08-31,5216342,852223,4364119,크로아티아,2017-08
2017-08-31,5214537,4578,5209959,아프카니스탄,2017-08
2017-08-31,5068570,0,5068570,마이크로네시아,2017-08
2017-08-31,5021563,9806383,-4784820,세네갈,2017-08
2017-08-31,4835898,3350220,1485678,세르비아,2017-08
2017-08-31,4751250,210890,4540360,베닝,2017-08
2017-08-31,4315095,12909883,-8594788,브루나이,2017-08
2017-08-31,4197610,3627139,570471,라오스,2017-08
2017-08-31,4049048,175855,3873193,팔레스타인 해방기구,2017-08
2017-08-31,3975597,622498,3353099,벨라루스,2017-08
2017-08-31,3850225,34156248,-30306023,모잠비크,2017-08
2017-08-31,3467314,22476044,-19008730,뉴 칼레도니아,2017-08
2017-08-31,3320187,43632,3276555,부르키나 파소,2017-08
2017-08-31,3271406,5911046,-2639640,마다카스카르,2017-08
2017-08-31,3230555,48380,3182175,팔라우,2017-08
2017-08-31,3165905,383,3165522,투르크멘,2017-08
2017-08-31,3051244,10114955,-7063711,파푸아 뉴기니,2017-08
2017-08-31,2884353,676289,2208064,우간다,2017-08
2017-08-31,2834149,26739043,-23904894,앙골라,2017-08
2017-08-31,2822580,47233,2775347,괌,2017-08
2017-08-31,2809078,1050178,1758900,콩고,2017-08
2017-08-31,2750670,385327,2365343,모리셔스,2017-08
2017-08-31,2584533,96113,2488420,베네주엘라,2017-08
2017-08-31,2559773,85964,2473809,네팔,2017-08
2017-08-31,2503119,1700557,802562,기니,2017-08
2017-08-31,2460890,410975,2049915,마카오,2017-08
2017-08-31,2353155,0,2353155,세인트 마틴,2017-08
2017-08-31,2104982,259905,1845077,짐바브웨,2017-08
2017-08-31,1976827,19440,1957387,키리바티,2017-08
2017-08-31,1908134,10769346,-8861212,잠비아,2017-08
2017-08-31,1817331,2630389,-813058,아이슬란드,2017-08
2017-08-31,1780373,547583,1232790,카메룬,2017-08
2017-08-31,1580872,549946,1030926,소말리아,2017-08
2017-08-31,1449806,770178,679628,자마이카,2017-08
2017-08-31,1436383,2061354,-624971,세이쉘,2017-08
2017-08-31,1424703,0,1424703,불령 리유니온 코모도 제도,2017-08
2017-08-31,1322304,2007,1320297,사모아,2017-08
2017-08-31,1258145,0,1258145,과델로프,2017-08
2017-08-31,1192637,6073623,-4880986,룩셈부르그,2017-08
2017-08-31,1102564,46536121,-45433557,콩고민주공화국,2017-08
2017-08-31,1090314,3260,1087054,니제르,2017-08
2017-08-31,1067817,3474,1064343,말리,2017-08
2017-08-31,1043171,0,1043171,마티니크,2017-08
2017-08-31,1040673,0,1040673,세인트 바르탤르미,2017-08
2017-08-31,1022821,237313,785508,알바니아,2017-08
2017-08-31,1020574,0,1020574,버뮤다,2017-08
2017-08-31,966513,0,966513,몰디브,2017-08
2017-08-31,961648,559,961089,타지크,2017-08
2017-08-31,948031,145276,802755,북마리아나 군도,2017-08
2017-08-31,927455,997721,-70266,리히텐슈타인,2017-08
2017-08-31,815414,58931907,-58116493,기타국,2017-08
2017-08-31,766744,50098,716646,바베이도스,2017-08
2017-08-31,676802,948975,-272173,아루바,2017-08
2017-08-31,674759,1400386,-725627,몰도바,2017-08
2017-08-31,663093,692134,-29041,아르메니아,2017-08
2017-08-31,624355,1290,623065,바하마,2017-08
2017-08-31,602330,272572,329758,라이베리아,2017-08
2017-08-31,592024,3312350,-2720326,가봉,2017-08
2017-08-31,580286,0,580286,불령 가이아나,2017-08
2017-08-31,542914,71354,471560,말라위,2017-08
2017-08-31,529623,43998,485625,스와질랜드,2017-08
2017-08-31,522729,1996,520733,도미니카,2017-08
2017-08-31,490032,208949,281083,마세도니아,2017-08
2017-08-31,480686,40,480646,영령 캐이맨 군도,2017-08
2017-08-31,470300,675987,-205687,바누아투,2017-08
2017-08-31,462477,239184,223293,수리남,2017-08
2017-08-31,379122,0,379122,세인트 키츠 네비스,2017-08
2017-08-31,368118,2179832,-1811714,모리타니,2017-08
2017-08-31,353971,9377,344594,나미비아,2017-08
2017-08-31,349691,220,349471,몬테네그로,2017-08
2017-08-31,317153,123111,194042,르완다,2017-08
2017-08-31,315778,50659,265119,벨리제,2017-08
2017-08-31,292436,56,292380,그레나다,2017-08
2017-08-31,290191,358676,-68485,감비아,2017-08
2017-08-31,285037,542141,-257104,가이아나,2017-08
2017-08-31,280136,439,279697,안티가 바부다,2017-08
2017-08-31,275384,9823741,-9548357,에리트리아,2017-08
2017-08-31,274649,0,274649,지브랄타,2017-08
2017-08-31,272230,642,271588,네덜란드 열도,2017-08
2017-08-31,232542,0,232542,아메리칸 사모아,2017-08
2017-08-31,223861,1240089,-1016228,보스니아-헤르체고비나,2017-08
2017-08-31,221093,38299,182794,보츠와나,2017-08
2017-08-31,203851,505009,-301158,솔로몬 군도,2017-08
2017-08-31,193329,214,193115,큐라소,2017-08
2017-08-31,181819,16674,165145,세인트 루시아,2017-08
2017-08-31,176765,0,176765,세인트 빈센트 그레나딘,2017-08
2017-08-31,142329,0,142329,파로에 군도,2017-08
2017-08-31,128104,174239,-46135,티모르,2017-08
2017-08-31,117061,984768,-867707,시에라 리온,2017-08
2017-08-31,97246,0,97246,카보 베르데,2017-08
2017-08-31,84037,0,84037,부탄,2017-08
2017-08-31,74615,0,74615,영령 버진군도,2017-08
2017-08-31,56192,70507,-14315,중앙아프리카공화국,2017-08
2017-08-31,42888,0,42888,챠드,2017-08
2017-08-31,39585,703643,-664058,모나코,2017-08
2017-08-31,21195,0,21195,남조지아 & 남샌드위치 군도,2017-08
2017-08-31,17898,92,17806,투르크 & 카이코스 군도,2017-08
2017-08-31,14670,9964,4706,미령 버진군도,2017-08
2017-08-31,6688,1768,4920,안도라,2017-08
2017-08-31,6296,4733,1563,니우에,2017-08
2017-08-31,4000,8961,-4961,부룬디,2017-08
2017-08-31,2810,0,2810,통가,2017-08
2017-08-31,2810,18,2792,투발루,2017-08
2017-08-31,2250,55800,-53550,적도 기니,2017-08
2017-08-31,1125,62971,-61846,앙귈라,2017-08
2017-08-31,815,1223,-408,코모로스,2017-08
2017-08-31,165,0,165,저어지,2017-08
2017-08-31,18,57226,-57208,그린랜드,2017-08
2017-08-31,0,2489,-2489,레소토,2017-08
2017-08-31,0,136993,-136993,기네비소,2017-08
2017-08-31,0,2585,-2585,몬트세라트,2017-08
2017-08-31,0,25,-25,크리스마스 아일랜드,2017-08
2017-08-31,0,15997,-15997,피트카이른,2017-08
2017-08-31,0,49860,-49860,쿡 아일랜드,2017-08
2017-08-31,0,56130,-56130,산마리노,2017-08
2017-08-31,0,11849,-11849,건지,2017-08
2017-08-31,0,12283,-12283,토켈라우,2017-08
2017-08-31,0,6787,-6787,나우루,2017-08
2017-08-31,0,571,-571,자이르,2017-08
2017-09-30,13540682915,8443413537,5097269378,중국,2017-09
2017-09-30,6597924202,4077685959,2520238243,미국,2017-09
2017-09-30,4734487418,1716380705,3018106713,베트남,2017-09
2017-09-30,3828534234,192326859,3636207375,홍콩,2017-09
2017-09-30,2516087938,4925623410,-2409535472,일본,2017-09
2017-09-30,1882297446,104308725,1777988721,노르웨이,2017-09
2017-09-30,1357133789,1643946290,-286812501,대만,2017-09
2017-09-30,1151673364,443099420,708573944,인도,2017-09
2017-09-30,1136452666,811546943,324905723,싱가포르,2017-09
2017-09-30,1064494529,498910372,565584157,멕시코,2017-09
2017-09-30,1052530810,315797412,736733398,필리핀,2017-09
2017-09-30,951096873,1807136401,-856039528,호주,2017-09
2017-09-30,899231970,1790,899230180,마샬군도,2017-09
2017-09-30,721606606,1694062154,-972455548,독일,2017-09
2017-09-30,719005980,801461802,-82455822,인도네시아,2017-09
2017-09-30,714454465,472366571,242087894,태국,2017-09
2017-09-30,656245695,58037960,598207735,튀르키예,2017-09
2017-09-30,644478532,719410308,-74931776,말레이시아,2017-09
2017-09-30,566454567,2480,566452087,바하마,2017-09
2017-09-30,564923015,1214134202,-649211187,러시아 연방,2017-09
2017-09-30,554229648,100,554229548,영령 캐이맨 군도,2017-09
2017-09-30,502578899,372194283,130384616,브라질,2017-09
2017-09-30,469803668,687247287,-217443619,아랍에미리트 연합,2017-09
2017-09-30,440646131,831981489,-391335358,네덜란드,2017-09
2017-09-30,431145319,538989821,-107844502,이탈리아,2017-09
2017-09-30,413135423,523109633,-109974210,영국,2017-09
2017-09-30,407918566,525517703,-117599137,캐나다,2017-09
2017-09-30,390707252,778877771,-388170519,이란,2017-09
2017-09-30,348776291,1703394604,-1354618313,사우디아라비아,2017-09
2017-09-30,333689421,494587198,-160897777,프랑스,2017-09
2017-09-30,269824715,2359446,267465269,토고,2017-09
2017-09-30,268971900,56161985,212809915,폴란드,2017-09
2017-09-30,266591083,155816852,110774231,스페인,2017-09
2017-09-30,255253092,105935966,149317126,벨기에,2017-09
2017-09-30,230805977,57725578,173080399,체코공화국,2017-09
2017-09-30,225645406,16585592,209059814,슬로바키아,2017-09
2017-09-30,215433815,5410966,210022849,그리스,2017-09
2017-09-30,179960398,8599396,171361002,슬로베니아,2017-09
2017-09-30,146823726,111578163,35245563,페루,2017-09
2017-09-30,137174557,86228306,50946251,이스라엘,2017-09
2017-09-30,131197019,2111370,129085649,파나마,2017-09
2017-09-30,124971955,794832,124177123,우즈베키스탄,2017-09
2017-09-30,118796363,377919052,-259122689,칠레,2017-09
2017-09-30,115164605,1047538,114117067,크로아티아,2017-09
2017-09-30,113904698,99053487,14851211,뉴질랜드,2017-09
2017-09-30,113421975,6544755,106877220,이집트,2017-09
2017-09-30,109051000,644717870,-535666870,쿠웨이트,2017-09
2017-09-30,105959031,397487920,-291528889,이라크,2017-09
2017-09-30,97128117,163398055,-66269938,오스트리아,2017-09
2017-09-30,97005168,63674025,33331143,콜롬비아,2017-09
2017-09-30,96083439,145741751,-49658312,남아프리카공화국,2017-09
2017-09-30,91557465,32365248,59192217,방글라데시,2017-09
2017-09-30,89437531,67772530,21665001,헝가리,2017-09
2017-09-30,88411607,49588065,38823542,아르헨티나,2017-09
2017-09-30,88356614,21357652,66998962,파키스탄,2017-09
2017-09-30,87154771,142735668,-55580897,오만,2017-09
2017-09-30,79336973,131824683,-52487710,스웨덴,2017-09
2017-09-30,73781435,229565073,-155783638,스위스,2017-09
2017-09-30,71813983,25438211,46375772,알제리,2017-09
2017-09-30,60533336,92986677,-32453341,기타국,2017-09
2017-09-30,58065136,12906075,45159061,에쿠아도르,2017-09
2017-09-30,56488138,26111532,30376606,캄보디아,2017-09
2017-09-30,54604883,51134,54553749,라이베리아,2017-09
2017-09-30,49419085,59565790,-10146705,미얀마,2017-09
2017-09-30,49402685,4973636,44429049,요르단,2017-09
2017-09-30,47291880,86738259,-39446379,카자흐스탄,2017-09
2017-09-30,47067714,95514955,-48447241,아일랜드,2017-09
2017-09-30,44723316,27733776,16989540,포루투갈,2017-09
2017-09-30,41477260,36657203,4820057,나이지리아,2017-09
2017-09-30,41085699,42125996,-1040297,루마니아,2017-09
2017-09-30,35002927,782213930,-747211003,카타르,2017-09
2017-09-30,34572883,55502135,-20929252,덴마크,2017-09
2017-09-30,33462376,350991,33111385,피지,2017-09
2017-09-30,33198190,0,33198190,맨섬,2017-09
2017-09-30,31500414,1157,31499257,시리아,2017-09
2017-09-30,27997285,8617826,19379459,리투아니아,2017-09
2017-09-30,25928747,116750591,-90821844,핀란드,2017-09
2017-09-30,24966372,2437202,22529170,몽골,2017-09
2017-09-30,24483864,17876415,6607449,모로코,2017-09
2017-09-30,23406757,7014737,16392020,스리랑카,2017-09
2017-09-30,22651597,12794347,9857250,푸에르토리코,2017-09
2017-09-30,22466291,12388233,10078058,도미니카 공화국,2017-09
2017-09-30,22285075,6136743,16148332,과테말라,2017-09
2017-09-30,21871844,55323477,-33451633,우크라이나,2017-09
2017-09-30,21717583,30117865,-8400282,리비아,2017-09
2017-09-30,20539275,1197573,19341702,레바논,2017-09
2017-09-30,19409594,73044439,-53634845,바레인,2017-09
2017-09-30,17688892,5167360,12521532,파라과이,2017-09
2017-09-30,17300146,2914675,14385471,가나,2017-09
2017-09-30,16411552,11476226,4935326,코스타리카,2017-09
2017-09-30,13442361,12982188,460173,모잠비크,2017-09
2017-09-30,13107921,9814289,3293632,불가리아,2017-09
2017-09-30,12993456,0,12993456,불령 폴리네시아,2017-09
2017-09-30,12669709,2841687,9828022,케냐,2017-09
2017-09-30,12318347,4888050,7430297,튀니지,2017-09
2017-09-30,11767338,925221,10842117,탄자니아,2017-09
2017-09-30,10900188,2114332,8785856,엘살바도르,2017-09
2017-09-30,10649742,2193709,8456033,수단,2017-09
2017-09-30,10381777,4662537,5719240,예맨,2017-09
2017-09-30,9854384,2217431,7636953,아이슬란드,2017-09
2017-09-30,9680023,6364955,3315068,세르비아,2017-09
2017-09-30,9553964,561720,8992244,니카라과,2017-09
2017-09-30,9359578,0,9359578,팔레스타인 해방기구,2017-09
2017-09-30,8986166,6922854,2063312,트리니다드 토바고,2017-09
2017-09-30,8980396,2659178,6321218,온두라스,2017-09
2017-09-30,8344763,6629285,1715478,에티오피아,2017-09
2017-09-30,8244484,10634,8233850,키르기스스탄,2017-09
2017-09-30,8184284,6994088,1190196,에스토니아,2017-09
2017-09-30,7741846,141,7741705,지부티,2017-09
2017-09-30,7589442,9375927,-1786485,우루과이,2017-09
2017-09-30,7534157,331688,7202469,코트디봐르,2017-09
2017-09-30,7359802,66447,7293355,아이티,2017-09
2017-09-30,7151666,116932,7034734,쿠바,2017-09
2017-09-30,6096002,58434145,-52338143,브루나이,2017-09
2017-09-30,5847748,234095,5613653,네팔,2017-09
2017-09-30,5759750,7554233,-1794483,세네갈,2017-09
2017-09-30,5728993,1306232,4422761,마카오,2017-09
2017-09-30,5594637,102702,5491935,아제르바이잔,2017-09
2017-09-30,5508990,1362789,4146201,라오스,2017-09
2017-09-30,5467316,1116,5466200,아프카니스탄,2017-09
2017-09-30,5106433,39923028,-34816595,뉴 칼레도니아,2017-09
2017-09-30,5015389,2808838,2206551,파푸아 뉴기니,2017-09
2017-09-30,4813044,144165,4668879,괌,2017-09
2017-09-30,4782210,176820,4605390,마이크로네시아,2017-09
2017-09-30,4343024,1729,4341295,부르키나 파소,2017-09
2017-09-30,4332600,4128240,204360,베닝,2017-09
2017-09-30,4146588,2491787,1654801,조지아,2017-09
2017-09-30,4110569,3619893,490676,몰타,2017-09
2017-09-30,4108783,671136,3437647,베네주엘라,2017-09
2017-09-30,3991409,6613517,-2622108,라트비아,2017-09
2017-09-30,3655101,24846138,-21191037,볼리비아,2017-09
2017-09-30,3552257,609,3551648,투르크멘,2017-09
2017-09-30,3519509,2469691,1049818,벨라루스,2017-09
2017-09-30,3301829,375552,2926277,카메룬,2017-09
2017-09-30,2842190,5460445,-2618255,마다카스카르,2017-09
2017-09-30,2581727,127854,2453873,자마이카,2017-09
2017-09-30,2437138,748019,1689119,앙골라,2017-09
2017-09-30,2404782,18449,2386333,사모아,2017-09
2017-09-30,2335775,425295,1910480,모리셔스,2017-09
2017-09-30,2288709,790168,1498541,시에라 리온,2017-09
2017-09-30,2285432,385746,1899686,사이프러스,2017-09
2017-09-30,1857781,119,1857662,말리,2017-09
2017-09-30,1832023,181078,1650945,북마리아나 군도,2017-09
2017-09-30,1650424,184380,1466044,세이쉘,2017-09
2017-09-30,1535384,53671,1481713,말라위,2017-09
2017-09-30,1520673,552,1520121,불령 리유니온 코모도 제도,2017-09
2017-09-30,1509247,709933,799314,소말리아,2017-09
2017-09-30,1496318,10380789,-8884471,잠비아,2017-09
2017-09-30,1453695,699422,754273,우간다,2017-09
2017-09-30,1405238,13714,1391524,바베이도스,2017-09
2017-09-30,1396454,54748,1341706,타지크,2017-09
2017-09-30,1328208,2441157,-1112949,기니,2017-09
2017-09-30,1286149,1021606,264543,마세도니아,2017-09
2017-09-30,1235909,625261,610648,아루바,2017-09
2017-09-30,1202203,459285,742918,짐바브웨,2017-09
2017-09-30,1186732,941453,245279,리히텐슈타인,2017-09
2017-09-30,1177770,64170,1113600,티모르,2017-09
2017-09-30,1088411,1420757,-332346,모리타니,2017-09
2017-09-30,1052158,2652142,-1599984,콩고,2017-09
2017-09-30,1013685,4052293,-3038608,룩셈부르그,2017-09
2017-09-30,951503,1014642,-63139,아르메니아,2017-09
2017-09-30,890485,141,890344,챠드,2017-09
2017-09-30,861903,310426,551477,수리남,2017-09
2017-09-30,861431,250166,611265,가이아나,2017-09
2017-09-30,778902,2409,776493,몰디브,2017-09
2017-09-30,688804,230750,458054,벨리제,2017-09
2017-09-30,655736,512413,143323,알바니아,2017-09
2017-09-30,649492,138416,511076,가봉,2017-09
2017-09-30,606472,1362487,-756015,몰도바,2017-09
2017-09-30,589212,0,589212,세인트 마틴,2017-09
2017-09-30,578461,0,578461,불령 가이아나,2017-09
2017-09-30,568805,215028,353777,솔로몬 군도,2017-09
2017-09-30,549096,44032,505064,보츠와나,2017-09
2017-09-30,545309,1111,544198,아메리칸 사모아,2017-09
2017-09-30,537498,0,537498,과델로프,2017-09
2017-09-30,536170,373,535797,큐라소,2017-09
2017-09-30,525383,111168,414215,스와질랜드,2017-09
2017-09-30,490415,585,489830,마티니크,2017-09
2017-09-30,468099,627810,-159711,키리바티,2017-09
2017-09-30,456721,100,456621,버뮤다,2017-09
2017-09-30,445650,94,445556,감비아,2017-09
2017-09-30,420837,62209215,-61788378,콩고민주공화국,2017-09
2017-09-30,418073,80,417993,안티가 바부다,2017-09
2017-09-30,416455,24146,392309,세인트 키츠 네비스,2017-09
2017-09-30,305430,296333,9097,바누아투,2017-09
2017-09-30,273898,29204,244694,팔라우,2017-09
2017-09-30,260848,7434,253414,도미니카,2017-09
2017-09-30,241285,2906,238379,부탄,2017-09
2017-09-30,234230,319162,-84932,몬테네그로,2017-09
2017-09-30,229615,1290454,-1060839,보스니아-헤르체고비나,2017-09
2017-09-30,200067,0,200067,영령 버진군도,2017-09
2017-09-30,199800,57236,142564,르완다,2017-09
2017-09-30,192166,0,192166,세인트 루시아,2017-09
2017-09-30,180328,20327746,-20147418,나미비아,2017-09
2017-09-30,176838,959,175879,미령 버진군도,2017-09
2017-09-30,136660,0,136660,지브랄타,2017-09
2017-09-30,131537,0,131537,그레나다,2017-09
2017-09-30,89738,3720,86018,안도라,2017-09
2017-09-30,83887,0,83887,네덜란드 열도,2017-09
2017-09-30,68765,0,68765,투발루,2017-09
2017-09-30,56071,0,56071,세인트 빈센트 그레나딘,2017-09
2017-09-30,34997,494523,-459526,모나코,2017-09
2017-09-30,31357,221,31136,나우루,2017-09
2017-09-30,26030,0,26030,안타티카,2017-09
2017-09-30,25357,0,25357,카보 베르데,2017-09
2017-09-30,24980,59,24921,상토메 프린스페,2017-09
2017-09-30,20597,39810,-19213,산마리노,2017-09
2017-09-30,19854,71924,-52070,통가,2017-09
2017-09-30,13266,2334,10932,세인트 바르탤르미,2017-09
2017-09-30,13135,296,12839,레소토,2017-09
2017-09-30,8485,8277,208,니제르,2017-09
2017-09-30,6281,3026,3255,부룬디,2017-09
2017-09-30,5880,17,5863,코모로스,2017-09
2017-09-30,3350,11864,-8514,세인트 헬레나,2017-09
2017-09-30,2731,173004,-170273,쿡 아일랜드,2017-09
2017-09-30,961,0,961,파로에 군도,2017-09
2017-09-30,747,1033,-286,투르크 & 카이코스 군도,2017-09
2017-09-30,450,68,382,중앙아프리카공화국,2017-09
2017-09-30,78,0,78,앙귈라,2017-09
2017-09-30,49,51767,-51718,그린랜드,2017-09
2017-09-30,0,1365,-1365,마이너 아우틀링 합중국 군도,2017-09
2017-09-30,0,94059,-94059,크리스마스 아일랜드,2017-09
2017-09-30,0,39730952,-39730952,적도 기니,2017-09
2017-09-30,0,623,-623,저어지,2017-09
2017-09-30,0,169471,-169471,포클랜드 군도,2017-09
2017-09-30,0,108,-108,교황청,2017-09
2017-09-30,0,808,-808,몬트세라트,2017-09
2017-09-30,0,707,-707,니우에,2017-09
2017-09-30,0,22,-22,토켈라우,2017-09
2017-10-31,12580473717,7932402734,4648070983,중국,2017-10
2017-10-31,4726842191,3448256858,1278585333,미국,2017-10
2017-10-31,3864652296,1532299391,2332352905,베트남,2017-10
2017-10-31,3657235729,141061931,3516173798,홍콩,2017-10
2017-10-31,1847998975,4418583379,-2570584404,일본,2017-10
2017-10-31,1703914422,15407365,1688507057,나이지리아,2017-10
2017-10-31,1138592992,1428411072,-289818080,대만,2017-10
2017-10-31,904567365,318569964,585997401,필리핀,2017-10
2017-10-31,898662394,378921114,519741280,인도,2017-10
2017-10-31,896779598,585247848,311531750,싱가포르,2017-10
2017-10-31,773650759,1317970483,-544319724,호주,2017-10
2017-10-31,741086243,345395055,395691188,멕시코,2017-10
2017-10-31,624105045,1622007601,-997902556,독일,2017-10
2017-10-31,623016153,889874245,-266858092,인도네시아,2017-10
2017-10-31,530227946,395481786,134746160,태국,2017-10
2017-10-31,513251656,100180607,413071049,튀르키예,2017-10
2017-10-31,495787806,651139372,-155351566,말레이시아,2017-10
2017-10-31,431119021,1101570463,-670451442,러시아 연방,2017-10
2017-10-31,417475217,1305087300,-887612083,사우디아라비아,2017-10
2017-10-31,415327432,524910484,-109583052,영국,2017-10
2017-10-31,415140281,294671159,120469122,브라질,2017-10
2017-10-31,329643251,468550805,-138907554,이탈리아,2017-10
2017-10-31,322291817,752240157,-429948340,아랍에미리트 연합,2017-10
2017-10-31,319200870,310091,318890779,사이프러스,2017-10
2017-10-31,309479045,420981987,-111502942,캐나다,2017-10
2017-10-31,279038436,356316372,-77277936,네덜란드,2017-10
2017-10-31,269135781,51529843,217605938,폴란드,2017-10
2017-10-31,267212139,731976521,-464764382,이란,2017-10
2017-10-31,242501578,81518397,160983181,노르웨이,2017-10
2017-10-31,224619161,416998578,-192379417,프랑스,2017-10
2017-10-31,209083887,112419017,96664870,벨기에,2017-10
2017-10-31,192074520,1079,192073441,바하마,2017-10
2017-10-31,189786889,50046033,139740856,덴마크,2017-10
2017-10-31,183493038,124942884,58550154,스페인,2017-10
2017-10-31,165585770,15102351,150483419,슬로바키아,2017-10
2017-10-31,159772415,1360,159771055,마샬군도,2017-10
2017-10-31,149786653,56261081,93525572,체코공화국,2017-10
2017-10-31,134791002,3909873,130881129,토고,2017-10
2017-10-31,133036618,9690494,123346124,슬로베니아,2017-10
2017-10-31,132395478,245173589,-112778111,칠레,2017-10
2017-10-31,100224405,96935033,3289372,뉴질랜드,2017-10
2017-10-31,96653190,58291344,38361846,헝가리,2017-10
2017-10-31,94479690,3956930,90522760,이집트,2017-10
2017-10-31,92065044,22627011,69438033,방글라데시,2017-10
2017-10-31,85538695,490278642,-404739947,이라크,2017-10
2017-10-31,84879173,119984059,-35104886,오스트리아,2017-10
2017-10-31,81103494,197622303,-116518809,페루,2017-10
2017-10-31,81068427,131036956,-49968529,오만,2017-10
2017-10-31,78612358,1204330,77408028,우즈베키스탄,2017-10
2017-10-31,75203911,71945757,3258154,이스라엘,2017-10
2017-10-31,72750158,27986096,44764062,파키스탄,2017-10
2017-10-31,68683585,191757078,-123073493,남아프리카공화국,2017-10
2017-10-31,65875898,161242181,-95366283,알제리,2017-10
2017-10-31,64791529,913974971,-849183442,쿠웨이트,2017-10
2017-10-31,59411964,134676612,-75264648,스웨덴,2017-10
2017-10-31,57306910,882132,56424778,크로아티아,2017-10
2017-10-31,56702555,32378128,24324427,콜롬비아,2017-10
2017-10-31,56382862,97506342,-41123480,아르헨티나,2017-10
2017-10-31,51928438,8584986,43343452,에쿠아도르,2017-10
2017-10-31,44369573,94437716,-50068143,아일랜드,2017-10
2017-10-31,43284566,3361816,39922750,요르단,2017-10
2017-10-31,38056089,69755623,-31699534,카자흐스탄,2017-10
2017-10-31,37029643,18318433,18711210,캄보디아,2017-10
2017-10-31,36151609,22083954,14067655,포루투갈,2017-10
2017-10-31,35752207,948054181,-912301974,카타르,2017-10
2017-10-31,34620608,48322238,-13701630,미얀마,2017-10
2017-10-31,32288960,218784695,-186495735,스위스,2017-10
2017-10-31,29836311,29918511,-82200,루마니아,2017-10
2017-10-31,27707447,5504604,22202843,스리랑카,2017-10
2017-10-31,26685281,11282581,15402700,푸에르토리코,2017-10
2017-10-31,22401521,2681116,19720405,그리스,2017-10
2017-10-31,22305519,1670583,20634936,파나마,2017-10
2017-10-31,21587205,60851566,-39264361,리비아,2017-10
2017-10-31,20776371,4784924,15991447,리투아니아,2017-10
2017-10-31,20073227,19223999,849228,바레인,2017-10
2017-10-31,19767608,81373300,-61605692,핀란드,2017-10
2017-10-31,19027064,2400395,16626669,몽골,2017-10
2017-10-31,16429985,16063573,366412,모로코,2017-10
2017-10-31,15491282,2496115,12995167,케냐,2017-10
2017-10-31,14758524,52992980,-38234456,우크라이나,2017-10
2017-10-31,14496660,11468910,3027750,도미니카 공화국,2017-10
2017-10-31,14230905,3631070,10599835,가나,2017-10
2017-10-31,14154797,853240,13301557,레바논,2017-10
2017-10-31,13764771,1439712,12325059,엘살바도르,2017-10
2017-10-31,13354035,4365466,8988569,과테말라,2017-10
2017-10-31,12461187,2508557,9952630,수단,2017-10
2017-10-31,11349464,12072191,-722727,불가리아,2017-10
2017-10-31,10900998,0,10900998,팔레스타인 해방기구,2017-10
2017-10-31,10326503,1071,10325432,아프카니스탄,2017-10
2017-10-31,9843250,888,9842362,시리아,2017-10
2017-10-31,9620543,307455,9313088,파라과이,2017-10
2017-10-31,9225641,1678242,7547399,탄자니아,2017-10
2017-10-31,8588265,23476432,-14888167,트리니다드 토바고,2017-10
2017-10-31,8447674,9291742,-844068,코스타리카,2017-10
2017-10-31,8286651,6894198,1392453,우루과이,2017-10
2017-10-31,7426169,849563,6576606,코트디봐르,2017-10
2017-10-31,7313260,6624284,688976,세르비아,2017-10
2017-10-31,7284784,1741586,5543198,라오스,2017-10
2017-10-31,6820239,3657718,3162521,튀니지,2017-10
2017-10-31,6377770,5388203,989567,에티오피아,2017-10
2017-10-31,6045912,4901210,1144702,에스토니아,2017-10
2017-10-31,5988294,96,5988198,지부티,2017-10
2017-10-31,5457843,6271887,-814044,세네갈,2017-10
2017-10-31,5338162,2398171,2939991,예맨,2017-10
2017-10-31,5177277,42467,5134810,아이티,2017-10
2017-10-31,5010940,109528247,-104517307,브루나이,2017-10
2017-10-31,4935866,2536704,2399162,온두라스,2017-10
2017-10-31,4921008,565108,4355900,니카라과,2017-10
2017-10-31,4875312,194193,4681119,키르기스스탄,2017-10
2017-10-31,4826494,0,4826494,불령 리유니온 코모도 제도,2017-10
2017-10-31,4381201,74000,4307201,마이크로네시아,2017-10
2017-10-31,4272645,7468649,-3196004,라트비아,2017-10
2017-10-31,4167866,13745,4154121,아제르바이잔,2017-10
2017-10-31,4126247,55087758,-50961511,볼리비아,2017-10
2017-10-31,4124590,499004,3625586,모잠비크,2017-10
2017-10-31,4018069,22427572,-18409503,파푸아 뉴기니,2017-10
2017-10-31,3857525,2447627,1409898,조지아,2017-10
2017-10-31,3805564,253178,3552386,괌,2017-10
2017-10-31,3721319,132604346,-128883027,기타국,2017-10
2017-10-31,3301557,2541630,759927,베닝,2017-10
2017-10-31,3228104,113819,3114285,팔라우,2017-10
2017-10-31,2870011,2911088,-41077,몰타,2017-10
2017-10-31,2835724,368997,2466727,쿠바,2017-10
2017-10-31,2688545,5355757,-2667212,마다카스카르,2017-10
2017-10-31,2622335,89792,2532543,네팔,2017-10
2017-10-31,2609749,2632554,-22805,아이슬란드,2017-10
2017-10-31,2597495,342724,2254771,피지,2017-10
2017-10-31,2566366,15207798,-12641432,앙골라,2017-10
2017-10-31,2460673,49798,2410875,자마이카,2017-10
2017-10-31,2230360,352617,1877743,모리셔스,2017-10
2017-10-31,2031671,406,2031265,불령 폴리네시아,2017-10
2017-10-31,1992341,67790,1924551,부르키나 파소,2017-10
2017-10-31,1980000,287112,1692888,소말리아,2017-10
2017-10-31,1949911,764,1949147,투르크멘,2017-10
2017-10-31,1884345,54390988,-52506643,카메룬,2017-10
2017-10-31,1807171,1978415,-171244,벨라루스,2017-10
2017-10-31,1803276,349776,1453500,베네주엘라,2017-10
2017-10-31,1792136,11916419,-10124283,뉴 칼레도니아,2017-10
2017-10-31,1693115,225923,1467192,마카오,2017-10
2017-10-31,1584731,765,1583966,세인트 마틴,2017-10
2017-10-31,1473055,363478,1109577,세이쉘,2017-10
2017-10-31,1438812,412438,1026374,우간다,2017-10
2017-10-31,1410977,75992,1334985,사모아,2017-10
2017-10-31,1371840,54984749,-53612909,콩고민주공화국,2017-10
2017-10-31,1336440,14191614,-12855174,잠비아,2017-10
2017-10-31,1296019,139061,1156958,라이베리아,2017-10
2017-10-31,1288573,2805303,-1516730,콩고,2017-10
2017-10-31,1213391,69169,1144222,마세도니아,2017-10
2017-10-31,1198648,5754917,-4556269,룩셈부르그,2017-10
2017-10-31,1021775,84,1021691,타지크,2017-10
2017-10-31,956430,138245,818185,짐바브웨,2017-10
2017-10-31,942550,521375,421175,아루바,2017-10
2017-10-31,941076,1368741,-427665,리히텐슈타인,2017-10
2017-10-31,930270,1330397,-400127,기니,2017-10
2017-10-31,892930,13546795,-12653865,가봉,2017-10
2017-10-31,863890,887272,-23382,아르메니아,2017-10
2017-10-31,805918,2095235,-1289317,스와질랜드,2017-10
2017-10-31,802568,0,802568,네덜란드 열도,2017-10
2017-10-31,799592,0,799592,말리,2017-10
2017-10-31,790484,114576,675908,가이아나,2017-10
2017-10-31,782572,51,782521,마티니크,2017-10
2017-10-31,756031,95052,660979,북마리아나 군도,2017-10
2017-10-31,705685,266645,439040,키리바티,2017-10
2017-10-31,645920,1609837,-963917,알바니아,2017-10
2017-10-31,641270,931039,-289769,몰도바,2017-10
2017-10-31,579132,327,578805,수리남,2017-10
2017-10-31,554541,0,554541,과델로프,2017-10
2017-10-31,481191,339,480852,영령 캐이맨 군도,2017-10
2017-10-31,423427,613,422814,버뮤다,2017-10
2017-10-31,399336,1472203,-1072867,솔로몬 군도,2017-10
2017-10-31,382268,0,382268,벨리제,2017-10
2017-10-31,378599,274,378325,큐라소,2017-10
2017-10-31,370665,1615899,-1245234,모리타니,2017-10
2017-10-31,353773,0,353773,도미니카,2017-10
2017-10-31,346877,29319,317558,바베이도스,2017-10
2017-10-31,341870,22887,318983,몰디브,2017-10
2017-10-31,340500,0,340500,남조지아 & 남샌드위치 군도,2017-10
2017-10-31,308994,296,308698,부탄,2017-10
2017-10-31,308436,23211,285225,아메리칸 사모아,2017-10
2017-10-31,298964,7392,291572,보츠와나,2017-10
2017-10-31,290589,358613,-68024,감비아,2017-10
2017-10-31,286239,1154667,-868428,시에라 리온,2017-10
2017-10-31,277542,72352,205190,말라위,2017-10
2017-10-31,262652,457,262195,티모르,2017-10
2017-10-31,261322,46,261276,몬테네그로,2017-10
2017-10-31,210092,4501738,-4291646,보스니아-헤르체고비나,2017-10
2017-10-31,203393,0,203393,불령 가이아나,2017-10
2017-10-31,152843,42512,110331,바누아투,2017-10
2017-10-31,150206,156623,-6417,르완다,2017-10
2017-10-31,121183,55,121128,안티가 바부다,2017-10
2017-10-31,118723,31034,87689,세인트 키츠 네비스,2017-10
2017-10-31,106275,0,106275,지브랄타,2017-10
2017-10-31,103607,60639,42968,중앙아프리카공화국,2017-10
2017-10-31,97505,114,97391,투르크 & 카이코스 군도,2017-10
2017-10-31,75479,32,75447,남수단,2017-10
2017-10-31,72156,497,71659,그레나다,2017-10
2017-10-31,69924,0,69924,세인트 루시아,2017-10
2017-10-31,66245,29904,36341,챠드,2017-10
2017-10-31,60480,66498,-6018,기네비소,2017-10
2017-10-31,44624,0,44624,투발루,2017-10
2017-10-31,44148,0,44148,세인트 빈센트 그레나딘,2017-10
2017-10-31,42021,199500,-157479,나미비아,2017-10
2017-10-31,36763,252,36511,영령 버진군도,2017-10
2017-10-31,36586,1617274,-1580688,통가,2017-10
2017-10-31,28728,1242,27486,레소토,2017-10
2017-10-31,18752,89927,-71175,산마리노,2017-10
2017-10-31,14752,0,14752,메요트,2017-10
2017-10-31,13675,22062,-8387,코모로스,2017-10
2017-10-31,10824,17302,-6478,미령 버진군도,2017-10
2017-10-31,8227,1073,7154,니제르,2017-10
2017-10-31,7853,0,7853,앙귈라,2017-10
2017-10-31,5475,6621,-1146,부룬디,2017-10
2017-10-31,4286,230,4056,카보 베르데,2017-10
2017-10-31,2305,1680,625,세인트 헬레나,2017-10
2017-10-31,1824,0,1824,안타티카,2017-10
2017-10-31,950,6,944,상토메 프린스페,2017-10
2017-10-31,657,0,657,왈라스 & 퓨투나 군도,2017-10
2017-10-31,440,0,440,파로에 군도,2017-10
2017-10-31,291,40948084,-40947793,적도 기니,2017-10
2017-10-31,14,569,-555,저어지,2017-10
2017-10-31,0,355,-355,니우에,2017-10
2017-10-31,0,172,-172,토켈라우,2017-10
2017-10-31,0,9419,-9419,안도라,2017-10
2017-10-31,0,3593,-3593,건지,2017-10
2017-10-31,0,47961,-47961,쿡 아일랜드,2017-10
2017-10-31,0,36593273,-36593273,에리트리아,2017-10
2017-10-31,0,1061,-1061,크리스마스 아일랜드,2017-10
2017-10-31,0,500,-500,영령 인도양,2017-10
2017-10-31,0,115719,-115719,그린랜드,2017-10
2017-10-31,0,181,-181,나우루,2017-10
2017-10-31,0,4395,-4395,몬트세라트,2017-10
2017-10-31,0,124576,-124576,모나코,2017-10
2017-11-30,14000887074,9253318341,4747568733,중국,2017-11
2017-11-30,6381591389,4194796059,2186795330,미국,2017-11
2017-11-30,4411512124,1486102243,2925409881,베트남,2017-11
2017-11-30,3751698650,155679681,3596018969,홍콩,2017-11
2017-11-30,2520013186,4731861067,-2211847881,일본,2017-11
2017-11-30,1289957310,1559263187,-269305877,대만,2017-11
2017-11-30,1108705027,422063360,686641667,인도,2017-11
2017-11-30,997396544,1596609916,-599213372,호주,2017-11
2017-11-30,973535795,296460500,677075295,필리핀,2017-11
2017-11-30,824010591,716295789,107714802,싱가포르,2017-11
2017-11-30,783872205,445146511,338725694,멕시코,2017-11
2017-11-30,719386489,734762007,-15375518,인도네시아,2017-11
2017-11-30,691222623,1833954659,-1142732036,독일,2017-11
2017-11-30,650585888,410239470,240346418,태국,2017-11
2017-11-30,629842730,958459902,-328617172,말레이시아,2017-11
2017-11-30,570817329,1599246283,-1028428954,사우디아라비아,2017-11
2017-11-30,538023362,940446684,-402423322,러시아 연방,2017-11
2017-11-30,479254963,84292092,394962871,튀르키예,2017-11
2017-11-30,437578300,527323063,-89744763,영국,2017-11
2017-11-30,436998971,388089832,48909139,브라질,2017-11
2017-11-30,436898865,660355496,-223456631,아랍에미리트 연합,2017-11
2017-11-30,369337005,561678654,-192341649,네덜란드,2017-11
2017-11-30,354560512,348193717,6366795,캐나다,2017-11
2017-11-30,324240743,615010326,-290769583,이란,2017-11
2017-11-30,317814722,135,317814587,바하마,2017-11
2017-11-30,316312488,497726749,-181414261,이탈리아,2017-11
2017-11-30,301049464,57156229,243893235,폴란드,2017-11
2017-11-30,271250231,172338021,98912210,스페인,2017-11
2017-11-30,259784734,481636586,-221851852,프랑스,2017-11
2017-11-30,246596155,12735266,233860889,슬로바키아,2017-11
2017-11-30,241528794,113480223,128048571,벨기에,2017-11
2017-11-30,232178028,66286404,165891624,체코공화국,2017-11
2017-11-30,194929044,8522450,186406594,슬로베니아,2017-11
2017-11-30,194811816,10877,194800939,마샬군도,2017-11
2017-11-30,160401970,7186239,153215731,파나마,2017-11
2017-11-30,133842961,89310456,44532505,뉴질랜드,2017-11
2017-11-30,132714588,526257287,-393542699,이라크,2017-11
2017-11-30,123892818,196460466,-72567648,알제리,2017-11
2017-11-30,123367627,374802443,-251434816,칠레,2017-11
2017-11-30,116382951,18980006,97402945,방글라데시,2017-11
2017-11-30,115558112,113243355,2314757,이스라엘,2017-11
2017-11-30,111175424,900889149,-789713725,쿠웨이트,2017-11
2017-11-30,105257303,209002371,-103745068,페루,2017-11
2017-11-30,104222769,2039771,102182998,우즈베키스탄,2017-11
2017-11-30,102804467,20168381,82636086,이집트,2017-11
2017-11-30,98760625,28485311,70275314,파키스탄,2017-11
2017-11-30,88588658,52560646,36028012,헝가리,2017-11
2017-11-30,82084025,186010002,-103925977,오스트리아,2017-11
2017-11-30,76665900,143312521,-66646621,스웨덴,2017-11
2017-11-30,74144562,87395323,-13250761,아르헨티나,2017-11
2017-11-30,71620191,177657660,-106037469,남아프리카공화국,2017-11
2017-11-30,68162268,216976186,-148813918,오만,2017-11
2017-11-30,61641628,5310076,56331552,요르단,2017-11
2017-11-30,59524808,24467831,35056977,콜롬비아,2017-11
2017-11-30,58821506,8215943,50605563,에쿠아도르,2017-11
2017-11-30,55166854,15181876,39984978,캄보디아,2017-11
2017-11-30,54965613,76593660,-21628047,아일랜드,2017-11
2017-11-30,54683971,2665668,52018303,토고,2017-11
2017-11-30,50706754,888178042,-837471288,카타르,2017-11
2017-11-30,49553805,267908151,-218354346,카자흐스탄,2017-11
2017-11-30,47158071,44384105,2773966,미얀마,2017-11
2017-11-30,45826293,230895414,-185069121,스위스,2017-11
2017-11-30,41290968,32024989,9265979,나이지리아,2017-11
2017-11-30,40061520,21896901,18164619,포루투갈,2017-11
2017-11-30,33861986,34962569,-1100583,리비아,2017-11
2017-11-30,33857994,40078403,-6220409,루마니아,2017-11
2017-11-30,32973056,2361,32970695,시리아,2017-11
2017-11-30,30457727,61770390,-31312663,덴마크,2017-11
2017-11-30,29969452,97030427,-67060975,노르웨이,2017-11
2017-11-30,29479997,4956040,24523957,과테말라,2017-11
2017-11-30,29306185,101153445,-71847260,핀란드,2017-11
2017-11-30,27119405,336175,26783230,피지,2017-11
2017-11-30,26416667,975617,25441050,앙골라,2017-11
2017-11-30,23951155,5411859,18539296,스리랑카,2017-11
2017-11-30,23677436,6625862,17051574,리투아니아,2017-11
2017-11-30,23447384,12904119,10543265,도미니카 공화국,2017-11
2017-11-30,21633738,16615635,5018103,푸에르토리코,2017-11
2017-11-30,21591143,1822847,19768296,온두라스,2017-11
2017-11-30,20380476,21498608,-1118132,모로코,2017-11
2017-11-30,19951397,49222526,-29271129,우크라이나,2017-11
2017-11-30,19936597,6572041,13364556,레바논,2017-11
2017-11-30,19481134,52781673,-33300539,그리스,2017-11
2017-11-30,19411217,1238700,18172517,수단,2017-11
2017-11-30,18655235,3359365,15295870,가나,2017-11
2017-11-30,17146032,3730856,13415176,케냐,2017-11
2017-11-30,17030612,1916242,15114370,몽골,2017-11
2017-11-30,15488742,11377617,4111125,코스타리카,2017-11
2017-11-30,15262611,4019630,11242981,튀니지,2017-11
2017-11-30,13782296,1776903,12005393,엘살바도르,2017-11
2017-11-30,13250012,35884,13214128,불령 폴리네시아,2017-11
2017-11-30,12767706,32649455,-19881749,파라과이,2017-11
2017-11-30,12291679,10324688,1966991,불가리아,2017-11
2017-11-30,12216522,50807732,-38591210,바레인,2017-11
2017-11-30,11491002,1419519,10071483,탄자니아,2017-11
2017-11-30,11418290,22833761,-11415471,트리니다드 토바고,2017-11
2017-11-30,11258941,291253,10967688,라이베리아,2017-11
2017-11-30,10186607,9605460,581147,우루과이,2017-11
2017-11-30,9625660,922388,8703272,쿠바,2017-11
2017-11-30,9414165,0,9414165,팔레스타인 해방기구,2017-11
2017-11-30,8882107,1169519,7712588,라오스,2017-11
2017-11-30,8849536,7239512,1610024,세르비아,2017-11
2017-11-30,7918437,1137158,6781279,코트디봐르,2017-11
2017-11-30,7843040,738385,7104655,니카라과,2017-11
2017-11-30,7628506,50145,7578361,키르기스스탄,2017-11
2017-11-30,6987577,4322524,2665053,예맨,2017-11
2017-11-30,6902992,4814001,2088991,세네갈,2017-11
2017-11-30,6824575,4698921,2125654,에티오피아,2017-11
2017-11-30,6613366,46386403,-39773037,브루나이,2017-11
2017-11-30,6255743,197445,6058298,아이티,2017-11
2017-11-30,6142337,69517,6072820,지부티,2017-11
2017-11-30,5885990,6735045,-849055,에스토니아,2017-11
2017-11-30,5798838,44653566,-38854728,뉴 칼레도니아,2017-11
2017-11-30,5759180,8199279,-2440099,라트비아,2017-11
2017-11-30,5090820,4177827,912993,조지아,2017-11
2017-11-30,4900504,1502,4899002,아프카니스탄,2017-11
2017-11-30,4840428,5021586,-181158,파푸아 뉴기니,2017-11
2017-11-30,4600263,409285,4190978,자마이카,2017-11
2017-11-30,4425079,8556400,-4131321,베닝,2017-11
2017-11-30,4297772,3778,4293994,말리,2017-11
2017-11-30,4289947,207424,4082523,괌,2017-11
2017-11-30,4233070,1815777,2417293,아이슬란드,2017-11
2017-11-30,4090680,21775992,-17685312,볼리비아,2017-11
2017-11-30,4060899,4171,4056728,불령 리유니온 코모도 제도,2017-11
2017-11-30,4023299,813225,3210074,크로아티아,2017-11
2017-11-30,3860760,3258,3857502,아제르바이잔,2017-11
2017-11-30,3815427,821861,2993566,마카오,2017-11
2017-11-30,3556226,4723102,-1166876,몰타,2017-11
2017-11-30,3399657,71328,3328329,보츠와나,2017-11
2017-11-30,3114032,78495810,-75381778,기타국,2017-11
2017-11-30,2811174,0,2811174,투르크멘,2017-11
2017-11-30,2797885,525324,2272561,사이프러스,2017-11
2017-11-30,2791821,407773,2384048,모리셔스,2017-11
2017-11-30,2731977,6483488,-3751511,룩셈부르그,2017-11
2017-11-30,2717936,1605740,1112196,카메룬,2017-11
2017-11-30,2710394,48685988,-45975594,콩고민주공화국,2017-11
2017-11-30,2697484,5586982,-2889498,마다카스카르,2017-11
2017-11-30,2696971,21560,2675411,마세도니아,2017-11
2017-11-30,2688853,620315,2068538,벨라루스,2017-11
2017-11-30,2570641,298979,2271662,네팔,2017-11
2017-11-30,2364309,5971427,-3607118,모잠비크,2017-11
2017-11-30,2211951,1416517,795434,콩고,2017-11
2017-11-30,2109266,0,2109266,세인트 마틴,2017-11
2017-11-30,1910323,725717,1184606,기니,2017-11
2017-11-30,1853073,11417,1841656,부르키나 파소,2017-11
2017-11-30,1803627,921946,881681,베네주엘라,2017-11
2017-11-30,1738087,760939,977148,세이쉘,2017-11
2017-11-30,1661122,0,1661122,마티니크,2017-11
2017-11-30,1568409,91236,1477173,북마리아나 군도,2017-11
2017-11-30,1475042,0,1475042,타지크,2017-11
2017-11-30,1411300,552827,858473,아루바,2017-11
2017-11-30,1333908,145247,1188661,짐바브웨,2017-11
2017-11-30,1328453,74683,1253770,수리남,2017-11
2017-11-30,1327382,46243,1281139,사모아,2017-11
2017-11-30,1279241,1771776,-492535,키리바티,2017-11
2017-11-30,1260020,738149,521871,리히텐슈타인,2017-11
2017-11-30,1231250,0,1231250,과델로프,2017-11
2017-11-30,1195571,180547,1015024,가이아나,2017-11
2017-11-30,1176711,339439,837272,르완다,2017-11
2017-11-30,1104608,16411727,-15307119,잠비아,2017-11
2017-11-30,1030221,1832811,-802590,시에라 리온,2017-11
2017-11-30,1011781,31519,980262,말라위,2017-11
2017-11-30,908872,147,908725,네덜란드 열도,2017-11
2017-11-30,876985,84887,792098,우간다,2017-11
2017-11-30,868569,21990,846579,바베이도스,2017-11
2017-11-30,780639,0,780639,상토메 프린스페,2017-11
2017-11-30,765518,274,765244,몰디브,2017-11
2017-11-30,695643,350566,345077,소말리아,2017-11
2017-11-30,660541,257870,402671,가봉,2017-11
2017-11-30,650544,423171,227373,알바니아,2017-11
2017-11-30,628481,332591,295890,티모르,2017-11
2017-11-30,601284,9189,592095,도미니카,2017-11
2017-11-30,561877,904853,-342976,아르메니아,2017-11
2017-11-30,553785,240371,313414,바누아투,2017-11
2017-11-30,531111,356,530755,아메리칸 사모아,2017-11
2017-11-30,510070,467430,42640,마이크로네시아,2017-11
2017-11-30,505008,1222340,-717332,모리타니,2017-11
2017-11-30,498025,1026254,-528229,몰도바,2017-11
2017-11-30,437629,405,437224,큐라소,2017-11
2017-11-30,426517,0,426517,부탄,2017-11
2017-11-30,417133,5721,411412,세인트 빈센트 그레나딘,2017-11
2017-11-30,408056,452159,-44103,스와질랜드,2017-11
2017-11-30,401236,2936890,-2535654,보스니아-헤르체고비나,2017-11
2017-11-30,351272,0,351272,버뮤다,2017-11
2017-11-30,308407,1020,307387,솔로몬 군도,2017-11
2017-11-30,298112,43126,254986,세인트 루시아,2017-11
2017-11-30,291379,1335,290044,영령 캐이맨 군도,2017-11
2017-11-30,264324,1125,263199,몬테네그로,2017-11
2017-11-30,218060,289,217771,벨리제,2017-11
2017-11-30,181546,0,181546,불령 가이아나,2017-11
2017-11-30,179746,14,179732,중앙아프리카공화국,2017-11
2017-11-30,166935,136290,30645,감비아,2017-11
2017-11-30,158922,42,158880,그레나다,2017-11
2017-11-30,158800,714773,-555973,나미비아,2017-11
2017-11-30,153533,3488,150045,세인트 키츠 네비스,2017-11
2017-11-30,142691,1863,140828,팔라우,2017-11
2017-11-30,142269,8663,133606,안티가 바부다,2017-11
2017-11-30,136649,0,136649,영령 버진군도,2017-11
2017-11-30,89000,67406982,-67317982,적도 기니,2017-11
2017-11-30,58713,0,58713,챠드,2017-11
2017-11-30,37161,0,37161,메요트,2017-11
2017-11-30,33812,0,33812,저어지,2017-11
2017-11-30,30628,12207,18421,안도라,2017-11
2017-11-30,30410,0,30410,코모로스,2017-11
2017-11-30,29279,1406721,-1377442,통가,2017-11
2017-11-30,22910,0,22910,지브랄타,2017-11
2017-11-30,20589,61702,-41113,니제르,2017-11
2017-11-30,20303,420206,-399903,모나코,2017-11
2017-11-30,19096,0,19096,투르크 & 카이코스 군도,2017-11
2017-11-30,17100,0,17100,왈라스 & 퓨투나 군도,2017-11
2017-11-30,8947,0,8947,세인트 바르탤르미,2017-11
2017-11-30,7759,7363,396,부룬디,2017-11
2017-11-30,7040,2450,4590,몬트세라트,2017-11
2017-11-30,4916,0,4916,카보 베르데,2017-11
2017-11-30,3820,0,3820,앙귈라,2017-11
2017-11-30,936,50200,-49264,산마리노,2017-11
2017-11-30,0,1427821,-1427821,쿡 아일랜드,2017-11
2017-11-30,0,125760,-125760,자이르,2017-11
2017-11-30,0,129,-129,나우루,2017-11
2017-11-30,0,109,-109,레소토,2017-11
2017-11-30,0,2874,-2874,니우에,2017-11
2017-11-30,0,10,-10,세인트 헬레나,2017-11
2017-11-30,0,70799,-70799,기네비소,2017-11
2017-11-30,0,1474,-1474,포클랜드 군도,2017-11
2017-11-30,0,3529,-3529,마이너 아우틀링 합중국 군도,2017-11
2017-11-30,0,969,-969,미령 버진군도,2017-11
2017-11-30,0,10188833,-10188833,에리트리아,2017-11
2017-11-30,0,36274,-36274,그린랜드,2017-11
2017-11-30,0,2938,-2938,남조지아 & 남샌드위치 군도,2017-11
2017-11-30,0,12469,-12469,건지,2017-11
2017-11-30,0,14838,-14838,크리스마스 아일랜드,2017-11
2017-12-31,13848364137,8600132458,5248231679,중국,2017-12
2017-12-31,5295553358,4366639561,928913797,미국,2017-12
2017-12-31,4059314859,1356913717,2702401142,베트남,2017-12
2017-12-31,3984650207,233165932,3751484275,홍콩,2017-12
2017-12-31,2449866992,4947939403,-2498072411,일본,2017-12
2017-12-31,1226017516,904806222,321211294,싱가포르,2017-12
2017-12-31,1224555303,1472938432,-248383129,대만,2017-12
2017-12-31,1160619565,422749302,737870263,인도,2017-12
2017-12-31,952889125,285291650,667597475,필리핀,2017-12
2017-12-31,856847516,1629993082,-773145566,호주,2017-12
2017-12-31,809903684,421209368,388694316,멕시코,2017-12
2017-12-31,715291043,767164102,-51873059,인도네시아,2017-12
2017-12-31,679918582,1790592200,-1110673618,독일,2017-12
2017-12-31,638854066,415700212,223153854,태국,2017-12
2017-12-31,625452845,80975,625371870,마샬군도,2017-12
2017-12-31,608583395,941171093,-332587698,말레이시아,2017-12
2017-12-31,502809144,1310890661,-808081517,러시아 연방,2017-12
2017-12-31,471806380,87446950,384359430,튀르키예,2017-12
2017-12-31,437768275,401571010,36197265,브라질,2017-12
2017-12-31,399705498,1980531632,-1580826134,사우디아라비아,2017-12
2017-12-31,380662571,556239861,-175577290,이란,2017-12
2017-12-31,365180967,846790321,-481609354,영국,2017-12
2017-12-31,364649640,882518350,-517868710,아랍에미리트 연합,2017-12
2017-12-31,351447302,49976937,301470365,덴마크,2017-12
2017-12-31,344760732,650661616,-305900884,네덜란드,2017-12
2017-12-31,333289090,498518855,-165229765,이탈리아,2017-12
2017-12-31,315022309,498085307,-183062998,캐나다,2017-12
2017-12-31,284646301,51814884,232831417,폴란드,2017-12
2017-12-31,259383949,485401820,-226017871,프랑스,2017-12
2017-12-31,256785654,156754025,100031629,스페인,2017-12
2017-12-31,246535954,97173682,149362272,벨기에,2017-12
2017-12-31,209204439,386905,208817534,라이베리아,2017-12
2017-12-31,205597780,1375,205596405,버뮤다,2017-12
2017-12-31,181821586,57096795,124724791,체코공화국,2017-12
2017-12-31,174162246,753463765,-579301519,이라크,2017-12
2017-12-31,173911571,300483488,-126571917,칠레,2017-12
2017-12-31,172934507,44879521,128054986,그리스,2017-12
2017-12-31,171564823,11243296,160321527,슬로베니아,2017-12
2017-12-31,169457717,13889806,155567911,슬로바키아,2017-12
2017-12-31,137795793,9177491,128618302,파나마,2017-12
2017-12-31,136981456,21246872,115734584,방글라데시,2017-12
2017-12-31,128345352,4093860,124251492,토고,2017-12
2017-12-31,115569291,858885878,-743316587,쿠웨이트,2017-12
2017-12-31,108973286,78560963,30412323,뉴질랜드,2017-12
2017-12-31,107887536,103621040,4266496,이스라엘,2017-12
2017-12-31,106349934,21158209,85191725,이집트,2017-12
2017-12-31,97429933,3888987,93540946,몰타,2017-12
2017-12-31,95911514,25987281,69924233,파키스탄,2017-12
2017-12-31,95213452,101492826,-6279374,아일랜드,2017-12
2017-12-31,88411095,855470,87555625,우즈베키스탄,2017-12
2017-12-31,87983263,49328884,38654379,헝가리,2017-12
2017-12-31,82631737,1131,82630606,알제리,2017-12
2017-12-31,80848920,41245256,39603664,아르헨티나,2017-12
2017-12-31,78111101,204184249,-126073148,스웨덴,2017-12
2017-12-31,73625822,240268821,-166642999,남아프리카공화국,2017-12
2017-12-31,68798426,204510767,-135712341,오만,2017-12
2017-12-31,66953023,152632689,-85679666,오스트리아,2017-12
2017-12-31,60413083,49826376,10586707,콜롬비아,2017-12
2017-12-31,56348376,8405614,47942762,에쿠아도르,2017-12
2017-12-31,56017103,243169675,-187152572,페루,2017-12
2017-12-31,55548643,5380068,50168575,크로아티아,2017-12
2017-12-31,53840473,24565371,29275102,캄보디아,2017-12
2017-12-31,48646692,39801810,8844882,미얀마,2017-12
2017-12-31,46376326,19978004,26398322,포루투갈,2017-12
2017-12-31,44456969,1079224723,-1034767754,카타르,2017-12
2017-12-31,42414539,726074,41688465,피지,2017-12
2017-12-31,37894695,6865314,31029381,요르단,2017-12
2017-12-31,36343736,238502463,-202158727,스위스,2017-12
2017-12-31,34480745,3811,34476934,바하마,2017-12
2017-12-31,34349685,85479765,-51130080,카자흐스탄,2017-12
2017-12-31,34041931,29136591,4905340,루마니아,2017-12
2017-12-31,32812546,69233942,-36421396,핀란드,2017-12
2017-12-31,31620063,127970899,-96350836,노르웨이,2017-12
2017-12-31,30971796,11973515,18998281,바레인,2017-12
2017-12-31,30441657,70077015,-39635358,리비아,2017-12
2017-12-31,29747279,131022168,-101274889,나이지리아,2017-12
2017-12-31,27146357,38601445,-11455088,우크라이나,2017-12
2017-12-31,25331799,1539066,23792733,몽골,2017-12
2017-12-31,21981234,9101064,12880170,도미니카 공화국,2017-12
2017-12-31,20065449,1591324,18474125,레바논,2017-12
2017-12-31,20050925,7261173,12789752,스리랑카,2017-12
2017-12-31,20036972,3443875,16593097,케냐,2017-12
2017-12-31,19430353,14411365,5018988,모로코,2017-12
2017-12-31,19276460,5701572,13574888,리투아니아,2017-12
2017-12-31,18534544,4291967,14242577,과테말라,2017-12
2017-12-31,17975102,1876089,16099013,수단,2017-12
2017-12-31,16135131,2275616,13859515,엘살바도르,2017-12
2017-12-31,14670390,9822897,4847493,불가리아,2017-12
2017-12-31,13849328,2988042,10861286,가나,2017-12
2017-12-31,11714646,28849,11685797,아프카니스탄,2017-12
2017-12-31,11340934,6538430,4802504,에티오피아,2017-12
2017-12-31,11209022,18916430,-7707408,파라과이,2017-12
2017-12-31,10955905,15526050,-4570145,우루과이,2017-12
2017-12-31,10058525,1241,10057284,시리아,2017-12
2017-12-31,9217408,31224363,-22006955,뉴 칼레도니아,2017-12
2017-12-31,9057406,41290,9016116,쿠바,2017-12
2017-12-31,8764395,9567063,-802668,코스타리카,2017-12
2017-12-31,8433335,9320603,-887268,에스토니아,2017-12
2017-12-31,8303754,5779467,2524287,튀니지,2017-12
2017-12-31,8053861,6617156,1436705,세르비아,2017-12
2017-12-31,7683574,39807237,-32123663,트리니다드 토바고,2017-12
2017-12-31,7634327,1229853,6404474,탄자니아,2017-12
2017-12-31,7479059,844405,6634654,니카라과,2017-12
2017-12-31,7182379,4236057,2946322,라오스,2017-12
2017-12-31,6738451,43071,6695380,키르기스스탄,2017-12
2017-12-31,6735816,1383331,5352485,온두라스,2017-12
2017-12-31,6055417,5224,6050193,팔레스타인 해방기구,2017-12
2017-12-31,6014162,5611576,402586,라트비아,2017-12
2017-12-31,5963240,373620,5589620,코트디봐르,2017-12
2017-12-31,5724359,770513,4953846,사이프러스,2017-12
2017-12-31,5609168,355,5608813,마이크로네시아,2017-12
2017-12-31,5455344,13727911,-8272567,푸에르토리코,2017-12
2017-12-31,5271738,3742798,1528940,세네갈,2017-12
2017-12-31,5229390,225660,5003730,아이티,2017-12
2017-12-31,5018406,5357787,-339381,예맨,2017-12
2017-12-31,4625782,69634,4556148,마카오,2017-12
2017-12-31,4547933,2296626,2251307,조지아,2017-12
2017-12-31,4283663,0,4283663,지부티,2017-12
2017-12-31,4143247,101582,4041665,괌,2017-12
2017-12-31,3847446,11607075,-7759629,모잠비크,2017-12
2017-12-31,3801104,22271291,-18470187,앙골라,2017-12
2017-12-31,3518166,12522,3505644,아메리칸 사모아,2017-12
2017-12-31,3515619,33398141,-29882522,파푸아 뉴기니,2017-12
2017-12-31,3485192,142961,3342231,아제르바이잔,2017-12
2017-12-31,3301956,69513587,-66211631,기타국,2017-12
2017-12-31,3253040,172064056,-168811016,브루나이,2017-12
2017-12-31,3229288,3116424,112864,베닝,2017-12
2017-12-31,2966393,9135158,-6168765,마다카스카르,2017-12
2017-12-31,2907523,3505922,-598399,베네주엘라,2017-12
2017-12-31,2819852,2351341,468511,짐바브웨,2017-12
2017-12-31,2651029,4225240,-1574211,벨라루스,2017-12
2017-12-31,2638142,0,2638142,불령 리유니온 코모도 제도,2017-12
2017-12-31,2520706,165027,2355679,네팔,2017-12
2017-12-31,2428552,5538329,-3109777,룩셈부르그,2017-12
2017-12-31,2394530,58999698,-56605168,콩고민주공화국,2017-12
2017-12-31,2330653,65988318,-63657665,볼리비아,2017-12
2017-12-31,2110329,2715,2107614,말리,2017-12
2017-12-31,2031782,0,2031782,타지크,2017-12
2017-12-31,1912917,24187,1888730,부르키나 파소,2017-12
2017-12-31,1887499,2835680,-948181,아이슬란드,2017-12
2017-12-31,1772116,2498863,-726747,콩고,2017-12
2017-12-31,1747183,219113,1528070,카메룬,2017-12
2017-12-31,1695069,13145,1681924,투르크멘,2017-12
2017-12-31,1536932,5957458,-4420526,잠비아,2017-12
2017-12-31,1501294,356938,1144356,모리셔스,2017-12
2017-12-31,1443142,0,1443142,불령 폴리네시아,2017-12
2017-12-31,1441082,252209,1188873,가이아나,2017-12
2017-12-31,1395816,317067,1078749,세이쉘,2017-12
2017-12-31,1331936,0,1331936,마티니크,2017-12
2017-12-31,1315438,391213,924225,아르메니아,2017-12
2017-12-31,1268515,0,1268515,과델로프,2017-12
2017-12-31,1210335,118345,1091990,키리바티,2017-12
2017-12-31,1199005,592937,606068,알바니아,2017-12
2017-12-31,1159500,1693334,-533834,기니,2017-12
2017-12-31,1100163,0,1100163,세인트 마틴,2017-12
2017-12-31,1087405,243807,843598,아루바,2017-12
2017-12-31,1078909,455083,623826,소말리아,2017-12
2017-12-31,1065781,562947,502834,몰도바,2017-12
2017-12-31,1064794,243269,821525,우간다,2017-12
2017-12-31,1061772,441277,620495,자마이카,2017-12
2017-12-31,945025,360865,584160,르완다,2017-12
2017-12-31,938947,111492,827455,북마리아나 군도,2017-12
2017-12-31,935934,115533,820401,마세도니아,2017-12
2017-12-31,914479,846154,68325,리히텐슈타인,2017-12
2017-12-31,827017,2521343,-1694326,모리타니,2017-12
2017-12-31,827007,100,826907,네덜란드 열도,2017-12
2017-12-31,745228,0,745228,영령 캐이맨 군도,2017-12
2017-12-31,640735,188,640547,몰디브,2017-12
2017-12-31,607423,10170944,-9563521,에리트리아,2017-12
2017-12-31,561119,134407,426712,벨리제,2017-12
2017-12-31,497643,161764,335879,수리남,2017-12
2017-12-31,495237,1196495,-701258,말라위,2017-12
2017-12-31,453235,328,452907,파로에 군도,2017-12
2017-12-31,452358,37442,414916,사모아,2017-12
2017-12-31,442750,375681,67069,스와질랜드,2017-12
2017-12-31,438279,1275,437004,카보 베르데,2017-12
2017-12-31,436167,0,436167,불령 가이아나,2017-12
2017-12-31,422265,0,422265,세인트 바르탤르미,2017-12
2017-12-31,406033,6029,400004,안티가 바부다,2017-12
2017-12-31,352084,102405,249679,가봉,2017-12
2017-12-31,347075,0,347075,세인트 빈센트 그레나딘,2017-12
2017-12-31,340493,0,340493,도미니카,2017-12
2017-12-31,323792,0,323792,큐라소,2017-12
2017-12-31,315506,0,315506,영령 버진군도,2017-12
2017-12-31,300888,1332,299556,티모르,2017-12
2017-12-31,293197,103,293094,바베이도스,2017-12
2017-12-31,261114,3078659,-2817545,보스니아-헤르체고비나,2017-12
2017-12-31,224787,715602,-490815,바누아투,2017-12
2017-12-31,200248,0,200248,세인트 루시아,2017-12
2017-12-31,183626,1785450,-1601824,시에라 리온,2017-12
2017-12-31,182161,590765,-408604,나미비아,2017-12
2017-12-31,172606,2768,169838,팔라우,2017-12
2017-12-31,153834,2484787,-2330953,솔로몬 군도,2017-12
2017-12-31,149225,81693333,-81544108,적도 기니,2017-12
2017-12-31,147971,188580,-40609,보츠와나,2017-12
2017-12-31,142103,627,141476,부탄,2017-12
2017-12-31,99605,0,99605,그레나다,2017-12
2017-12-31,80526,79,80447,투르크 & 카이코스 군도,2017-12
2017-12-31,71372,974,70398,세인트 키츠 네비스,2017-12
2017-12-31,58020,0,58020,지브랄타,2017-12
2017-12-31,48108,0,48108,왈라스 & 퓨투나 군도,2017-12
2017-12-31,47682,68094,-20412,몬테네그로,2017-12
2017-12-31,47676,79575,-31899,기네비소,2017-12
2017-12-31,44740,0,44740,메요트,2017-12
2017-12-31,35252,31726,3526,니제르,2017-12
2017-12-31,26328,58529,-32201,쿡 아일랜드,2017-12
2017-12-31,25500,0,25500,포클랜드 군도,2017-12
2017-12-31,19017,573488,-554471,감비아,2017-12
2017-12-31,15725,396,15329,나우루,2017-12
2017-12-31,11803,0,11803,챠드,2017-12
2017-12-31,10355,8006,2349,미령 버진군도,2017-12
2017-12-31,5745,123419,-117674,부룬디,2017-12
2017-12-31,4520,0,4520,투발루,2017-12
2017-12-31,3580,0,3580,코모로스,2017-12
2017-12-31,2720,1916,804,산마리노,2017-12
2017-12-31,2520,674432,-671912,모나코,2017-12
2017-12-31,2490,278020,-275530,통가,2017-12
2017-12-31,1693,199,1494,남수단,2017-12
2017-12-31,932,0,932,중앙아프리카공화국,2017-12
2017-12-31,667,0,667,앙귈라,2017-12
2017-12-31,480,1841,-1361,안도라,2017-12
2017-12-31,255,0,255,세인트마틴(생마르탱),2017-12
2017-12-31,32,0,32,저어지,2017-12
2017-12-31,0,19736,-19736,크리스마스 아일랜드,2017-12
2017-12-31,0,274,-274,남조지아 & 남샌드위치 군도,2017-12
2017-12-31,0,412,-412,영령 인도양,2017-12
2017-12-31,0,421,-421,피트카이른,2017-12
2017-12-31,0,11807,-11807,건지,2017-12
2017-12-31,0,2261,-2261,니우에,2017-12
2017-12-31,0,290,-290,상토메 프린스페,2017-12
2017-12-31,0,345,-345,맨섬,2017-12
2017-12-31,0,299,-299,안타티카,2017-12
2017-12-31,0,50212,-50212,코스 군도,2017-12
2017-12-31,0,38,-38,토켈라우,2017-12
2017-12-31,0,53965,-53965,그린랜드,2017-12
2018-01-31,13381305014,9156929837,4224375177,중국,2018-01
2018-01-31,5159690617,4930570098,229120519,미국,2018-01
2018-01-31,4277334440,1757248158,2520086282,베트남,2018-01
2018-01-31,3429413331,187696330,3241717001,홍콩,2018-01
2018-01-31,2583914212,4485212876,-1901298664,일본,2018-01
2018-01-31,1431090534,1516678640,-85588106,대만,2018-01
2018-01-31,1221122197,449711729,771410468,인도,2018-01
2018-01-31,979044002,823497446,155546556,싱가포르,2018-01
2018-01-31,945320998,294178056,651142942,필리핀,2018-01
2018-01-31,912020629,452694241,459326388,멕시코,2018-01
2018-01-31,805668955,1607055050,-801386095,호주,2018-01
2018-01-31,740534491,127600904,612933587,노르웨이,2018-01
2018-01-31,740321380,1931691478,-1191370098,독일,2018-01
2018-01-31,733274138,842110432,-108836294,인도네시아,2018-01
2018-01-31,653156556,421221902,231934654,태국,2018-01
2018-01-31,646366189,913999966,-267633777,말레이시아,2018-01
2018-01-31,612055791,93329573,518726218,튀르키예,2018-01
2018-01-31,566186106,1226945572,-660759466,러시아 연방,2018-01
2018-01-31,492937459,427468372,65469087,브라질,2018-01
2018-01-31,466407115,1986822856,-1520415741,사우디아라비아,2018-01
2018-01-31,459867248,892551384,-432684136,네덜란드,2018-01
2018-01-31,406328267,4328,406323939,마샬군도,2018-01
2018-01-31,381193395,554469198,-173275803,이탈리아,2018-01
2018-01-31,362999934,494883148,-131883214,영국,2018-01
2018-01-31,352328114,467742984,-115414870,캐나다,2018-01
2018-01-31,335333595,53087856,282245739,폴란드,2018-01
2018-01-31,320027907,59124708,260903199,파나마,2018-01
2018-01-31,308702677,524000748,-215298071,이란,2018-01
2018-01-31,299960693,763578609,-463617916,아랍에미리트 연합,2018-01
2018-01-31,289198995,493856726,-204657731,프랑스,2018-01
2018-01-31,275702884,220016000,55686884,스페인,2018-01
2018-01-31,262107817,126324629,135783188,벨기에,2018-01
2018-01-31,229471196,2200,229468996,바하마,2018-01
2018-01-31,217327457,66476432,150851025,체코공화국,2018-01
2018-01-31,199030020,508340704,-309310684,칠레,2018-01
2018-01-31,193446929,3138780,190308149,토고,2018-01
2018-01-31,191469716,15858747,175610969,슬로바키아,2018-01
2018-01-31,175409586,112928926,62480660,뉴질랜드,2018-01
2018-01-31,170334239,14759408,155574831,몰타,2018-01
2018-01-31,159068603,24598674,134469929,이집트,2018-01
2018-01-31,147670079,10117300,137552779,슬로베니아,2018-01
2018-01-31,128577049,138029174,-9452125,이스라엘,2018-01
2018-01-31,116555885,50940355,65615530,헝가리,2018-01
2018-01-31,114855661,27457308,87398353,방글라데시,2018-01
2018-01-31,112788915,42011456,70777459,그리스,2018-01
2018-01-31,101049780,76965320,24084460,아르헨티나,2018-01
2018-01-31,99839547,1427661,98411886,우즈베키스탄,2018-01
2018-01-31,98085340,1039841266,-941755926,쿠웨이트,2018-01
2018-01-31,92633316,923222114,-830588798,이라크,2018-01
2018-01-31,91849495,267547610,-175698115,알제리,2018-01
2018-01-31,84416496,191822506,-107406010,오스트리아,2018-01
2018-01-31,81386010,174241010,-92855000,스웨덴,2018-01
2018-01-31,79604395,56908573,22695822,파키스탄,2018-01
2018-01-31,79114106,71261114,7852992,콜롬비아,2018-01
2018-01-31,75785032,202106483,-126321451,남아프리카공화국,2018-01
2018-01-31,70242287,239481658,-169239371,오만,2018-01
2018-01-31,63104056,11641511,51462545,에쿠아도르,2018-01
2018-01-31,58778318,240862284,-182083966,페루,2018-01
2018-01-31,58757137,1330380083,-1271622946,카타르,2018-01
2018-01-31,53559028,24675390,28883638,포루투갈,2018-01
2018-01-31,49527196,29523865,20003331,캄보디아,2018-01
2018-01-31,46251311,37845958,8405353,미얀마,2018-01
2018-01-31,45796576,3541037,42255539,요르단,2018-01
2018-01-31,45466790,103145920,-57679130,아일랜드,2018-01
2018-01-31,44366477,34927079,9439398,루마니아,2018-01
2018-01-31,33399555,89659207,-56259652,카자흐스탄,2018-01
2018-01-31,32849092,60804277,-27955185,덴마크,2018-01
2018-01-31,32773105,30527049,2246056,나이지리아,2018-01
2018-01-31,32249112,253236449,-220987337,스위스,2018-01
2018-01-31,30607534,119210868,-88603334,핀란드,2018-01
2018-01-31,25237242,11810356,13426886,모로코,2018-01
2018-01-31,25029109,20573938,4455171,우크라이나,2018-01
2018-01-31,24586441,9142936,15443505,스리랑카,2018-01
2018-01-31,24005252,15213177,8792075,푸에르토리코,2018-01
2018-01-31,22677942,39276908,-16598966,리비아,2018-01
2018-01-31,19703969,7783858,11920111,리투아니아,2018-01
2018-01-31,19179156,2058994,17120162,가나,2018-01
2018-01-31,19115516,34302344,-15186828,바레인,2018-01
2018-01-31,17854998,13211879,4643119,도미니카 공화국,2018-01
2018-01-31,16796974,220,16796754,시리아,2018-01
2018-01-31,16566433,1879160,14687273,엘살바도르,2018-01
2018-01-31,15116699,3775019,11341680,케냐,2018-01
2018-01-31,14678461,10384722,4293739,불가리아,2018-01
2018-01-31,14557759,915952,13641807,몽골,2018-01
2018-01-31,13523792,3798629,9725163,과테말라,2018-01
2018-01-31,12309046,370316,11938730,라이베리아,2018-01
2018-01-31,11816756,4936930,6879826,레바논,2018-01
2018-01-31,11667119,7418149,4248970,우루과이,2018-01
2018-01-31,11355971,115709317,-104353346,기타국,2018-01
2018-01-31,11175967,6633082,4542885,튀니지,2018-01
2018-01-31,10799727,1852995,8946732,수단,2018-01
2018-01-31,10440214,11245667,-805453,코스타리카,2018-01
2018-01-31,10043693,5304044,4739649,세르비아,2018-01
2018-01-31,9466195,12779185,-3312990,파라과이,2018-01
2018-01-31,9409938,37287839,-27877901,트리니다드 토바고,2018-01
2018-01-31,9083891,4586630,4497261,조지아,2018-01
2018-01-31,9034395,126668,8907727,코트디봐르,2018-01
2018-01-31,8643040,96,8642944,아프카니스탄,2018-01
2018-01-31,8633484,9080320,-446836,에스토니아,2018-01
2018-01-31,8452874,853118,7599756,크로아티아,2018-01
2018-01-31,8297082,650875,7646207,모잠비크,2018-01
2018-01-31,7416534,1317316,6099218,온두라스,2018-01
2018-01-31,6602093,7049007,-446914,탄자니아,2018-01
2018-01-31,6584825,901295,5683530,니카라과,2018-01
2018-01-31,6387189,102906,6284283,팔레스타인 해방기구,2018-01
2018-01-31,6287293,2992280,3295013,세네갈,2018-01
2018-01-31,6083226,6950962,-867736,앙골라,2018-01
2018-01-31,5794066,343456,5450610,아이티,2018-01
2018-01-31,5661135,3140602,2520533,에티오피아,2018-01
2018-01-31,5594813,2784515,2810298,예맨,2018-01
2018-01-31,5590840,2110711,3480129,라오스,2018-01
2018-01-31,5487075,2827,5484248,키르기스스탄,2018-01
2018-01-31,5360075,207892,5152183,괌,2018-01
2018-01-31,4992346,16796,4975550,지부티,2018-01
2018-01-31,4035480,873,4034607,말리,2018-01
2018-01-31,3970884,8907074,-4936190,라트비아,2018-01
2018-01-31,3964569,211697,3752872,쿠바,2018-01
2018-01-31,3938191,9705816,-5767625,베닝,2018-01
2018-01-31,3904569,259938,3644631,피지,2018-01
2018-01-31,3875404,11920838,-8045434,잠비아,2018-01
2018-01-31,3746974,513827,3233147,카메룬,2018-01
2018-01-31,3685653,2784212,901441,콩고,2018-01
2018-01-31,3371924,4212355,-840431,파푸아 뉴기니,2018-01
2018-01-31,3285465,2219742,1065723,아이슬란드,2018-01
2018-01-31,3062007,52754121,-49692114,콩고민주공화국,2018-01
2018-01-31,3040294,265951,2774343,아제르바이잔,2018-01
2018-01-31,3025379,518844,2506535,마카오,2018-01
2018-01-31,2974015,152092,2821923,사모아,2018-01
2018-01-31,2947959,605035,2342924,사이프러스,2018-01
2018-01-31,2870483,1103075,1767408,모리셔스,2018-01
2018-01-31,2715422,141473031,-138757609,볼리비아,2018-01
2018-01-31,2656939,201478,2455461,가이아나,2018-01
2018-01-31,2505257,746417,1758840,베네주엘라,2018-01
2018-01-31,2431476,77254497,-74823021,브루나이,2018-01
2018-01-31,2390717,446264,1944453,소말리아,2018-01
2018-01-31,2372417,62381,2310036,보츠와나,2018-01
2018-01-31,2319479,152443,2167036,네팔,2018-01
2018-01-31,2216981,0,2216981,세인트 마틴,2018-01
2018-01-31,2042662,2523342,-480680,벨라루스,2018-01
2018-01-31,2001604,138244,1863360,짐바브웨,2018-01
2018-01-31,1954761,1033234,921527,세이쉘,2018-01
2018-01-31,1894864,7445189,-5550325,마다카스카르,2018-01
2018-01-31,1801878,6291611,-4489733,룩셈부르그,2018-01
2018-01-31,1799772,52134,1747638,부르키나 파소,2018-01
2018-01-31,1786474,5733076,-3946602,기니,2018-01
2018-01-31,1649529,437266,1212263,자마이카,2018-01
2018-01-31,1582754,294873,1287881,알바니아,2018-01
2018-01-31,1553969,40296460,-38742491,뉴 칼레도니아,2018-01
2018-01-31,1448580,0,1448580,불령 리유니온 코모도 제도,2018-01
2018-01-31,1412801,2807053,-1394252,모리타니,2018-01
2018-01-31,1410989,0,1410989,키리바티,2018-01
2018-01-31,1337997,0,1337997,마티니크,2018-01
2018-01-31,1312633,448,1312185,마이크로네시아,2018-01
2018-01-31,1286871,0,1286871,네덜란드 열도,2018-01
2018-01-31,1232338,60621,1171717,투르크멘,2018-01
2018-01-31,1109005,258286,850719,북마리아나 군도,2018-01
2018-01-31,1086704,296858,789846,마세도니아,2018-01
2018-01-31,1040556,1567066,-526510,리히텐슈타인,2018-01
2018-01-31,943755,874902,68853,몰도바,2018-01
2018-01-31,907315,0,907315,타지크,2018-01
2018-01-31,852315,209,852106,큐라소,2018-01
2018-01-31,848899,122884,726015,르완다,2018-01
2018-01-31,804357,1516845,-712488,아루바,2018-01
2018-01-31,786252,1659,784593,몰디브,2018-01
2018-01-31,774915,4002,770913,몬테네그로,2018-01
2018-01-31,746608,0,746608,과델로프,2018-01
2018-01-31,624408,0,624408,벨리제,2018-01
2018-01-31,623309,43975,579334,불령 폴리네시아,2018-01
2018-01-31,617712,4235378,-3617666,스와질랜드,2018-01
2018-01-31,584954,0,584954,버뮤다,2018-01
2018-01-31,584484,1690139,-1105655,보스니아-헤르체고비나,2018-01
2018-01-31,580251,27284,552967,세인트 루시아,2018-01
2018-01-31,575257,46539,528718,바베이도스,2018-01
2018-01-31,568936,90383,478553,수리남,2018-01
2018-01-31,568552,2006,566546,아메리칸 사모아,2018-01
2018-01-31,529200,608634,-79434,우간다,2018-01
2018-01-31,485622,1322,484300,상토메 프린스페,2018-01
2018-01-31,457428,4867234,-4409806,가봉,2018-01
2018-01-31,450677,0,450677,세인트 키츠 네비스,2018-01
2018-01-31,432237,0,432237,지브랄타,2018-01
2018-01-31,428339,553526,-125187,아르메니아,2018-01
2018-01-31,415167,151,415016,영령 캐이맨 군도,2018-01
2018-01-31,386225,12969,373256,팔라우,2018-01
2018-01-31,359290,0,359290,세인트 빈센트 그레나딘,2018-01
2018-01-31,333528,1498699,-1165171,말라위,2018-01
2018-01-31,316560,27819,288741,안티가 바부다,2018-01
2018-01-31,300310,1354385,-1054075,바누아투,2018-01
2018-01-31,284604,0,284604,세인트 바르탤르미,2018-01
2018-01-31,276592,0,276592,카보 베르데,2018-01
2018-01-31,264090,3133,260957,도미니카,2018-01
2018-01-31,232286,62763312,-62531026,적도 기니,2018-01
2018-01-31,229587,1923193,-1693606,시에라 리온,2018-01
2018-01-31,224510,64594,159916,티모르,2018-01
2018-01-31,188635,671188,-482553,솔로몬 군도,2018-01
2018-01-31,177960,966620,-788660,감비아,2018-01
2018-01-31,165468,0,165468,챠드,2018-01
2018-01-31,152867,654074,-501207,나미비아,2018-01
2018-01-31,87628,0,87628,불령 가이아나,2018-01
2018-01-31,74870,0,74870,그레나다,2018-01
2018-01-31,72454,366382,-293928,중앙아프리카공화국,2018-01
2018-01-31,68020,0,68020,메요트,2018-01
2018-01-31,66475,687674,-621199,기네비소,2018-01
2018-01-31,49986,391,49595,부탄,2018-01
2018-01-31,46964,0,46964,영령 버진군도,2018-01
2018-01-31,45005,231876,-186871,모나코,2018-01
2018-01-31,27316,2078,25238,레소토,2018-01
2018-01-31,23400,0,23400,투르크 & 카이코스 군도,2018-01
2018-01-31,17166,446,16720,미령 버진군도,2018-01
2018-01-31,16551,392,16159,니제르,2018-01
2018-01-31,15580,2878,12702,나우루,2018-01
2018-01-31,6909,77044,-70135,부룬디,2018-01
2018-01-31,6480,67229,-60749,통가,2018-01
2018-01-31,5189,0,5189,에리트리아,2018-01
2018-01-31,4000,0,4000,포클랜드 군도,2018-01
2018-01-31,3327,2272,1055,안도라,2018-01
2018-01-31,2697,0,2697,코모로스,2018-01
2018-01-31,0,345,-345,맨섬,2018-01
2018-01-31,0,32,-32,코스 군도,2018-01
2018-01-31,0,55,-55,토켈라우,2018-01
2018-01-31,0,618000,-618000,자이르,2018-01
2018-01-31,0,590,-590,보네르 신트외스타티위스,2018-01
2018-01-31,0,32736,-32736,그린랜드,2018-01
2018-01-31,0,5670,-5670,건지,2018-01
2018-01-31,0,79587,-79587,산마리노,2018-01
2018-01-31,0,47172,-47172,쿡 아일랜드,2018-01
2018-01-31,0,27874,-27874,크리스마스 아일랜드,2018-01
2018-01-31,0,750,-750,마이너 아우틀링 합중국 군도,2018-01
2018-01-31,0,4284,-4284,니우에,2018-01
2018-01-31,0,77748,-77748,몬트세라트,2018-01
2018-02-28,11522664092,7598364160,3924299932,중국,2018-02
2018-02-28,4682547672,4528135344,154412328,미국,2018-02
2018-02-28,3627831822,1456629513,2171202309,베트남,2018-02
2018-02-28,3032519739,164897845,2867621894,홍콩,2018-02
2018-02-28,2446179743,4513248757,-2067069014,일본,2018-02
2018-02-28,1161496090,388631294,772864796,인도,2018-02
2018-02-28,1117926263,1189030053,-71103790,대만,2018-02
2018-02-28,877618464,261597395,616021069,필리핀,2018-02
2018-02-28,864255743,770156791,94098952,말레이시아,2018-02
2018-02-28,830104455,662446274,167658181,싱가포르,2018-02
2018-02-28,789677007,1855027651,-1065350644,호주,2018-02
2018-02-28,742319802,283634262,458685540,멕시코,2018-02
2018-02-28,653371563,409412949,243958614,태국,2018-02
2018-02-28,650629068,1508455779,-857826711,독일,2018-02
2018-02-28,644120776,851217455,-207096679,인도네시아,2018-02
2018-02-28,590238077,1162169288,-571931211,러시아 연방,2018-02
2018-02-28,554674723,126426856,428247867,노르웨이,2018-02
2018-02-28,538612106,63341265,475270841,튀르키예,2018-02
2018-02-28,445018230,307312947,137705283,브라질,2018-02
2018-02-28,420942279,2330136115,-1909193836,사우디아라비아,2018-02
2018-02-28,414499400,1619159,412880241,파나마,2018-02
2018-02-28,413101348,691325556,-278224208,네덜란드,2018-02
2018-02-28,395574266,492974661,-97400395,이탈리아,2018-02
2018-02-28,391732368,493570755,-101838387,캐나다,2018-02
2018-02-28,341681305,623581140,-281899835,영국,2018-02
2018-02-28,328474960,759506806,-431031846,아랍에미리트 연합,2018-02
2018-02-28,307518064,93435668,214082396,벨기에,2018-02
2018-02-28,306433186,44557544,261875642,폴란드,2018-02
2018-02-28,304986086,4796,304981290,마샬군도,2018-02
2018-02-28,258073384,175215226,82858158,스페인,2018-02
2018-02-28,236751668,569876721,-333125053,프랑스,2018-02
2018-02-28,235039046,636712715,-401673669,이란,2018-02
2018-02-28,228830418,13705561,215124857,슬로바키아,2018-02
2018-02-28,213949389,42862005,171087384,이집트,2018-02
2018-02-28,205174737,0,205174737,버뮤다,2018-02
2018-02-28,200495292,50486081,150009211,덴마크,2018-02
2018-02-28,193721702,4604619,189117083,몰타,2018-02
2018-02-28,177516462,60298606,117217856,체코공화국,2018-02
2018-02-28,174007712,3529246,170478466,토고,2018-02
2018-02-28,160920784,6918226,154002558,슬로베니아,2018-02
2018-02-28,157089220,385341261,-228252041,칠레,2018-02
2018-02-28,138071188,107039935,31031253,뉴질랜드,2018-02
2018-02-28,125805869,122900569,2905300,이스라엘,2018-02
2018-02-28,125222819,47366637,77856182,헝가리,2018-02
2018-02-28,117115306,577376,116537930,우즈베키스탄,2018-02
2018-02-28,114710575,443137641,-328427066,이라크,2018-02
2018-02-28,94426983,1194158656,-1099731673,쿠웨이트,2018-02
2018-02-28,90999751,40990939,50008812,파키스탄,2018-02
2018-02-28,88761278,137774703,-49013425,오스트리아,2018-02
2018-02-28,84625031,173848164,-89223133,페루,2018-02
2018-02-28,82961336,220793354,-137832018,오만,2018-02
2018-02-28,77438814,202374997,-124936183,알제리,2018-02
2018-02-28,76161093,27377890,48783203,방글라데시,2018-02
2018-02-28,68028330,126947596,-58919266,스웨덴,2018-02
2018-02-28,62189529,216216447,-154026918,남아프리카공화국,2018-02
2018-02-28,61129851,36042552,25087299,나이지리아,2018-02
2018-02-28,59686031,54810921,4875110,아르헨티나,2018-02
2018-02-28,58338824,46315053,12023771,콜롬비아,2018-02
2018-02-28,47839198,26606743,21232455,포루투갈,2018-02
2018-02-28,44544091,11660079,32884012,에쿠아도르,2018-02
2018-02-28,43300665,71384049,-28083384,아일랜드,2018-02
2018-02-28,42356228,24075698,18280530,캄보디아,2018-02
2018-02-28,42048373,28988875,13059498,루마니아,2018-02
2018-02-28,41508672,34849959,6658713,미얀마,2018-02
2018-02-28,40011977,1387558180,-1347546203,카타르,2018-02
2018-02-28,36333420,17206172,19127248,우크라이나,2018-02
2018-02-28,34982570,28680693,6301877,그리스,2018-02
2018-02-28,34815142,1122,34814020,바하마,2018-02
2018-02-28,34507925,3332419,31175506,요르단,2018-02
2018-02-28,31211050,207334013,-176122963,스위스,2018-02
2018-02-28,29406212,90962257,-61556045,카자흐스탄,2018-02
2018-02-28,28679774,363642,28316132,피지,2018-02
2018-02-28,28122056,6066573,22055483,리투아니아,2018-02
2018-02-28,22926326,28066745,-5140419,뉴 칼레도니아,2018-02
2018-02-28,21688006,162267808,-140579802,핀란드,2018-02
2018-02-28,21536821,399933,21136888,괌,2018-02
2018-02-28,21378112,1668720,19709392,가나,2018-02
2018-02-28,19934563,25204265,-5269702,모로코,2018-02
2018-02-28,19657098,15282830,4374268,도미니카 공화국,2018-02
2018-02-28,18827061,72603172,-53776111,리비아,2018-02
2018-02-28,18374456,6463514,11910942,스리랑카,2018-02
2018-02-28,16274701,17051190,-776489,푸에르토리코,2018-02
2018-02-28,16270751,3046546,13224205,과테말라,2018-02
2018-02-28,15581958,5744767,9837191,튀니지,2018-02
2018-02-28,15241522,2623815,12617707,케냐,2018-02
2018-02-28,15151194,2623423,12527771,레바논,2018-02
2018-02-28,15060909,1056829,14004080,몽골,2018-02
2018-02-28,14801136,1537104,13264032,엘살바도르,2018-02
2018-02-28,14750845,12558148,2192697,바레인,2018-02
2018-02-28,13311258,13874770,-563512,불가리아,2018-02
2018-02-28,13156208,9588995,3567213,파라과이,2018-02
2018-02-28,13143848,1395,13142453,시리아,2018-02
2018-02-28,11211160,8329523,2881637,우루과이,2018-02
2018-02-28,10562009,8680368,1881641,코스타리카,2018-02
2018-02-28,9865328,787927,9077401,코트디봐르,2018-02
2018-02-28,9257833,16269,9241564,아제르바이잔,2018-02
2018-02-28,9110402,4175762,4934640,세르비아,2018-02
2018-02-28,8195825,2693765,5502060,수단,2018-02
2018-02-28,7503872,4018958,3484914,라오스,2018-02
2018-02-28,7281094,2055384,5225710,니카라과,2018-02
2018-02-28,7041913,6540259,501654,에스토니아,2018-02
2018-02-28,6886038,2661703,4224335,세네갈,2018-02
2018-02-28,6640045,1586660,5053385,탄자니아,2018-02
2018-02-28,6629507,2846577,3782930,에티오피아,2018-02
2018-02-28,6495215,4366719,2128496,예맨,2018-02
2018-02-28,6356198,967742,5388456,크로아티아,2018-02
2018-02-28,6026893,2022306,4004587,조지아,2018-02
2018-02-28,5878166,218572,5659594,아이티,2018-02
2018-02-28,5613209,4758,5608451,아프카니스탄,2018-02
2018-02-28,5561182,3555,5557627,말리,2018-02
2018-02-28,5459299,183331,5275968,팔레스타인 해방기구,2018-02
2018-02-28,5198840,3046526,2152314,온두라스,2018-02
2018-02-28,4995779,70009,4925770,지부티,2018-02
2018-02-28,4795853,6448868,-1653015,라트비아,2018-02
2018-02-28,4750694,1632052,3118642,쿠바,2018-02
2018-02-28,4575191,15034289,-10459098,트리니다드 토바고,2018-02
2018-02-28,4352706,2272,4350434,키르기스스탄,2018-02
2018-02-28,3938717,8164945,-4226228,앙골라,2018-02
2018-02-28,3826795,333,3826462,팔라우,2018-02
2018-02-28,3559516,166332,3393184,마카오,2018-02
2018-02-28,3555619,64728,3490891,사모아,2018-02
2018-02-28,3453384,55058521,-51605137,브루나이,2018-02
2018-02-28,3175412,7583444,-4408032,베닝,2018-02
2018-02-28,3047761,948547,2099214,모잠비크,2018-02
2018-02-28,2606189,126307,2479882,네팔,2018-02
2018-02-28,2570935,11260,2559675,불령 리유니온 코모도 제도,2018-02
2018-02-28,2498398,2715697,-217299,아이슬란드,2018-02
2018-02-28,2311161,1704561,606600,콩고,2018-02
2018-02-28,2258152,36779618,-34521466,파푸아 뉴기니,2018-02
2018-02-28,2235851,28955,2206896,부르키나 파소,2018-02
2018-02-28,2163159,172272,1990887,자마이카,2018-02
2018-02-28,2038552,37705,2000847,과델로프,2018-02
2018-02-28,2033513,188782,1844731,마세도니아,2018-02
2018-02-28,2032939,256282,1776657,우간다,2018-02
2018-02-28,2024949,269,2024680,투르크멘,2018-02
2018-02-28,1996492,106618,1889874,카메룬,2018-02
2018-02-28,1982490,4929422,-2946932,마다카스카르,2018-02
2018-02-28,1969284,88996,1880288,짐바브웨,2018-02
2018-02-28,1935469,266405,1669064,알바니아,2018-02
2018-02-28,1916303,33094,1883209,마티니크,2018-02
2018-02-28,1875033,27306830,-25431797,볼리비아,2018-02
2018-02-28,1862023,2147367,-285344,벨라루스,2018-02
2018-02-28,1842909,468960,1373949,소말리아,2018-02
2018-02-28,1781550,83764,1697786,마이크로네시아,2018-02
2018-02-28,1751373,15,1751358,타지크,2018-02
2018-02-28,1741778,136836,1604942,사이프러스,2018-02
2018-02-28,1662084,190261670,-188599586,기타국,2018-02
2018-02-28,1649601,4724421,-3074820,룩셈부르그,2018-02
2018-02-28,1617759,668136,949623,모리셔스,2018-02
2018-02-28,1563347,0,1563347,가이아나,2018-02
2018-02-28,1561164,44893811,-43332647,콩고민주공화국,2018-02
2018-02-28,1435099,0,1435099,세인트 마틴,2018-02
2018-02-28,1340578,0,1340578,불령 폴리네시아,2018-02
2018-02-28,1201039,4332158,-3131119,기니,2018-02
2018-02-28,1118314,8561,1109753,벨리제,2018-02
2018-02-28,1005459,101459,904000,북마리아나 군도,2018-02
2018-02-28,985729,172032,813697,라이베리아,2018-02
2018-02-28,974632,1152833,-178201,몰도바,2018-02
2018-02-28,947187,6824495,-5877308,베네주엘라,2018-02
2018-02-28,941162,355163,585999,세이쉘,2018-02
2018-02-28,913428,14813179,-13899751,잠비아,2018-02
2018-02-28,786168,0,786168,불령 가이아나,2018-02
2018-02-28,740649,2010,738639,바베이도스,2018-02
2018-02-28,628495,1587313,-958818,리히텐슈타인,2018-02
2018-02-28,618640,114014,504626,말라위,2018-02
2018-02-28,609832,291242,318590,수리남,2018-02
2018-02-28,606404,2702094,-2095690,모리타니,2018-02
2018-02-28,585646,194164,391482,키리바티,2018-02
2018-02-28,559517,241609,317908,아르메니아,2018-02
2018-02-28,530687,110629281,-110098594,가봉,2018-02
2018-02-28,493799,162,493637,도미니카,2018-02
2018-02-28,472826,0,472826,큐라소,2018-02
2018-02-28,459356,213008,246348,스와질랜드,2018-02
2018-02-28,421260,208,421052,영령 캐이맨 군도,2018-02
2018-02-28,392855,0,392855,세인트 바르탤르미,2018-02
2018-02-28,377927,502097,-124170,아루바,2018-02
2018-02-28,370963,787,370176,아메리칸 사모아,2018-02
2018-02-28,370080,91167,278913,보츠와나,2018-02
2018-02-28,357843,49,357794,네덜란드 열도,2018-02
2018-02-28,339355,0,339355,세인트 루시아,2018-02
2018-02-28,326321,27962,298359,르완다,2018-02
2018-02-28,262068,1309,260759,몬테네그로,2018-02
2018-02-28,261320,1232202,-970882,감비아,2018-02
2018-02-28,260382,537679,-277297,바누아투,2018-02
2018-02-28,240957,0,240957,영령 버진군도,2018-02
2018-02-28,240180,65063,175117,몰디브,2018-02
2018-02-28,235103,2339684,-2104581,나미비아,2018-02
2018-02-28,214405,301,214104,안티가 바부다,2018-02
2018-02-28,213498,1532398,-1318900,시에라 리온,2018-02
2018-02-28,207432,0,207432,에리트리아,2018-02
2018-02-28,183556,2194121,-2010565,보스니아-헤르체고비나,2018-02
2018-02-28,170831,26755,144076,적도 기니,2018-02
2018-02-28,169113,0,169113,그레나다,2018-02
2018-02-28,160700,3903,156797,코스 군도,2018-02
2018-02-28,135375,0,135375,부탄,2018-02
2018-02-28,96482,566140,-469658,솔로몬 군도,2018-02
2018-02-28,88679,654,88025,지브랄타,2018-02
2018-02-28,82557,0,82557,챠드,2018-02
2018-02-28,68960,0,68960,통가,2018-02
2018-02-28,54063,0,54063,메요트,2018-02
2018-02-28,50364,0,50364,세인트 빈센트 그레나딘,2018-02
2018-02-28,34618,0,34618,투르크 & 카이코스 군도,2018-02
2018-02-28,34218,0,34218,투발루,2018-02
2018-02-28,21486,49839,-28353,티모르,2018-02
2018-02-28,18000,341,17659,남수단,2018-02
2018-02-28,17433,0,17433,포클랜드 군도,2018-02
2018-02-28,15386,8544,6842,코모로스,2018-02
2018-02-28,15118,0,15118,영령 인도양,2018-02
2018-02-28,14336,133406,-119070,모나코,2018-02
2018-02-28,12675,13205,-530,니제르,2018-02
2018-02-28,10284,6944,3340,미령 버진군도,2018-02
2018-02-28,9709,0,9709,남조지아 & 남샌드위치 군도,2018-02
2018-02-28,5472,0,5472,몬트세라트,2018-02
2018-02-28,2895,2389,506,안도라,2018-02
2018-02-28,676,10135,-9459,카보 베르데,2018-02
2018-02-28,202,48928,-48726,쿡 아일랜드,2018-02
2018-02-28,198,479,-281,나우루,2018-02
2018-02-28,191,0,191,앙귈라,2018-02
2018-02-28,180,15,165,세인트 키츠 네비스,2018-02
2018-02-28,66,0,66,노폴크 아일랜드,2018-02
2018-02-28,11,73440,-73429,그린랜드,2018-02
2018-02-28,8,273749,-273741,중앙아프리카공화국,2018-02
2018-02-28,0,13132,-13132,크리스마스 아일랜드,2018-02
2018-02-28,0,1344,-1344,토켈라우,2018-02
2018-02-28,0,47,-47,교황청,2018-02
2018-02-28,0,131174,-131174,산마리노,2018-02
2018-02-28,0,104,-104,보네르 신트외스타티위스,2018-02
2018-02-28,0,98,-98,알랜드 군도,2018-02
2018-02-28,0,155,-155,세인트 헬레나,2018-02
2018-02-28,0,212,-212,건지,2018-02
2018-02-28,0,871,-871,레소토,2018-02
2018-02-28,0,196197,-196197,기네비소,2018-02
2018-02-28,0,6333,-6333,니우에,2018-02
2018-03-31,13576667103,8412516452,5164150651,중국,2018-03
2018-03-31,6078616405,5207430780,871185625,미국,2018-03
2018-03-31,4196644652,1572122749,2624521903,베트남,2018-03
2018-03-31,4122520611,235192971,3887327640,홍콩,2018-03
2018-03-31,2603449960,5226140866,-2622690906,일본,2018-03
2018-03-31,1379982306,1413262281,-33279975,대만,2018-03
2018-03-31,1211036138,524523693,686512445,인도,2018-03
2018-03-31,1056796593,846683171,210113422,인도네시아,2018-03
2018-03-31,968633947,272632047,696001900,필리핀,2018-03
2018-03-31,879525427,742770343,136755084,싱가포르,2018-03
2018-03-31,842529903,597188647,245341256,멕시코,2018-03
2018-03-31,833411658,1708571999,-875160341,호주,2018-03
2018-03-31,831472290,2029132485,-1197660195,독일,2018-03
2018-03-31,692381432,889016750,-196635318,말레이시아,2018-03
2018-03-31,668948492,501177157,167771335,태국,2018-03
2018-03-31,659943957,1366951538,-707007581,러시아 연방,2018-03
2018-03-31,609840378,122277438,487562940,튀르키예,2018-03
2018-03-31,555655737,445268523,110387214,캐나다,2018-03
2018-03-31,506846839,521054249,-14207410,영국,2018-03
2018-03-31,448064637,254965343,193099294,브라질,2018-03
2018-03-31,428579570,534681338,-106101768,이탈리아,2018-03
2018-03-31,395600785,658190694,-262589909,네덜란드,2018-03
2018-03-31,354650624,604866906,-250216282,프랑스,2018-03
2018-03-31,347405577,1636425468,-1289019891,사우디아라비아,2018-03
2018-03-31,347126533,849377620,-502251087,아랍에미리트 연합,2018-03
2018-03-31,307282963,60197921,247085042,폴란드,2018-03
2018-03-31,306513295,749394850,-442881555,이란,2018-03
2018-03-31,297427471,220980712,76446759,스페인,2018-03
2018-03-31,288712760,150216903,138495857,벨기에,2018-03
2018-03-31,249565113,27073,249538040,마샬군도,2018-03
2018-03-31,229188630,17683213,211505417,슬로바키아,2018-03
2018-03-31,222894495,77800721,145093774,체코공화국,2018-03
2018-03-31,211957067,38,211957029,버뮤다,2018-03
2018-03-31,208453974,44328890,164125084,그리스,2018-03
2018-03-31,203806035,145298656,58507379,노르웨이,2018-03
2018-03-31,196332519,4727139,191605380,몰타,2018-03
2018-03-31,194594372,64399021,130195351,덴마크,2018-03
2018-03-31,169517458,7706810,161810648,슬로베니아,2018-03
2018-03-31,147671347,623664172,-475992825,쿠웨이트,2018-03
2018-03-31,143001000,129640614,13360386,뉴질랜드,2018-03
2018-03-31,132105179,1077867,131027312,우즈베키스탄,2018-03
2018-03-31,130775733,148787474,-18011741,이스라엘,2018-03
2018-03-31,126940578,29046556,97894022,이집트,2018-03
2018-03-31,124098282,412928689,-288830407,칠레,2018-03
2018-03-31,121919921,59245107,62674814,헝가리,2018-03
2018-03-31,120249012,543987611,-423738599,이라크,2018-03
2018-03-31,118741482,2105419,116636063,파나마,2018-03
2018-03-31,117085423,4328932,112756491,토고,2018-03
2018-03-31,102327101,38115193,64211908,방글라데시,2018-03
2018-03-31,101552079,48510291,53041788,파키스탄,2018-03
2018-03-31,94709021,178462127,-83753106,스웨덴,2018-03
2018-03-31,93624215,625992,92998223,라이베리아,2018-03
2018-03-31,90658603,242603232,-151944629,페루,2018-03
2018-03-31,89414290,201488207,-112073917,오스트리아,2018-03
2018-03-31,80295368,253693657,-173398289,남아프리카공화국,2018-03
2018-03-31,74918054,27613674,47304380,아르헨티나,2018-03
2018-03-31,73084038,84700189,-11616151,알제리,2018-03
2018-03-31,66655908,1261384947,-1194729039,카타르,2018-03
2018-03-31,63117613,11282867,51834746,에쿠아도르,2018-03
2018-03-31,62726669,52061409,10665260,콜롬비아,2018-03
2018-03-31,57881975,205434440,-147552465,오만,2018-03
2018-03-31,55792495,30465399,25327096,캄보디아,2018-03
2018-03-31,50084207,43643805,6440402,미얀마,2018-03
2018-03-31,48778661,1033868,47744793,크로아티아,2018-03
2018-03-31,47704921,1921935,45782986,요르단,2018-03
2018-03-31,44122331,22119607,22002724,나이지리아,2018-03
2018-03-31,43640561,34003902,9636659,루마니아,2018-03
2018-03-31,42718088,30310380,12407708,포루투갈,2018-03
2018-03-31,41174934,95634094,-54459160,아일랜드,2018-03
2018-03-31,38315817,282895469,-244579652,스위스,2018-03
2018-03-31,36421122,18356440,18064682,푸에르토리코,2018-03
2018-03-31,35047037,14194377,20852660,카자흐스탄,2018-03
2018-03-31,32893319,42200189,-9306870,앙골라,2018-03
2018-03-31,29946486,18689267,11257219,모로코,2018-03
2018-03-31,29559761,104630376,-75070615,핀란드,2018-03
2018-03-31,29399757,57289608,-27889851,바레인,2018-03
2018-03-31,28681296,871263,27810033,리비아,2018-03
2018-03-31,25870477,6111060,19759417,리투아니아,2018-03
2018-03-31,25011810,43989362,-18977552,우크라이나,2018-03
2018-03-31,24246595,365,24246230,시리아,2018-03
2018-03-31,23764074,511219,23252855,몽골,2018-03
2018-03-31,23248976,6848862,16400114,과테말라,2018-03
2018-03-31,21991959,2811268,19180691,세르비아,2018-03
2018-03-31,21956883,4294808,17662075,케냐,2018-03
2018-03-31,21637145,231710,21405435,피지,2018-03
2018-03-31,21258612,10789462,10469150,도미니카 공화국,2018-03
2018-03-31,19399205,8700289,10698916,스리랑카,2018-03
2018-03-31,18030029,541,18029488,세인트 키츠 네비스,2018-03
2018-03-31,17834439,2113962,15720477,가나,2018-03
2018-03-31,15338221,11030033,4308188,불가리아,2018-03
2018-03-31,15129005,2087585,13041420,레바논,2018-03
2018-03-31,15054224,3027216,12027008,파라과이,2018-03
2018-03-31,13466573,1455134,12011439,엘살바도르,2018-03
2018-03-31,12963937,7013093,5950844,튀니지,2018-03
2018-03-31,11680166,7554884,4125282,온두라스,2018-03
2018-03-31,11587073,1918617,9668456,수단,2018-03
2018-03-31,11214358,753351,10461007,탄자니아,2018-03
2018-03-31,10698963,10868794,-169831,우루과이,2018-03
2018-03-31,10141619,9948060,193559,코스타리카,2018-03
2018-03-31,10104407,565373,9539034,아이티,2018-03
2018-03-31,9857345,1477641,8379704,코트디봐르,2018-03
2018-03-31,9619776,3126948,6492828,라오스,2018-03
2018-03-31,8930096,7517619,1412477,에스토니아,2018-03
2018-03-31,8929527,1059715,7869812,니카라과,2018-03
2018-03-31,8353627,158231,8195396,가이아나,2018-03
2018-03-31,8029909,5702586,2327323,세네갈,2018-03
2018-03-31,7716493,36314559,-28598066,모잠비크,2018-03
2018-03-31,7292167,5665710,1626457,예맨,2018-03
2018-03-31,7224546,3962163,3262383,조지아,2018-03
2018-03-31,7060621,36346552,-29285931,트리니다드 토바고,2018-03
2018-03-31,7027310,23831,7003479,키르기스스탄,2018-03
2018-03-31,7021144,2346570,4674574,베닝,2018-03
2018-03-31,6949848,127404308,-120454460,브루나이,2018-03
2018-03-31,6927973,472120,6455853,팔레스타인 해방기구,2018-03
2018-03-31,6830863,1143,6829720,아프카니스탄,2018-03
2018-03-31,6671192,3106730,3564462,에티오피아,2018-03
2018-03-31,5780395,204815,5575580,괌,2018-03
2018-03-31,4853632,0,4853632,지부티,2018-03
2018-03-31,4500864,11419,4489445,쿠바,2018-03
2018-03-31,4218792,59268222,-55049430,볼리비아,2018-03
2018-03-31,4203292,87758,4115534,부르키나 파소,2018-03
2018-03-31,4099760,6102226,-2002466,라트비아,2018-03
2018-03-31,4071580,7995,4063585,말리,2018-03
2018-03-31,3793692,532,3793160,아제르바이잔,2018-03
2018-03-31,3595456,25394,3570062,사모아,2018-03
2018-03-31,3514839,17627312,-14112473,사이프러스,2018-03
2018-03-31,3316727,0,3316727,불령 리유니온 코모도 제도,2018-03
2018-03-31,3289225,202275,3086950,자마이카,2018-03
2018-03-31,3087799,1947956,1139843,콩고,2018-03
2018-03-31,3036815,628743,2408072,짐바브웨,2018-03
2018-03-31,2983368,1481939,1501429,아이슬란드,2018-03
2018-03-31,2722295,5410912,-2688617,룩셈부르그,2018-03
2018-03-31,2720703,25456756,-22736053,파푸아 뉴기니,2018-03
2018-03-31,2599048,436166,2162882,모리셔스,2018-03
2018-03-31,2545558,60034,2485524,불령 폴리네시아,2018-03
2018-03-31,2496449,3406704,-910255,마다카스카르,2018-03
2018-03-31,2350301,244061,2106240,네팔,2018-03
2018-03-31,2241354,11819935,-9578581,잠비아,2018-03
2018-03-31,2234295,836363,1397932,마카오,2018-03
2018-03-31,2181120,0,2181120,영령 버진군도,2018-03
2018-03-31,2037966,86192,1951774,말라위,2018-03
2018-03-31,1932217,2626361,-694144,벨라루스,2018-03
2018-03-31,1896401,1978209,-81808,키리바티,2018-03
2018-03-31,1887822,274977,1612845,카메룬,2018-03
2018-03-31,1863989,6839992,-4976003,기니,2018-03
2018-03-31,1827937,0,1827937,타지크,2018-03
2018-03-31,1821628,462869,1358759,세이쉘,2018-03
2018-03-31,1718190,109404,1608786,소말리아,2018-03
2018-03-31,1625050,0,1625050,과델로프,2018-03
2018-03-31,1537778,12157387,-10619609,뉴 칼레도니아,2018-03
2018-03-31,1515791,151680,1364111,북마리아나 군도,2018-03
2018-03-31,1500752,1831730,-330978,베네주엘라,2018-03
2018-03-31,1463390,197,1463193,몰디브,2018-03
2018-03-31,1454925,0,1454925,세인트 마틴,2018-03
2018-03-31,1330974,155766079,-154435105,기타국,2018-03
2018-03-31,1324350,57915943,-56591593,콩고민주공화국,2018-03
2018-03-31,1184326,170473,1013853,마세도니아,2018-03
2018-03-31,1070183,257719,812464,아르메니아,2018-03
2018-03-31,1056450,224779,831671,마이크로네시아,2018-03
2018-03-31,999331,893360,105971,몰도바,2018-03
2018-03-31,972939,4661,968278,부룬디,2018-03
2018-03-31,964612,479751,484861,알바니아,2018-03
2018-03-31,916756,947884,-31128,리히텐슈타인,2018-03
2018-03-31,916364,2387,913977,안티가 바부다,2018-03
2018-03-31,890356,45297,845059,르완다,2018-03
2018-03-31,859576,306442,553134,스와질랜드,2018-03
2018-03-31,846919,56033,790886,마티니크,2018-03
2018-03-31,845548,198242,647306,우간다,2018-03
2018-03-31,829572,2029,827543,투르크멘,2018-03
2018-03-31,826710,385,826325,바하마,2018-03
2018-03-31,802123,155776,646347,수리남,2018-03
2018-03-31,771355,2772650,-2001295,시에라 리온,2018-03
2018-03-31,754065,748536,5529,아루바,2018-03
2018-03-31,751633,0,751633,영령 캐이맨 군도,2018-03
2018-03-31,745874,1725432,-979558,모리타니,2018-03
2018-03-31,736214,118,736096,큐라소,2018-03
2018-03-31,637735,36952,600783,아메리칸 사모아,2018-03
2018-03-31,586265,82785,503480,몬테네그로,2018-03
2018-03-31,522569,26525,496044,세인트 루시아,2018-03
2018-03-31,459716,0,459716,불령 가이아나,2018-03
2018-03-31,434339,57478,376861,보츠와나,2018-03
2018-03-31,400238,51056900,-50656662,가봉,2018-03
2018-03-31,375551,119966,255585,벨리제,2018-03
2018-03-31,374879,1571537,-1196658,보스니아-헤르체고비나,2018-03
2018-03-31,371814,8649,363165,바베이도스,2018-03
2018-03-31,370105,0,370105,네덜란드 열도,2018-03
2018-03-31,333376,3627502,-3294126,바누아투,2018-03
2018-03-31,323422,1030805,-707383,감비아,2018-03
2018-03-31,320499,0,320499,에리트리아,2018-03
2018-03-31,314855,489691,-174836,모나코,2018-03
2018-03-31,313670,953546,-639876,나미비아,2018-03
2018-03-31,302406,0,302406,그레나다,2018-03
2018-03-31,294995,335570,-40575,적도 기니,2018-03
2018-03-31,272521,1128,271393,세인트 바르탤르미,2018-03
2018-03-31,253382,1223,252159,티모르,2018-03
2018-03-31,198989,9600,189389,팔라우,2018-03
2018-03-31,155500,372275,-216775,기네비소,2018-03
2018-03-31,146300,10895,135405,부탄,2018-03
2018-03-31,138485,1035968,-897483,솔로몬 군도,2018-03
2018-03-31,117381,0,117381,세인트 빈센트 그레나딘,2018-03
2018-03-31,86699,15169,71530,도미니카,2018-03
2018-03-31,75558,140,75418,카보 베르데,2018-03
2018-03-31,50902,3502,47400,안도라,2018-03
2018-03-31,46150,0,46150,메요트,2018-03
2018-03-31,42717,0,42717,투르크 & 카이코스 군도,2018-03
2018-03-31,41184,144330,-103146,니제르,2018-03
2018-03-31,37494,0,37494,지브랄타,2018-03
2018-03-31,37156,2015,35141,몬트세라트,2018-03
2018-03-31,24448,19,24429,투발루,2018-03
2018-03-31,19120,0,19120,남수단,2018-03
2018-03-31,14863,231984,-217121,산마리노,2018-03
2018-03-31,14400,1750,12650,레소토,2018-03
2018-03-31,11142,22,11120,챠드,2018-03
2018-03-31,3830,0,3830,파로에 군도,2018-03
2018-03-31,2611,133362,-130751,앙귈라,2018-03
2018-03-31,1900,0,1900,상토메 프린스페,2018-03
2018-03-31,1621,68000,-66379,쿡 아일랜드,2018-03
2018-03-31,461,0,461,저어지,2018-03
2018-03-31,165,44944,-44779,그린랜드,2018-03
2018-03-31,135,0,135,왈라스 & 퓨투나 군도,2018-03
2018-03-31,0,26328,-26328,니우에,2018-03
2018-03-31,0,27725,-27725,코모로스,2018-03
2018-03-31,0,28826,-28826,통가,2018-03
2018-03-31,0,2954,-2954,마이너 아우틀링 합중국 군도,2018-03
2018-03-31,0,85,-85,허드 앤 맥도날드 군도,2018-03
2018-03-31,0,27,-27,크리스마스 아일랜드,2018-03
2018-03-31,0,1783,-1783,건지,2018-03
2018-03-31,0,58986,-58986,스발비드 군도,2018-03
2018-03-31,0,1279,-1279,토켈라우,2018-03
2018-03-31,0,134,-134,미령 버진군도,2018-03
2018-03-31,0,209219,-209219,중앙아프리카공화국,2018-03
2018-03-31,0,330,-330,세인트 헬레나,2018-03
2018-03-31,0,1577,-1577,나우루,2018-03
2018-04-30,13034964359,8720319596,4314644763,중국,2018-04
2018-04-30,5942113553,4757056686,1185056867,미국,2018-04
2018-04-30,3838410014,171772480,3666637534,홍콩,2018-04
2018-04-30,3724493793,1561285497,2163208296,베트남,2018-04
2018-04-30,2482756392,4939589149,-2456832757,일본,2018-04
2018-04-30,1425180295,1447551714,-22371419,대만,2018-04
2018-04-30,1363779230,689535846,674243384,싱가포르,2018-04
2018-04-30,1260185701,409886952,850298749,인도,2018-04
2018-04-30,1028081450,253106414,774975036,필리핀,2018-04
2018-04-30,907245257,445122326,462122931,멕시코,2018-04
2018-04-30,876952660,887754519,-10801859,말레이시아,2018-04
2018-04-30,843057869,1774031730,-930973861,독일,2018-04
2018-04-30,824987097,1483407426,-658420329,호주,2018-04
2018-04-30,732730892,982352670,-249621778,인도네시아,2018-04
2018-04-30,717162149,492746498,224415651,태국,2018-04
2018-04-30,640087512,373740249,266347263,영국,2018-04
2018-04-30,611782485,1522219028,-910436543,러시아 연방,2018-04
2018-04-30,605368127,100230246,505137881,튀르키예,2018-04
2018-04-30,480368257,561993149,-81624892,캐나다,2018-04
2018-04-30,438123576,245445216,192678360,브라질,2018-04
2018-04-30,436355654,678503657,-242148003,네덜란드,2018-04
2018-04-30,418769670,1866402943,-1447633273,사우디아라비아,2018-04
2018-04-30,391443644,498011610,-106567966,이탈리아,2018-04
2018-04-30,376828152,642160789,-265332637,아랍에미리트 연합,2018-04
2018-04-30,325883238,127730421,198152817,벨기에,2018-04
2018-04-30,321343185,60331697,261011488,폴란드,2018-04
2018-04-30,316483198,534371678,-217888480,이라크,2018-04
2018-04-30,305244163,474112176,-168868013,프랑스,2018-04
2018-04-30,274792407,175865306,98927101,스페인,2018-04
2018-04-30,243513167,104072573,139440594,뉴질랜드,2018-04
2018-04-30,232929944,13550805,219379139,슬로바키아,2018-04
2018-04-30,231334901,666420179,-435085278,이란,2018-04
2018-04-30,207844952,75479032,132365920,체코공화국,2018-04
2018-04-30,204459589,64122854,140336735,덴마크,2018-04
2018-04-30,194294963,490,194294473,바하마,2018-04
2018-04-30,170283231,405891797,-235608566,칠레,2018-04
2018-04-30,152959027,11266764,141692263,슬로베니아,2018-04
2018-04-30,144531287,53546524,90984763,헝가리,2018-04
2018-04-30,142317906,2615329,139702577,토고,2018-04
2018-04-30,129552121,133934034,-4381913,이스라엘,2018-04
2018-04-30,128024359,28664289,99360070,이집트,2018-04
2018-04-30,123156910,34965541,88191369,방글라데시,2018-04
2018-04-30,122547217,2262375,120284842,우즈베키스탄,2018-04
2018-04-30,121323083,1086333921,-965010838,쿠웨이트,2018-04
2018-04-30,119672451,9373272,110299179,그리스,2018-04
2018-04-30,96861107,98298876,-1437769,노르웨이,2018-04
2018-04-30,96009419,166087807,-70078388,스웨덴,2018-04
2018-04-30,88871248,23080425,65790823,파키스탄,2018-04
2018-04-30,84240398,222764256,-138523858,남아프리카공화국,2018-04
2018-04-30,80101087,138940656,-58839569,알제리,2018-04
2018-04-30,76937803,170726900,-93789097,오스트리아,2018-04
2018-04-30,73362540,11470126,61892414,에쿠아도르,2018-04
2018-04-30,65334230,73836709,-8502479,콜롬비아,2018-04
2018-04-30,59622613,18491332,41131281,아르헨티나,2018-04
2018-04-30,59591729,1047143251,-987551522,카타르,2018-04
2018-04-30,53986357,317896493,-263910136,페루,2018-04
2018-04-30,51625708,27314777,24310931,캄보디아,2018-04
2018-04-30,51260862,81489596,-30228734,아일랜드,2018-04
2018-04-30,51188668,266262535,-215073867,오만,2018-04
2018-04-30,50981952,23010057,27971895,푸에르토리코,2018-04
2018-04-30,47958545,98386962,-50428417,카자흐스탄,2018-04
2018-04-30,47685573,29704045,17981528,미얀마,2018-04
2018-04-30,45249218,46122,45203096,마샬군도,2018-04
2018-04-30,43211922,31143580,12068342,루마니아,2018-04
2018-04-30,42811529,28975047,13836482,포루투갈,2018-04
2018-04-30,40043099,52912809,-12869710,나이지리아,2018-04
2018-04-30,39969365,3175690,36793675,요르단,2018-04
2018-04-30,38896321,240871370,-201975049,스위스,2018-04
2018-04-30,34676833,279826,34397007,라이베리아,2018-04
2018-04-30,33949173,361871,33587302,피지,2018-04
2018-04-30,32726529,36532757,-3806228,리비아,2018-04
2018-04-30,27353651,46436508,-19082857,몰타,2018-04
2018-04-30,27154802,368077,26786725,카메룬,2018-04
2018-04-30,26013000,21476406,4536594,우크라이나,2018-04
2018-04-30,24821602,853961,23967641,몽골,2018-04
2018-04-30,24667216,14850339,9816877,모로코,2018-04
2018-04-30,24325245,5375439,18949806,과테말라,2018-04
2018-04-30,23796307,10380939,13415368,도미니카 공화국,2018-04
2018-04-30,22828822,39108302,-16279480,파나마,2018-04
2018-04-30,22414930,107981138,-85566208,핀란드,2018-04
2018-04-30,21069553,6481144,14588409,리투아니아,2018-04
2018-04-30,20158490,67192488,-47033998,바레인,2018-04
2018-04-30,20118942,3113673,17005269,가나,2018-04
2018-04-30,18327831,7036389,11291442,스리랑카,2018-04
2018-04-30,18084261,5086349,12997912,튀니지,2018-04
2018-04-30,17359994,23929810,-6569816,뉴 칼레도니아,2018-04
2018-04-30,17326051,4183322,13142729,케냐,2018-04
2018-04-30,15594900,10571911,5022989,불가리아,2018-04
2018-04-30,12905206,1315748,11589458,파라과이,2018-04
2018-04-30,12701467,6774895,5926572,탄자니아,2018-04
2018-04-30,12674195,5999227,6674968,세르비아,2018-04
2018-04-30,12573388,1478355,11095033,수단,2018-04
2018-04-30,12545076,1473768,11071308,레바논,2018-04
2018-04-30,12165220,729023,11436197,코트디봐르,2018-04
2018-04-30,11593203,64105,11529098,쿠바,2018-04
2018-04-30,10893771,111046,10782725,시리아,2018-04
2018-04-30,10595452,5325820,5269632,온두라스,2018-04
2018-04-30,10468341,15081,10453260,아제르바이잔,2018-04
2018-04-30,10374973,37211112,-26836139,앙골라,2018-04
2018-04-30,10274049,2780440,7493609,니카라과,2018-04
2018-04-30,9481258,357593,9123665,괌,2018-04
2018-04-30,9190131,6654352,2535779,에스토니아,2018-04
2018-04-30,8923614,9860037,-936423,코스타리카,2018-04
2018-04-30,8605803,1719084,6886719,세네갈,2018-04
2018-04-30,8257743,1811502,6446241,엘살바도르,2018-04
2018-04-30,8195766,1518142,6677624,크로아티아,2018-04
2018-04-30,8041007,347878,7693129,아이티,2018-04
2018-04-30,7946272,15000797,-7054525,우루과이,2018-04
2018-04-30,7856409,2377546,5478863,라오스,2018-04
2018-04-30,7842168,899830,6942338,브루나이,2018-04
2018-04-30,6803199,1978,6801221,키르기스스탄,2018-04
2018-04-30,6781504,57429910,-50648406,볼리비아,2018-04
2018-04-30,6622604,154672,6467932,팔레스타인 해방기구,2018-04
2018-04-30,6116924,4388443,1728481,예맨,2018-04
2018-04-30,5469735,11503376,-6033641,트리니다드 토바고,2018-04
2018-04-30,5406361,3532611,1873750,에티오피아,2018-04
2018-04-30,5321921,2364500,2957421,조지아,2018-04
2018-04-30,4969502,706,4968796,아프카니스탄,2018-04
2018-04-30,4405118,5198180,-793062,베닝,2018-04
2018-04-30,4273677,5884058,-1610381,라트비아,2018-04
2018-04-30,4171883,270,4171613,지부티,2018-04
2018-04-30,3739801,1053444,2686357,파푸아 뉴기니,2018-04
2018-04-30,3609140,3713,3605427,말리,2018-04
2018-04-30,3463062,553513,2909549,마카오,2018-04
2018-04-30,3460315,51121,3409194,사모아,2018-04
2018-04-30,3209975,2057260,1152715,말라위,2018-04
2018-04-30,2926199,57935036,-55008837,콩고민주공화국,2018-04
2018-04-30,2900308,5810403,-2910095,룩셈부르그,2018-04
2018-04-30,2728782,909722,1819060,모잠비크,2018-04
2018-04-30,2679687,203327,2476360,자마이카,2018-04
2018-04-30,2569069,379565,2189504,짐바브웨,2018-04
2018-04-30,2537108,176422,2360686,사이프러스,2018-04
2018-04-30,2482082,93353,2388729,부르키나 파소,2018-04
2018-04-30,2476278,3763289,-1287011,기니,2018-04
2018-04-30,2455070,0,2455070,타지크,2018-04
2018-04-30,2285662,8318088,-6032426,마다카스카르,2018-04
2018-04-30,2228613,1000716,1227897,베네주엘라,2018-04
2018-04-30,2224255,463959,1760296,우간다,2018-04
2018-04-30,2177112,32215,2144897,투르크멘,2018-04
2018-04-30,2155062,240815,1914247,모리셔스,2018-04
2018-04-30,2134485,36202,2098283,불령 리유니온 코모도 제도,2018-04
2018-04-30,1913783,89124,1824659,북마리아나 군도,2018-04
2018-04-30,1912444,91430,1821014,네팔,2018-04
2018-04-30,1791195,85182,1706013,마이크로네시아,2018-04
2018-04-30,1533015,1267,1531748,몰디브,2018-04
2018-04-30,1499358,210510,1288848,알바니아,2018-04
2018-04-30,1395266,4858860,-3463594,벨라루스,2018-04
2018-04-30,1389985,80647961,-79257976,기타국,2018-04
2018-04-30,1379800,10825,1368975,불령 폴리네시아,2018-04
2018-04-30,1288476,11296077,-10007601,잠비아,2018-04
2018-04-30,1274598,1124231,150367,아이슬란드,2018-04
2018-04-30,1233775,491614,742161,세이쉘,2018-04
2018-04-30,1233068,252298,980770,아르메니아,2018-04
2018-04-30,1134586,0,1134586,벨리제,2018-04
2018-04-30,1106044,0,1106044,세인트 마틴,2018-04
2018-04-30,1060431,66543897,-65483466,콩고,2018-04
2018-04-30,1019581,240526,779055,소말리아,2018-04
2018-04-30,965777,1247872,-282095,리히텐슈타인,2018-04
2018-04-30,958278,654267,304011,몰도바,2018-04
2018-04-30,905045,39590,865455,과델로프,2018-04
2018-04-30,814844,14211,800633,바베이도스,2018-04
2018-04-30,798246,149074,649172,아루바,2018-04
2018-04-30,774347,3209763,-2435416,모리타니,2018-04
2018-04-30,709472,81848,627624,가이아나,2018-04
2018-04-30,617345,0,617345,도미니카,2018-04
2018-04-30,615304,0,615304,영령 버진군도,2018-04
2018-04-30,597833,216376,381457,수리남,2018-04
2018-04-30,589332,200,589132,버뮤다,2018-04
2018-04-30,510044,60673,449371,마티니크,2018-04
2018-04-30,490089,111054,379035,스와질랜드,2018-04
2018-04-30,473977,600285,-126308,시에라 리온,2018-04
2018-04-30,450592,253352,197240,마세도니아,2018-04
2018-04-30,420053,0,420053,안티가 바부다,2018-04
2018-04-30,417200,0,417200,세인트 빈센트 그레나딘,2018-04
2018-04-30,413358,0,413358,네덜란드 열도,2018-04
2018-04-30,402369,13,402356,키리바티,2018-04
2018-04-30,366231,70761032,-70394801,가봉,2018-04
2018-04-30,342870,2079613,-1736743,바누아투,2018-04
2018-04-30,321089,2937,318152,아메리칸 사모아,2018-04
2018-04-30,320143,0,320143,몬테네그로,2018-04
2018-04-30,318497,0,318497,큐라소,2018-04
2018-04-30,316880,2161477,-1844597,보스니아-헤르체고비나,2018-04
2018-04-30,293967,50045,243922,보츠와나,2018-04
2018-04-30,282214,0,282214,세인트 루시아,2018-04
2018-04-30,255699,13261969,-13006270,에리트리아,2018-04
2018-04-30,233001,575948,-342947,르완다,2018-04
2018-04-30,231554,229451,2103,감비아,2018-04
2018-04-30,192623,0,192623,세인트 바르탤르미,2018-04
2018-04-30,168729,226,168503,팔라우,2018-04
2018-04-30,141247,89,141158,부탄,2018-04
2018-04-30,133930,0,133930,카보 베르데,2018-04
2018-04-30,109805,0,109805,불령 가이아나,2018-04
2018-04-30,106020,11435,94585,니제르,2018-04
2018-04-30,103979,625209,-521230,나미비아,2018-04
2018-04-30,99817,922,98895,영령 캐이맨 군도,2018-04
2018-04-30,91980,162034,-70054,기네비소,2018-04
2018-04-30,88856,0,88856,티모르,2018-04
2018-04-30,66688,11,66677,그레나다,2018-04
2018-04-30,61070,137,60933,세인트 키츠 네비스,2018-04
2018-04-30,57202,398,56804,지브랄타,2018-04
2018-04-30,49250,0,49250,적도 기니,2018-04
2018-04-30,48534,147386,-98852,솔로몬 군도,2018-04
2018-04-30,38287,0,38287,챠드,2018-04
2018-04-30,36715,0,36715,투르크 & 카이코스 군도,2018-04
2018-04-30,32310,0,32310,앙귈라,2018-04
2018-04-30,31191,184,31007,통가,2018-04
2018-04-30,11206,495408,-484202,모나코,2018-04
2018-04-30,7920,1559,6361,상토메 프린스페,2018-04
2018-04-30,6000,25557,-19557,부룬디,2018-04
2018-04-30,2531,8564,-6033,안도라,2018-04
2018-04-30,698,6519,-5821,미령 버진군도,2018-04
2018-04-30,102,21228,-21126,그린랜드,2018-04
2018-04-30,15,0,15,메요트,2018-04
2018-04-30,0,5019,-5019,코스 군도,2018-04
2018-04-30,0,8831,-8831,크리스마스 아일랜드,2018-04
2018-04-30,0,503019,-503019,중앙아프리카공화국,2018-04
2018-04-30,0,953,-953,니우에,2018-04
2018-04-30,0,79826,-79826,산마리노,2018-04
2018-04-30,0,13685,-13685,쿡 아일랜드,2018-04
2018-04-30,0,264,-264,서사하라,2018-04
2018-04-30,0,10,-10,허드 앤 맥도날드 군도,2018-04
2018-04-30,0,466,-466,레소토,2018-04
2018-04-30,0,849,-849,알랜드 군도,2018-04
2018-04-30,0,630,-630,토켈라우,2018-04
2018-04-30,0,603,-603,영령 인도양,2018-04
2018-04-30,0,2955,-2955,불령 남부지역,2018-04
2018-05-31,13851899898,9279720113,4572179785,중국,2018-05
2018-05-31,6153032588,4822091296,1330941292,미국,2018-05
2018-05-31,4237216652,169694457,4067522195,홍콩,2018-05
2018-05-31,3781174443,1521908222,2259266221,베트남,2018-05
2018-05-31,2513782252,4422427759,-1908645507,일본,2018-05
2018-05-31,1466128915,1490222880,-24093965,대만,2018-05
2018-05-31,1361681024,484178858,877502166,인도,2018-05
2018-05-31,1058923883,291775107,767148776,필리핀,2018-05
2018-05-31,917333229,463222982,454110247,멕시코,2018-05
2018-05-31,905209084,1829284592,-924075508,독일,2018-05
2018-05-31,898288739,641929049,256359690,싱가포르,2018-05
2018-05-31,858134130,1459848842,-601714712,호주,2018-05
2018-05-31,718151187,500027777,218123410,태국,2018-05
2018-05-31,698899356,804556834,-105657478,말레이시아,2018-05
2018-05-31,674240709,848303334,-174062625,영국,2018-05
2018-05-31,668245349,821662681,-153417332,인도네시아,2018-05
2018-05-31,603794818,1537786034,-933991216,러시아 연방,2018-05
2018-05-31,584006655,473038728,110967927,캐나다,2018-05
2018-05-31,568297183,98061779,470235404,튀르키예,2018-05
2018-05-31,440109091,556064446,-115955355,이탈리아,2018-05
2018-05-31,428541439,303901659,124639780,브라질,2018-05
2018-05-31,409041220,571532736,-162491516,네덜란드,2018-05
2018-05-31,377547042,793132446,-415585404,아랍에미리트 연합,2018-05
2018-05-31,323379835,52112025,271267810,폴란드,2018-05
2018-05-31,305395679,487447344,-182051665,프랑스,2018-05
2018-05-31,296313702,428979916,-132666214,이란,2018-05
2018-05-31,279337666,1970751990,-1691414324,사우디아라비아,2018-05
2018-05-31,278523204,203363134,75160070,스페인,2018-05
2018-05-31,266064413,138826259,127238154,벨기에,2018-05
2018-05-31,254758917,15581357,239177560,슬로바키아,2018-05
2018-05-31,215117183,70875724,144241459,체코공화국,2018-05
2018-05-31,175989657,63849793,112139864,헝가리,2018-05
2018-05-31,175163508,12310938,162852570,슬로베니아,2018-05
2018-05-31,172259937,419159302,-246899365,칠레,2018-05
2018-05-31,164177985,3055895,161122090,우즈베키스탄,2018-05
2018-05-31,163797144,262449,163534695,라이베리아,2018-05
2018-05-31,155812909,8456015,147356894,토고,2018-05
2018-05-31,147587885,20890792,126697093,이집트,2018-05
2018-05-31,137377388,101332396,36044992,이스라엘,2018-05
2018-05-31,130672478,1109482425,-978809947,쿠웨이트,2018-05
2018-05-31,129701517,130966916,-1265399,뉴질랜드,2018-05
2018-05-31,128894376,140633479,-11739103,스웨덴,2018-05
2018-05-31,105104215,76745359,28358856,콜롬비아,2018-05
2018-05-31,102032598,253398680,-151366082,페루,2018-05
2018-05-31,99990356,21232347,78758009,방글라데시,2018-05
2018-05-31,95069020,68801507,26267513,나이지리아,2018-05
2018-05-31,94504979,41346040,53158939,파키스탄,2018-05
2018-05-31,94476105,57231494,37244611,알제리,2018-05
2018-05-31,89333205,192224050,-102890845,남아프리카공화국,2018-05
2018-05-31,87489819,897589999,-810100180,이라크,2018-05
2018-05-31,80481578,170996056,-90514478,오스트리아,2018-05
2018-05-31,77418635,1594213,75824422,파나마,2018-05
2018-05-31,75917730,173151442,-97233712,카자흐스탄,2018-05
2018-05-31,68309181,136838507,-68529326,아일랜드,2018-05
2018-05-31,67655363,11387683,56267680,에쿠아도르,2018-05
2018-05-31,59122396,1040147714,-981025318,카타르,2018-05
2018-05-31,57091228,20712497,36378731,캄보디아,2018-05
2018-05-31,56809037,7587013,49222024,요르단,2018-05
2018-05-31,55728466,271412643,-215684177,스위스,2018-05
2018-05-31,52878381,183076347,-130197966,오만,2018-05
2018-05-31,50007029,30756346,19250683,미얀마,2018-05
2018-05-31,48465359,16210583,32254776,아르헨티나,2018-05
2018-05-31,46005856,31679066,14326790,포루투갈,2018-05
2018-05-31,42554870,59849338,-17294468,리비아,2018-05
2018-05-31,41435782,1736,41434046,바하마,2018-05
2018-05-31,40707440,32706612,8000828,루마니아,2018-05
2018-05-31,38080684,102101590,-64020906,덴마크,2018-05
2018-05-31,34380401,2485,34377916,나우루,2018-05
2018-05-31,33202083,64595466,-31393383,그리스,2018-05
2018-05-31,30530592,15143115,15387477,푸에르토리코,2018-05
2018-05-31,30489931,17122005,13367926,우크라이나,2018-05
2018-05-31,29819143,11117207,18701936,모로코,2018-05
2018-05-31,28210978,148172413,-119961435,핀란드,2018-05
2018-05-31,28102017,3164781,24937236,몰타,2018-05
2018-05-31,27753423,90718480,-62965057,노르웨이,2018-05
2018-05-31,27542046,985163,26556883,몽골,2018-05
2018-05-31,26291432,1405299,24886133,크로아티아,2018-05
2018-05-31,26105421,6866351,19239070,리투아니아,2018-05
2018-05-31,26080858,5464857,20616001,케냐,2018-05
2018-05-31,24826919,22943372,1883547,도미니카 공화국,2018-05
2018-05-31,23856316,5958919,17897397,스리랑카,2018-05
2018-05-31,19232406,7581251,11651155,과테말라,2018-05
2018-05-31,18607843,10242150,8365693,불가리아,2018-05
2018-05-31,17828042,2202406,15625636,가나,2018-05
2018-05-31,17310045,1336162,15973883,파라과이,2018-05
2018-05-31,14546597,5602557,8944040,에티오피아,2018-05
2018-05-31,13630480,2096614,11533866,탄자니아,2018-05
2018-05-31,13580875,70420951,-56840076,바레인,2018-05
2018-05-31,13275366,13028385,246981,우루과이,2018-05
2018-05-31,13233622,5477566,7756056,튀니지,2018-05
2018-05-31,13130046,2006663,11123383,엘살바도르,2018-05
2018-05-31,12603006,4843446,7759560,예맨,2018-05
2018-05-31,12474808,944,12473864,시리아,2018-05
2018-05-31,11588854,1789374,9799480,니카라과,2018-05
2018-05-31,11565565,13612219,-2046654,온두라스,2018-05
2018-05-31,11242570,1573842,9668728,레바논,2018-05
2018-05-31,10126019,813721,9312298,코트디봐르,2018-05
2018-05-31,9974686,7806856,2167830,코스타리카,2018-05
2018-05-31,9667304,1756668,7910636,수단,2018-05
2018-05-31,9608500,5088141,4520359,세르비아,2018-05
2018-05-31,9205126,5888460,3316666,에스토니아,2018-05
2018-05-31,8817486,1110916,7706570,쿠바,2018-05
2018-05-31,8388148,831039,7557109,앙골라,2018-05
2018-05-31,8139885,127374,8012511,아이티,2018-05
2018-05-31,7522001,862607,6659394,브루나이,2018-05
2018-05-31,7354875,4900795,2454080,세네갈,2018-05
2018-05-31,6986300,3580436,3405864,파푸아 뉴기니,2018-05
2018-05-31,6934506,250447,6684059,키르기스스탄,2018-05
2018-05-31,6844348,8906805,-2062457,트리니다드 토바고,2018-05
2018-05-31,6694111,6866503,-172392,라트비아,2018-05
2018-05-31,6579881,34696034,-28116153,모잠비크,2018-05
2018-05-31,6419320,61,6419259,세인트 키츠 네비스,2018-05
2018-05-31,5475264,212662,5262602,팔레스타인 해방기구,2018-05
2018-05-31,5299631,275158,5024473,피지,2018-05
2018-05-31,5227417,0,5227417,지부티,2018-05
2018-05-31,4775593,182508,4593085,괌,2018-05
2018-05-31,4744864,406168,4338696,콩고,2018-05
2018-05-31,4688563,81876520,-77187957,콩고민주공화국,2018-05
2018-05-31,4517070,2652157,1864913,조지아,2018-05
2018-05-31,4516438,23631955,-19115517,볼리비아,2018-05
2018-05-31,4360066,5110192,-750126,벨라루스,2018-05
2018-05-31,4147072,66733,4080339,아제르바이잔,2018-05
2018-05-31,3584423,952,3583471,아프카니스탄,2018-05
2018-05-31,3558858,2390862,1167996,라오스,2018-05
2018-05-31,3508134,13483361,-9975227,잠비아,2018-05
2018-05-31,3496274,62685,3433589,사모아,2018-05
2018-05-31,2907707,1555045,1352662,아이슬란드,2018-05
2018-05-31,2848834,4573715,-1724881,마다카스카르,2018-05
2018-05-31,2827726,244197,2583529,모리셔스,2018-05
2018-05-31,2811794,77241,2734553,네팔,2018-05
2018-05-31,2768194,970868,1797326,사이프러스,2018-05
2018-05-31,2689297,12238,2677059,투르크멘,2018-05
2018-05-31,2646283,5405325,-2759042,베닝,2018-05
2018-05-31,2596347,6770051,-4173704,룩셈부르그,2018-05
2018-05-31,2529013,1032059,1496954,감비아,2018-05
2018-05-31,2225645,278,2225367,타지크,2018-05
2018-05-31,2219504,63016,2156488,가이아나,2018-05
2018-05-31,2169405,7549,2161856,부르키나 파소,2018-05
2018-05-31,2164257,92626779,-90462522,기타국,2018-05
2018-05-31,2048155,117265,1930890,마카오,2018-05
2018-05-31,2041726,706338,1335388,세이쉘,2018-05
2018-05-31,2019348,3299,2016049,말리,2018-05
2018-05-31,1939759,225412,1714347,카메룬,2018-05
2018-05-31,1911557,4637337,-2725780,기니,2018-05
2018-05-31,1910585,534145,1376440,짐바브웨,2018-05
2018-05-31,1874888,20713,1854175,자마이카,2018-05
2018-05-31,1806395,99407,1706988,알바니아,2018-05
2018-05-31,1776695,1048469,728226,우간다,2018-05
2018-05-31,1625739,126416,1499323,르완다,2018-05
2018-05-31,1541937,715228,826709,소말리아,2018-05
2018-05-31,1522953,2298715,-775762,모리타니,2018-05
2018-05-31,1404471,0,1404471,버뮤다,2018-05
2018-05-31,1388515,23,1388492,불령 리유니온 코모도 제도,2018-05
2018-05-31,1367884,1648261,-280377,시에라 리온,2018-05
2018-05-31,1312537,27542017,-26229480,가봉,2018-05
2018-05-31,1299628,435628,864000,마이크로네시아,2018-05
2018-05-31,1270219,88209,1182010,벨리제,2018-05
2018-05-31,1078984,0,1078984,세인트 마틴,2018-05
2018-05-31,1004232,441903,562329,키리바티,2018-05
2018-05-31,992480,631778,360702,아르메니아,2018-05
2018-05-31,973819,28183152,-27209333,뉴 칼레도니아,2018-05
2018-05-31,905908,853683,52225,리히텐슈타인,2018-05
2018-05-31,866374,1128230,-261856,몬테네그로,2018-05
2018-05-31,862714,1115,861599,과델로프,2018-05
2018-05-31,846246,248384,597862,북마리아나 군도,2018-05
2018-05-31,756430,313737,442693,수리남,2018-05
2018-05-31,723793,47160,676633,불령 폴리네시아,2018-05
2018-05-31,694740,46935,647805,팔라우,2018-05
2018-05-31,689585,0,689585,아루바,2018-05
2018-05-31,686269,21619,664650,보츠와나,2018-05
2018-05-31,681972,3444,678528,몰디브,2018-05
2018-05-31,603529,125376,478153,마세도니아,2018-05
2018-05-31,509103,827780,-318677,몰도바,2018-05
2018-05-31,506942,1058581,-551639,베네주엘라,2018-05
2018-05-31,485887,152,485735,도미니카,2018-05
2018-05-31,452551,871,451680,챠드,2018-05
2018-05-31,446269,55767,390502,바베이도스,2018-05
2018-05-31,429451,0,429451,큐라소,2018-05
2018-05-31,414083,19,414064,영령 캐이맨 군도,2018-05
2018-05-31,396817,1250675,-853858,바누아투,2018-05
2018-05-31,387869,24629,363240,말라위,2018-05
2018-05-31,365369,148380,216989,안티가 바부다,2018-05
2018-05-31,352880,0,352880,마티니크,2018-05
2018-05-31,337285,1811677,-1474392,보스니아-헤르체고비나,2018-05
2018-05-31,331279,30112,301167,마샬군도,2018-05
2018-05-31,328306,18,328288,영령 버진군도,2018-05
2018-05-31,322525,0,322525,불령 가이아나,2018-05
2018-05-31,321899,455955,-134056,아메리칸 사모아,2018-05
2018-05-31,308738,1057315,-748577,솔로몬 군도,2018-05
2018-05-31,270800,551239,-280439,스와질랜드,2018-05
2018-05-31,258448,418,258030,니제르,2018-05
2018-05-31,204784,0,204784,그레나다,2018-05
2018-05-31,200709,1248,199461,부탄,2018-05
2018-05-31,163818,28723,135095,티모르,2018-05
2018-05-31,155487,1748,153739,지브랄타,2018-05
2018-05-31,149275,27508,121767,세인트 루시아,2018-05
2018-05-31,148077,0,148077,세인트 빈센트 그레나딘,2018-05
2018-05-31,143375,13,143362,투르크 & 카이코스 군도,2018-05
2018-05-31,121820,228,121592,네덜란드 열도,2018-05
2018-05-31,106174,2426612,-2320438,나미비아,2018-05
2018-05-31,80137,21,80116,카보 베르데,2018-05
2018-05-31,68923,76309,-7386,모나코,2018-05
2018-05-31,63980,0,63980,상토메 프린스페,2018-05
2018-05-31,47854,253665,-205811,기네비소,2018-05
2018-05-31,41172,54816,-13644,코모로스,2018-05
2018-05-31,20666,46726,-26060,통가,2018-05
2018-05-31,15509,0,15509,세인트 바르탤르미,2018-05
2018-05-31,14135,0,14135,메요트,2018-05
2018-05-31,12314,0,12314,왈라스 & 퓨투나 군도,2018-05
2018-05-31,8840,11360,-2520,안도라,2018-05
2018-05-31,6765,41,6724,레소토,2018-05
2018-05-31,6005,0,6005,앙귈라,2018-05
2018-05-31,5760,21854,-16094,산마리노,2018-05
2018-05-31,4039,0,4039,교황청,2018-05
2018-05-31,3830,3138,692,미령 버진군도,2018-05
2018-05-31,3708,0,3708,안타티카,2018-05
2018-05-31,3125,12811,-9686,남수단,2018-05
2018-05-31,2883,73270,-70387,쿡 아일랜드,2018-05
2018-05-31,2248,89406,-87158,부룬디,2018-05
2018-05-31,1925,174160,-172235,포클랜드 군도,2018-05
2018-05-31,1768,40851437,-40849669,적도 기니,2018-05
2018-05-31,1225,31080,-29855,파로에 군도,2018-05
2018-05-31,777,16800,-16023,그린랜드,2018-05
2018-05-31,755,227675,-226920,중앙아프리카공화국,2018-05
2018-05-31,0,4974,-4974,니우에,2018-05
2018-05-31,0,19,-19,허드 앤 맥도날드 군도,2018-05
2018-05-31,0,10583980,-10583980,에리트리아,2018-05
2018-05-31,0,997,-997,몬트세라트,2018-05
2018-05-31,0,228,-228,맨섬,2018-05
2018-05-31,0,17,-17,토켈라우,2018-05
2018-06-30,13814240920,8713018133,5101222787,중국,2018-06
2018-06-30,6421517754,4788171096,1633346658,미국,2018-06
2018-06-30,4363034750,151253298,4211781452,홍콩,2018-06
2018-06-30,3934797470,1533169765,2401627705,베트남,2018-06
2018-06-30,2578912716,4450259265,-1871346549,일본,2018-06
2018-06-30,1631558033,1345607097,285950936,대만,2018-06
2018-06-30,1367431156,457317383,910113773,인도,2018-06
2018-06-30,967830498,500886081,466944417,멕시코,2018-06
2018-06-30,957240376,1651996863,-694756487,호주,2018-06
2018-06-30,947827397,248459064,699368333,필리핀,2018-06
2018-06-30,832284636,1852044826,-1019760190,독일,2018-06
2018-06-30,800640555,869205211,-68564656,말레이시아,2018-06
2018-06-30,756103708,580021786,176081922,싱가포르,2018-06
2018-06-30,676062335,521714035,154348300,태국,2018-06
2018-06-30,672775825,990608613,-317832788,인도네시아,2018-06
2018-06-30,628620824,1309118466,-680497642,러시아 연방,2018-06
2018-06-30,545212151,113241883,431970268,튀르키예,2018-06
2018-06-30,514622006,442705100,71916906,캐나다,2018-06
2018-06-30,469450427,5546,469444881,마샬군도,2018-06
2018-06-30,441582569,544035019,-102452450,영국,2018-06
2018-06-30,410755731,595100455,-184344724,네덜란드,2018-06
2018-06-30,396582356,354754376,41827980,브라질,2018-06
2018-06-30,390848788,931566197,-540717409,아랍에미리트 연합,2018-06
2018-06-30,360962331,513335523,-152373192,이탈리아,2018-06
2018-06-30,328686883,48553269,280133614,폴란드,2018-06
2018-06-30,318111055,417389310,-99278255,이란,2018-06
2018-06-30,255833776,2697138880,-2441305104,사우디아라비아,2018-06
2018-06-30,247494719,465841768,-218347049,프랑스,2018-06
2018-06-30,240067837,18889325,221178512,슬로바키아,2018-06
2018-06-30,239176840,98344368,140832472,벨기에,2018-06
2018-06-30,229804188,63706342,166097846,그리스,2018-06
2018-06-30,226528884,134526936,92001948,스페인,2018-06
2018-06-30,197414227,67864343,129549884,체코공화국,2018-06
2018-06-30,194846544,22176,194824368,바하마,2018-06
2018-06-30,183935917,983366151,-799430234,이라크,2018-06
2018-06-30,140013127,114178959,25834168,뉴질랜드,2018-06
2018-06-30,139161370,412188096,-273026726,칠레,2018-06
2018-06-30,136532915,2865436,133667479,우즈베키스탄,2018-06
2018-06-30,135268611,8605095,126663516,슬로베니아,2018-06
2018-06-30,134882841,1291340,133591501,파나마,2018-06
2018-06-30,131079628,5523565,125556063,이집트,2018-06
2018-06-30,125640871,4457212,121183659,토고,2018-06
2018-06-30,124963520,437661,124525859,라이베리아,2018-06
2018-06-30,119880396,84938792,34941604,이스라엘,2018-06
2018-06-30,119038419,61612138,57426281,헝가리,2018-06
2018-06-30,98056227,954100701,-856044474,쿠웨이트,2018-06
2018-06-30,91812115,24266402,67545713,방글라데시,2018-06
2018-06-30,88232693,154698019,-66465326,오스트리아,2018-06
2018-06-30,87183173,151797374,-64614201,나이지리아,2018-06
2018-06-30,85506730,108349714,-22842984,알제리,2018-06
2018-06-30,82177244,46831563,35345681,파키스탄,2018-06
2018-06-30,81736497,212605734,-130869237,남아프리카공화국,2018-06
2018-06-30,75272406,93379746,-18107340,아일랜드,2018-06
2018-06-30,71662417,143237468,-71575051,스웨덴,2018-06
2018-06-30,67750400,258652223,-190901823,페루,2018-06
2018-06-30,67329995,72151520,-4821525,콜롬비아,2018-06
2018-06-30,54587698,26090204,28497494,캄보디아,2018-06
2018-06-30,51913417,8790770,43122647,에쿠아도르,2018-06
2018-06-30,47437823,97124426,-49686603,카자흐스탄,2018-06
2018-06-30,46751446,237739545,-190988099,오만,2018-06
2018-06-30,46685126,268271779,-221586653,스위스,2018-06
2018-06-30,46559598,159661597,-113101999,노르웨이,2018-06
2018-06-30,45327798,27715083,17612715,포루투갈,2018-06
2018-06-30,42413010,32426028,9986982,미얀마,2018-06
2018-06-30,41166773,57254971,-16088198,덴마크,2018-06
2018-06-30,38609495,2525882,36083613,요르단,2018-06
2018-06-30,36259878,21862983,14396895,아르헨티나,2018-06
2018-06-30,35142289,30312021,4830268,루마니아,2018-06
2018-06-30,33610877,147786,33463091,리비아,2018-06
2018-06-30,32758893,56428222,-23669329,우크라이나,2018-06
2018-06-30,31404544,1648840547,-1617436003,카타르,2018-06
2018-06-30,30636809,943011,29693798,몽골,2018-06
2018-06-30,28254869,337241,27917628,피지,2018-06
2018-06-30,28103276,82730125,-54626849,핀란드,2018-06
2018-06-30,26728914,8884328,17844586,스리랑카,2018-06
2018-06-30,24726202,11927631,12798571,도미니카 공화국,2018-06
2018-06-30,24320232,236756,24083476,괌,2018-06
2018-06-30,24088305,5575894,18512411,케냐,2018-06
2018-06-30,21515603,1934215,19581388,가나,2018-06
2018-06-30,20602980,5725902,14877078,과테말라,2018-06
2018-06-30,20050902,8919220,11131682,모로코,2018-06
2018-06-30,16648748,284328,16364420,파라과이,2018-06
2018-06-30,16379514,8882074,7497440,불가리아,2018-06
2018-06-30,16296530,1097591,15198939,레바논,2018-06
2018-06-30,15936333,3764597,12171736,튀니지,2018-06
2018-06-30,15698056,6827981,8870075,리투아니아,2018-06
2018-06-30,15560489,23506566,-7946077,푸에르토리코,2018-06
2018-06-30,13912024,8743765,5168259,코스타리카,2018-06
2018-06-30,12369285,279547,12089738,코트디봐르,2018-06
2018-06-30,11966385,2388084,9578301,라오스,2018-06
2018-06-30,11584775,3730,11581045,시리아,2018-06
2018-06-30,11532666,2297687,9234979,엘살바도르,2018-06
2018-06-30,11068106,10738483,329623,우루과이,2018-06
2018-06-30,10746014,5202185,5543829,세르비아,2018-06
2018-06-30,10708422,78040866,-67332444,바레인,2018-06
2018-06-30,8788537,5642368,3146169,온두라스,2018-06
2018-06-30,8774762,2717889,6056873,탄자니아,2018-06
2018-06-30,8737540,1230289,7507251,크로아티아,2018-06
2018-06-30,7983853,2188415,5795438,니카라과,2018-06
2018-06-30,7887026,6413097,1473929,에스토니아,2018-06
2018-06-30,7655695,165266,7490429,아이티,2018-06
2018-06-30,7153999,19810320,-12656321,트리니다드 토바고,2018-06
2018-06-30,7127941,4531293,2596648,에티오피아,2018-06
2018-06-30,6781038,1427,6779611,아프카니스탄,2018-06
2018-06-30,6485933,959,6484974,말리,2018-06
2018-06-30,6021750,6209,6015541,쿠바,2018-06
2018-06-30,5877207,41083,5836124,키르기스스탄,2018-06
2018-06-30,5541252,1295040,4246212,조지아,2018-06
2018-06-30,5512495,74684291,-69171796,볼리비아,2018-06
2018-06-30,5475288,8037576,-2562288,세네갈,2018-06
2018-06-30,5398321,7604499,-2206178,라트비아,2018-06
2018-06-30,5120407,43316584,-38196177,콩고민주공화국,2018-06
2018-06-30,4675851,3564424,1111427,예맨,2018-06
2018-06-30,4540036,88206841,-83666805,파푸아 뉴기니,2018-06
2018-06-30,4536824,1183042,3353782,수단,2018-06
2018-06-30,4375875,62363,4313512,아제르바이잔,2018-06
2018-06-30,4216826,5661222,-1444396,베닝,2018-06
2018-06-30,4172243,89671350,-85499107,브루나이,2018-06
2018-06-30,4158035,3519278,638757,몰타,2018-06
2018-06-30,4060480,813,4059667,팔라우,2018-06
2018-06-30,4039378,537886,3501492,모리셔스,2018-06
2018-06-30,3893931,20806,3873125,불령 폴리네시아,2018-06
2018-06-30,3612828,878946,2733882,마카오,2018-06
2018-06-30,3577164,0,3577164,지부티,2018-06
2018-06-30,3508648,319016,3189632,팔레스타인 해방기구,2018-06
2018-06-30,3478178,10784742,-7306564,모잠비크,2018-06
2018-06-30,3383153,77524,3305629,사모아,2018-06
2018-06-30,3267779,127543,3140236,네팔,2018-06
2018-06-30,3087477,10952,3076525,불령 리유니온 코모도 제도,2018-06
2018-06-30,2976590,5268184,-2291594,벨라루스,2018-06
2018-06-30,2814401,6624605,-3810204,룩셈부르그,2018-06
2018-06-30,2812987,650514,2162473,앙골라,2018-06
2018-06-30,2721718,474236,2247482,자마이카,2018-06
2018-06-30,2697136,11204629,-8507493,마다카스카르,2018-06
2018-06-30,2618412,4468952,-1850540,기니,2018-06
2018-06-30,2561362,16,2561346,가이아나,2018-06
2018-06-30,2479636,2139277,340359,아이슬란드,2018-06
2018-06-30,2468898,763975,1704923,잠비아,2018-06
2018-06-30,2376794,1224975,1151819,콩고,2018-06
2018-06-30,2216310,95131,2121179,우간다,2018-06
2018-06-30,2004518,145472,1859046,말라위,2018-06
2018-06-30,1956200,399254,1556946,카메룬,2018-06
2018-06-30,1913459,291421,1622038,짐바브웨,2018-06
2018-06-30,1831224,101967585,-100136361,가봉,2018-06
2018-06-30,1765727,515664,1250063,사이프러스,2018-06
2018-06-30,1736542,246895,1489647,소말리아,2018-06
2018-06-30,1701404,0,1701404,타지크,2018-06
2018-06-30,1677486,498272,1179214,몰도바,2018-06
2018-06-30,1673860,1078,1672782,투르크멘,2018-06
2018-06-30,1628471,33089243,-31460772,뉴 칼레도니아,2018-06
2018-06-30,1616239,94689,1521550,부르키나 파소,2018-06
2018-06-30,1535262,484749,1050513,세이쉘,2018-06
2018-06-30,1506395,165136,1341259,키리바티,2018-06
2018-06-30,1491927,51562,1440365,벨리제,2018-06
2018-06-30,1397912,0,1397912,세인트 마틴,2018-06
2018-06-30,1382957,384425,998532,마세도니아,2018-06
2018-06-30,1350440,30,1350410,아루바,2018-06
2018-06-30,1288796,10641,1278155,바베이도스,2018-06
2018-06-30,1260189,212307,1047882,알바니아,2018-06
2018-06-30,1257369,445,1256924,마이크로네시아,2018-06
2018-06-30,1244463,0,1244463,버뮤다,2018-06
2018-06-30,1128063,1229462,-101399,베네주엘라,2018-06
2018-06-30,1061538,102852080,-101790542,기타국,2018-06
2018-06-30,1054001,144165,909836,르완다,2018-06
2018-06-30,876283,0,876283,마티니크,2018-06
2018-06-30,831671,346163,485508,수리남,2018-06
2018-06-30,807068,172076,634992,북마리아나 군도,2018-06
2018-06-30,771749,757393,14356,리히텐슈타인,2018-06
2018-06-30,704315,1680071,-975756,모리타니,2018-06
2018-06-30,669082,686,668396,아메리칸 사모아,2018-06
2018-06-30,571088,325961,245127,솔로몬 군도,2018-06
2018-06-30,563495,0,563495,네덜란드 열도,2018-06
2018-06-30,538045,6379,531666,부룬디,2018-06
2018-06-30,526719,134,526585,도미니카,2018-06
2018-06-30,515935,1666,514269,니제르,2018-06
2018-06-30,514799,416187,98612,바누아투,2018-06
2018-06-30,510330,38606,471724,보츠와나,2018-06
2018-06-30,467069,0,467069,과델로프,2018-06
2018-06-30,463169,984452,-521283,나미비아,2018-06
2018-06-30,447355,261632,185723,아르메니아,2018-06
2018-06-30,418295,319,417976,영령 캐이맨 군도,2018-06
2018-06-30,417681,77391,340290,안티가 바부다,2018-06
2018-06-30,391183,0,391183,몰디브,2018-06
2018-06-30,382326,31568,350758,몬테네그로,2018-06
2018-06-30,355886,0,355886,영령 버진군도,2018-06
2018-06-30,353418,1990492,-1637074,보스니아-헤르체고비나,2018-06
2018-06-30,323532,818,322714,티모르,2018-06
2018-06-30,315135,192,314943,큐라소,2018-06
2018-06-30,301054,0,301054,세인트 루시아,2018-06
2018-06-30,294286,0,294286,불령 가이아나,2018-06
2018-06-30,252260,0,252260,그레나다,2018-06
2018-06-30,232468,25154,207314,챠드,2018-06
2018-06-30,225213,1401203,-1175990,시에라 리온,2018-06
2018-06-30,140373,0,140373,파로에 군도,2018-06
2018-06-30,134234,365,133869,지브랄타,2018-06
2018-06-30,126665,1240493,-1113828,감비아,2018-06
2018-06-30,121534,416,121118,세인트 바르탤르미,2018-06
2018-06-30,121413,2388865,-2267452,스와질랜드,2018-06
2018-06-30,117090,10793,106297,세인트 빈센트 그레나딘,2018-06
2018-06-30,106837,55,106782,코모로스,2018-06
2018-06-30,63439,0,63439,에리트리아,2018-06
2018-06-30,59076,5853,53223,세인트 키츠 네비스,2018-06
2018-06-30,37696,4844,32852,카보 베르데,2018-06
2018-06-30,36025,0,36025,투발루,2018-06
2018-06-30,22483,7585,14898,미령 버진군도,2018-06
2018-06-30,15369,3106833,-3091464,나우루,2018-06
2018-06-30,14849,0,14849,적도 기니,2018-06
2018-06-30,13266,0,13266,왈라스 & 퓨투나 군도,2018-06
2018-06-30,11744,73,11671,투르크 & 카이코스 군도,2018-06
2018-06-30,10847,31246,-20399,부탄,2018-06
2018-06-30,10202,157405,-147203,산마리노,2018-06
2018-06-30,5755,360269,-354514,모나코,2018-06
2018-06-30,3185,136482,-133297,안도라,2018-06
2018-06-30,2427,236,2191,앙귈라,2018-06
2018-06-30,1381,59189,-57808,쿡 아일랜드,2018-06
2018-06-30,119,0,119,저어지,2018-06
2018-06-30,80,16154,-16074,통가,2018-06
2018-06-30,12,70943,-70931,그린랜드,2018-06
2018-06-30,0,1578,-1578,니우에,2018-06
2018-06-30,0,29,-29,건지,2018-06
2018-06-30,0,9206,-9206,불령 남부지역,2018-06
2018-06-30,0,223021,-223021,기네비소,2018-06
2018-06-30,0,2008,-2008,남수단,2018-06
2018-06-30,0,185,-185,마이너 아우틀링 합중국 군도,2018-06
2018-06-30,0,133492,-133492,코스 군도,2018-06
2018-06-30,0,245,-245,노폴크 아일랜드,2018-06
2018-06-30,0,361,-361,보네르 신트외스타티위스,2018-06
2018-06-30,0,174124,-174124,중앙아프리카공화국,2018-06
2018-06-30,0,384,-384,레소토,2018-06
2018-06-30,0,1578149,-1578149,안타티카,2018-06
2018-06-30,0,41494,-41494,몬트세라트,2018-06
2018-07-31,13721233127,8869277702,4851955425,중국,2018-07
2018-07-31,6151681428,4904394218,1247287210,미국,2018-07
2018-07-31,4150645518,140124404,4010521114,홍콩,2018-07
2018-07-31,3915009646,1665902616,2249107030,베트남,2018-07
2018-07-31,2542258168,4585405682,-2043147514,일본,2018-07
2018-07-31,1860747598,1450008626,410738972,대만,2018-07
2018-07-31,1482487152,542663754,939823398,인도,2018-07
2018-07-31,1130467918,541125816,589342102,멕시코,2018-07
2018-07-31,1022763807,633618956,389144851,싱가포르,2018-07
2018-07-31,985977043,336467178,649509865,필리핀,2018-07
2018-07-31,846915890,707520850,139395040,아랍에미리트 연합,2018-07
2018-07-31,840018976,1505767297,-665748321,호주,2018-07
2018-07-31,798129067,1712708714,-914579647,독일,2018-07
2018-07-31,736486639,484899480,251587159,태국,2018-07
2018-07-31,724815173,794767461,-69952288,말레이시아,2018-07
2018-07-31,694610720,919182686,-224571966,인도네시아,2018-07
2018-07-31,641263405,1686156680,-1044893275,러시아 연방,2018-07
2018-07-31,531491341,340387068,191104273,네덜란드,2018-07
2018-07-31,496847533,474477565,22369968,캐나다,2018-07
2018-07-31,477113819,109370693,367743126,튀르키예,2018-07
2018-07-31,440783637,541092957,-100309320,영국,2018-07
2018-07-31,393802965,58930518,334872447,폴란드,2018-07
2018-07-31,383693439,544579524,-160886085,이탈리아,2018-07
2018-07-31,370624872,350405208,20219664,브라질,2018-07
2018-07-31,350863256,204536774,146326482,벨기에,2018-07
2018-07-31,318546169,25910,318520259,바하마,2018-07
2018-07-31,270099463,481617991,-211518528,프랑스,2018-07
2018-07-31,268449134,9894718,258554416,파나마,2018-07
2018-07-31,234826039,16026650,218799389,슬로바키아,2018-07
2018-07-31,232072288,2153210814,-1921138526,사우디아라비아,2018-07
2018-07-31,231745570,490681014,-258935444,이란,2018-07
2018-07-31,229191335,188204742,40986593,스페인,2018-07
2018-07-31,212466255,426174,212040081,라이베리아,2018-07
2018-07-31,209034297,84226724,124807573,체코공화국,2018-07
2018-07-31,205799890,30689545,175110345,이집트,2018-07
2018-07-31,174189097,2210235,171978862,우즈베키스탄,2018-07
2018-07-31,166216377,354694182,-188477805,칠레,2018-07
2018-07-31,164282386,7674300,156608086,슬로베니아,2018-07
2018-07-31,150415628,174772012,-24356384,카자흐스탄,2018-07
2018-07-31,138918266,50478189,88440077,헝가리,2018-07
2018-07-31,129991964,875361352,-745369388,이라크,2018-07
2018-07-31,127982250,2535202,125447048,토고,2018-07
2018-07-31,119499677,1131000066,-1011500389,쿠웨이트,2018-07
2018-07-31,106281588,109963909,-3682321,이스라엘,2018-07
2018-07-31,106198660,120697162,-14498502,뉴질랜드,2018-07
2018-07-31,101817337,165445042,-63627705,남아프리카공화국,2018-07
2018-07-31,100181624,25623119,74558505,방글라데시,2018-07
2018-07-31,96105792,165128827,-69023035,알제리,2018-07
2018-07-31,94411522,22023334,72388188,파키스탄,2018-07
2018-07-31,92197450,172400583,-80203133,오스트리아,2018-07
2018-07-31,86377150,135967223,-49590073,스웨덴,2018-07
2018-07-31,81767910,163653795,-81885885,노르웨이,2018-07
2018-07-31,74991895,151137598,-76145703,나이지리아,2018-07
2018-07-31,71037369,191944833,-120907464,오만,2018-07
2018-07-31,66354035,8985965,57368070,에쿠아도르,2018-07
2018-07-31,65680734,83923994,-18243260,콜롬비아,2018-07
2018-07-31,61834779,30520043,31314736,캄보디아,2018-07
2018-07-31,60434358,246109320,-185674962,페루,2018-07
2018-07-31,56749965,247,56749718,영령 캐이맨 군도,2018-07
2018-07-31,45739223,27425275,18313948,포루투갈,2018-07
2018-07-31,44172505,1300511585,-1256339080,카타르,2018-07
2018-07-31,43749599,42437874,1311725,미얀마,2018-07
2018-07-31,41301823,1557879,39743944,요르단,2018-07
2018-07-31,39128876,28754599,10374277,루마니아,2018-07
2018-07-31,36951615,37793005,-841390,리비아,2018-07
2018-07-31,36231543,21242751,14988792,아르헨티나,2018-07
2018-07-31,36017009,281116659,-245099650,스위스,2018-07
2018-07-31,32755090,81636456,-48881366,마샬군도,2018-07
2018-07-31,31967221,91473084,-59505863,아일랜드,2018-07
2018-07-31,31811102,70651956,-38840854,덴마크,2018-07
2018-07-31,28566041,24078104,4487937,우크라이나,2018-07
2018-07-31,28558420,7891669,20666751,리투아니아,2018-07
2018-07-31,26441413,3523259,22918154,크로아티아,2018-07
2018-07-31,26318495,623690,25694805,피지,2018-07
2018-07-31,25795504,2548462,23247042,몽골,2018-07
2018-07-31,24832274,7670241,17162033,스리랑카,2018-07
2018-07-31,23107823,14990408,8117415,모로코,2018-07
2018-07-31,22569508,7189477,15380031,과테말라,2018-07
2018-07-31,22022387,168158,21854229,괌,2018-07
2018-07-31,21937471,14934675,7002796,도미니카 공화국,2018-07
2018-07-31,21848728,48778052,-26929324,그리스,2018-07
2018-07-31,20321838,5109700,15212138,케냐,2018-07
2018-07-31,19694261,115980172,-96285911,핀란드,2018-07
2018-07-31,18072048,3125476,14946572,가나,2018-07
2018-07-31,17426726,868637,16558089,모리셔스,2018-07
2018-07-31,16048877,3024264,13024613,엘살바도르,2018-07
2018-07-31,15522716,14735855,786861,불가리아,2018-07
2018-07-31,13858901,909,13857992,시리아,2018-07
2018-07-31,13596409,1212894,12383515,탄자니아,2018-07
2018-07-31,13530499,2591798,10938701,레바논,2018-07
2018-07-31,13161172,348371,12812801,파라과이,2018-07
2018-07-31,12836902,2842624,9994278,세르비아,2018-07
2018-07-31,11596130,15037427,-3441297,바레인,2018-07
2018-07-31,11580621,4152232,7428389,튀니지,2018-07
2018-07-31,11288493,41542717,-30254224,수단,2018-07
2018-07-31,11088690,3980353,7108337,온두라스,2018-07
2018-07-31,10716324,13663490,-2947166,푸에르토리코,2018-07
2018-07-31,10129138,9928468,200670,코스타리카,2018-07
2018-07-31,9988795,31999323,-22010528,트리니다드 토바고,2018-07
2018-07-31,9520163,5132072,4388091,에티오피아,2018-07
2018-07-31,9374718,8431,9366287,아프카니스탄,2018-07
2018-07-31,8846386,7599938,1246448,에스토니아,2018-07
2018-07-31,8763809,447569,8316240,코트디봐르,2018-07
2018-07-31,8533429,11308075,-2774646,우루과이,2018-07
2018-07-31,8295960,7489458,806502,라트비아,2018-07
2018-07-31,7950567,29397757,-21447190,모잠비크,2018-07
2018-07-31,7936422,2273785,5662637,라오스,2018-07
2018-07-31,7798494,181530675,-173732181,기타국,2018-07
2018-07-31,7632750,5736355,1896395,세네갈,2018-07
2018-07-31,7311274,274792,7036482,앙골라,2018-07
2018-07-31,7281640,5200679,2080961,예맨,2018-07
2018-07-31,7227229,2697804,4529425,조지아,2018-07
2018-07-31,7191516,222695,6968821,아이티,2018-07
2018-07-31,7112738,556,7112182,키르기스스탄,2018-07
2018-07-31,5147359,0,5147359,카보 베르데,2018-07
2018-07-31,4936868,104169,4832699,팔레스타인 해방기구,2018-07
2018-07-31,4921525,0,4921525,지부티,2018-07
2018-07-31,4638357,42477601,-37839244,볼리비아,2018-07
2018-07-31,4616748,0,4616748,불령 리유니온 코모도 제도,2018-07
2018-07-31,4569037,52501683,-47932646,콩고민주공화국,2018-07
2018-07-31,4561583,1279759,3281824,니카라과,2018-07
2018-07-31,4453422,204633,4248789,아제르바이잔,2018-07
2018-07-31,4441047,3609237,831810,몰타,2018-07
2018-07-31,4417838,676344,3741494,자마이카,2018-07
2018-07-31,3789240,21303108,-17513868,파푸아 뉴기니,2018-07
2018-07-31,3584289,90849992,-87265703,브루나이,2018-07
2018-07-31,3531534,135583,3395951,마카오,2018-07
2018-07-31,3329615,197114,3132501,쿠바,2018-07
2018-07-31,3302264,3267,3298997,부르키나 파소,2018-07
2018-07-31,3204523,94313,3110210,네팔,2018-07
2018-07-31,3126975,58846,3068129,불령 폴리네시아,2018-07
2018-07-31,2976835,11488671,-8511836,마다카스카르,2018-07
2018-07-31,2875606,17,2875589,세인트 마틴,2018-07
2018-07-31,2781920,4593871,-1811951,룩셈부르그,2018-07
2018-07-31,2743623,24897,2718726,과델로프,2018-07
2018-07-31,2394187,4353053,-1958866,잠비아,2018-07
2018-07-31,2377253,4515732,-2138479,벨라루스,2018-07
2018-07-31,2372097,6004,2366093,투르크멘,2018-07
2018-07-31,2335702,543690,1792012,콩고,2018-07
2018-07-31,2329981,97058,2232923,사모아,2018-07
2018-07-31,2175283,98019,2077264,바누아투,2018-07
2018-07-31,2049364,20286985,-18237621,사이프러스,2018-07
2018-07-31,2024574,0,2024574,타지크,2018-07
2018-07-31,1953361,3974972,-2021611,기니,2018-07
2018-07-31,1883948,44700,1839248,가이아나,2018-07
2018-07-31,1789176,889848,899328,모리타니,2018-07
2018-07-31,1783681,92699,1690982,마이크로네시아,2018-07
2018-07-31,1744190,294893,1449297,카메룬,2018-07
2018-07-31,1729811,302074,1427737,키리바티,2018-07
2018-07-31,1625711,1303436,322275,몰도바,2018-07
2018-07-31,1579293,192583,1386710,알바니아,2018-07
2018-07-31,1572793,0,1572793,말리,2018-07
2018-07-31,1515041,28537192,-27022151,뉴 칼레도니아,2018-07
2018-07-31,1495610,862222,633388,우간다,2018-07
2018-07-31,1471850,1356620,115230,시에라 리온,2018-07
2018-07-31,1357655,1006317,351338,수리남,2018-07
2018-07-31,1244906,2022548,-777642,스와질랜드,2018-07
2018-07-31,1234637,1745776,-511139,베네주엘라,2018-07
2018-07-31,1221854,84481,1137373,세이쉘,2018-07
2018-07-31,1212409,362439,849970,소말리아,2018-07
2018-07-31,1203328,737064,466264,아이슬란드,2018-07
2018-07-31,1177072,143241,1033831,북마리아나 군도,2018-07
2018-07-31,1129457,159108,970349,마세도니아,2018-07
2018-07-31,1106113,14148,1091965,아루바,2018-07
2018-07-31,1087319,132441,954878,짐바브웨,2018-07
2018-07-31,1036395,444426,591969,르완다,2018-07
2018-07-31,1028188,26944,1001244,마티니크,2018-07
2018-07-31,1002588,3657,998931,세인트 키츠 네비스,2018-07
2018-07-31,988233,1013,987220,버뮤다,2018-07
2018-07-31,967425,17743,949682,바베이도스,2018-07
2018-07-31,942969,0,942969,몰디브,2018-07
2018-07-31,928160,0,928160,큐라소,2018-07
2018-07-31,902228,4779099,-3876871,베닝,2018-07
2018-07-31,749724,831668,-81944,리히텐슈타인,2018-07
2018-07-31,690847,32957,657890,아메리칸 사모아,2018-07
2018-07-31,601565,72724,528841,가봉,2018-07
2018-07-31,575876,19804,556072,말라위,2018-07
2018-07-31,575539,310497,265042,아르메니아,2018-07
2018-07-31,537500,204828,332672,나미비아,2018-07
2018-07-31,513782,751681,-237899,감비아,2018-07
2018-07-31,511438,83199,428239,안티가 바부다,2018-07
2018-07-31,460868,100,460768,팔라우,2018-07
2018-07-31,431349,989072,-557723,몬테네그로,2018-07
2018-07-31,421679,11731,409948,벨리제,2018-07
2018-07-31,421234,1464,419770,도미니카,2018-07
2018-07-31,374646,0,374646,불령 가이아나,2018-07
2018-07-31,343468,236,343232,티모르,2018-07
2018-07-31,337637,551,337086,네덜란드 열도,2018-07
2018-07-31,328583,1961793,-1633210,보스니아-헤르체고비나,2018-07
2018-07-31,322678,25300,297378,세인트 루시아,2018-07
2018-07-31,317058,28333,288725,보츠와나,2018-07
2018-07-31,302703,821811,-519108,솔로몬 군도,2018-07
2018-07-31,285185,0,285185,그레나다,2018-07
2018-07-31,275891,2099,273792,안도라,2018-07
2018-07-31,269724,31417,238307,남수단,2018-07
2018-07-31,229695,117,229578,지브랄타,2018-07
2018-07-31,114554,0,114554,영령 버진군도,2018-07
2018-07-31,79720,176,79544,투르크 & 카이코스 군도,2018-07
2018-07-31,68250,265,67985,부룬디,2018-07
2018-07-31,52729,52282,447,챠드,2018-07
2018-07-31,46571,5049,41522,부탄,2018-07
2018-07-31,40948,257766,-216818,니제르,2018-07
2018-07-31,34674,558087,-523413,중앙아프리카공화국,2018-07
2018-07-31,21235,41569,-20334,통가,2018-07
2018-07-31,14222,281,13941,건지,2018-07
2018-07-31,11269,0,11269,왈라스 & 퓨투나 군도,2018-07
2018-07-31,9412,31827,-22415,코모로스,2018-07
2018-07-31,9000,0,9000,에리트리아,2018-07
2018-07-31,3945,1612357,-1608412,남조지아 & 남샌드위치 군도,2018-07
2018-07-31,2345,0,2345,앙귈라,2018-07
2018-07-31,1400,6100,-4700,미령 버진군도,2018-07
2018-07-31,1350,78456,-77106,산마리노,2018-07
2018-07-31,261,92947,-92686,쿡 아일랜드,2018-07
2018-07-31,146,0,146,세인트 빈센트 그레나딘,2018-07
2018-07-31,82,379779,-379697,모나코,2018-07
2018-07-31,0,200,-200,맨섬,2018-07
2018-07-31,0,585,-585,마이너 아우틀링 합중국 군도,2018-07
2018-07-31,0,925,-925,코스 군도,2018-07
2018-07-31,0,401,-401,보네르 신트외스타티위스,2018-07
2018-07-31,0,928533,-928533,적도 기니,2018-07
2018-07-31,0,207,-207,세인트 바르탤르미,2018-07
2018-07-31,0,4506,-4506,토켈라우,2018-07
2018-07-31,0,200,-200,투발루,2018-07
2018-07-31,0,3640,-3640,나우루,2018-07
2018-07-31,0,465,-465,니우에,2018-07
2018-07-31,0,58,-58,세인트 헬레나,2018-07
2018-07-31,0,49013,-49013,그린랜드,2018-07
2018-07-31,0,224237,-224237,기네비소,2018-07
2018-07-31,0,12,-12,저어지,2018-07
2018-07-31,0,7206,-7206,몬트세라트,2018-07
2018-07-31,0,219,-219,메요트,2018-07
2018-08-31,14401521303,8525532265,5875989038,중국,2018-08
2018-08-31,6048101982,4832944943,1215157039,미국,2018-08
2018-08-31,4353160159,1704257804,2648902355,베트남,2018-08
2018-08-31,4076287662,162600343,3913687319,홍콩,2018-08
2018-08-31,2409639571,4232367582,-1822728011,일본,2018-08
2018-08-31,1980591002,1542037244,438553758,대만,2018-08
2018-08-31,1416876320,458817847,958058473,인도,2018-08
2018-08-31,1180707512,247836744,932870768,멕시코,2018-08
2018-08-31,1064737597,262175681,802561916,필리핀,2018-08
2018-08-31,851308628,1927225109,-1075916481,호주,2018-08
2018-08-31,770942732,581900469,189042263,싱가포르,2018-08
2018-08-31,767245371,1554593558,-787348187,독일,2018-08
2018-08-31,748614785,843580104,-94965319,말레이시아,2018-08
2018-08-31,735679081,979987939,-244308858,인도네시아,2018-08
2018-08-31,655957924,478074792,177883132,태국,2018-08
2018-08-31,586591503,892259487,-305667984,아랍에미리트 연합,2018-08
2018-08-31,586462929,1439562706,-853099777,러시아 연방,2018-08
2018-08-31,498697668,462586027,36111641,캐나다,2018-08
2018-08-31,457063694,87577816,369485878,튀르키예,2018-08
2018-08-31,451140925,827977791,-376836866,영국,2018-08
2018-08-31,405559389,371403160,34156229,브라질,2018-08
2018-08-31,392961187,56704048,336257139,폴란드,2018-08
2018-08-31,387540010,511561805,-124021795,이탈리아,2018-08
2018-08-31,318434412,492434669,-174000257,네덜란드,2018-08
2018-08-31,318113004,464227399,-146114395,프랑스,2018-08
2018-08-31,310884818,134802260,176082558,벨기에,2018-08
2018-08-31,244034450,14321459,229712991,슬로바키아,2018-08
2018-08-31,225233625,190027940,35205685,스페인,2018-08
2018-08-31,210683303,5848,210677455,바하마,2018-08
2018-08-31,207729744,2385364357,-2177634613,사우디아라비아,2018-08
2018-08-31,184392375,65007448,119384927,체코공화국,2018-08
2018-08-31,178031123,8836569,169194554,슬로베니아,2018-08
2018-08-31,171988109,1473327,170514782,우즈베키스탄,2018-08
2018-08-31,156101463,63129883,92971580,헝가리,2018-08
2018-08-31,150739011,118022238,32716773,뉴질랜드,2018-08
2018-08-31,134793424,160931883,-26138459,이란,2018-08
2018-08-31,122911502,38571478,84340024,이집트,2018-08
2018-08-31,118103808,372013735,-253909927,칠레,2018-08
2018-08-31,110052504,6513475,103539029,에쿠아도르,2018-08
2018-08-31,107907078,923353774,-815446696,이라크,2018-08
2018-08-31,104141285,1105360229,-1001218944,쿠웨이트,2018-08
2018-08-31,103915935,94553360,9362575,이스라엘,2018-08
2018-08-31,103130677,124721772,-21591095,나이지리아,2018-08
2018-08-31,102089603,148868753,-46779150,오스트리아,2018-08
2018-08-31,100151774,156364177,-56212403,남아프리카공화국,2018-08
2018-08-31,93098265,6982935,86115330,파나마,2018-08
2018-08-31,87696303,3398879,84297424,몰타,2018-08
2018-08-31,84453019,29465085,54987934,방글라데시,2018-08
2018-08-31,77701222,17926395,59774827,파키스탄,2018-08
2018-08-31,68336497,200899600,-132563103,스웨덴,2018-08
2018-08-31,65776128,149226175,-83450047,카자흐스탄,2018-08
2018-08-31,60725053,186943365,-126218312,페루,2018-08
2018-08-31,60027027,52018070,8008957,콜롬비아,2018-08
2018-08-31,58751824,356789113,-298037289,알제리,2018-08
2018-08-31,58472944,58051305,421639,마샬군도,2018-08
2018-08-31,56731433,32291920,24439513,캄보디아,2018-08
2018-08-31,55964042,250,55963792,영령 캐이맨 군도,2018-08
2018-08-31,54390063,647566,53742497,콩고,2018-08
2018-08-31,49950903,2346270,47604633,요르단,2018-08
2018-08-31,43458130,1159702454,-1116244324,카타르,2018-08
2018-08-31,42738551,31030423,11708128,루마니아,2018-08
2018-08-31,41866601,27879854,13986747,포루투갈,2018-08
2018-08-31,40903990,224503950,-183599960,오만,2018-08
2018-08-31,39249823,38576877,672946,뉴 칼레도니아,2018-08
2018-08-31,38909780,257775773,-218865993,스위스,2018-08
2018-08-31,38877986,54755575,-15877589,미얀마,2018-08
2018-08-31,36536495,104803569,-68267074,아일랜드,2018-08
2018-08-31,35792686,70795011,-35002325,덴마크,2018-08
2018-08-31,34291073,21966651,12324422,우크라이나,2018-08
2018-08-31,33988240,39820422,-5832182,리비아,2018-08
2018-08-31,33975743,178700,33797043,라이베리아,2018-08
2018-08-31,27971331,17363286,10608045,모로코,2018-08
2018-08-31,27797597,82554965,-54757368,그리스,2018-08
2018-08-31,26626261,1996434,24629827,몽골,2018-08
2018-08-31,26170950,433953,25736997,피지,2018-08
2018-08-31,25419711,6611578,18808133,탄자니아,2018-08
2018-08-31,24842386,149976347,-125133961,노르웨이,2018-08
2018-08-31,24769168,7000255,17768913,리투아니아,2018-08
2018-08-31,23848121,973445,22874676,크로아티아,2018-08
2018-08-31,23419629,14295675,9123954,도미니카 공화국,2018-08
2018-08-31,23363070,4621099,18741971,레바논,2018-08
2018-08-31,23053217,14328878,8724339,아르헨티나,2018-08
2018-08-31,22470958,8011619,14459339,스리랑카,2018-08
2018-08-31,21667515,107802012,-86134497,핀란드,2018-08
2018-08-31,21042660,6062566,14980094,과테말라,2018-08
2018-08-31,20333059,270874,20062185,괌,2018-08
2018-08-31,19941168,6755431,13185737,세르비아,2018-08
2018-08-31,18359702,4940321,13419381,케냐,2018-08
2018-08-31,16849607,17231774,-382167,푸에르토리코,2018-08
2018-08-31,16030967,2754681,13276286,가나,2018-08
2018-08-31,13448638,1816246,11632392,엘살바도르,2018-08
2018-08-31,13320850,10560808,2760042,코스타리카,2018-08
2018-08-31,11879732,213690,11666042,아제르바이잔,2018-08
2018-08-31,11864316,46961435,-35097119,바레인,2018-08
2018-08-31,11411842,4553174,6858668,튀니지,2018-08
2018-08-31,11156079,241,11155838,코트디봐르,2018-08
2018-08-31,10026809,22605163,-12578354,불가리아,2018-08
2018-08-31,9420679,10191439,-770760,우루과이,2018-08
2018-08-31,9012233,3135178,5877055,온두라스,2018-08
2018-08-31,8937191,560,8936631,시리아,2018-08
2018-08-31,8341028,1142,8339886,키르기스스탄,2018-08
2018-08-31,8318678,359275,7959403,파라과이,2018-08
2018-08-31,8276537,396,8276141,아프카니스탄,2018-08
2018-08-31,7883969,1210852,6673117,수단,2018-08
2018-08-31,7858759,170753,7688006,팔레스타인 해방기구,2018-08
2018-08-31,7850987,59215,7791772,아이티,2018-08
2018-08-31,7535214,4954096,2581118,예맨,2018-08
2018-08-31,7423898,39177483,-31753585,조지아,2018-08
2018-08-31,7028486,4835829,2192657,모잠비크,2018-08
2018-08-31,7004333,4827190,2177143,에티오피아,2018-08
2018-08-31,6804258,1098655,5705603,니카라과,2018-08
2018-08-31,6018452,6604008,-585556,에스토니아,2018-08
2018-08-31,5555946,454697,5101249,앙골라,2018-08
2018-08-31,5452570,327776173,-322323603,기타국,2018-08
2018-08-31,5446056,8593582,-3147526,세네갈,2018-08
2018-08-31,5347345,1948800,3398545,라오스,2018-08
2018-08-31,5276996,913237,4363759,브루나이,2018-08
2018-08-31,4648859,33932089,-29283230,볼리비아,2018-08
2018-08-31,4336021,3794605,541416,벨라루스,2018-08
2018-08-31,4204266,22262816,-18058550,트리니다드 토바고,2018-08
2018-08-31,4140254,6252219,-2111965,라트비아,2018-08
2018-08-31,3946247,795975,3150272,마카오,2018-08
2018-08-31,3084457,0,3084457,부르키나 파소,2018-08
2018-08-31,3076783,70523559,-67446776,콩고민주공화국,2018-08
2018-08-31,2962273,1611,2960662,말리,2018-08
2018-08-31,2934463,0,2934463,지부티,2018-08
2018-08-31,2892922,636408,2256514,모리셔스,2018-08
2018-08-31,2829084,4919204,-2090120,파푸아 뉴기니,2018-08
2018-08-31,2722837,124140,2598697,사모아,2018-08
2018-08-31,2682453,3630279,-947826,기니,2018-08
2018-08-31,2629900,1169,2628731,투르크멘,2018-08
2018-08-31,2579289,118298,2460991,자마이카,2018-08
2018-08-31,2551100,7155005,-4603905,마다카스카르,2018-08
2018-08-31,2296522,6067115,-3770593,잠비아,2018-08
2018-08-31,2289137,0,2289137,과델로프,2018-08
2018-08-31,2283999,31731,2252268,쿠바,2018-08
2018-08-31,2238733,441369,1797364,세이쉘,2018-08
2018-08-31,2161369,440980,1720389,짐바브웨,2018-08
2018-08-31,2149066,947856,1201210,아이슬란드,2018-08
2018-08-31,2086679,142,2086537,타지크,2018-08
2018-08-31,2052041,445759,1606282,우간다,2018-08
2018-08-31,2046643,188901,1857742,네팔,2018-08
2018-08-31,2008228,5175025,-3166797,베닝,2018-08
2018-08-31,1858074,180336,1677738,불령 폴리네시아,2018-08
2018-08-31,1785656,732433,1053223,소말리아,2018-08
2018-08-31,1735287,57420,1677867,불령 리유니온 코모도 제도,2018-08
2018-08-31,1730442,5433723,-3703281,룩셈부르그,2018-08
2018-08-31,1714941,719132,995809,베네주엘라,2018-08
2018-08-31,1708201,535,1707666,아루바,2018-08
2018-08-31,1676579,127,1676452,마티니크,2018-08
2018-08-31,1562689,2071850,-509161,몰도바,2018-08
2018-08-31,1504988,0,1504988,세인트 루시아,2018-08
2018-08-31,1454691,149277,1305414,카메룬,2018-08
2018-08-31,1384095,3422672,-2038577,토고,2018-08
2018-08-31,1263828,603632,660196,사이프러스,2018-08
2018-08-31,1239164,218783,1020381,북마리아나 군도,2018-08
2018-08-31,1198252,248855,949397,알바니아,2018-08
2018-08-31,1138565,24094,1114471,말라위,2018-08
2018-08-31,1035327,94091,941236,르완다,2018-08
2018-08-31,1026142,0,1026142,버뮤다,2018-08
2018-08-31,1000483,163709,836774,가이아나,2018-08
2018-08-31,935156,0,935156,가봉,2018-08
2018-08-31,840015,724330,115685,리히텐슈타인,2018-08
2018-08-31,831704,609230,222474,아르메니아,2018-08
2018-08-31,806208,1149354,-343146,시에라 리온,2018-08
2018-08-31,689017,188138,500879,수리남,2018-08
2018-08-31,640970,132379,508591,몰디브,2018-08
2018-08-31,614001,2448170,-1834169,마세도니아,2018-08
2018-08-31,593518,0,593518,큐라소,2018-08
2018-08-31,582287,326761,255526,키리바티,2018-08
2018-08-31,579740,2060331,-1480591,모리타니,2018-08
2018-08-31,574060,28946,545114,보츠와나,2018-08
2018-08-31,466926,11453,455473,바베이도스,2018-08
2018-08-31,465439,716905,-251466,마이크로네시아,2018-08
2018-08-31,464589,0,464589,세인트 마틴,2018-08
2018-08-31,457912,0,457912,불령 가이아나,2018-08
2018-08-31,453669,23613,430056,벨리제,2018-08
2018-08-31,430793,82137,348656,안티가 바부다,2018-08
2018-08-31,415915,0,415915,몬테네그로,2018-08
2018-08-31,350273,0,350273,팔라우,2018-08
2018-08-31,317303,271187,46116,아메리칸 사모아,2018-08
2018-08-31,290558,0,290558,도미니카,2018-08
2018-08-31,290022,3658,286364,티모르,2018-08
2018-08-31,289153,760,288393,부탄,2018-08
2018-08-31,263019,1189455,-926436,감비아,2018-08
2018-08-31,259306,1727494,-1468188,보스니아-헤르체고비나,2018-08
2018-08-31,256300,8569,247731,세인트 키츠 네비스,2018-08
2018-08-31,230850,284368,-53518,바누아투,2018-08
2018-08-31,200541,15476,185065,나미비아,2018-08
2018-08-31,170518,1749729,-1579211,솔로몬 군도,2018-08
2018-08-31,162288,5885131,-5722843,적도 기니,2018-08
2018-08-31,146792,391935,-245143,스와질랜드,2018-08
2018-08-31,144675,0,144675,영령 버진군도,2018-08
2018-08-31,124798,0,124798,네덜란드 열도,2018-08
2018-08-31,124092,0,124092,그레나다,2018-08
2018-08-31,102910,0,102910,지브랄타,2018-08
2018-08-31,99591,108,99483,카보 베르데,2018-08
2018-08-31,81034,225,80809,챠드,2018-08
2018-08-31,68482,14562,53920,부룬디,2018-08
2018-08-31,40966,1309,39657,세인트 빈센트 그레나딘,2018-08
2018-08-31,38944,178,38766,나우루,2018-08
2018-08-31,37545,59,37486,레소토,2018-08
2018-08-31,32181,9254,22927,미령 버진군도,2018-08
2018-08-31,23588,0,23588,투발루,2018-08
2018-08-31,22340,449,21891,투르크 & 카이코스 군도,2018-08
2018-08-31,16010,164861,-148851,기네비소,2018-08
2018-08-31,13916,4005,9911,몬트세라트,2018-08
2018-08-31,12877,1256,11621,중앙아프리카공화국,2018-08
2018-08-31,12222,1110,11112,니제르,2018-08
2018-08-31,10407,0,10407,코모로스,2018-08
2018-08-31,8262,2915,5347,안도라,2018-08
2018-08-31,6012,113434,-107422,산마리노,2018-08
2018-08-31,5276,23709,-18433,모나코,2018-08
2018-08-31,4861,0,4861,상토메 프린스페,2018-08
2018-08-31,1256,70,1186,파로에 군도,2018-08
2018-08-31,1180,40548,-39368,통가,2018-08
2018-08-31,986,267,719,앙귈라,2018-08
2018-08-31,232,0,232,세인트 바르탤르미,2018-08
2018-08-31,0,100913,-100913,쿡 아일랜드,2018-08
2018-08-31,0,1620,-1620,니우에,2018-08
2018-08-31,0,45,-45,맨섬,2018-08
2018-08-31,0,308,-308,저어지,2018-08
2018-08-31,0,73440,-73440,그린랜드,2018-08
2018-08-31,0,1188,-1188,보네르 신트외스타티위스,2018-08
2018-08-31,0,392,-392,코스 군도,2018-08
2018-08-31,0,19928689,-19928689,에리트리아,2018-08
2018-08-31,0,278,-278,보빗군도,2018-08
2018-08-31,0,294,-294,토켈라우,2018-08
2018-09-30,14590529300,7889890245,6700639055,중국,2018-09
2018-09-30,5821080858,4347494009,1473586849,미국,2018-09
2018-09-30,4903221049,164734444,4738486605,홍콩,2018-09
2018-09-30,3946877918,1627618033,2319259885,베트남,2018-09
2018-09-30,2469036724,4181051010,-1712014286,일본,2018-09
2018-09-30,2260226643,1299625059,960601584,대만,2018-09
2018-09-30,1284519710,484279825,800239885,인도,2018-09
2018-09-30,1150517126,225188173,925328953,필리핀,2018-09
2018-09-30,965686104,353602996,612083108,멕시코,2018-09
2018-09-30,786254228,604783344,181470884,싱가포르,2018-09
2018-09-30,741647601,1351501303,-609853702,독일,2018-09
2018-09-30,699934568,1075052351,-375117783,인도네시아,2018-09
2018-09-30,693399407,691178665,2220742,말레이시아,2018-09
2018-09-30,612086297,1885362276,-1273275979,호주,2018-09
2018-09-30,582355748,415187084,167168664,태국,2018-09
2018-09-30,553579842,1394096307,-840516465,러시아 연방,2018-09
2018-09-30,440786587,436961833,3824754,캐나다,2018-09
2018-09-30,425597041,60360637,365236404,폴란드,2018-09
2018-09-30,375138727,280003499,95135228,브라질,2018-09
2018-09-30,370513307,246981,370266326,라이베리아,2018-09
2018-09-30,364083827,102640152,261443675,튀르키예,2018-09
2018-09-30,337875843,501579510,-163703667,이탈리아,2018-09
2018-09-30,336040434,2128005696,-1791965262,사우디아라비아,2018-09
2018-09-30,327878947,278622103,49256844,영국,2018-09
2018-09-30,309438851,7165,309431686,마샬군도,2018-09
2018-09-30,296477101,716478263,-420001162,네덜란드,2018-09
2018-09-30,277098505,707616645,-430518140,이라크,2018-09
2018-09-30,226014483,383177743,-157163260,프랑스,2018-09
2018-09-30,222555432,170557502,51997930,스페인,2018-09
2018-09-30,220324838,938369844,-718045006,아랍에미리트 연합,2018-09
2018-09-30,214739365,1829504,212909861,우즈베키스탄,2018-09
2018-09-30,208403627,81611463,126792164,벨기에,2018-09
2018-09-30,198257142,15035874,183221268,슬로바키아,2018-09
2018-09-30,193971304,63161325,130809979,체코공화국,2018-09
2018-09-30,172444404,8431504,164012900,슬로베니아,2018-09
2018-09-30,147987172,230135936,-82148764,칠레,2018-09
2018-09-30,139701794,99721997,39979797,헝가리,2018-09
2018-09-30,139180492,47337489,91843003,이집트,2018-09
2018-09-30,130473169,92547488,37925681,뉴질랜드,2018-09
2018-09-30,107317243,5619464,101697779,이란,2018-09
2018-09-30,100024057,104466408,-4442351,오스트리아,2018-09
2018-09-30,88357367,42026502,46330865,나이지리아,2018-09
2018-09-30,85506968,60141521,25365447,이스라엘,2018-09
2018-09-30,81920429,21869,81898560,바하마,2018-09
2018-09-30,78806212,136309378,-57503166,남아프리카공화국,2018-09
2018-09-30,75614919,14816761,60798158,파키스탄,2018-09
2018-09-30,73940359,33750333,40190026,방글라데시,2018-09
2018-09-30,70521009,1284203872,-1213682863,쿠웨이트,2018-09
2018-09-30,65885611,45141197,20744414,콜롬비아,2018-09
2018-09-30,65373390,93928888,-28555498,아일랜드,2018-09
2018-09-30,64022032,125700992,-61678960,스웨덴,2018-09
2018-09-30,61419824,10111297,51308527,에쿠아도르,2018-09
2018-09-30,58045025,166298531,-108253506,페루,2018-09
2018-09-30,57821189,4591039,53230150,파나마,2018-09
2018-09-30,57631314,83959972,-26328658,알제리,2018-09
2018-09-30,55928281,28737106,27191175,캄보디아,2018-09
2018-09-30,53471552,183044,53288508,탄자니아,2018-09
2018-09-30,51706109,141997,51564112,사이프러스,2018-09
2018-09-30,47097630,99705727,-52608097,카자흐스탄,2018-09
2018-09-30,45896669,19664964,26231705,포루투갈,2018-09
2018-09-30,42073063,232433917,-190360854,스위스,2018-09
2018-09-30,41274213,242031739,-200757526,오만,2018-09
2018-09-30,38473758,3267342,35206416,케냐,2018-09
2018-09-30,35066133,66640179,-31574046,미얀마,2018-09
2018-09-30,34588519,32958019,1630500,루마니아,2018-09
2018-09-30,33008434,48285360,-15276926,덴마크,2018-09
2018-09-30,31539643,5691561,25848082,리투아니아,2018-09
2018-09-30,31084073,3853393,27230680,요르단,2018-09
2018-09-30,29408229,318169,29090060,리비아,2018-09
2018-09-30,29392043,125916620,-96524577,노르웨이,2018-09
2018-09-30,28299736,21833681,6466055,아르헨티나,2018-09
2018-09-30,28025272,6631488,21393784,스리랑카,2018-09
2018-09-30,27801754,1552030305,-1524228551,카타르,2018-09
2018-09-30,27039335,27488753,-449418,우크라이나,2018-09
2018-09-30,26830463,305159,26525304,괌,2018-09
2018-09-30,26742351,13908958,12833393,푸에르토리코,2018-09
2018-09-30,22472897,3149686,19323211,몽골,2018-09
2018-09-30,22198525,8344857,13853668,모로코,2018-09
2018-09-30,21302226,50947602,-29645376,그리스,2018-09
2018-09-30,20305251,62097562,-41792311,핀란드,2018-09
2018-09-30,19306532,11026095,8280437,도미니카 공화국,2018-09
2018-09-30,16592727,15911092,681635,뉴 칼레도니아,2018-09
2018-09-30,16408111,5727589,10680522,과테말라,2018-09
2018-09-30,15288810,53685299,-38396489,바레인,2018-09
2018-09-30,14840533,3551416,11289117,가나,2018-09
2018-09-30,14065630,1845748,12219882,엘살바도르,2018-09
2018-09-30,14016906,12048721,1968185,불가리아,2018-09
2018-09-30,13462908,210083,13252825,피지,2018-09
2018-09-30,13435539,10205864,3229675,코스타리카,2018-09
2018-09-30,12997552,4178156,8819396,레바논,2018-09
2018-09-30,12214693,846477,11368216,크로아티아,2018-09
2018-09-30,12005065,36208,11968857,파라과이,2018-09
2018-09-30,11835594,5051064,6784530,에티오피아,2018-09
2018-09-30,10379887,12806463,-2426576,우루과이,2018-09
2018-09-30,10359579,2158903,8200676,온두라스,2018-09
2018-09-30,10120008,2809671,7310337,조지아,2018-09
2018-09-30,10029064,501162,9527902,코트디봐르,2018-09
2018-09-30,9871869,4809709,5062160,세르비아,2018-09
2018-09-30,9383182,1262112,8121070,수단,2018-09
2018-09-30,8912784,4395389,4517395,튀니지,2018-09
2018-09-30,8103247,1506354,6596893,라오스,2018-09
2018-09-30,7971234,4678110,3293124,세네갈,2018-09
2018-09-30,7005951,320516,6685435,아이티,2018-09
2018-09-30,6942073,326116,6615957,자마이카,2018-09
2018-09-30,6852093,51470237,-44618144,트리니다드 토바고,2018-09
2018-09-30,6617334,35839,6581495,시리아,2018-09
2018-09-30,6402800,2720437,3682363,예맨,2018-09
2018-09-30,6198029,5168647,1029382,에스토니아,2018-09
2018-09-30,5956125,16340,5939785,키르기스스탄,2018-09
2018-09-30,5680794,1583193,4097601,니카라과,2018-09
2018-09-30,5160039,3709606,1450433,몰타,2018-09
2018-09-30,4670958,3381,4667577,아프카니스탄,2018-09
2018-09-30,4524584,56858000,-52333416,모잠비크,2018-09
2018-09-30,4425633,22891102,-18465469,브루나이,2018-09
2018-09-30,4197759,35928888,-31731129,앙골라,2018-09
2018-09-30,4146577,1435,4145142,불령 리유니온 코모도 제도,2018-09
2018-09-30,4028268,14,4028254,지부티,2018-09
2018-09-30,3903407,308430,3594977,마카오,2018-09
2018-09-30,3807953,6071081,-2263128,라트비아,2018-09
2018-09-30,3693551,252584688,-248891137,기타국,2018-09
2018-09-30,3601300,316961,3284339,모리셔스,2018-09
2018-09-30,3542505,29523093,-25980588,파푸아 뉴기니,2018-09
2018-09-30,3372236,0,3372236,팔레스타인 해방기구,2018-09
2018-09-30,3340542,115210,3225332,아제르바이잔,2018-09
2018-09-30,3274303,227127,3047176,사모아,2018-09
2018-09-30,3206374,35736824,-32530450,볼리비아,2018-09
2018-09-30,3192879,359338,2833541,짐바브웨,2018-09
2018-09-30,3001009,155556,2845453,네팔,2018-09
2018-09-30,2984131,47693866,-44709735,가봉,2018-09
2018-09-30,2734395,2720414,13981,베닝,2018-09
2018-09-30,2580940,49242455,-46661515,콩고민주공화국,2018-09
2018-09-30,2560638,8505942,-5945304,벨라루스,2018-09
2018-09-30,2526365,1010528,1515837,아이슬란드,2018-09
2018-09-30,2391218,3840137,-1448919,기니,2018-09
2018-09-30,2333194,9654689,-7321495,마다카스카르,2018-09
2018-09-30,2245063,24605,2220458,말라위,2018-09
2018-09-30,2236563,640,2235923,부르키나 파소,2018-09
2018-09-30,2235435,0,2235435,세인트 마틴,2018-09
2018-09-30,2207642,800157,1407485,콩고,2018-09
2018-09-30,2205918,265165,1940753,알바니아,2018-09
2018-09-30,2142746,0,2142746,마티니크,2018-09
2018-09-30,2124669,5164962,-3040293,베네주엘라,2018-09
2018-09-30,2092579,245,2092334,투르크멘,2018-09
2018-09-30,2069853,637507,1432346,말리,2018-09
2018-09-30,1975181,4348150,-2372969,룩셈부르그,2018-09
2018-09-30,1908310,0,1908310,타지크,2018-09
2018-09-30,1638991,251057,1387934,마세도니아,2018-09
2018-09-30,1618263,486206,1132057,우간다,2018-09
2018-09-30,1585639,36664,1548975,불령 폴리네시아,2018-09
2018-09-30,1554590,378656,1175934,소말리아,2018-09
2018-09-30,1505137,31551,1473586,르완다,2018-09
2018-09-30,1379018,111074,1267944,벨리제,2018-09
2018-09-30,1363954,422735,941219,마이크로네시아,2018-09
2018-09-30,1361668,0,1361668,큐라소,2018-09
2018-09-30,1254075,382,1253693,아루바,2018-09
2018-09-30,1240659,119893,1120766,쿠바,2018-09
2018-09-30,1187756,216257,971499,북마리아나 군도,2018-09
2018-09-30,1175203,1849049,-673846,몰도바,2018-09
2018-09-30,1165660,82842,1082818,카메룬,2018-09
2018-09-30,1151798,1537613,-385815,스와질랜드,2018-09
2018-09-30,1145809,14,1145795,과델로프,2018-09
2018-09-30,1137010,5967684,-4830674,잠비아,2018-09
2018-09-30,1087973,774437,313536,세이쉘,2018-09
2018-09-30,997741,1518,996223,영령 캐이맨 군도,2018-09
2018-09-30,917814,3845135,-2927321,모리타니,2018-09
2018-09-30,870310,0,870310,버뮤다,2018-09
2018-09-30,731683,151155,580528,키리바티,2018-09
2018-09-30,707053,3432179,-2725126,토고,2018-09
2018-09-30,695617,689796,5821,리히텐슈타인,2018-09
2018-09-30,651708,8606,643102,바베이도스,2018-09
2018-09-30,571797,149442,422355,몰디브,2018-09
2018-09-30,549380,522299,27081,아르메니아,2018-09
2018-09-30,512343,180,512163,티모르,2018-09
2018-09-30,499076,202260,296816,가이아나,2018-09
2018-09-30,483860,87692,396168,보츠와나,2018-09
2018-09-30,440665,273434,167231,감비아,2018-09
2018-09-30,440661,13346,427315,아메리칸 사모아,2018-09
2018-09-30,404136,0,404136,불령 가이아나,2018-09
2018-09-30,395966,156238,239728,수리남,2018-09
2018-09-30,390283,39,390244,팔라우,2018-09
2018-09-30,364687,1560181,-1195494,시에라 리온,2018-09
2018-09-30,357026,410684,-53658,바누아투,2018-09
2018-09-30,353751,824,352927,니제르,2018-09
2018-09-30,316652,0,316652,그레나다,2018-09
2018-09-30,279697,0,279697,몬테네그로,2018-09
2018-09-30,268978,31347,237631,세인트 루시아,2018-09
2018-09-30,214076,544798,-330722,나미비아,2018-09
2018-09-30,211143,1853414,-1642271,솔로몬 군도,2018-09
2018-09-30,202980,64210,138770,세인트 키츠 네비스,2018-09
2018-09-30,191799,0,191799,안티가 바부다,2018-09
2018-09-30,178825,1665,177160,세인트 빈센트 그레나딘,2018-09
2018-09-30,156040,3654,152386,도미니카,2018-09
2018-09-30,127514,0,127514,기네비소,2018-09
2018-09-30,125505,2057998,-1932493,보스니아-헤르체고비나,2018-09
2018-09-30,125430,2463,122967,카보 베르데,2018-09
2018-09-30,123144,2155,120989,부룬디,2018-09
2018-09-30,98182,8495,89687,나우루,2018-09
2018-09-30,94315,0,94315,영령 버진군도,2018-09
2018-09-30,89370,1356,88014,네덜란드 열도,2018-09
2018-09-30,84553,2047,82506,지브랄타,2018-09
2018-09-30,61469,0,61469,상토메 프린스페,2018-09
2018-09-30,52670,6416,46254,챠드,2018-09
2018-09-30,40925,67254,-26329,중앙아프리카공화국,2018-09
2018-09-30,37776,665,37111,투르크 & 카이코스 군도,2018-09
2018-09-30,36574,0,36574,에리트리아,2018-09
2018-09-30,29149,57482,-28333,산마리노,2018-09
2018-09-30,28893,36808,-7915,통가,2018-09
2018-09-30,27127,0,27127,적도 기니,2018-09
2018-09-30,20271,29601,-9330,모나코,2018-09
2018-09-30,9116,34000,-24884,부탄,2018-09
2018-09-30,4639,0,4639,안타티카,2018-09
2018-09-30,4153,0,4153,파로에 군도,2018-09
2018-09-30,3182,0,3182,투발루,2018-09
2018-09-30,2768,621,2147,안도라,2018-09
2018-09-30,980,0,980,세인트 헬레나,2018-09
2018-09-30,784,0,784,세인트 바르탤르미,2018-09
2018-09-30,396,619,-223,레소토,2018-09
2018-09-30,214,0,214,그린랜드,2018-09
2018-09-30,99,7051,-6952,미령 버진군도,2018-09
2018-09-30,0,2,-2,몬트세라트,2018-09
2018-09-30,0,255,-255,토켈라우,2018-09
2018-09-30,0,60306,-60306,피트카이른,2018-09
2018-09-30,0,175,-175,코스 군도,2018-09
2018-09-30,0,11180,-11180,코모로스,2018-09
2018-09-30,0,1896825,-1896825,앙귈라,2018-09
2018-09-30,0,158,-158,보빗군도,2018-09
2018-09-30,0,40115,-40115,쿡 아일랜드,2018-09
2018-10-31,14767040501,9963108268,4803932233,중국,2018-10
2018-10-31,6980163813,5587854218,1392309595,미국,2018-10
2018-10-31,4248685490,2059802553,2188882937,베트남,2018-10
2018-10-31,3869674845,138261582,3731413263,홍콩,2018-10
2018-10-31,2764707751,4972817449,-2208109698,일본,2018-10
2018-10-31,2577681199,1443226252,1134454947,대만,2018-10
2018-10-31,1332085706,648248573,683837133,인도,2018-10
2018-10-31,1123924391,303464306,820460085,필리핀,2018-10
2018-10-31,1108494200,469761735,638732465,멕시코,2018-10
2018-10-31,940456010,807903964,132552046,싱가포르,2018-10
2018-10-31,900994298,902026053,-1031755,말레이시아,2018-10
2018-10-31,820959386,1843900342,-1022940956,호주,2018-10
2018-10-31,810479524,1112403262,-301923738,인도네시아,2018-10
2018-10-31,761038411,1831333787,-1070295376,독일,2018-10
2018-10-31,680035530,516115729,163919801,태국,2018-10
2018-10-31,651506691,1448533116,-797026425,러시아 연방,2018-10
2018-10-31,634928223,652897096,-17968873,영국,2018-10
2018-10-31,506076002,514072603,-7996601,캐나다,2018-10
2018-10-31,485135054,61489049,423646005,폴란드,2018-10
2018-10-31,459742644,227184902,232557742,네덜란드,2018-10
2018-10-31,455992194,8216701,447775493,파나마,2018-10
2018-10-31,437275722,476404937,-39129215,프랑스,2018-10
2018-10-31,403449457,99164983,304284474,튀르키예,2018-10
2018-10-31,380050801,346728540,33322261,브라질,2018-10
2018-10-31,361090055,2712546621,-2351456566,사우디아라비아,2018-10
2018-10-31,334624101,544701718,-210077617,이탈리아,2018-10
2018-10-31,320374430,37406880,282967550,사이프러스,2018-10
2018-10-31,293583456,55769800,237813656,헝가리,2018-10
2018-10-31,262522497,629729053,-367206556,아랍에미리트 연합,2018-10
2018-10-31,251212848,1502721,249710127,우즈베키스탄,2018-10
2018-10-31,245468625,169459552,76009073,스페인,2018-10
2018-10-31,239414786,77031833,162382953,체코공화국,2018-10
2018-10-31,232552049,14180088,218371961,슬로바키아,2018-10
2018-10-31,230555364,105183780,125371584,벨기에,2018-10
2018-10-31,201434973,6128022,195306951,이집트,2018-10
2018-10-31,168228333,59664234,108564099,콜롬비아,2018-10
2018-10-31,147396808,1009882991,-862486183,이라크,2018-10
2018-10-31,139297075,61336917,77960158,나이지리아,2018-10
2018-10-31,134449894,32440791,102009103,방글라데시,2018-10
2018-10-31,131547130,8469395,123077735,슬로베니아,2018-10
2018-10-31,125938289,301847987,-175909698,칠레,2018-10
2018-10-31,113566710,130387592,-16820882,오스트리아,2018-10
2018-10-31,110390407,121126037,-10735630,뉴질랜드,2018-10
2018-10-31,109251685,185314120,-76062435,카자흐스탄,2018-10
2018-10-31,99511559,107425916,-7914357,이스라엘,2018-10
2018-10-31,90570392,134821189,-44250797,남아프리카공화국,2018-10
2018-10-31,90404131,4862881,85541250,이란,2018-10
2018-10-31,90097621,5068269,85029352,몰타,2018-10
2018-10-31,90022527,167426087,-77403560,스웨덴,2018-10
2018-10-31,85433558,259139,85174419,라이베리아,2018-10
2018-10-31,84471638,1222030670,-1137559032,쿠웨이트,2018-10
2018-10-31,82328812,28719,82300093,바하마,2018-10
2018-10-31,76984670,210291675,-133307005,알제리,2018-10
2018-10-31,72641806,21970285,50671521,파키스탄,2018-10
2018-10-31,72374199,22587510,49786689,포루투갈,2018-10
2018-10-31,68577324,9547926,59029398,에쿠아도르,2018-10
2018-10-31,58398302,94308176,-35909874,아일랜드,2018-10
2018-10-31,57779000,90525921,-32746921,노르웨이,2018-10
2018-10-31,57606918,160906405,-103299487,페루,2018-10
2018-10-31,56598416,793,56597623,영령 캐이맨 군도,2018-10
2018-10-31,55686697,8589438,47097259,요르단,2018-10
2018-10-31,54774454,25807588,28966866,캄보디아,2018-10
2018-10-31,46605876,76524749,-29918873,미얀마,2018-10
2018-10-31,44668123,5614729,39053394,세네갈,2018-10
2018-10-31,42899447,81828562,-38929115,덴마크,2018-10
2018-10-31,41730934,267672676,-225941742,스위스,2018-10
2018-10-31,40540517,40462674,77843,루마니아,2018-10
2018-10-31,38437440,24363400,14074040,푸에르토리코,2018-10
2018-10-31,36243312,253177361,-216934049,오만,2018-10
2018-10-31,35965910,7350106,28615804,리투아니아,2018-10
2018-10-31,35885910,25720,35860190,마샬군도,2018-10
2018-10-31,35067836,1682440,33385396,크로아티아,2018-10
2018-10-31,33802693,623942,33178751,피지,2018-10
2018-10-31,31673726,41652681,-9978955,리비아,2018-10
2018-10-31,31068168,30243411,824757,뉴 칼레도니아,2018-10
2018-10-31,30495717,6476032,24019685,스리랑카,2018-10
2018-10-31,30426555,27714296,2712259,그리스,2018-10
2018-10-31,29659862,1469277688,-1439617826,카타르,2018-10
2018-10-31,29069238,55354145,-26284907,우크라이나,2018-10
2018-10-31,28810653,12439176,16371477,모로코,2018-10
2018-10-31,28703652,118360089,-89656437,핀란드,2018-10
2018-10-31,23803167,5457325,18345842,과테말라,2018-10
2018-10-31,23664591,35595945,-11931354,아르헨티나,2018-10
2018-10-31,22714165,12438122,10276043,도미니카 공화국,2018-10
2018-10-31,22412435,3993968,18418467,몽골,2018-10
2018-10-31,17613240,3631935,13981305,케냐,2018-10
2018-10-31,16619864,3264986,13354878,가나,2018-10
2018-10-31,16397244,511414,15885830,수단,2018-10
2018-10-31,14993905,10692176,4301729,코스타리카,2018-10
2018-10-31,14527187,22946134,-8418947,바레인,2018-10
2018-10-31,14223073,1913670,12309403,엘살바도르,2018-10
2018-10-31,14101871,4595327,9506544,레바논,2018-10
2018-10-31,14041567,408822,13632745,콩고,2018-10
2018-10-31,13807885,15863384,-2055499,불가리아,2018-10
2018-10-31,13206304,807631,12398673,탄자니아,2018-10
2018-10-31,12955077,37987405,-25032328,트리니다드 토바고,2018-10
2018-10-31,12705455,2522543,10182912,온두라스,2018-10
2018-10-31,12366010,5194350,7171660,튀니지,2018-10
2018-10-31,12297253,419108,11878145,파라과이,2018-10
2018-10-31,12264237,2498697,9765540,세르비아,2018-10
2018-10-31,12230709,45078077,-32847368,앙골라,2018-10
2018-10-31,11671169,5734937,5936232,에티오피아,2018-10
2018-10-31,10593046,4737238,5855808,예맨,2018-10
2018-10-31,10341062,1724,10339338,시리아,2018-10
2018-10-31,9154083,792397,8361686,코트디봐르,2018-10
2018-10-31,9048135,501471,8546664,니카라과,2018-10
2018-10-31,8294960,27221,8267739,키르기스스탄,2018-10
2018-10-31,7963318,0,7963318,팔레스타인 해방기구,2018-10
2018-10-31,7874143,4633,7869510,아프카니스탄,2018-10
2018-10-31,7844010,9312919,-1468909,라트비아,2018-10
2018-10-31,7571821,308069949,-300498128,기타국,2018-10
2018-10-31,7401322,3663772,3737550,조지아,2018-10
2018-10-31,7264743,7635096,-370353,우루과이,2018-10
2018-10-31,7167584,1224083,5943501,아이슬란드,2018-10
2018-10-31,7036658,1831171,5205487,파푸아 뉴기니,2018-10
2018-10-31,6822502,6180736,641766,에스토니아,2018-10
2018-10-31,6561001,430669,6130332,괌,2018-10
2018-10-31,6558864,49821163,-43262299,브루나이,2018-10
2018-10-31,5913841,22987862,-17074021,모잠비크,2018-10
2018-10-31,5733897,309185,5424712,아이티,2018-10
2018-10-31,4823282,2563719,2259563,라오스,2018-10
2018-10-31,4518574,268115,4250459,아제르바이잔,2018-10
2018-10-31,4393584,388617,4004967,네팔,2018-10
2018-10-31,4336485,39538,4296947,팔라우,2018-10
2018-10-31,4243390,0,4243390,지부티,2018-10
2018-10-31,4003751,890153,3113598,짐바브웨,2018-10
2018-10-31,3774568,8900039,-5125471,볼리비아,2018-10
2018-10-31,3751894,3035265,716629,쿠바,2018-10
2018-10-31,3512446,0,3512446,부탄,2018-10
2018-10-31,3486372,261303,3225069,모리셔스,2018-10
2018-10-31,3483287,281093,3202194,자마이카,2018-10
2018-10-31,3204549,54900134,-51695585,콩고민주공화국,2018-10
2018-10-31,3082033,131,3081902,마티니크,2018-10
2018-10-31,2972063,7908245,-4936182,룩셈부르그,2018-10
2018-10-31,2910867,221131,2689736,마카오,2018-10
2018-10-31,2878168,925484,1952684,벨라루스,2018-10
2018-10-31,2824957,315197,2509760,사모아,2018-10
2018-10-31,2677221,6086738,-3409517,마다카스카르,2018-10
2018-10-31,2645891,11726851,-9080960,잠비아,2018-10
2018-10-31,2492768,0,2492768,타지크,2018-10
2018-10-31,2218270,0,2218270,과델로프,2018-10
2018-10-31,2196587,116345,2080242,불령 폴리네시아,2018-10
2018-10-31,2190880,506157,1684723,베닝,2018-10
2018-10-31,2123048,5907,2117141,부르키나 파소,2018-10
2018-10-31,2082068,759110,1322958,소말리아,2018-10
2018-10-31,2066914,0,2066914,세인트 마틴,2018-10
2018-10-31,1799690,7600294,-5800604,베네주엘라,2018-10
2018-10-31,1765760,152,1765608,불령 리유니온 코모도 제도,2018-10
2018-10-31,1758749,602453,1156296,마이크로네시아,2018-10
2018-10-31,1734310,3006673,-1272363,기니,2018-10
2018-10-31,1682678,215276,1467402,북마리아나 군도,2018-10
2018-10-31,1572907,72772,1500135,카메룬,2018-10
2018-10-31,1485902,614573,871329,말리,2018-10
2018-10-31,1402735,1011467,391268,세이쉘,2018-10
2018-10-31,1311365,179833,1131532,마세도니아,2018-10
2018-10-31,1285605,254168,1031437,키리바티,2018-10
2018-10-31,1264906,3217543,-1952637,토고,2018-10
2018-10-31,1257039,1718694,-461655,시에라 리온,2018-10
2018-10-31,1233689,1415646,-181957,우간다,2018-10
2018-10-31,1188123,879,1187244,아루바,2018-10
2018-10-31,1060803,21,1060782,투르크멘,2018-10
2018-10-31,1046369,4048298,-3001929,모리타니,2018-10
2018-10-31,996106,534294,461812,솔로몬 군도,2018-10
2018-10-31,948016,1440180,-492164,몰도바,2018-10
2018-10-31,944223,1000646,-56423,리히텐슈타인,2018-10
2018-10-31,917461,255526,661935,알바니아,2018-10
2018-10-31,856005,470778,385227,수리남,2018-10
2018-10-31,784983,0,784983,바베이도스,2018-10
2018-10-31,763875,43118,720757,몰디브,2018-10
2018-10-31,732917,0,732917,가이아나,2018-10
2018-10-31,725911,1785299,-1059388,아르메니아,2018-10
2018-10-31,646851,23,646828,버뮤다,2018-10
2018-10-31,612314,144588895,-143976581,가봉,2018-10
2018-10-31,581634,202471,379163,아메리칸 사모아,2018-10
2018-10-31,547910,6,547904,불령 가이아나,2018-10
2018-10-31,465383,62,465321,벨리제,2018-10
2018-10-31,458852,188526,270326,르완다,2018-10
2018-10-31,456612,0,456612,세인트 루시아,2018-10
2018-10-31,418645,44388,374257,큐라소,2018-10
2018-10-31,411524,102825,308699,티모르,2018-10
2018-10-31,401835,1215771,-813936,감비아,2018-10
2018-10-31,351987,21410,330577,세인트 키츠 네비스,2018-10
2018-10-31,348316,1305735,-957419,바누아투,2018-10
2018-10-31,342886,0,342886,안티가 바부다,2018-10
2018-10-31,306528,0,306528,세인트 빈센트 그레나딘,2018-10
2018-10-31,294495,15652,278843,보츠와나,2018-10
2018-10-31,285759,56,285703,몬테네그로,2018-10
2018-10-31,282759,172413,110346,나미비아,2018-10
2018-10-31,273689,199358,74331,말라위,2018-10
2018-10-31,260929,23482,237447,카보 베르데,2018-10
2018-10-31,224261,88652,135609,스와질랜드,2018-10
2018-10-31,203108,5235,197873,부룬디,2018-10
2018-10-31,202183,0,202183,그레나다,2018-10
2018-10-31,154686,0,154686,네덜란드 열도,2018-10
2018-10-31,124654,0,124654,지브랄타,2018-10
2018-10-31,116449,25416,91033,도미니카,2018-10
2018-10-31,108537,2334124,-2225587,보스니아-헤르체고비나,2018-10
2018-10-31,107891,0,107891,중앙아프리카공화국,2018-10
2018-10-31,83284,1652,81632,니제르,2018-10
2018-10-31,69889,796,69093,투르크 & 카이코스 군도,2018-10
2018-10-31,69188,0,69188,투발루,2018-10
2018-10-31,62496,46673,15823,기네비소,2018-10
2018-10-31,44910,141869,-96959,모나코,2018-10
2018-10-31,41755,0,41755,세인트 바르탤르미,2018-10
2018-10-31,41609,458403,-416794,통가,2018-10
2018-10-31,30981,1903,29078,남수단,2018-10
2018-10-31,29880,516,29364,나우루,2018-10
2018-10-31,26122,449383,-423261,산마리노,2018-10
2018-10-31,24250,0,24250,챠드,2018-10
2018-10-31,21500,64446,-42946,코모로스,2018-10
2018-10-31,20078,0,20078,안타티카,2018-10
2018-10-31,16508,53690109,-53673601,적도 기니,2018-10
2018-10-31,15521,0,15521,왈라스 & 퓨투나 군도,2018-10
2018-10-31,14677,2259,12418,안도라,2018-10
2018-10-31,13536,604,12932,레소토,2018-10
2018-10-31,10935,230,10705,영령 버진군도,2018-10
2018-10-31,5753,58972,-53219,쿡 아일랜드,2018-10
2018-10-31,2833,7950,-5117,미령 버진군도,2018-10
2018-10-31,1424,4969,-3545,토켈라우,2018-10
2018-10-31,776,0,776,앙귈라,2018-10
2018-10-31,534,0,534,세인트 헬레나,2018-10
2018-10-31,43,36806,-36763,파로에 군도,2018-10
2018-10-31,43,7984,-7941,그린랜드,2018-10
2018-10-31,0,414,-414,메요트,2018-10
2018-10-31,0,37,-37,에리트리아,2018-10
2018-10-31,0,1845,-1845,영령 인도양,2018-10
2018-10-31,0,365,-365,알랜드 군도,2018-10
2018-10-31,0,19,-19,맨섬,2018-10
2018-10-31,0,40,-40,상토메 프린스페,2018-10
2018-10-31,0,4953,-4953,니우에,2018-10
2018-10-31,0,137,-137,건지,2018-10
2018-10-31,0,92468,-92468,몬트세라트,2018-10
2018-11-30,13558761072,9852084321,3706676751,중국,2018-11
2018-11-30,6840970688,4878622430,1962348258,미국,2018-11
2018-11-30,4520135567,1634162305,2885973262,베트남,2018-11
2018-11-30,3104349754,155745482,2948604272,홍콩,2018-11
2018-11-30,2707330806,4322175788,-1614844982,일본,2018-11
2018-11-30,2235810334,1323201765,912608569,대만,2018-11
2018-11-30,1355046953,642075437,712971516,싱가포르,2018-11
2018-11-30,1234976091,513829651,721146440,인도,2018-11
2018-11-30,1124818836,587522144,537296692,필리핀,2018-11
2018-11-30,889358727,425893443,463465284,멕시코,2018-11
2018-11-30,754594327,1833921855,-1079327528,독일,2018-11
2018-11-30,751074371,930341910,-179267539,인도네시아,2018-11
2018-11-30,716575321,927673260,-211097939,말레이시아,2018-11
2018-11-30,713086562,417534290,295552272,태국,2018-11
2018-11-30,700546767,2003319738,-1302772971,호주,2018-11
2018-11-30,688459448,147715,688311733,사이프러스,2018-11
2018-11-30,638668593,1938803253,-1300134660,러시아 연방,2018-11
2018-11-30,618687122,475546388,143140734,영국,2018-11
2018-11-30,462810222,407512150,55298072,캐나다,2018-11
2018-11-30,422189451,97608436,324581015,튀르키예,2018-11
2018-11-30,384436733,59661073,324775660,폴란드,2018-11
2018-11-30,353819336,348172334,5647002,브라질,2018-11
2018-11-30,325826299,2574692175,-2248865876,사우디아라비아,2018-11
2018-11-30,319451715,540001882,-220550167,이탈리아,2018-11
2018-11-30,314874093,684599539,-369725446,아랍에미리트 연합,2018-11
2018-11-30,303960254,538290119,-234329865,네덜란드,2018-11
2018-11-30,297243902,1808967,295434935,우즈베키스탄,2018-11
2018-11-30,274554166,213562523,60991643,노르웨이,2018-11
2018-11-30,255506508,479556366,-224049858,프랑스,2018-11
2018-11-30,235049956,410410675,-175360719,스페인,2018-11
2018-11-30,227909699,138386372,89523327,벨기에,2018-11
2018-11-30,222602332,16160544,206441788,슬로바키아,2018-11
2018-11-30,200449025,1755,200447270,바하마,2018-11
2018-11-30,196950562,46225418,150725144,헝가리,2018-11
2018-11-30,191865534,70462222,121403312,체코공화국,2018-11
2018-11-30,172689270,993124237,-820434967,이라크,2018-11
2018-11-30,146527172,118826357,27700815,뉴질랜드,2018-11
2018-11-30,140535882,371403961,-230868079,칠레,2018-11
2018-11-30,139756964,11359117,128397847,슬로베니아,2018-11
2018-11-30,138901633,76167534,62734099,이스라엘,2018-11
2018-11-30,131913149,4862631,127050518,이집트,2018-11
2018-11-30,124955504,26256035,98699469,방글라데시,2018-11
2018-11-30,107911171,140419684,-32508513,콜롬비아,2018-11
2018-11-30,99097539,117830866,-18733327,오스트리아,2018-11
2018-11-30,95040273,155914692,-60874419,스웨덴,2018-11
2018-11-30,87924932,105297318,-17372386,카자흐스탄,2018-11
2018-11-30,85237210,152029880,-66792670,알제리,2018-11
2018-11-30,77587921,8272126,69315795,에쿠아도르,2018-11
2018-11-30,76271134,1023788945,-947517811,쿠웨이트,2018-11
2018-11-30,75679913,22821137,52858776,파키스탄,2018-11
2018-11-30,72970247,190109767,-117139520,남아프리카공화국,2018-11
2018-11-30,69498193,253150345,-183652152,오만,2018-11
2018-11-30,62138497,16969986,45168511,캄보디아,2018-11
2018-11-30,62008892,101352076,-39343184,아일랜드,2018-11
2018-11-30,60778184,127085,60651099,라이베리아,2018-11
2018-11-30,55423006,185476183,-130053177,나이지리아,2018-11
2018-11-30,52194640,251252214,-199057574,스위스,2018-11
2018-11-30,51339628,101807664,-50468036,페루,2018-11
2018-11-30,48511525,47635536,875989,미얀마,2018-11
2018-11-30,47756643,227640,47529003,리비아,2018-11
2018-11-30,46708234,7848707,38859527,몽골,2018-11
2018-11-30,46157451,10446342,35711109,모로코,2018-11
2018-11-30,41655309,34358393,7296916,포루투갈,2018-11
2018-11-30,39331568,55291922,-15960354,덴마크,2018-11
2018-11-30,38982316,36688912,2293404,루마니아,2018-11
2018-11-30,38173304,6560023,31613281,요르단,2018-11
2018-11-30,37133645,1428709835,-1391576190,카타르,2018-11
2018-11-30,34433269,317180,34116089,괌,2018-11
2018-11-30,30917603,16562920,14354683,푸에르토리코,2018-11
2018-11-30,30377749,101894049,-71516300,핀란드,2018-11
2018-11-30,28460101,6117217,22342884,리투아니아,2018-11
2018-11-30,24528088,42283779,-17755691,아르헨티나,2018-11
2018-11-30,23716914,73218823,-49501909,그리스,2018-11
2018-11-30,23673532,6574185,17099347,스리랑카,2018-11
2018-11-30,21331694,4350932,16980762,파나마,2018-11
2018-11-30,19618316,52850723,-33232407,우크라이나,2018-11
2018-11-30,19029822,11568735,7461087,도미니카 공화국,2018-11
2018-11-30,17826037,3307799,14518238,가나,2018-11
2018-11-30,17476269,5829868,11646401,과테말라,2018-11
2018-11-30,15666926,1353161,14313765,크로아티아,2018-11
2018-11-30,15199721,679875,14519846,탄자니아,2018-11
2018-11-30,15186568,6010,15180558,아프카니스탄,2018-11
2018-11-30,14356672,3475038,10881634,레바논,2018-11
2018-11-30,14256478,2060990,12195488,이란,2018-11
2018-11-30,14144910,1945558,12199352,엘살바도르,2018-11
2018-11-30,13711274,17288239,-3576965,불가리아,2018-11
2018-11-30,13676026,1358351,12317675,수단,2018-11
2018-11-30,13580515,1665857,11914658,앙골라,2018-11
2018-11-30,12549754,8949606,3600148,세르비아,2018-11
2018-11-30,12451746,95628827,-83177081,바레인,2018-11
2018-11-30,11179541,4657190,6522351,튀니지,2018-11
2018-11-30,11115346,1741746,9373600,파라과이,2018-11
2018-11-30,10705949,8196491,2509458,마샬군도,2018-11
2018-11-30,10455661,4277897,6177764,케냐,2018-11
2018-11-30,10208204,13703545,-3495341,우루과이,2018-11
2018-11-30,9919151,441494,9477657,콩고,2018-11
2018-11-30,9777637,2103826,7673811,온두라스,2018-11
2018-11-30,9291115,24709062,-15417947,트리니다드 토바고,2018-11
2018-11-30,9174009,978509,8195500,니카라과,2018-11
2018-11-30,9030081,5970333,3059748,에티오피아,2018-11
2018-11-30,8831137,9945812,-1114675,코스타리카,2018-11
2018-11-30,8721267,106114,8615153,시리아,2018-11
2018-11-30,7776875,475150,7301725,코트디봐르,2018-11
2018-11-30,7270523,31560,7238963,키르기스스탄,2018-11
2018-11-30,7197161,7782610,-585449,라트비아,2018-11
2018-11-30,7041897,5966269,1075628,에스토니아,2018-11
2018-11-30,6975225,739686,6235539,아이티,2018-11
2018-11-30,6286053,282744279,-276458226,기타국,2018-11
2018-11-30,6097681,3787743,2309938,세네갈,2018-11
2018-11-30,5740876,2344706,3396170,라오스,2018-11
2018-11-30,5138306,292332,4845974,모리셔스,2018-11
2018-11-30,5079040,9444,5069596,불령 리유니온 코모도 제도,2018-11
2018-11-30,5067282,155093,4912189,네팔,2018-11
2018-11-30,5024966,59728912,-54703946,브루나이,2018-11
2018-11-30,4954247,174224,4780023,아제르바이잔,2018-11
2018-11-30,4772594,56109041,-51336447,파푸아 뉴기니,2018-11
2018-11-30,4494388,203973,4290415,쿠바,2018-11
2018-11-30,3992036,5626793,-1634757,예맨,2018-11
2018-11-30,3971334,3966457,4877,몰타,2018-11
2018-11-30,3949220,3007423,941797,조지아,2018-11
2018-11-30,3869392,55968528,-52099136,볼리비아,2018-11
2018-11-30,3757995,510738,3247257,모잠비크,2018-11
2018-11-30,3623938,0,3623938,팔레스타인 해방기구,2018-11
2018-11-30,3595072,1590427,2004645,아이슬란드,2018-11
2018-11-30,3305344,2842964,462380,기니,2018-11
2018-11-30,3106094,243492,2862602,자마이카,2018-11
2018-11-30,2969346,694961,2274385,피지,2018-11
2018-11-30,2899140,458320,2440820,세이쉘,2018-11
2018-11-30,2697550,30346868,-27649318,뉴 칼레도니아,2018-11
2018-11-30,2657611,347878,2309733,지부티,2018-11
2018-11-30,2591774,3241130,-649356,스와질랜드,2018-11
2018-11-30,2461077,191918,2269159,마카오,2018-11
2018-11-30,2449708,6599332,-4149624,룩셈부르그,2018-11
2018-11-30,2352357,318997,2033360,북마리아나 군도,2018-11
2018-11-30,2326478,0,2326478,부르키나 파소,2018-11
2018-11-30,2321121,2424,2318697,아루바,2018-11
2018-11-30,2242966,44344006,-42101040,콩고민주공화국,2018-11
2018-11-30,2218056,274550,1943506,사모아,2018-11
2018-11-30,2102054,0,2102054,타지크,2018-11
2018-11-30,2080519,3325269,-1244750,베닝,2018-11
2018-11-30,2045808,1008270,1037538,벨라루스,2018-11
2018-11-30,1981521,173793,1807728,우간다,2018-11
2018-11-30,1889192,4141557,-2252365,잠비아,2018-11
2018-11-30,1873703,79167,1794536,불령 폴리네시아,2018-11
2018-11-30,1815784,60,1815724,마티니크,2018-11
2018-11-30,1795686,3714712,-1919026,마다카스카르,2018-11
2018-11-30,1782164,289005,1493159,알바니아,2018-11
2018-11-30,1526570,1899721,-373151,베네주엘라,2018-11
2018-11-30,1514330,623659,890671,소말리아,2018-11
2018-11-30,1496269,2899,1493370,말리,2018-11
2018-11-30,1477762,403648,1074114,짐바브웨,2018-11
2018-11-30,1371041,3296750,-1925709,모리타니,2018-11
2018-11-30,1364508,129032,1235476,카메룬,2018-11
2018-11-30,1243354,0,1243354,세인트 마틴,2018-11
2018-11-30,1218892,3885701,-2666809,토고,2018-11
2018-11-30,1123739,678060,445679,솔로몬 군도,2018-11
2018-11-30,1102606,20,1102586,안티가 바부다,2018-11
2018-11-30,960678,93573,867105,마세도니아,2018-11
2018-11-30,899845,42463,857382,말라위,2018-11
2018-11-30,885080,23328,861752,아메리칸 사모아,2018-11
2018-11-30,879420,1629397,-749977,아르메니아,2018-11
2018-11-30,863873,1871890,-1008017,리히텐슈타인,2018-11
2018-11-30,806048,0,806048,키리바티,2018-11
2018-11-30,751489,382,751107,부룬디,2018-11
2018-11-30,662910,232274,430636,가봉,2018-11
2018-11-30,646297,0,646297,투르크멘,2018-11
2018-11-30,644685,36,644649,과델로프,2018-11
2018-11-30,633104,1471802,-838698,몰도바,2018-11
2018-11-30,619886,515187,104699,수리남,2018-11
2018-11-30,555551,0,555551,큐라소,2018-11
2018-11-30,508087,97,507990,영령 캐이맨 군도,2018-11
2018-11-30,490339,0,490339,영령 버진군도,2018-11
2018-11-30,478600,11566,467034,가이아나,2018-11
2018-11-30,468252,60181,408071,바베이도스,2018-11
2018-11-30,461112,108839,352273,마이크로네시아,2018-11
2018-11-30,450481,1307393,-856912,보스니아-헤르체고비나,2018-11
2018-11-30,436198,401,435797,네덜란드 열도,2018-11
2018-11-30,427366,0,427366,버뮤다,2018-11
2018-11-30,375408,0,375408,세인트 루시아,2018-11
2018-11-30,358583,482915,-124332,바누아투,2018-11
2018-11-30,340801,479,340322,지브랄타,2018-11
2018-11-30,337986,0,337986,불령 가이아나,2018-11
2018-11-30,316824,1588778,-1271954,시에라 리온,2018-11
2018-11-30,308636,67104,241532,몰디브,2018-11
2018-11-30,283790,11740,272050,팔라우,2018-11
2018-11-30,259397,4558,254839,그레나다,2018-11
2018-11-30,249861,525,249336,카보 베르데,2018-11
2018-11-30,230924,1459,229465,도미니카,2018-11
2018-11-30,221458,109040,112418,티모르,2018-11
2018-11-30,198338,61586,136752,보츠와나,2018-11
2018-11-30,160750,0,160750,감비아,2018-11
2018-11-30,112804,384386,-271582,르완다,2018-11
2018-11-30,110391,0,110391,메요트,2018-11
2018-11-30,108836,1879,106957,벨리제,2018-11
2018-11-30,92411,3006,89405,안도라,2018-11
2018-11-30,90653,0,90653,니제르,2018-11
2018-11-30,90029,478,89551,세인트 키츠 네비스,2018-11
2018-11-30,85194,101937593,-101852399,적도 기니,2018-11
2018-11-30,81576,8057800,-7976224,나미비아,2018-11
2018-11-30,57781,1469,56312,몬테네그로,2018-11
2018-11-30,45655,0,45655,세인트 바르탤르미,2018-11
2018-11-30,37722,94224,-56502,기네비소,2018-11
2018-11-30,34979,17327,17652,코모로스,2018-11
2018-11-30,30559,611,29948,부탄,2018-11
2018-11-30,27993,0,27993,챠드,2018-11
2018-11-30,26285,15546,10739,나우루,2018-11
2018-11-30,25384,92833,-67449,모나코,2018-11
2018-11-30,25000,0,25000,에리트리아,2018-11
2018-11-30,16826,653273,-636447,통가,2018-11
2018-11-30,15469,22966,-7497,상토메 프린스페,2018-11
2018-11-30,12393,25648,-13255,중앙아프리카공화국,2018-11
2018-11-30,11120,7065,4055,세인트 빈센트 그레나딘,2018-11
2018-11-30,5673,0,5673,앙귈라,2018-11
2018-11-30,3680,0,3680,남수단,2018-11
2018-11-30,2828,49916,-47088,산마리노,2018-11
2018-11-30,2084,0,2084,그린랜드,2018-11
2018-11-30,1930,0,1930,왈라스 & 퓨투나 군도,2018-11
2018-11-30,828,3750,-2922,미령 버진군도,2018-11
2018-11-30,10,0,10,건지,2018-11
2018-11-30,0,88543,-88543,쿡 아일랜드,2018-11
2018-11-30,0,131,-131,마이너 아우틀링 합중국 군도,2018-11
2018-11-30,0,12120,-12120,니우에,2018-11
2018-11-30,0,617,-617,영령 인도양,2018-11
2018-11-30,0,11,-11,투발루,2018-11
2018-11-30,0,18982,-18982,교황청,2018-11
2018-11-30,0,952,-952,레소토,2018-11
2018-11-30,0,14160,-14160,투르크 & 카이코스 군도,2018-11
2018-11-30,0,31,-31,맨섬,2018-11
2018-11-30,0,0,0,남조지아 & 남샌드위치 군도,2018-11
2018-11-30,0,794,-794,보네르 신트외스타티위스,2018-11
2018-11-30,0,595,-595,토켈라우,2018-11
2018-11-30,0,789,-789,몬트세라트,2018-11
2018-12-31,11904228702,9507830704,2396397998,중국,2018-12
2018-12-31,6440414832,5283547668,1156867164,미국,2018-12
2018-12-31,4095952159,1549277341,2546674818,베트남,2018-12
2018-12-31,2869147063,155348161,2713798902,홍콩,2018-12
2018-12-31,2426612069,4273053149,-1846441080,일본,2018-12
2018-12-31,1416588375,1277922310,138666065,대만,2018-12
2018-12-31,1272323549,522617911,749705638,인도,2018-12
2018-12-31,1199873048,563861588,636011460,싱가포르,2018-12
2018-12-31,1050219806,424331029,625888777,태국,2018-12
2018-12-31,917902519,627757992,290144527,영국,2018-12
2018-12-31,894238840,309098677,585140163,멕시코,2018-12
2018-12-31,760872881,232830207,528042674,필리핀,2018-12
2018-12-31,747027725,1645271319,-898243594,독일,2018-12
2018-12-31,736411836,138113728,598298108,노르웨이,2018-12
2018-12-31,716385383,1787157753,-1070772370,호주,2018-12
2018-12-31,633473071,809589223,-176116152,인도네시아,2018-12
2018-12-31,629983969,911768610,-281784641,말레이시아,2018-12
2018-12-31,588851040,1471708031,-882856991,러시아 연방,2018-12
2018-12-31,459300295,573349705,-114049410,캐나다,2018-12
2018-12-31,377072084,102034796,275037288,튀르키예,2018-12
2018-12-31,349232649,317499720,31732929,브라질,2018-12
2018-12-31,340338872,494966018,-154627146,네덜란드,2018-12
2018-12-31,331960274,510809444,-178849170,이탈리아,2018-12
2018-12-31,329313955,57282430,272031525,폴란드,2018-12
2018-12-31,311622764,12998988,298623776,사이프러스,2018-12
2018-12-31,300496455,1894262867,-1593766412,사우디아라비아,2018-12
2018-12-31,295050751,498177025,-203126274,프랑스,2018-12
2018-12-31,258824017,245524019,13299998,스페인,2018-12
2018-12-31,238418754,41998483,196420271,헝가리,2018-12
2018-12-31,236456940,695576637,-459119697,아랍에미리트 연합,2018-12
2018-12-31,235759491,1828345,233931146,우즈베키스탄,2018-12
2018-12-31,228133070,96830472,131302598,벨기에,2018-12
2018-12-31,209795194,16514737,193280457,슬로바키아,2018-12
2018-12-31,205483248,195703,205287545,라이베리아,2018-12
2018-12-31,199686565,66998605,132687960,덴마크,2018-12
2018-12-31,194850131,85208664,109641467,체코공화국,2018-12
2018-12-31,165234442,747,165233695,바하마,2018-12
2018-12-31,160951535,734125561,-573174026,이라크,2018-12
2018-12-31,160694126,10597644,150096482,슬로베니아,2018-12
2018-12-31,149744814,4138597,145606217,몰타,2018-12
2018-12-31,146779922,300605391,-153825469,칠레,2018-12
2018-12-31,142026099,93291901,48734198,이스라엘,2018-12
2018-12-31,138878781,33470213,105408568,이집트,2018-12
2018-12-31,129515078,109991020,19524058,뉴질랜드,2018-12
2018-12-31,117516720,9962,117506758,마샬군도,2018-12
2018-12-31,114381365,68400830,45980535,그리스,2018-12
2018-12-31,112015757,25557447,86458310,방글라데시,2018-12
2018-12-31,107846271,1020320118,-912473847,쿠웨이트,2018-12
2018-12-31,105945297,60853661,45091636,콜롬비아,2018-12
2018-12-31,104080820,273815077,-169734257,남아프리카공화국,2018-12
2018-12-31,102107517,146058728,-43951211,스웨덴,2018-12
2018-12-31,96329063,120662191,-24333128,나이지리아,2018-12
2018-12-31,84241868,22727160,61514708,파키스탄,2018-12
2018-12-31,72459143,137680845,-65221702,알제리,2018-12
2018-12-31,70499906,104186424,-33686518,아일랜드,2018-12
2018-12-31,68184978,84315449,-16130471,카자흐스탄,2018-12
2018-12-31,64577083,392807,64184276,리비아,2018-12
2018-12-31,61964944,108701600,-46736656,오스트리아,2018-12
2018-12-31,58037850,21968241,36069609,캄보디아,2018-12
2018-12-31,56944063,125038284,-68094221,페루,2018-12
2018-12-31,54024299,257476014,-203451715,오만,2018-12
2018-12-31,53574553,20592491,32982062,포루투갈,2018-12
2018-12-31,52344696,5113292,47231404,앙골라,2018-12
2018-12-31,50187171,117824100,-67636929,핀란드,2018-12
2018-12-31,43297853,39362991,3934862,미얀마,2018-12
2018-12-31,42520768,223182180,-180661412,스위스,2018-12
2018-12-31,40548787,9628690,30920097,요르단,2018-12
2018-12-31,38354496,41911950,-3557454,루마니아,2018-12
2018-12-31,34184144,7228823,26955321,에쿠아도르,2018-12
2018-12-31,33634341,27686774,5947567,모로코,2018-12
2018-12-31,28207981,1667940311,-1639732330,카타르,2018-12
2018-12-31,27250284,2101655,25148629,몽골,2018-12
2018-12-31,27113152,28153195,-1040043,우크라이나,2018-12
2018-12-31,26655137,16987244,9667893,푸에르토리코,2018-12
2018-12-31,22638235,4539849,18098386,토고,2018-12
2018-12-31,22410549,14146471,8264078,파나마,2018-12
2018-12-31,21085181,3464266,17620915,크로아티아,2018-12
2018-12-31,20927894,6207450,14720444,스리랑카,2018-12
2018-12-31,20582386,54704475,-34122089,아르헨티나,2018-12
2018-12-31,20558139,6306963,14251176,리투아니아,2018-12
2018-12-31,20252825,3493780,16759045,이란,2018-12
2018-12-31,19969627,8891199,11078428,바레인,2018-12
2018-12-31,19079231,5866242,13212989,도미니카 공화국,2018-12
2018-12-31,18945806,309880,18635926,솔로몬 군도,2018-12
2018-12-31,18776386,2114830,16661556,가나,2018-12
2018-12-31,18525022,4264704,14260318,과테말라,2018-12
2018-12-31,16295574,2425200,13870374,엘살바도르,2018-12
2018-12-31,14556123,3308541,11247582,케냐,2018-12
2018-12-31,13570713,2145482,11425231,레바논,2018-12
2018-12-31,13348142,31902494,-18554352,불가리아,2018-12
2018-12-31,13233253,2686506,10546747,탄자니아,2018-12
2018-12-31,11729834,18923,11710911,시리아,2018-12
2018-12-31,11728735,3856345,7872390,튀니지,2018-12
2018-12-31,11663449,6490733,5172716,세르비아,2018-12
2018-12-31,11610053,3036,11607017,아프카니스탄,2018-12
2018-12-31,11531119,808049,10723070,수단,2018-12
2018-12-31,10768085,608085,10160000,피지,2018-12
2018-12-31,10300241,11453977,-1153736,우루과이,2018-12
2018-12-31,10255520,99297293,-89041773,코스타리카,2018-12
2018-12-31,9835527,14473336,-4637809,파라과이,2018-12
2018-12-31,9817109,4972420,4844689,에티오피아,2018-12
2018-12-31,9651248,533733,9117515,니카라과,2018-12
2018-12-31,9408600,1692780,7715820,온두라스,2018-12
2018-12-31,8635070,441457,8193613,코트디봐르,2018-12
2018-12-31,8387731,4477992,3909739,예맨,2018-12
2018-12-31,7811362,46060712,-38249350,파푸아 뉴기니,2018-12
2018-12-31,7679968,6894058,785910,에스토니아,2018-12
2018-12-31,7199898,85923,7113975,팔레스타인 해방기구,2018-12
2018-12-31,7047224,4966928,2080296,트리니다드 토바고,2018-12
2018-12-31,7026110,259674,6766436,괌,2018-12
2018-12-31,6494940,419151,6075789,아이티,2018-12
2018-12-31,6038900,2032327,4006573,조지아,2018-12
2018-12-31,5942800,6948452,-1005652,라트비아,2018-12
2018-12-31,5905257,3076892,2828365,라오스,2018-12
2018-12-31,5426839,1916384,3510455,아이슬란드,2018-12
2018-12-31,5311094,8318,5302776,키르기스스탄,2018-12
2018-12-31,4902406,4842077,60329,세네갈,2018-12
2018-12-31,4571991,781717,3790274,콩고,2018-12
2018-12-31,4541568,34965132,-30423564,브루나이,2018-12
2018-12-31,4491737,103717,4388020,보츠와나,2018-12
2018-12-31,4408791,23477,4385314,쿠바,2018-12
2018-12-31,4395977,56354,4339623,지부티,2018-12
2018-12-31,4294035,33141625,-28847590,뉴 칼레도니아,2018-12
2018-12-31,4100359,368633,3731726,모리셔스,2018-12
2018-12-31,4097730,2548,4095182,니제르,2018-12
2018-12-31,3969973,227636,3742337,아제르바이잔,2018-12
2018-12-31,3791911,3484664,307247,벨라루스,2018-12
2018-12-31,3350537,4615357,-1264820,베네주엘라,2018-12
2018-12-31,3327710,0,3327710,과델로프,2018-12
2018-12-31,3323902,4288350,-964448,베닝,2018-12
2018-12-31,3211919,28408052,-25196133,볼리비아,2018-12
2018-12-31,2907125,28,2907097,불령 리유니온 코모도 제도,2018-12
2018-12-31,2816915,4485,2812430,말리,2018-12
2018-12-31,2775985,32611692,-29835707,콩고민주공화국,2018-12
2018-12-31,2611665,165052,2446613,북마리아나 군도,2018-12
2018-12-31,2541540,189392,2352148,마카오,2018-12
2018-12-31,2520905,36682515,-34161610,모잠비크,2018-12
2018-12-31,2455187,0,2455187,아루바,2018-12
2018-12-31,2333622,128,2333494,타지크,2018-12
2018-12-31,2193728,88,2193640,마티니크,2018-12
2018-12-31,2136003,6557217,-4421214,기니,2018-12
2018-12-31,2056990,236630,1820360,네팔,2018-12
2018-12-31,1906672,106268861,-104362189,기타국,2018-12
2018-12-31,1865453,44600,1820853,부르키나 파소,2018-12
2018-12-31,1834582,346953,1487629,사모아,2018-12
2018-12-31,1812816,9393017,-7580201,마다카스카르,2018-12
2018-12-31,1805392,4187307,-2381915,룩셈부르그,2018-12
2018-12-31,1582675,11989964,-10407289,잠비아,2018-12
2018-12-31,1523022,205138,1317884,르완다,2018-12
2018-12-31,1490634,155447,1335187,자마이카,2018-12
2018-12-31,1334375,255826,1078549,세이쉘,2018-12
2018-12-31,1314172,32221,1281951,바베이도스,2018-12
2018-12-31,1152350,9889175,-8736825,모리타니,2018-12
2018-12-31,1077282,51095,1026187,카메룬,2018-12
2018-12-31,1073660,430520,643140,수리남,2018-12
2018-12-31,1037580,0,1037580,키리바티,2018-12
2018-12-31,1008908,120967,887941,가봉,2018-12
2018-12-31,966532,0,966532,큐라소,2018-12
2018-12-31,939479,193846,745633,알바니아,2018-12
2018-12-31,936499,252201,684298,우간다,2018-12
2018-12-31,897132,480356,416776,소말리아,2018-12
2018-12-31,868488,133938,734550,불령 폴리네시아,2018-12
2018-12-31,860864,1127652,-266788,리히텐슈타인,2018-12
2018-12-31,788239,36,788203,가이아나,2018-12
2018-12-31,783650,1219895,-436245,몰도바,2018-12
2018-12-31,782045,0,782045,세인트 마틴,2018-12
2018-12-31,765735,2308249,-1542514,보스니아-헤르체고비나,2018-12
2018-12-31,706553,161,706392,몰디브,2018-12
2018-12-31,673731,0,673731,불령 가이아나,2018-12
2018-12-31,650456,0,650456,영령 캐이맨 군도,2018-12
2018-12-31,640218,621411,18807,짐바브웨,2018-12
2018-12-31,635383,47837,587546,마이크로네시아,2018-12
2018-12-31,553616,896296,-342680,시에라 리온,2018-12
2018-12-31,503138,435355,67783,스와질랜드,2018-12
2018-12-31,493907,514794,-20887,아르메니아,2018-12
2018-12-31,483728,0,483728,벨리제,2018-12
2018-12-31,480214,204064,276150,감비아,2018-12
2018-12-31,394180,183044,211136,마세도니아,2018-12
2018-12-31,393544,30,393514,투르크멘,2018-12
2018-12-31,357042,0,357042,팔라우,2018-12
2018-12-31,302747,2830,299917,도미니카,2018-12
2018-12-31,287457,218,287239,버뮤다,2018-12
2018-12-31,253277,0,253277,세인트 키츠 네비스,2018-12
2018-12-31,252665,7339878,-7087213,안티가 바부다,2018-12
2018-12-31,246266,4041,242225,지브랄타,2018-12
2018-12-31,233489,14122,219367,아메리칸 사모아,2018-12
2018-12-31,223621,833,222788,세인트 빈센트 그레나딘,2018-12
2018-12-31,204447,0,204447,카보 베르데,2018-12
2018-12-31,202576,1581048,-1378472,말라위,2018-12
2018-12-31,198908,0,198908,세인트 루시아,2018-12
2018-12-31,175543,1464,174079,안도라,2018-12
2018-12-31,171905,4317786,-4145881,나미비아,2018-12
2018-12-31,160817,42,160775,그레나다,2018-12
2018-12-31,155186,533,154653,네덜란드 열도,2018-12
2018-12-31,147422,1463080,-1315658,바누아투,2018-12
2018-12-31,131290,31168,100122,몬테네그로,2018-12
2018-12-31,126646,0,126646,영령 버진군도,2018-12
2018-12-31,94833,785,94048,부탄,2018-12
2018-12-31,88130,0,88130,세인트 바르탤르미,2018-12
2018-12-31,83659,0,83659,마이너 아우틀링 합중국 군도,2018-12
2018-12-31,83485,506,82979,티모르,2018-12
2018-12-31,71351,132667,-61316,기네비소,2018-12
2018-12-31,52686,298745,-246059,모나코,2018-12
2018-12-31,49154,241,48913,투르크 & 카이코스 군도,2018-12
2018-12-31,37591,68548,-30957,중앙아프리카공화국,2018-12
2018-12-31,32510,142,32368,코모로스,2018-12
2018-12-31,30080,118760,-88680,쿡 아일랜드,2018-12
2018-12-31,24514,73434,-48920,부룬디,2018-12
2018-12-31,15508,220,15288,챠드,2018-12
2018-12-31,12655,596473,-583818,통가,2018-12
2018-12-31,6748,0,6748,왈라스 & 퓨투나 군도,2018-12
2018-12-31,4902,10901346,-10896444,에리트리아,2018-12
2018-12-31,3501,7540,-4039,투발루,2018-12
2018-12-31,2890,0,2890,적도 기니,2018-12
2018-12-31,546,0,546,교황청,2018-12
2018-12-31,300,225,75,안타티카,2018-12
2018-12-31,291,0,291,앙귈라,2018-12
2018-12-31,32,70355,-70323,그린랜드,2018-12
2018-12-31,18,0,18,건지,2018-12
2018-12-31,0,1294,-1294,토켈라우,2018-12
2018-12-31,0,3326,-3326,니우에,2018-12
2018-12-31,0,35148,-35148,산마리노,2018-12
2018-12-31,0,4657,-4657,미령 버진군도,2018-12
2018-12-31,0,1094,-1094,피트카이른,2018-12
2018-12-31,0,153,-153,스발비드 군도,2018-12
2018-12-31,0,1576,-1576,남수단,2018-12
2018-12-31,0,16262,-16262,상토메 프린스페,2018-12
2018-12-31,0,279,-279,저어지,2018-12
2018-12-31,0,19325,-19325,레소토,2018-12
2018-12-31,0,183,-183,파로에 군도,2018-12
2018-12-31,0,200,-200,맨섬,2018-12
2018-12-31,0,15051,-15051,세인트 헬레나,2018-12
2018-12-31,0,1879,-1879,나우루,2018-12
2018-12-31,0,2339,-2339,몬트세라트,2018-12
2019-01-31,10836336432,10338824519,497511913,중국,2019-01
2019-01-31,6209466480,5290688136,918778344,미국,2019-01
2019-01-31,4025559711,1965417819,2060141892,베트남,2019-01
2019-01-31,2617332541,4050305075,-1432972534,일본,2019-01
2019-01-31,2217703931,155370705,2062333226,홍콩,2019-01
2019-01-31,1426878605,469814718,957063887,인도,2019-01
2019-01-31,1289232932,1331338334,-42105402,대만,2019-01
2019-01-31,1274627881,575122852,699505029,싱가포르,2019-01
2019-01-31,1105291537,678562070,426729467,멕시코,2019-01
2019-01-31,943094150,895751150,47343000,말레이시아,2019-01
2019-01-31,862420994,224600757,637820237,필리핀,2019-01
2019-01-31,806680650,1616982470,-810301820,독일,2019-01
2019-01-31,740681639,896431231,-155749592,인도네시아,2019-01
2019-01-31,713895629,352432455,361463174,영국,2019-01
2019-01-31,707863293,2043827834,-1335964541,호주,2019-01
2019-01-31,701507905,466517589,234990316,태국,2019-01
2019-01-31,653641641,1164148374,-510506733,러시아 연방,2019-01
2019-01-31,503161493,542688433,-39526940,캐나다,2019-01
2019-01-31,452902739,104020781,348881958,튀르키예,2019-01
2019-01-31,430586490,444286391,-13699901,브라질,2019-01
2019-01-31,417240520,70358626,346881894,폴란드,2019-01
2019-01-31,378998676,353913415,25085261,네덜란드,2019-01
2019-01-31,371455107,569945544,-198490437,이탈리아,2019-01
2019-01-31,312445969,500788044,-188342075,프랑스,2019-01
2019-01-31,309204897,4966,309199931,마샬군도,2019-01
2019-01-31,287353602,145671821,141681781,벨기에,2019-01
2019-01-31,282693754,5867,282687887,바하마,2019-01
2019-01-31,270574241,243678021,26896220,스페인,2019-01
2019-01-31,251329819,646179520,-394849701,아랍에미리트 연합,2019-01
2019-01-31,239244112,42937839,196306273,그리스,2019-01
2019-01-31,224042559,40694332,183348227,슬로바키아,2019-01
2019-01-31,215289712,1771641053,-1556351341,사우디아라비아,2019-01
2019-01-31,198074834,22044463,176030371,이집트,2019-01
2019-01-31,185805624,1217160,184588464,우즈베키스탄,2019-01
2019-01-31,179163141,46715650,132447491,헝가리,2019-01
2019-01-31,170416306,83367601,87048705,체코공화국,2019-01
2019-01-31,169497679,140667085,28830594,카자흐스탄,2019-01
2019-01-31,158002489,12254093,145748396,슬로베니아,2019-01
2019-01-31,145736543,781696010,-635959467,이라크,2019-01
2019-01-31,129125703,117458544,11667159,뉴질랜드,2019-01
2019-01-31,124438948,4858436,119580512,토고,2019-01
2019-01-31,119955987,90764840,29191147,이스라엘,2019-01
2019-01-31,104788149,402661347,-297873198,칠레,2019-01
2019-01-31,102584094,39985080,62599014,방글라데시,2019-01
2019-01-31,92369374,116955272,-24585898,노르웨이,2019-01
2019-01-31,90110169,127836221,-37726052,오스트리아,2019-01
2019-01-31,86683409,7331774,79351635,앙골라,2019-01
2019-01-31,85589196,63759156,21830040,나이지리아,2019-01
2019-01-31,82061809,163459304,-81397495,알제리,2019-01
2019-01-31,78766201,187324508,-108558307,스웨덴,2019-01
2019-01-31,72317062,70088866,2228196,콜롬비아,2019-01
2019-01-31,69649669,15097310,54552359,에쿠아도르,2019-01
2019-01-31,66981860,21699923,45281937,파키스탄,2019-01
2019-01-31,65399759,168619077,-103219318,남아프리카공화국,2019-01
2019-01-31,64064052,220406065,-156342013,페루,2019-01
2019-01-31,60731769,970118900,-909387131,쿠웨이트,2019-01
2019-01-31,58844992,37285498,21559494,캄보디아,2019-01
2019-01-31,58098783,3551615,54547168,예맨,2019-01
2019-01-31,56940419,32962128,23978291,리비아,2019-01
2019-01-31,53346474,91213573,-37867099,아일랜드,2019-01
2019-01-31,48788116,263061911,-214273795,오만,2019-01
2019-01-31,48248848,37206137,11042711,루마니아,2019-01
2019-01-31,44781393,29651808,15129585,포루투갈,2019-01
2019-01-31,42633211,9373305,33259906,요르단,2019-01
2019-01-31,41979807,41661493,318314,미얀마,2019-01
2019-01-31,41866782,6881246,34985536,리투아니아,2019-01
2019-01-31,40239863,262961344,-222721481,스위스,2019-01
2019-01-31,38020083,5285981,32734102,몰타,2019-01
2019-01-31,36765252,13845111,22920141,모로코,2019-01
2019-01-31,34596548,90089762,-55493214,덴마크,2019-01
2019-01-31,28903357,38765310,-9861953,아르헨티나,2019-01
2019-01-31,27869652,9481085,18388567,스리랑카,2019-01
2019-01-31,26241983,56929112,-30687129,우크라이나,2019-01
2019-01-31,26140683,788451,25352232,피지,2019-01
2019-01-31,25829409,1279261609,-1253432200,카타르,2019-01
2019-01-31,24742692,1051839,23690853,크로아티아,2019-01
2019-01-31,24243980,0,24243980,맨섬,2019-01
2019-01-31,20939173,803024,20136149,수단,2019-01
2019-01-31,20913954,22766722,-1852768,푸에르토리코,2019-01
2019-01-31,20320892,13094770,7226122,파나마,2019-01
2019-01-31,20046943,136610599,-116563656,핀란드,2019-01
2019-01-31,19150102,375860,18774242,솔로몬 군도,2019-01
2019-01-31,17928789,2474417,15454372,몽골,2019-01
2019-01-31,16475579,8007005,8468574,도미니카 공화국,2019-01
2019-01-31,16388487,4249093,12139394,과테말라,2019-01
2019-01-31,16307538,3501108,12806430,가나,2019-01
2019-01-31,15919384,22004612,-6085228,세르비아,2019-01
2019-01-31,14977686,1643443,13334243,엘살바도르,2019-01
2019-01-31,14916654,103570173,-88653519,이란,2019-01
2019-01-31,14643639,24148844,-9505205,불가리아,2019-01
2019-01-31,13822157,29734885,-15912728,바레인,2019-01
2019-01-31,13338522,2350587,10987935,레바논,2019-01
2019-01-31,10789658,14188886,-3399228,우루과이,2019-01
2019-01-31,10779450,908558,9870892,코트디봐르,2019-01
2019-01-31,10507400,9122707,1384693,탄자니아,2019-01
2019-01-31,10361591,348256,10013335,라이베리아,2019-01
2019-01-31,10113067,4024362,6088705,케냐,2019-01
2019-01-31,10072053,4207719,5864334,파라과이,2019-01
2019-01-31,9742763,1823182,7919581,온두라스,2019-01
2019-01-31,9481121,1547077,7934044,니카라과,2019-01
2019-01-31,8789842,51,8789791,시리아,2019-01
2019-01-31,7819646,3567376,4252270,라오스,2019-01
2019-01-31,7676129,7509787,166342,튀니지,2019-01
2019-01-31,7280607,3914826,3365781,세네갈,2019-01
2019-01-31,7192614,33784703,-26592089,코스타리카,2019-01
2019-01-31,6963188,518262,6444926,아이티,2019-01
2019-01-31,6437052,6692,6430360,키르기스스탄,2019-01
2019-01-31,6088539,4186257,1902282,에티오피아,2019-01
2019-01-31,5942520,5734185,208335,에스토니아,2019-01
2019-01-31,5779471,1526973,4252498,조지아,2019-01
2019-01-31,5688524,139614,5548910,아제르바이잔,2019-01
2019-01-31,5531098,7017219,-1486121,라트비아,2019-01
2019-01-31,4925830,258719,4667111,괌,2019-01
2019-01-31,4802990,3448,4799542,아프카니스탄,2019-01
2019-01-31,4794468,1100189,3694279,트리니다드 토바고,2019-01
2019-01-31,4184061,10219292,-6035231,벨라루스,2019-01
2019-01-31,4013568,19138201,-15124633,뉴 칼레도니아,2019-01
2019-01-31,3997159,24839488,-20842329,파푸아 뉴기니,2019-01
2019-01-31,3710770,211788,3498982,사모아,2019-01
2019-01-31,3697565,4302108,-604543,베닝,2019-01
2019-01-31,3670067,290540,3379527,팔레스타인 해방기구,2019-01
2019-01-31,3383634,15529050,-12145416,사이프러스,2019-01
2019-01-31,3357519,918464,2439055,브루나이,2019-01
2019-01-31,3315078,8366568,-5051490,룩셈부르그,2019-01
2019-01-31,3311492,46197947,-42886455,콩고민주공화국,2019-01
2019-01-31,3041323,2640919,400404,아이슬란드,2019-01
2019-01-31,2938186,197114,2741072,마카오,2019-01
2019-01-31,2905156,147209,2757947,부르키나 파소,2019-01
2019-01-31,2842173,633284,2208889,모잠비크,2019-01
2019-01-31,2809794,878686,1931108,콩고,2019-01
2019-01-31,2764739,671753,2092986,소말리아,2019-01
2019-01-31,2727585,111057,2616528,네팔,2019-01
2019-01-31,2689438,221910905,-219221467,기타국,2019-01
2019-01-31,2544191,6630605,-4086414,기니,2019-01
2019-01-31,2421934,942898,1479036,지부티,2019-01
2019-01-31,2341421,1244632,1096789,세이쉘,2019-01
2019-01-31,2340076,52518650,-50178574,볼리비아,2019-01
2019-01-31,2279617,485336,1794281,수리남,2019-01
2019-01-31,2274221,8630679,-6356458,마다카스카르,2019-01
2019-01-31,2259460,0,2259460,투르크멘,2019-01
2019-01-31,2240896,1067751,1173145,모리셔스,2019-01
2019-01-31,2216513,266,2216247,불령 리유니온 코모도 제도,2019-01
2019-01-31,2091856,6503,2085353,과델로프,2019-01
2019-01-31,1927016,148347,1778669,카메룬,2019-01
2019-01-31,1826389,0,1826389,타지크,2019-01
2019-01-31,1753207,695430,1057777,자마이카,2019-01
2019-01-31,1739478,1084136,655342,짐바브웨,2019-01
2019-01-31,1663056,6258279,-4595223,모리타니,2019-01
2019-01-31,1622842,107680,1515162,북마리아나 군도,2019-01
2019-01-31,1529863,1106292,423571,나미비아,2019-01
2019-01-31,1399810,342342,1057468,쿠바,2019-01
2019-01-31,1392370,35686,1356684,불령 폴리네시아,2019-01
2019-01-31,1381514,2794,1378720,말리,2019-01
2019-01-31,1269728,12819582,-11549854,잠비아,2019-01
2019-01-31,1204604,0,1204604,세인트 마틴,2019-01
2019-01-31,1137279,1472958,-335679,베네주엘라,2019-01
2019-01-31,1098023,778521,319502,몰도바,2019-01
2019-01-31,1095065,667234,427831,리히텐슈타인,2019-01
2019-01-31,1079830,11,1079819,니제르,2019-01
2019-01-31,1053393,206935,846458,알바니아,2019-01
2019-01-31,1005216,0,1005216,챠드,2019-01
2019-01-31,988137,1728925,-740788,키리바티,2019-01
2019-01-31,889166,88967,800199,가봉,2019-01
2019-01-31,801400,2573044,-1771644,시에라 리온,2019-01
2019-01-31,798162,0,798162,아루바,2019-01
2019-01-31,780806,151169,629637,마세도니아,2019-01
2019-01-31,780468,266704,513764,가이아나,2019-01
2019-01-31,712781,1841,710940,몰디브,2019-01
2019-01-31,703166,31766,671400,바베이도스,2019-01
2019-01-31,669907,64521,605386,우간다,2019-01
2019-01-31,669398,994797,-325399,아르메니아,2019-01
2019-01-31,638441,55015,583426,보츠와나,2019-01
2019-01-31,567356,860,566496,안도라,2019-01
2019-01-31,558666,33014,525652,티모르,2019-01
2019-01-31,536380,431,535949,버뮤다,2019-01
2019-01-31,518532,46316,472216,마이크로네시아,2019-01
2019-01-31,505334,0,505334,마티니크,2019-01
2019-01-31,489475,682,488793,안티가 바부다,2019-01
2019-01-31,467438,34674,432764,팔라우,2019-01
2019-01-31,416592,438635,-22043,르완다,2019-01
2019-01-31,407783,0,407783,나우루,2019-01
2019-01-31,351149,439,350710,세인트 빈센트 그레나딘,2019-01
2019-01-31,323895,112,323783,몬테네그로,2019-01
2019-01-31,298222,80,298142,영령 캐이맨 군도,2019-01
2019-01-31,297512,1174934,-877422,바누아투,2019-01
2019-01-31,286941,26347,260594,세인트 루시아,2019-01
2019-01-31,282721,2659,280062,아메리칸 사모아,2019-01
2019-01-31,266354,0,266354,카보 베르데,2019-01
2019-01-31,250242,0,250242,그레나다,2019-01
2019-01-31,222051,653940,-431889,감비아,2019-01
2019-01-31,221446,0,221446,큐라소,2019-01
2019-01-31,215676,6384453,-6168777,말라위,2019-01
2019-01-31,195018,116452,78566,스와질랜드,2019-01
2019-01-31,187055,1999035,-1811980,보스니아-헤르체고비나,2019-01
2019-01-31,161916,0,161916,중앙아프리카공화국,2019-01
2019-01-31,132898,11228,121670,도미니카,2019-01
2019-01-31,131536,399,131137,네덜란드 열도,2019-01
2019-01-31,131389,0,131389,부탄,2019-01
2019-01-31,124342,94,124248,벨리제,2019-01
2019-01-31,105918,66,105852,세인트 키츠 네비스,2019-01
2019-01-31,99368,208327,-108959,부룬디,2019-01
2019-01-31,87652,4595,83057,지브랄타,2019-01
2019-01-31,75993,0,75993,불령 가이아나,2019-01
2019-01-31,49501,0,49501,투발루,2019-01
2019-01-31,48354,0,48354,투르크 & 카이코스 군도,2019-01
2019-01-31,37857,326531,-288674,적도 기니,2019-01
2019-01-31,17469,337,17132,왈라스 & 퓨투나 군도,2019-01
2019-01-31,11858,180770,-168912,산마리노,2019-01
2019-01-31,10486,6439,4047,상토메 프린스페,2019-01
2019-01-31,10311,26201,-15890,코모로스,2019-01
2019-01-31,7411,41111,-33700,통가,2019-01
2019-01-31,6981,0,6981,영령 버진군도,2019-01
2019-01-31,5188,0,5188,앙귈라,2019-01
2019-01-31,2587,4796,-2209,미령 버진군도,2019-01
2019-01-31,2410,18993218,-18990808,에리트리아,2019-01
2019-01-31,1046,0,1046,세인트 바르탤르미,2019-01
2019-01-31,1019,0,1019,남수단,2019-01
2019-01-31,0,1002,-1002,토켈라우,2019-01
2019-01-31,0,1124,-1124,세인트 헬레나,2019-01
2019-01-31,0,1237,-1237,남조지아 & 남샌드위치 군도,2019-01
2019-01-31,0,33774,-33774,모나코,2019-01
2019-01-31,0,146046,-146046,그린랜드,2019-01
2019-01-31,0,7868,-7868,레소토,2019-01
2019-01-31,0,6666,-6666,니우에,2019-01
2019-01-31,0,25598,-25598,쿡 아일랜드,2019-01
2019-01-31,0,74,-74,알랜드 군도,2019-01
2019-01-31,0,178,-178,마이너 아우틀링 합중국 군도,2019-01
2019-01-31,0,562984,-562984,기네비소,2019-01
2019-01-31,0,4154,-4154,몬트세라트,2019-01
2019-01-31,0,46612,-46612,안타티카,2019-01
2019-02-28,9532194006,6583454711,2948739295,중국,2019-02
2019-02-28,5442457412,4371194168,1071263244,미국,2019-02
2019-02-28,3576740231,1342924219,2233816012,베트남,2019-02
2019-02-28,2311680172,126412060,2185268112,홍콩,2019-02
2019-02-28,2296310001,3807446042,-1511136041,일본,2019-02
2019-02-28,1243481146,401196246,842284900,싱가포르,2019-02
2019-02-28,1211542091,362804850,848737241,인도,2019-02
2019-02-28,1110423356,1005369031,105054325,대만,2019-02
2019-02-28,798012863,382762911,415249952,멕시코,2019-02
2019-02-28,647903649,261485804,386417845,필리핀,2019-02
2019-02-28,638772251,1213228425,-574456174,독일,2019-02
2019-02-28,607240001,420985431,186254570,태국,2019-02
2019-02-28,604624551,736181633,-131557082,말레이시아,2019-02
2019-02-28,594601778,837420205,-242818427,인도네시아,2019-02
2019-02-28,575262470,1338197683,-762935213,러시아 연방,2019-02
2019-02-28,554573405,317281893,237291512,영국,2019-02
2019-02-28,546973862,1382631333,-835657471,호주,2019-02
2019-02-28,420648648,469946765,-49298117,캐나다,2019-02
2019-02-28,374221105,326196644,48024461,브라질,2019-02
2019-02-28,349961015,56197291,293763724,폴란드,2019-02
2019-02-28,347641947,78875100,268766847,튀르키예,2019-02
2019-02-28,322209169,414701787,-92492618,이탈리아,2019-02
2019-02-28,289722876,311688162,-21965286,네덜란드,2019-02
2019-02-28,280201845,2053777869,-1773576024,사우디아라비아,2019-02
2019-02-28,247669615,84359365,163310250,벨기에,2019-02
2019-02-28,233024275,571729315,-338705040,아랍에미리트 연합,2019-02
2019-02-28,230131464,17289625,212841839,라이베리아,2019-02
2019-02-28,225558891,400504036,-174945145,프랑스,2019-02
2019-02-28,210487990,122417082,88070908,스페인,2019-02
2019-02-28,197878341,6497816,191380525,이집트,2019-02
2019-02-28,192265726,32129987,160135739,헝가리,2019-02
2019-02-28,187591012,65262755,122328257,슬로바키아,2019-02
2019-02-28,178455823,69911660,108544163,카자흐스탄,2019-02
2019-02-28,164279191,1427675,162851516,우즈베키스탄,2019-02
2019-02-28,154506096,75629737,78876359,이스라엘,2019-02
2019-02-28,142697585,5246845,137450740,슬로베니아,2019-02
2019-02-28,127045864,56539046,70506818,체코공화국,2019-02
2019-02-28,114674017,54291,114619726,마샬군도,2019-02
2019-02-28,107430672,675752171,-568321499,이라크,2019-02
2019-02-28,104443379,2091538,102351841,토고,2019-02
2019-02-28,94395038,290995095,-196600057,칠레,2019-02
2019-02-28,88263114,31450645,56812469,방글라데시,2019-02
2019-02-28,87735360,98458824,-10723464,알제리,2019-02
2019-02-28,74914534,96397872,-21483338,뉴질랜드,2019-02
2019-02-28,63870978,115707271,-51836293,오스트리아,2019-02
2019-02-28,62928934,140444158,-77515224,스웨덴,2019-02
2019-02-28,60393173,44913133,15480040,콜롬비아,2019-02
2019-02-28,60136589,61081875,-945286,파키스탄,2019-02
2019-02-28,59669884,131468138,-71798254,남아프리카공화국,2019-02
2019-02-28,56865769,844249028,-787383259,쿠웨이트,2019-02
2019-02-28,54281998,499356,53782642,리비아,2019-02
2019-02-28,51804558,2110017,49694541,파나마,2019-02
2019-02-28,51206596,83543011,-32336415,나이지리아,2019-02
2019-02-28,43056515,27332593,15723922,캄보디아,2019-02
2019-02-28,39329027,200938,39128089,괌,2019-02
2019-02-28,37644855,302476114,-264831259,오만,2019-02
2019-02-28,37181917,6385352,30796565,몰타,2019-02
2019-02-28,36843581,147150732,-110307151,페루,2019-02
2019-02-28,36254990,46475040,-10220050,미얀마,2019-02
2019-02-28,34933485,8256478,26677007,요르단,2019-02
2019-02-28,34285081,26890318,7394763,포루투갈,2019-02
2019-02-28,33978530,1067568,32910962,크로아티아,2019-02
2019-02-28,32861645,43147808,-10286163,루마니아,2019-02
2019-02-28,31637888,1398656978,-1367019090,카타르,2019-02
2019-02-28,30823648,97366756,-66543108,아일랜드,2019-02
2019-02-28,29314871,6397881,22916990,리투아니아,2019-02
2019-02-28,29188633,211526449,-182337816,스위스,2019-02
2019-02-28,26266707,8780098,17486609,에쿠아도르,2019-02
2019-02-28,24902465,73452540,-48550075,핀란드,2019-02
2019-02-28,24397280,49000031,-24602751,덴마크,2019-02
2019-02-28,23449916,15268787,8181129,모로코,2019-02
2019-02-28,22458946,103120817,-80661871,노르웨이,2019-02
2019-02-28,22064798,4004981,18059817,뉴 칼레도니아,2019-02
2019-02-28,21013215,31015312,-10002097,아르헨티나,2019-02
2019-02-28,19040134,31112705,-12072571,우크라이나,2019-02
2019-02-28,18805030,507861178,-489056148,이란,2019-02
2019-02-28,18671621,3629904,15041717,몽골,2019-02
2019-02-28,17363215,36725338,-19362123,그리스,2019-02
2019-02-28,16125453,1280766,14844687,레바논,2019-02
2019-02-28,15905404,4052293,11853111,과테말라,2019-02
2019-02-28,14559379,7659084,6900295,스리랑카,2019-02
2019-02-28,14366513,2685790,11680723,가나,2019-02
2019-02-28,13911826,6607841,7303985,도미니카 공화국,2019-02
2019-02-28,13201980,1150867,12051113,엘살바도르,2019-02
2019-02-28,12884681,3616,12881065,시리아,2019-02
2019-02-28,11759960,17852702,-6092742,푸에르토리코,2019-02
2019-02-28,11324729,10030327,1294402,탄자니아,2019-02
2019-02-28,11104328,2021804,9082524,케냐,2019-02
2019-02-28,10364366,23305,10341061,수단,2019-02
2019-02-28,10189351,54454247,-44264896,바레인,2019-02
2019-02-28,9761368,17008964,-7247596,불가리아,2019-02
2019-02-28,9155301,8752910,402391,파라과이,2019-02
2019-02-28,8551148,643898,7907250,코트디봐르,2019-02
2019-02-28,7640971,2795365,4845606,온두라스,2019-02
2019-02-28,7346376,6065686,1280690,튀니지,2019-02
2019-02-28,7029123,15903920,-8874797,우루과이,2019-02
2019-02-28,6987489,22705433,-15717944,코스타리카,2019-02
2019-02-28,6820394,21067256,-14246862,세르비아,2019-02
2019-02-28,6013516,22291999,-16278483,트리니다드 토바고,2019-02
2019-02-28,5991518,6269776,-278258,에스토니아,2019-02
2019-02-28,5781393,4037947,1743446,세네갈,2019-02
2019-02-28,5683841,3308921,2374920,조지아,2019-02
2019-02-28,5656462,35468655,-29812193,모잠비크,2019-02
2019-02-28,5557991,77837,5480154,키르기스스탄,2019-02
2019-02-28,5454128,146164,5307964,네팔,2019-02
2019-02-28,5424412,2967559,2456853,에티오피아,2019-02
2019-02-28,4698213,519588,4178625,아이티,2019-02
2019-02-28,4653254,1882954,2770300,니카라과,2019-02
2019-02-28,4624642,693729,3930913,앙골라,2019-02
2019-02-28,4299618,3250620,1048998,라오스,2019-02
2019-02-28,3929896,28807343,-24877447,라트비아,2019-02
2019-02-28,3824372,15515,3808857,팔라우,2019-02
2019-02-28,3779978,343128,3436850,피지,2019-02
2019-02-28,3764619,210500,3554119,사모아,2019-02
2019-02-28,3741169,21575233,-17834064,콩고민주공화국,2019-02
2019-02-28,3670374,3579182,91192,베닝,2019-02
2019-02-28,3498910,2796915,701995,예맨,2019-02
2019-02-28,3206905,587063,2619842,콩고,2019-02
2019-02-28,3183271,233918,2949353,팔레스타인 해방기구,2019-02
2019-02-28,2971282,585,2970697,말리,2019-02
2019-02-28,2894307,29088,2865219,부르키나 파소,2019-02
2019-02-28,2708855,718,2708137,아프카니스탄,2019-02
2019-02-28,2685024,19403157,-16718133,파푸아 뉴기니,2019-02
2019-02-28,2588453,435884,2152569,모리셔스,2019-02
2019-02-28,2574774,151366,2423408,지부티,2019-02
2019-02-28,2492949,220754,2272195,자마이카,2019-02
2019-02-28,2482230,6046107,-3563877,기니,2019-02
2019-02-28,2274863,60221383,-57946520,볼리비아,2019-02
2019-02-28,2257838,1493143,764695,베네주엘라,2019-02
2019-02-28,2219040,198549,2020491,아제르바이잔,2019-02
2019-02-28,2178256,246495,1931761,마카오,2019-02
2019-02-28,1823311,1537274,286037,아이슬란드,2019-02
2019-02-28,1817520,9245457,-7427937,벨라루스,2019-02
2019-02-28,1796423,133938293,-132141870,기타국,2019-02
2019-02-28,1792153,11147101,-9354948,사이프러스,2019-02
2019-02-28,1695968,19755384,-18059416,브루나이,2019-02
2019-02-28,1579258,29558,1549700,카메룬,2019-02
2019-02-28,1512075,3102399,-1590324,룩셈부르그,2019-02
2019-02-28,1495717,603628,892089,소말리아,2019-02
2019-02-28,1492163,4230906,-2738743,마다카스카르,2019-02
2019-02-28,1408723,1024695,384028,세이쉘,2019-02
2019-02-28,1358070,0,1358070,타지크,2019-02
2019-02-28,1257830,24695,1233135,가이아나,2019-02
2019-02-28,1250696,248042,1002654,쿠바,2019-02
2019-02-28,1118201,571038,547163,리히텐슈타인,2019-02
2019-02-28,1113501,140745,972756,우간다,2019-02
2019-02-28,1054646,0,1054646,불령 리유니온 코모도 제도,2019-02
2019-02-28,1017401,0,1017401,세인트 마틴,2019-02
2019-02-28,1008325,798588,209737,짐바브웨,2019-02
2019-02-28,1006310,357650,648660,수리남,2019-02
2019-02-28,1003008,299591,703417,알바니아,2019-02
2019-02-28,998728,0,998728,과델로프,2019-02
2019-02-28,972421,1134772,-162351,몰도바,2019-02
2019-02-28,966045,1731625,-765580,시에라 리온,2019-02
2019-02-28,876737,118557,758180,북마리아나 군도,2019-02
2019-02-28,873665,0,873665,마티니크,2019-02
2019-02-28,853666,445343,408323,아르메니아,2019-02
2019-02-28,849680,177464,672216,불령 폴리네시아,2019-02
2019-02-28,789141,1605821,-816680,말라위,2019-02
2019-02-28,763438,62494,700944,바베이도스,2019-02
2019-02-28,756154,0,756154,큐라소,2019-02
2019-02-28,648287,53562974,-52914687,가봉,2019-02
2019-02-28,614609,183980,430629,마세도니아,2019-02
2019-02-28,606570,1263390,-656820,잠비아,2019-02
2019-02-28,584595,0,584595,투르크멘,2019-02
2019-02-28,571278,517724,53554,모리타니,2019-02
2019-02-28,566568,0,566568,몰디브,2019-02
2019-02-28,547100,0,547100,아루바,2019-02
2019-02-28,513108,22916,490192,벨리제,2019-02
2019-02-28,479249,718,478531,바하마,2019-02
2019-02-28,462981,84721,378260,티모르,2019-02
2019-02-28,455250,29945,425305,안도라,2019-02
2019-02-28,417756,4608765,-4191009,나미비아,2019-02
2019-02-28,394489,587,393902,영령 캐이맨 군도,2019-02
2019-02-28,380557,50840,329717,스와질랜드,2019-02
2019-02-28,376948,225672,151276,르완다,2019-02
2019-02-28,316395,20620,295775,아메리칸 사모아,2019-02
2019-02-28,309585,1848395,-1538810,솔로몬 군도,2019-02
2019-02-28,305277,26154,279123,보츠와나,2019-02
2019-02-28,294435,982619,-688184,바누아투,2019-02
2019-02-28,291365,97956,193409,마이크로네시아,2019-02
2019-02-28,278458,79,278379,몬테네그로,2019-02
2019-02-28,269023,132782,136241,도미니카,2019-02
2019-02-28,260403,4724105,-4463702,불령 가이아나,2019-02
2019-02-28,199906,0,199906,버뮤다,2019-02
2019-02-28,185841,0,185841,파로에 군도,2019-02
2019-02-28,185370,13923,171447,세인트 루시아,2019-02
2019-02-28,170292,1076930,-906638,보스니아-헤르체고비나,2019-02
2019-02-28,154787,28,154759,그레나다,2019-02
2019-02-28,138781,0,138781,상토메 프린스페,2019-02
2019-02-28,136943,144617,-7674,감비아,2019-02
2019-02-28,118375,0,118375,키리바티,2019-02
2019-02-28,93374,0,93374,영령 버진군도,2019-02
2019-02-28,83277,16,83261,세인트 헬레나,2019-02
2019-02-28,69141,8680,60461,안티가 바부다,2019-02
2019-02-28,65498,394,65104,투르크 & 카이코스 군도,2019-02
2019-02-28,65118,0,65118,지브랄타,2019-02
2019-02-28,49392,26271,23121,코모로스,2019-02
2019-02-28,45161,860,44301,네덜란드 열도,2019-02
2019-02-28,44035,0,44035,카보 베르데,2019-02
2019-02-28,37523,294726,-257203,기네비소,2019-02
2019-02-28,35995,0,35995,니제르,2019-02
2019-02-28,28800,0,28800,투발루,2019-02
2019-02-28,25623,586,25037,나우루,2019-02
2019-02-28,22950,0,22950,부탄,2019-02
2019-02-28,20820,5825,14995,세인트 키츠 네비스,2019-02
2019-02-28,20730,1803,18927,세인트 빈센트 그레나딘,2019-02
2019-02-28,12809,22,12787,챠드,2019-02
2019-02-28,5430,1303,4127,산마리노,2019-02
2019-02-28,4307,208,4099,세인트 바르탤르미,2019-02
2019-02-28,4000,1281,2719,부룬디,2019-02
2019-02-28,2000,103694,-101694,모나코,2019-02
2019-02-28,746,438,308,앙귈라,2019-02
2019-02-28,225,28889263,-28889038,적도 기니,2019-02
2019-02-28,0,82425,-82425,쿡 아일랜드,2019-02
2019-02-28,0,118680,-118680,그린랜드,2019-02
2019-02-28,0,301,-301,니우에,2019-02
2019-02-28,0,216,-216,몬트세라트,2019-02
2019-02-28,0,500,-500,맨섬,2019-02
2019-02-28,0,22,-22,포클랜드 군도,2019-02
2019-02-28,0,18,-18,저어지,2019-02
2019-02-28,0,7121,-7121,건지,2019-02
2019-02-28,0,4435,-4435,토켈라우,2019-02
2019-02-28,0,244,-244,중앙아프리카공화국,2019-02
2019-02-28,0,2488,-2488,해외교포,2019-02
2019-02-28,0,99618,-99618,안타티카,2019-02
2019-02-28,0,188,-188,레소토,2019-02
2019-02-28,0,8876,-8876,미령 버진군도,2019-02
2019-02-28,0,11714407,-11714407,에리트리아,2019-02
2019-02-28,0,121,-121,크리스마스 아일랜드,2019-02
2019-02-28,0,8613,-8613,통가,2019-02
2019-03-31,11442780896,8804782197,2637998699,중국,2019-03
2019-03-31,6319152288,5022183696,1296968592,미국,2019-03
2019-03-31,4065313919,1792399480,2272914439,베트남,2019-03
2019-03-31,3266774709,170408031,3096366678,홍콩,2019-03
2019-03-31,2261652259,4315380987,-2053728728,일본,2019-03
2019-03-31,1374742288,384586125,990156163,인도,2019-03
2019-03-31,1295304028,1325309640,-30005612,대만,2019-03
2019-03-31,954672067,550742121,403929946,싱가포르,2019-03
2019-03-31,948653908,428810113,519843795,멕시코,2019-03
2019-03-31,782634272,1643711357,-861077085,독일,2019-03
2019-03-31,730149188,785002893,-54853705,말레이시아,2019-03
2019-03-31,696238411,324882712,371355699,필리핀,2019-03
2019-03-31,677512504,745960995,-68448491,인도네시아,2019-03
2019-03-31,675540176,436828826,238711350,태국,2019-03
2019-03-31,643786522,1395509788,-751723266,러시아 연방,2019-03
2019-03-31,588306172,1483663205,-895357033,호주,2019-03
2019-03-31,533660581,1242,533659339,바하마,2019-03
2019-03-31,459648951,462788614,-3139663,캐나다,2019-03
2019-03-31,458340232,100810354,357529878,튀르키예,2019-03
2019-03-31,437659656,333090319,104569337,브라질,2019-03
2019-03-31,428066323,98403405,329662918,노르웨이,2019-03
2019-03-31,406774625,58570058,348204567,폴란드,2019-03
2019-03-31,402682524,578453856,-175771332,영국,2019-03
2019-03-31,368827929,373382383,-4554454,네덜란드,2019-03
2019-03-31,362878203,531832822,-168954619,이탈리아,2019-03
2019-03-31,298046095,473057104,-175011009,프랑스,2019-03
2019-03-31,292903353,1490445787,-1197542434,사우디아라비아,2019-03
2019-03-31,287874271,43201289,244672982,마샬군도,2019-03
2019-03-31,274129635,45148473,228981162,카자흐스탄,2019-03
2019-03-31,264416404,530272545,-265856141,아랍에미리트 연합,2019-03
2019-03-31,251894174,419186083,-167291909,스페인,2019-03
2019-03-31,250064873,38211161,211853712,헝가리,2019-03
2019-03-31,241030344,15780312,225250032,그리스,2019-03
2019-03-31,223970089,103534430,120435659,벨기에,2019-03
2019-03-31,212706805,0,212706805,버뮤다,2019-03
2019-03-31,184948830,32650014,152298816,슬로바키아,2019-03
2019-03-31,175489466,2622471,172866995,우즈베키스탄,2019-03
2019-03-31,173625867,66430917,107194950,체코공화국,2019-03
2019-03-31,171594819,11164505,160430314,슬로베니아,2019-03
2019-03-31,148163652,783321457,-635157805,이라크,2019-03
2019-03-31,131095864,5546664,125549200,이집트,2019-03
2019-03-31,120421675,377104988,-256683313,칠레,2019-03
2019-03-31,118892550,2864804,116027746,토고,2019-03
2019-03-31,117990450,110312883,7677567,뉴질랜드,2019-03
2019-03-31,116253241,40512260,75740981,방글라데시,2019-03
2019-03-31,113541977,30751628,82790349,콜롬비아,2019-03
2019-03-31,112375303,68165902,44209401,알제리,2019-03
2019-03-31,109779810,66228984,43550826,이스라엘,2019-03
2019-03-31,95356435,145543921,-50187486,스웨덴,2019-03
2019-03-31,80089886,9169139,70920747,나이지리아,2019-03
2019-03-31,70842461,39828933,31013528,파키스탄,2019-03
2019-03-31,68059617,251846,67807771,라이베리아,2019-03
2019-03-31,67575333,176622542,-109047209,남아프리카공화국,2019-03
2019-03-31,66362793,350529,66012264,리비아,2019-03
2019-03-31,66175470,108971070,-42795600,오스트리아,2019-03
2019-03-31,65754452,4403548,61350904,몰타,2019-03
2019-03-31,63642493,666373325,-602730832,이란,2019-03
2019-03-31,62312214,2117983,60194231,파나마,2019-03
2019-03-31,56486737,30393661,26093076,캄보디아,2019-03
2019-03-31,53555125,917892445,-864337320,쿠웨이트,2019-03
2019-03-31,49318615,201521032,-152202417,페루,2019-03
2019-03-31,47710977,17433083,30277894,아르헨티나,2019-03
2019-03-31,46536116,24290660,22245456,포루투갈,2019-03
2019-03-31,46395487,239891490,-193496003,스위스,2019-03
2019-03-31,45490655,92269721,-46779066,아일랜드,2019-03
2019-03-31,41931172,34194354,7736818,루마니아,2019-03
2019-03-31,39418191,43963298,-4545107,미얀마,2019-03
2019-03-31,39015698,208368875,-169353177,오만,2019-03
2019-03-31,38219524,5470374,32749150,요르단,2019-03
2019-03-31,33654567,7287878,26366689,리투아니아,2019-03
2019-03-31,33348842,71324371,-37975529,덴마크,2019-03
2019-03-31,32620842,10791084,21829758,에쿠아도르,2019-03
2019-03-31,32335803,556069,31779734,앙골라,2019-03
2019-03-31,31557668,923500227,-891942559,카타르,2019-03
2019-03-31,27568101,24899249,2668852,푸에르토리코,2019-03
2019-03-31,26772415,31591666,-4819251,우크라이나,2019-03
2019-03-31,23418205,1276643,22141562,몽골,2019-03
2019-03-31,23367422,685648,22681774,솔로몬 군도,2019-03
2019-03-31,22747399,87507542,-64760143,핀란드,2019-03
2019-03-31,21988074,9071506,12916568,도미니카 공화국,2019-03
2019-03-31,21844910,10612372,11232538,모로코,2019-03
2019-03-31,18933795,10010885,8922910,스리랑카,2019-03
2019-03-31,18836779,4217188,14619591,과테말라,2019-03
2019-03-31,17850074,2739507,15110567,가나,2019-03
2019-03-31,17433300,1754230,15679070,크로아티아,2019-03
2019-03-31,16301829,14419071,1882758,불가리아,2019-03
2019-03-31,16210836,2303013,13907823,엘살바도르,2019-03
2019-03-31,14184705,58399307,-44214602,바레인,2019-03
2019-03-31,12094940,5157908,6937032,파라과이,2019-03
2019-03-31,11963287,3136548,8826739,케냐,2019-03
2019-03-31,11296731,2578,11294153,시리아,2019-03
2019-03-31,11085466,4686963,6398503,에스토니아,2019-03
2019-03-31,10992413,2369460,8622953,에티오피아,2019-03
2019-03-31,10980384,14300818,-3320434,우루과이,2019-03
2019-03-31,10891435,2328770,8562665,예맨,2019-03
2019-03-31,10519504,2041949,8477555,레바논,2019-03
2019-03-31,9365142,23907640,-14542498,세르비아,2019-03
2019-03-31,8894419,25465746,-16571327,코스타리카,2019-03
2019-03-31,8821681,5280617,3541064,튀니지,2019-03
2019-03-31,8682859,268264,8414595,코트디봐르,2019-03
2019-03-31,8325388,1309,8324079,키르기스스탄,2019-03
2019-03-31,8091244,2031733,6059511,탄자니아,2019-03
2019-03-31,7980830,3817527,4163303,온두라스,2019-03
2019-03-31,7908659,325523,7583136,피지,2019-03
2019-03-31,7641383,281795,7359588,괌,2019-03
2019-03-31,7527948,3953916,3574032,세네갈,2019-03
2019-03-31,7367159,2335,7364824,아프카니스탄,2019-03
2019-03-31,7333381,33182791,-25849410,트리니다드 토바고,2019-03
2019-03-31,7327043,99124,7227919,아제르바이잔,2019-03
2019-03-31,7176757,57213327,-50036570,브루나이,2019-03
2019-03-31,6911531,2597517,4314014,라오스,2019-03
2019-03-31,6907166,347706,6559460,쿠바,2019-03
2019-03-31,6783168,656515,6126653,수단,2019-03
2019-03-31,6594064,1182007,5412057,조지아,2019-03
2019-03-31,6174814,1963222,4211592,니카라과,2019-03
2019-03-31,5916481,655682,5260799,아이티,2019-03
2019-03-31,5915047,17241409,-11326362,라트비아,2019-03
2019-03-31,4776460,17715706,-12939246,파푸아 뉴기니,2019-03
2019-03-31,4452564,906855,3545709,사이프러스,2019-03
2019-03-31,4270048,373334,3896714,팔레스타인 해방기구,2019-03
2019-03-31,3927557,343847,3583710,사모아,2019-03
2019-03-31,3888709,386768,3501941,자마이카,2019-03
2019-03-31,3407587,46007940,-42600353,콩고민주공화국,2019-03
2019-03-31,3183045,770329,2412716,모잠비크,2019-03
2019-03-31,2994135,5371083,-2376948,짐바브웨,2019-03
2019-03-31,2962286,323218078,-320255792,기타국,2019-03
2019-03-31,2944501,3083084,-138583,베닝,2019-03
2019-03-31,2920392,1254751,1665641,아이슬란드,2019-03
2019-03-31,2883827,1932,2881895,부르키나 파소,2019-03
2019-03-31,2783537,5336792,-2553255,벨라루스,2019-03
2019-03-31,2622653,72768,2549885,카메룬,2019-03
2019-03-31,2611142,25594216,-22983074,볼리비아,2019-03
2019-03-31,2608218,1196,2607022,투르크멘,2019-03
2019-03-31,2578746,325060,2253686,우간다,2019-03
2019-03-31,2576318,619752,1956566,지부티,2019-03
2019-03-31,2560826,562,2560264,불령 리유니온 코모도 제도,2019-03
2019-03-31,2546669,1469,2545200,타지크,2019-03
2019-03-31,2507300,143973,2363327,네팔,2019-03
2019-03-31,2468009,6873810,-4405801,기니,2019-03
2019-03-31,2360379,13081514,-10721135,마다카스카르,2019-03
2019-03-31,2357803,493448,1864355,모리셔스,2019-03
2019-03-31,2286523,6084435,-3797912,룩셈부르그,2019-03
2019-03-31,2238694,299419,1939275,북마리아나 군도,2019-03
2019-03-31,2166751,338970,1827781,마카오,2019-03
2019-03-31,2029344,289105,1740239,알바니아,2019-03
2019-03-31,2026929,16296337,-14269408,잠비아,2019-03
2019-03-31,1948581,612667,1335914,소말리아,2019-03
2019-03-31,1815795,21619674,-19803879,뉴 칼레도니아,2019-03
2019-03-31,1773833,0,1773833,과델로프,2019-03
2019-03-31,1762330,4101,1758229,말리,2019-03
2019-03-31,1730823,1525650,205173,베네주엘라,2019-03
2019-03-31,1678473,55510,1622963,통가,2019-03
2019-03-31,1447523,1287996,159527,바누아투,2019-03
2019-03-31,1334087,825566,508521,리히텐슈타인,2019-03
2019-03-31,1287958,679505,608453,세이쉘,2019-03
2019-03-31,1249680,7979742,-6730062,모리타니,2019-03
2019-03-31,1194288,610917,583371,수리남,2019-03
2019-03-31,1039405,446604,592801,아르메니아,2019-03
2019-03-31,1032716,924748,107968,몰도바,2019-03
2019-03-31,1010029,0,1010029,큐라소,2019-03
2019-03-31,980173,93558,886615,바베이도스,2019-03
2019-03-31,938605,1521855,-583250,시에라 리온,2019-03
2019-03-31,930457,50527,879930,불령 폴리네시아,2019-03
2019-03-31,919858,87092,832766,가이아나,2019-03
2019-03-31,896284,2443,893841,키리바티,2019-03
2019-03-31,846190,0,846190,세인트 마틴,2019-03
2019-03-31,714207,285367,428840,콩고,2019-03
2019-03-31,683024,405438,277586,말라위,2019-03
2019-03-31,631296,29703,601593,마이크로네시아,2019-03
2019-03-31,619955,0,619955,마티니크,2019-03
2019-03-31,602873,2739,600134,몰디브,2019-03
2019-03-31,587173,196498,390675,마세도니아,2019-03
2019-03-31,534728,58476912,-57942184,가봉,2019-03
2019-03-31,505473,1134,504339,그레나다,2019-03
2019-03-31,493585,28653,464932,영령 캐이맨 군도,2019-03
2019-03-31,397790,1103091,-705301,나미비아,2019-03
2019-03-31,377164,3930,373234,도미니카,2019-03
2019-03-31,368138,3067,365071,몬테네그로,2019-03
2019-03-31,350340,43476,306864,카보 베르데,2019-03
2019-03-31,347423,14603,332820,아메리칸 사모아,2019-03
2019-03-31,340258,11,340247,아루바,2019-03
2019-03-31,300310,4199576,-3899266,스와질랜드,2019-03
2019-03-31,276587,0,276587,불령 가이아나,2019-03
2019-03-31,265972,1702916,-1436944,보스니아-헤르체고비나,2019-03
2019-03-31,262029,0,262029,세인트 루시아,2019-03
2019-03-31,254557,226017,28540,르완다,2019-03
2019-03-31,251584,0,251584,부탄,2019-03
2019-03-31,247756,0,247756,벨리제,2019-03
2019-03-31,247271,116876,130395,보츠와나,2019-03
2019-03-31,239120,644,238476,세인트 키츠 네비스,2019-03
2019-03-31,216163,4911,211252,네덜란드 열도,2019-03
2019-03-31,197198,2795536,-2598338,니제르,2019-03
2019-03-31,168242,589,167653,안도라,2019-03
2019-03-31,153660,365199,-211539,감비아,2019-03
2019-03-31,153290,8152,145138,팔라우,2019-03
2019-03-31,146880,0,146880,나우루,2019-03
2019-03-31,142376,0,142376,세인트 바르탤르미,2019-03
2019-03-31,125098,0,125098,안티가 바부다,2019-03
2019-03-31,112340,202,112138,상토메 프린스페,2019-03
2019-03-31,79525,0,79525,보빗군도,2019-03
2019-03-31,64564,9723,54841,모나코,2019-03
2019-03-31,50732,4212,46520,세인트 빈센트 그레나딘,2019-03
2019-03-31,43189,0,43189,지브랄타,2019-03
2019-03-31,37716,0,37716,투르크 & 카이코스 군도,2019-03
2019-03-31,36699,3300,33399,티모르,2019-03
2019-03-31,35549,0,35549,앙귈라,2019-03
2019-03-31,33764,24881271,-24847507,적도 기니,2019-03
2019-03-31,25929,0,25929,왈라스 & 퓨투나 군도,2019-03
2019-03-31,24487,330,24157,챠드,2019-03
2019-03-31,23035,0,23035,영령 버진군도,2019-03
2019-03-31,9624,19580,-9956,코모로스,2019-03
2019-03-31,4392,1835,2557,부룬디,2019-03
2019-03-31,2750,274303,-271553,파로에 군도,2019-03
2019-03-31,2139,11540,-9401,미령 버진군도,2019-03
2019-03-31,1691,83298,-81607,쿡 아일랜드,2019-03
2019-03-31,696,0,696,남수단,2019-03
2019-03-31,219,0,219,그린랜드,2019-03
2019-03-31,66,0,66,남조지아 & 남샌드위치 군도,2019-03
2019-03-31,0,338,-338,코스 군도,2019-03
2019-03-31,0,205,-205,크리스마스 아일랜드,2019-03
2019-03-31,0,9978,-9978,니우에,2019-03
2019-03-31,0,3459,-3459,레소토,2019-03
2019-03-31,0,69799,-69799,중앙아프리카공화국,2019-03
2019-03-31,0,177153,-177153,산마리노,2019-03
2019-03-31,0,4929,-4929,건지,2019-03
2019-03-31,0,22287610,-22287610,에리트리아,2019-03
2019-03-31,0,3360,-3360,토켈라우,2019-03
2019-03-31,0,88700,-88700,기네비소,2019-03
2019-03-31,0,377,-377,피트카이른,2019-03
2019-03-31,0,3784,-3784,마이너 아우틀링 합중국 군도,2019-03
2019-04-30,12429813199,9793054442,2636758757,중국,2019-04
2019-04-30,6158443400,5585755488,572687912,미국,2019-04
2019-04-30,4197071755,1853324244,2343747511,베트남,2019-04
2019-04-30,2591788494,178317102,2413471392,홍콩,2019-04
2019-04-30,2277192076,4632880639,-2355688563,일본,2019-04
2019-04-30,1365211683,1302324226,62887457,대만,2019-04
2019-04-30,1361362359,568476590,792885769,싱가포르,2019-04
2019-04-30,1322355640,430893353,891462287,인도,2019-04
2019-04-30,930782291,594054487,336727804,멕시코,2019-04
2019-04-30,850587012,2430,850584582,바하마,2019-04
2019-04-30,767487913,1619273712,-851785799,독일,2019-04
2019-04-30,725998032,359417383,366580649,필리핀,2019-04
2019-04-30,724293517,1562612447,-838318930,호주,2019-04
2019-04-30,704578431,665067472,39510959,말레이시아,2019-04
2019-04-30,697126581,1034949057,-337822476,러시아 연방,2019-04
2019-04-30,676562042,856862642,-180300600,인도네시아,2019-04
2019-04-30,665503743,499067158,166436585,태국,2019-04
2019-04-30,646880391,295075465,351804926,영국,2019-04
2019-04-30,582379698,539823255,42556443,네덜란드,2019-04
2019-04-30,518526140,93866941,424659199,튀르키예,2019-04
2019-04-30,496223383,468238359,27985024,캐나다,2019-04
2019-04-30,422632415,299846576,122785839,브라질,2019-04
2019-04-30,419023381,65416240,353607141,폴란드,2019-04
2019-04-30,361259947,527820439,-166560492,이탈리아,2019-04
2019-04-30,344110533,28035,344082498,마샬군도,2019-04
2019-04-30,326748700,517308540,-190559840,프랑스,2019-04
2019-04-30,291297041,818425107,-527128066,이라크,2019-04
2019-04-30,288894269,2092097541,-1803203272,사우디아라비아,2019-04
2019-04-30,282286487,239471,282047016,라이베리아,2019-04
2019-04-30,263329473,860892169,-597562696,아랍에미리트 연합,2019-04
2019-04-30,255973924,185140448,70833476,스페인,2019-04
2019-04-30,248305330,12478979,235826351,파나마,2019-04
2019-04-30,230839474,111896902,118942572,벨기에,2019-04
2019-04-30,199529159,99752231,99776928,카자흐스탄,2019-04
2019-04-30,192990431,34008259,158982172,슬로바키아,2019-04
2019-04-30,189430584,1836758,187593826,우즈베키스탄,2019-04
2019-04-30,181750212,44643698,137106514,헝가리,2019-04
2019-04-30,171737266,76471144,95266122,체코공화국,2019-04
2019-04-30,156693725,3852833,152840892,몰타,2019-04
2019-04-30,149627509,420990618,-271363109,칠레,2019-04
2019-04-30,148540310,8477456,140062854,슬로베니아,2019-04
2019-04-30,117382535,125308214,-7925679,뉴질랜드,2019-04
2019-04-30,113688869,22597721,91091148,이집트,2019-04
2019-04-30,109573870,81577049,27996821,이스라엘,2019-04
2019-04-30,101408421,35486116,65922305,방글라데시,2019-04
2019-04-30,98666220,154022244,-55356024,스웨덴,2019-04
2019-04-30,96838000,246445739,-149607739,페루,2019-04
2019-04-30,84200899,116256802,-32055903,노르웨이,2019-04
2019-04-30,82546821,34134354,48412467,콜롬비아,2019-04
2019-04-30,75589752,116180357,-40590605,알제리,2019-04
2019-04-30,75083657,36018138,39065519,파키스탄,2019-04
2019-04-30,72036880,269816081,-197779201,남아프리카공화국,2019-04
2019-04-30,67567339,1329782,66237557,아이슬란드,2019-04
2019-04-30,66455597,128479851,-62024254,오스트리아,2019-04
2019-04-30,64548981,13412653,51136328,에쿠아도르,2019-04
2019-04-30,61473814,403139,61070675,리비아,2019-04
2019-04-30,60876699,1929891,58946808,토고,2019-04
2019-04-30,60711262,421,60710841,지브랄타,2019-04
2019-04-30,59763894,25695273,34068621,캄보디아,2019-04
2019-04-30,59546614,907349444,-847802830,쿠웨이트,2019-04
2019-04-30,58559811,220361012,-161801201,오만,2019-04
2019-04-30,57836360,42966763,14869597,나이지리아,2019-04
2019-04-30,57080399,242429516,-185349117,스위스,2019-04
2019-04-30,52175218,38592203,13583015,미얀마,2019-04
2019-04-30,49840318,1759963,48080355,크로아티아,2019-04
2019-04-30,48255267,9059259,39196008,요르단,2019-04
2019-04-30,48065808,117659345,-69593537,아일랜드,2019-04
2019-04-30,44825397,21576042,23249355,포루투갈,2019-04
2019-04-30,44494479,858842226,-814347747,카타르,2019-04
2019-04-30,42534270,41962744,571526,루마니아,2019-04
2019-04-30,39469271,72137186,-32667915,그리스,2019-04
2019-04-30,37572719,5985747,31586972,리투아니아,2019-04
2019-04-30,34021814,849203843,-815182029,이란,2019-04
2019-04-30,33906541,79548119,-45641578,덴마크,2019-04
2019-04-30,33688094,902648,32785446,피지,2019-04
2019-04-30,31983073,29656227,2326846,아르헨티나,2019-04
2019-04-30,31632472,1976937,29655535,몽골,2019-04
2019-04-30,30230292,13455215,16775077,푸에르토리코,2019-04
2019-04-30,27357820,88969140,-61611320,우크라이나,2019-04
2019-04-30,26931402,293388,26638014,괌,2019-04
2019-04-30,26684626,10422238,16262388,모로코,2019-04
2019-04-30,23259396,7872071,15387325,도미니카 공화국,2019-04
2019-04-30,22958562,86689842,-63731280,핀란드,2019-04
2019-04-30,22443950,8687564,13756386,스리랑카,2019-04
2019-04-30,19372376,4265509,15106867,가나,2019-04
2019-04-30,18310130,5116804,13193326,과테말라,2019-04
2019-04-30,18251352,1539253,16712099,레바논,2019-04
2019-04-30,17721615,4408680,13312935,케냐,2019-04
2019-04-30,17286568,5990,17280578,시리아,2019-04
2019-04-30,15855114,37552702,-21697588,코스타리카,2019-04
2019-04-30,15359645,4579980,10779665,예맨,2019-04
2019-04-30,13614404,16858240,-3243836,세르비아,2019-04
2019-04-30,13349023,21865603,-8516580,불가리아,2019-04
2019-04-30,13229613,31366344,-18136731,바레인,2019-04
2019-04-30,13064690,2033467,11031223,파라과이,2019-04
2019-04-30,13047775,3910303,9137472,튀니지,2019-04
2019-04-30,12758409,371084,12387325,코트디봐르,2019-04
2019-04-30,12563463,4948091,7615372,탄자니아,2019-04
2019-04-30,12482949,8080523,4402426,온두라스,2019-04
2019-04-30,12405994,2368217,10037777,수단,2019-04
2019-04-30,12389987,1064686,11325301,앙골라,2019-04
2019-04-30,10317967,2157136,8160831,엘살바도르,2019-04
2019-04-30,10307023,77112751,-66805728,브루나이,2019-04
2019-04-30,9473035,4713665,4759370,에스토니아,2019-04
2019-04-30,9354423,966853,8387570,조지아,2019-04
2019-04-30,9152543,11338538,-2185995,우루과이,2019-04
2019-04-30,8686662,8036584,650078,라트비아,2019-04
2019-04-30,8353639,11262903,-2909264,모잠비크,2019-04
2019-04-30,8262550,173219,8089331,쿠바,2019-04
2019-04-30,7887424,836920,7050504,소말리아,2019-04
2019-04-30,7573836,9446,7564390,키르기스스탄,2019-04
2019-04-30,6728922,1556391,5172531,니카라과,2019-04
2019-04-30,6583809,3005321,3578488,에티오피아,2019-04
2019-04-30,6382553,3307774,3074779,세네갈,2019-04
2019-04-30,6323395,20910111,-14586716,트리니다드 토바고,2019-04
2019-04-30,6154339,404463,5749876,아이티,2019-04
2019-04-30,5658970,696655,4962315,베닝,2019-04
2019-04-30,5437068,3567196,1869872,라오스,2019-04
2019-04-30,5211610,340306,4871304,팔레스타인 해방기구,2019-04
2019-04-30,5109835,127675,4982160,네팔,2019-04
2019-04-30,4592939,17920,4575019,말리,2019-04
2019-04-30,4475875,636,4475239,아프카니스탄,2019-04
2019-04-30,3856657,707439,3149218,지부티,2019-04
2019-04-30,3639060,162782,3476278,사모아,2019-04
2019-04-30,3414951,29616,3385335,아제르바이잔,2019-04
2019-04-30,3331104,11125514,-7794410,파푸아 뉴기니,2019-04
2019-04-30,3290549,18587889,-15297340,볼리비아,2019-04
2019-04-30,3133125,6785774,-3652649,벨라루스,2019-04
2019-04-30,3016849,366386,2650463,모리셔스,2019-04
2019-04-30,2997393,36270922,-33273529,콩고민주공화국,2019-04
2019-04-30,2927328,4700178,-1772850,기니,2019-04
2019-04-30,2860234,16659213,-13798979,사이프러스,2019-04
2019-04-30,2834458,254207402,-251372944,기타국,2019-04
2019-04-30,2658934,201113,2457821,짐바브웨,2019-04
2019-04-30,2632962,4213,2628749,투르크멘,2019-04
2019-04-30,2586581,1365,2585216,불령 리유니온 코모도 제도,2019-04
2019-04-30,2537202,154281,2382921,마카오,2019-04
2019-04-30,2495016,6762803,-4267787,룩셈부르그,2019-04
2019-04-30,2486995,275,2486720,카보 베르데,2019-04
2019-04-30,2478397,254540,2223857,콩고,2019-04
2019-04-30,2390486,319640,2070846,자마이카,2019-04
2019-04-30,2311293,6266740,-3955447,마다카스카르,2019-04
2019-04-30,2151375,1157467,993908,수리남,2019-04
2019-04-30,2104929,113806,1991123,카메룬,2019-04
2019-04-30,2003567,16,2003551,부르키나 파소,2019-04
2019-04-30,1989467,3527,1985940,타지크,2019-04
2019-04-30,1885915,2114683,-228768,바누아투,2019-04
2019-04-30,1873046,12481528,-10608482,뉴 칼레도니아,2019-04
2019-04-30,1857826,0,1857826,큐라소,2019-04
2019-04-30,1843167,318850,1524317,세이쉘,2019-04
2019-04-30,1785088,56116017,-54330929,가봉,2019-04
2019-04-30,1610326,195,1610131,나우루,2019-04
2019-04-30,1595655,816889,778766,우간다,2019-04
2019-04-30,1558963,0,1558963,아루바,2019-04
2019-04-30,1491638,217955,1273683,르완다,2019-04
2019-04-30,1480270,193500,1286770,불령 폴리네시아,2019-04
2019-04-30,1403142,530985,872157,북마리아나 군도,2019-04
2019-04-30,1397271,2215907,-818636,잠비아,2019-04
2019-04-30,1339457,719694,619763,리히텐슈타인,2019-04
2019-04-30,1227168,136511,1090657,알바니아,2019-04
2019-04-30,1063564,97811,965753,가이아나,2019-04
2019-04-30,1063080,1007457,55623,베네주엘라,2019-04
2019-04-30,947837,34231,913606,과델로프,2019-04
2019-04-30,943273,0,943273,키리바티,2019-04
2019-04-30,935517,152990,782527,마세도니아,2019-04
2019-04-30,924375,1143099,-218724,몰도바,2019-04
2019-04-30,858048,359420,498628,아르메니아,2019-04
2019-04-30,853010,0,853010,세인트 마틴,2019-04
2019-04-30,849733,36946,812787,바베이도스,2019-04
2019-04-30,807145,0,807145,영령 캐이맨 군도,2019-04
2019-04-30,761793,1672517,-910724,솔로몬 군도,2019-04
2019-04-30,719897,829,719068,몰디브,2019-04
2019-04-30,717220,26081,691139,마티니크,2019-04
2019-04-30,703164,1130568,-427404,시에라 리온,2019-04
2019-04-30,663818,0,663818,버뮤다,2019-04
2019-04-30,659646,20,659626,앙귈라,2019-04
2019-04-30,499391,0,499391,그레나다,2019-04
2019-04-30,490213,1931375,-1441162,모리타니,2019-04
2019-04-30,438642,0,438642,불령 가이아나,2019-04
2019-04-30,423196,341459,81737,감비아,2019-04
2019-04-30,394510,291902,102608,말라위,2019-04
2019-04-30,382785,329055,53730,마이크로네시아,2019-04
2019-04-30,365911,0,365911,팔라우,2019-04
2019-04-30,347802,832,346970,몬테네그로,2019-04
2019-04-30,319954,322414,-2460,니제르,2019-04
2019-04-30,311786,0,311786,영령 버진군도,2019-04
2019-04-30,263840,4241923,-3978083,스와질랜드,2019-04
2019-04-30,258647,182074,76573,적도 기니,2019-04
2019-04-30,257079,213471,43608,아메리칸 사모아,2019-04
2019-04-30,251954,7439,244515,도미니카,2019-04
2019-04-30,249155,0,249155,에리트리아,2019-04
2019-04-30,232980,39042,193938,보츠와나,2019-04
2019-04-30,192374,0,192374,벨리제,2019-04
2019-04-30,182857,13826,169031,안티가 바부다,2019-04
2019-04-30,179241,2179833,-2000592,보스니아-헤르체고비나,2019-04
2019-04-30,143221,359128,-215907,나미비아,2019-04
2019-04-30,125083,382,124701,부탄,2019-04
2019-04-30,123208,1456,121752,세인트 키츠 네비스,2019-04
2019-04-30,114841,0,114841,세인트 빈센트 그레나딘,2019-04
2019-04-30,111834,0,111834,세인트 루시아,2019-04
2019-04-30,95632,0,95632,챠드,2019-04
2019-04-30,88660,0,88660,네덜란드 열도,2019-04
2019-04-30,65669,330,65339,통가,2019-04
2019-04-30,45772,248953,-203181,기네비소,2019-04
2019-04-30,39344,0,39344,중앙아프리카공화국,2019-04
2019-04-30,36026,0,36026,상토메 프린스페,2019-04
2019-04-30,31051,11167,19884,안도라,2019-04
2019-04-30,28009,875,27134,레소토,2019-04
2019-04-30,16798,236,16562,티모르,2019-04
2019-04-30,14910,0,14910,메요트,2019-04
2019-04-30,11568,0,11568,왈라스 & 퓨투나 군도,2019-04
2019-04-30,10430,389402,-378972,모나코,2019-04
2019-04-30,9012,59371,-50359,쿡 아일랜드,2019-04
2019-04-30,7500,0,7500,남수단,2019-04
2019-04-30,4899,0,4899,투발루,2019-04
2019-04-30,4454,13920,-9466,코모로스,2019-04
2019-04-30,2234,0,2234,건지,2019-04
2019-04-30,2066,0,2066,포클랜드 군도,2019-04
2019-04-30,1837,0,1837,세인트 바르탤르미,2019-04
2019-04-30,1781,17280,-15499,그린랜드,2019-04
2019-04-30,1658,4600,-2942,미령 버진군도,2019-04
2019-04-30,164,2379,-2215,세인트 헬레나,2019-04
2019-04-30,150,12,138,부룬디,2019-04
2019-04-30,0,6872,-6872,몬트세라트,2019-04
2019-04-30,0,3005442,-3005442,니우에,2019-04
2019-04-30,0,413,-413,토켈라우,2019-04
2019-04-30,0,61,-61,피트카이른,2019-04
2019-04-30,0,34,-34,남조지아 & 남샌드위치 군도,2019-04
2019-04-30,0,25200,-25200,파로에 군도,2019-04
2019-04-30,0,69220,-69220,산마리노,2019-04
2019-04-30,0,438,-438,마이너 아우틀링 합중국 군도,2019-04
2019-04-30,0,583,-583,영령 인도양,2019-04
2019-04-30,0,3190718,-3190718,안타티카,2019-04
2019-04-30,0,2342,-2342,맨섬,2019-04
2019-05-31,11014512679,9943418613,1071094066,중국,2019-05
2019-05-31,6500300797,5512695873,987604924,미국,2019-05
2019-05-31,3648722440,1500624342,2148098098,베트남,2019-05
2019-05-31,2944595164,219682097,2724913067,홍콩,2019-05
2019-05-31,2533489284,3715763883,-1182274599,일본,2019-05
2019-05-31,1414633494,568307912,846325582,인도,2019-05
2019-05-31,1314273289,1284695283,29578006,대만,2019-05
2019-05-31,986597471,540513923,446083548,싱가포르,2019-05
2019-05-31,943571064,438179087,505391977,멕시코,2019-05
2019-05-31,809083254,733333690,75749564,말레이시아,2019-05
2019-05-31,760332508,1613921886,-853589378,독일,2019-05
2019-05-31,747590118,1056366891,-308776773,러시아 연방,2019-05
2019-05-31,716840789,383130818,333709971,필리핀,2019-05
2019-05-31,677888812,455991624,221897188,태국,2019-05
2019-05-31,665620599,1760505270,-1094884671,호주,2019-05
2019-05-31,602297189,471156349,131140840,캐나다,2019-05
2019-05-31,598750138,715304659,-116554521,인도네시아,2019-05
2019-05-31,452372447,136770387,315602060,튀르키예,2019-05
2019-05-31,450457244,65057264,385399980,폴란드,2019-05
2019-05-31,449469002,276852269,172616733,브라질,2019-05
2019-05-31,439991249,370793482,69197767,영국,2019-05
2019-05-31,409711913,66084,409645829,마샬군도,2019-05
2019-05-31,366190940,546037415,-179846475,이탈리아,2019-05
2019-05-31,351871044,369280550,-17409506,네덜란드,2019-05
2019-05-31,315615326,687940,314927386,라이베리아,2019-05
2019-05-31,314174830,735411015,-421236185,아랍에미리트 연합,2019-05
2019-05-31,264233849,576153083,-311919234,프랑스,2019-05
2019-05-31,253962342,1955036556,-1701074214,사우디아라비아,2019-05
2019-05-31,240735330,103357690,137377640,벨기에,2019-05
2019-05-31,230201041,164716990,65484051,카자흐스탄,2019-05
2019-05-31,226907644,147268477,79639167,스페인,2019-05
2019-05-31,213108087,65922521,147185566,체코공화국,2019-05
2019-05-31,212872819,40364024,172508795,헝가리,2019-05
2019-05-31,191593235,18893835,172699400,슬로바키아,2019-05
2019-05-31,191536259,1568588,189967671,우즈베키스탄,2019-05
2019-05-31,180280341,8712977,171567364,슬로베니아,2019-05
2019-05-31,154726010,741023121,-586297111,이라크,2019-05
2019-05-31,130520889,6400985,124119904,이집트,2019-05
2019-05-31,123848256,24357149,99491107,방글라데시,2019-05
2019-05-31,109958154,320792307,-210834153,칠레,2019-05
2019-05-31,97583185,173910975,-76327790,스웨덴,2019-05
2019-05-31,96914027,81883225,15030802,이스라엘,2019-05
2019-05-31,96236837,150647416,-54410579,뉴질랜드,2019-05
2019-05-31,91185173,89463568,1721605,나이지리아,2019-05
2019-05-31,90352462,43766640,46585822,파키스탄,2019-05
2019-05-31,85109306,95430198,-10320892,노르웨이,2019-05
2019-05-31,84146956,167756837,-83609881,남아프리카공화국,2019-05
2019-05-31,83192904,3283,83189621,바하마,2019-05
2019-05-31,78044933,90484424,-12439491,콜롬비아,2019-05
2019-05-31,77812966,219779779,-141966813,페루,2019-05
2019-05-31,73687567,1014769,72672798,앙골라,2019-05
2019-05-31,69524065,126876486,-57352421,오스트리아,2019-05
2019-05-31,67558457,1091580293,-1024021836,쿠웨이트,2019-05
2019-05-31,66284414,240882460,-174598046,알제리,2019-05
2019-05-31,63358158,21620042,41738116,캄보디아,2019-05
2019-05-31,61864188,26788174,35076014,미얀마,2019-05
2019-05-31,60507150,4553747,55953403,토고,2019-05
2019-05-31,54742634,110447103,-55704469,아일랜드,2019-05
2019-05-31,45254081,5599107,39654974,파나마,2019-05
2019-05-31,44780765,81715133,-36934368,리비아,2019-05
2019-05-31,41661012,271205554,-229544542,스위스,2019-05
2019-05-31,41473578,37277429,4196149,루마니아,2019-05
2019-05-31,39042925,102404819,-63361894,덴마크,2019-05
2019-05-31,38701651,221166267,-182464616,오만,2019-05
2019-05-31,37999488,9847046,28152442,요르단,2019-05
2019-05-31,36512494,24866262,11646232,포루투갈,2019-05
2019-05-31,35285863,48774432,-13488569,아르헨티나,2019-05
2019-05-31,30949590,12637908,18311682,에쿠아도르,2019-05
2019-05-31,30394508,1022133362,-991738854,카타르,2019-05
2019-05-31,29281523,392502,28889021,몽골,2019-05
2019-05-31,27749818,26091917,1657901,우크라이나,2019-05
2019-05-31,26385997,80408907,-54022910,핀란드,2019-05
2019-05-31,26342202,113180526,-86838324,그리스,2019-05
2019-05-31,24663889,1594670,23069219,피지,2019-05
2019-05-31,23513686,5917993,17595693,리투아니아,2019-05
2019-05-31,23432449,19338538,4093911,푸에르토리코,2019-05
2019-05-31,22491206,5998852,16492354,도미니카 공화국,2019-05
2019-05-31,20262546,13544120,6718426,모로코,2019-05
2019-05-31,18488302,18732451,-244149,바레인,2019-05
2019-05-31,17323741,6342509,10981232,스리랑카,2019-05
2019-05-31,16448210,6114433,10333777,과테말라,2019-05
2019-05-31,14901581,880519,14021062,이란,2019-05
2019-05-31,14636602,4152048,10484554,탄자니아,2019-05
2019-05-31,14555555,2697780,11857775,가나,2019-05
2019-05-31,14173231,15764726,-1591495,세르비아,2019-05
2019-05-31,14013022,242858,13770164,시리아,2019-05
2019-05-31,12164126,371315,11792811,코트디봐르,2019-05
2019-05-31,11992213,12068978,-76765,불가리아,2019-05
2019-05-31,11557422,12524985,-967563,우루과이,2019-05
2019-05-31,10891381,4614,10886767,아제르바이잔,2019-05
2019-05-31,10820183,12776593,-1956410,엘살바도르,2019-05
2019-05-31,10737541,1337120,9400421,크로아티아,2019-05
2019-05-31,10649174,418367775,-407718601,레바논,2019-05
2019-05-31,10598352,5383248,5215104,예맨,2019-05
2019-05-31,10372463,4349281,6023182,케냐,2019-05
2019-05-31,10213711,4865064,5348647,온두라스,2019-05
2019-05-31,10040289,2988433,7051856,튀니지,2019-05
2019-05-31,9885935,1813898,8072037,파라과이,2019-05
2019-05-31,9526911,6369540,3157371,에티오피아,2019-05
2019-05-31,9455256,40489250,-31033994,코스타리카,2019-05
2019-05-31,9244860,5554996,3689864,에스토니아,2019-05
2019-05-31,7894985,4700288,3194697,라오스,2019-05
2019-05-31,7823780,17204218,-9380438,트리니다드 토바고,2019-05
2019-05-31,7632951,105720,7527231,아이티,2019-05
2019-05-31,7371053,1034478,6336575,수단,2019-05
2019-05-31,7030187,1864,7028323,키르기스스탄,2019-05
2019-05-31,6838071,216344,6621727,팔레스타인 해방기구,2019-05
2019-05-31,6778160,25198242,-18420082,뉴 칼레도니아,2019-05
2019-05-31,6619999,184865,6435134,네팔,2019-05
2019-05-31,6178985,7569658,-1390673,라트비아,2019-05
2019-05-31,6151841,3942435,2209406,벨라루스,2019-05
2019-05-31,6128722,2180595,3948127,니카라과,2019-05
2019-05-31,6086581,183633184,-177546603,기타국,2019-05
2019-05-31,6036026,2927326,3108700,파푸아 뉴기니,2019-05
2019-05-31,5976884,916478,5060406,조지아,2019-05
2019-05-31,5678353,1668,5676685,아프카니스탄,2019-05
2019-05-31,5508274,299293,5208981,베닝,2019-05
2019-05-31,5355901,3517295,1838606,세네갈,2019-05
2019-05-31,5266698,20455957,-15189259,몰타,2019-05
2019-05-31,5181733,511572,4670161,괌,2019-05
2019-05-31,4962715,30430415,-25467700,콩고민주공화국,2019-05
2019-05-31,4579905,91322716,-86742811,브루나이,2019-05
2019-05-31,4414271,407519,4006752,자마이카,2019-05
2019-05-31,4255398,1497287,2758111,쿠바,2019-05
2019-05-31,3960754,17802641,-13841887,모잠비크,2019-05
2019-05-31,3359097,1532101,1826996,부르키나 파소,2019-05
2019-05-31,3346435,988831,2357604,아이슬란드,2019-05
2019-05-31,3103915,511747,2592168,지부티,2019-05
2019-05-31,3073338,48004427,-44931089,볼리비아,2019-05
2019-05-31,3028175,253857,2774318,사모아,2019-05
2019-05-31,2960746,1371112,1589634,마카오,2019-05
2019-05-31,2946379,646600,2299779,모리셔스,2019-05
2019-05-31,2755219,209107,2546112,사이프러스,2019-05
2019-05-31,2411579,0,2411579,타지크,2019-05
2019-05-31,2394780,569607,1825173,우간다,2019-05
2019-05-31,2376586,909,2375677,불령 리유니온 코모도 제도,2019-05
2019-05-31,2336251,73,2336178,불령 폴리네시아,2019-05
2019-05-31,2102676,379834,1722842,수리남,2019-05
2019-05-31,2100595,1871549,229046,베네주엘라,2019-05
2019-05-31,1977868,14079941,-12102073,마다카스카르,2019-05
2019-05-31,1812811,643947,1168864,아르메니아,2019-05
2019-05-31,1664526,182083,1482443,카메룬,2019-05
2019-05-31,1428489,4473544,-3045055,기니,2019-05
2019-05-31,1411203,5767647,-4356444,룩셈부르그,2019-05
2019-05-31,1336823,13912,1322911,과델로프,2019-05
2019-05-31,1298594,923487,375107,세이쉘,2019-05
2019-05-31,1268495,197440,1071055,알바니아,2019-05
2019-05-31,1254067,2325282,-1071215,잠비아,2019-05
2019-05-31,1223536,1454,1222082,말리,2019-05
2019-05-31,1206182,835615,370567,리히텐슈타인,2019-05
2019-05-31,1196687,904217,292470,몰도바,2019-05
2019-05-31,1148625,689453,459172,콩고,2019-05
2019-05-31,1069844,0,1069844,마티니크,2019-05
2019-05-31,1061359,263219,798140,소말리아,2019-05
2019-05-31,1029525,253342,776183,북마리아나 군도,2019-05
2019-05-31,1026794,2784278,-1757484,니제르,2019-05
2019-05-31,1018451,0,1018451,큐라소,2019-05
2019-05-31,1009628,78375,931253,가봉,2019-05
2019-05-31,997481,113233,884248,가이아나,2019-05
2019-05-31,992625,0,992625,아루바,2019-05
2019-05-31,984350,3209994,-2225644,짐바브웨,2019-05
2019-05-31,880838,77425,803413,마세도니아,2019-05
2019-05-31,841306,1840999,-999693,모리타니,2019-05
2019-05-31,760465,18,760447,버뮤다,2019-05
2019-05-31,754855,263,754592,몬테네그로,2019-05
2019-05-31,739255,0,739255,안티가 바부다,2019-05
2019-05-31,731581,9754523,-9022942,말라위,2019-05
2019-05-31,687912,13742,674170,아메리칸 사모아,2019-05
2019-05-31,595524,342121,253403,키리바티,2019-05
2019-05-31,556253,0,556253,세인트 마틴,2019-05
2019-05-31,483073,2052653,-1569580,시에라 리온,2019-05
2019-05-31,470701,100,470601,팔라우,2019-05
2019-05-31,459574,138810,320764,바베이도스,2019-05
2019-05-31,456943,1336141,-879198,보스니아-헤르체고비나,2019-05
2019-05-31,443121,565,442556,불령 가이아나,2019-05
2019-05-31,412226,0,412226,세인트 루시아,2019-05
2019-05-31,411878,868107,-456229,솔로몬 군도,2019-05
2019-05-31,375101,3744722,-3369621,바누아투,2019-05
2019-05-31,321444,79098,242346,마이크로네시아,2019-05
2019-05-31,311941,216112,95829,르완다,2019-05
2019-05-31,288427,18873,269554,도미니카,2019-05
2019-05-31,280784,446,280338,티모르,2019-05
2019-05-31,267201,3866095,-3598894,나우루,2019-05
2019-05-31,257504,2463,255041,몰디브,2019-05
2019-05-31,221078,189,220889,영령 캐이맨 군도,2019-05
2019-05-31,208852,0,208852,영령 버진군도,2019-05
2019-05-31,197853,133108,64745,벨리제,2019-05
2019-05-31,194627,0,194627,그레나다,2019-05
2019-05-31,189562,0,189562,투르크멘,2019-05
2019-05-31,183224,6233414,-6050190,스와질랜드,2019-05
2019-05-31,150867,37016,113851,보츠와나,2019-05
2019-05-31,138320,13411,124909,안도라,2019-05
2019-05-31,128829,0,128829,네덜란드 열도,2019-05
2019-05-31,105910,574612,-468702,감비아,2019-05
2019-05-31,97248,13322426,-13225178,나미비아,2019-05
2019-05-31,93685,0,93685,부탄,2019-05
2019-05-31,72151,171,71980,투르크 & 카이코스 군도,2019-05
2019-05-31,71661,35347661,-35276000,적도 기니,2019-05
2019-05-31,63871,32,63839,메요트,2019-05
2019-05-31,31427,0,31427,중앙아프리카공화국,2019-05
2019-05-31,29589,1300,28289,지브랄타,2019-05
2019-05-31,23510,3391,20119,챠드,2019-05
2019-05-31,23455,12639,10816,세인트 빈센트 그레나딘,2019-05
2019-05-31,23144,1198,21946,세인트 키츠 네비스,2019-05
2019-05-31,21751,0,21751,코모로스,2019-05
2019-05-31,14667,37701,-23034,모나코,2019-05
2019-05-31,8100,8669,-569,부룬디,2019-05
2019-05-31,5532,445,5087,카보 베르데,2019-05
2019-05-31,4992,13238,-8246,미령 버진군도,2019-05
2019-05-31,3449,0,3449,파로에 군도,2019-05
2019-05-31,3144,0,3144,세인트 바르탤르미,2019-05
2019-05-31,3028,8583,-5555,그린랜드,2019-05
2019-05-31,2494,0,2494,앙귈라,2019-05
2019-05-31,1962,1118,844,몬트세라트,2019-05
2019-05-31,1800,11420,-9620,산마리노,2019-05
2019-05-31,1458,0,1458,투발루,2019-05
2019-05-31,1066,14778134,-14777068,에리트리아,2019-05
2019-05-31,0,106,-106,코스 군도,2019-05
2019-05-31,0,231419,-231419,기네비소,2019-05
2019-05-31,0,14227,-14227,레소토,2019-05
2019-05-31,0,431,-431,남조지아 & 남샌드위치 군도,2019-05
2019-05-31,0,398,-398,저어지,2019-05
2019-05-31,0,513,-513,마이너 아우틀링 합중국 군도,2019-05
2019-05-31,0,7705,-7705,토켈라우,2019-05
2019-05-31,0,20930,-20930,통가,2019-05
2019-05-31,0,262,-262,남수단,2019-05
2019-05-31,0,3863,-3863,니우에,2019-05
2019-05-31,0,17,-17,건지,2019-05
2019-05-31,0,57914,-57914,쿡 아일랜드,2019-05
2019-06-30,10422956041,8656550757,1766405284,중국,2019-06
2019-06-30,6249176071,4671519057,1577657014,미국,2019-06
2019-06-30,3589371927,1516165697,2073206230,베트남,2019-06
2019-06-30,2871892240,109543400,2762348840,홍콩,2019-06
2019-06-30,2255618857,3881637920,-1626019063,일본,2019-06
2019-06-30,1279975456,1261269209,18706247,대만,2019-06
2019-06-30,1271462559,523079943,748382616,인도,2019-06
2019-06-30,968410930,498697338,469713592,멕시코,2019-06
2019-06-30,822704182,555465516,267238666,싱가포르,2019-06
2019-06-30,723905103,377535812,346369291,필리핀,2019-06
2019-06-30,699696321,1501146427,-801450106,독일,2019-06
2019-06-30,697487974,676814288,20673686,말레이시아,2019-06
2019-06-30,650126027,1044752498,-394626471,러시아 연방,2019-06
2019-06-30,638612845,661052005,-22439160,인도네시아,2019-06
2019-06-30,634848350,481495274,153353076,태국,2019-06
2019-06-30,616376060,1717384409,-1101008349,호주,2019-06
2019-06-30,545587023,276531327,269055696,영국,2019-06
2019-06-30,517588894,498128247,19460647,캐나다,2019-06
2019-06-30,435347232,195794498,239552734,브라질,2019-06
2019-06-30,403976665,94266365,309710300,튀르키예,2019-06
2019-06-30,401552676,550,401552126,바하마,2019-06
2019-06-30,375726256,55848997,319877259,폴란드,2019-06
2019-06-30,362012280,217021,361795259,라이베리아,2019-06
2019-06-30,323593893,596437156,-272843263,아랍에미리트 연합,2019-06
2019-06-30,321890802,440086499,-118195697,네덜란드,2019-06
2019-06-30,297052581,2048878343,-1751825762,사우디아라비아,2019-06
2019-06-30,289441065,554095684,-264654619,이탈리아,2019-06
2019-06-30,248420052,450618448,-202198396,프랑스,2019-06
2019-06-30,235235213,100380245,134854968,노르웨이,2019-06
2019-06-30,232669286,98237181,134432105,벨기에,2019-06
2019-06-30,229274385,20485882,208788503,그리스,2019-06
2019-06-30,227763199,165878224,61884975,카자흐스탄,2019-06
2019-06-30,222665030,177750781,44914249,스페인,2019-06
2019-06-30,205913360,41848272,164065088,헝가리,2019-06
2019-06-30,196106879,12899780,183207099,마샬군도,2019-06
2019-06-30,189456657,4121138,185335519,토고,2019-06
2019-06-30,180446956,16092432,164354524,슬로바키아,2019-06
2019-06-30,168191371,65091723,103099648,체코공화국,2019-06
2019-06-30,158830086,1753365,157076721,우즈베키스탄,2019-06
2019-06-30,140905025,8202055,132702970,슬로베니아,2019-06
2019-06-30,135660195,768898004,-633237809,이라크,2019-06
2019-06-30,128456390,3063100,125393290,파나마,2019-06
2019-06-30,120183304,5396138,114787166,이집트,2019-06
2019-06-30,107991840,468904008,-360912168,칠레,2019-06
2019-06-30,107736876,129597589,-21860713,뉴질랜드,2019-06
2019-06-30,93417197,31218230,62198967,방글라데시,2019-06
2019-06-30,88068437,69976910,18091527,콜롬비아,2019-06
2019-06-30,84618272,65273330,19344942,이스라엘,2019-06
2019-06-30,72849260,229065025,-156215765,스위스,2019-06
2019-06-30,70988368,192012570,-121024202,남아프리카공화국,2019-06
2019-06-30,68515776,104360757,-35844981,스웨덴,2019-06
2019-06-30,65481325,33259509,32221816,루마니아,2019-06
2019-06-30,64989835,108447863,-43458028,페루,2019-06
2019-06-30,61700529,54953154,6747375,파키스탄,2019-06
2019-06-30,60811460,106895885,-46084425,오스트리아,2019-06
2019-06-30,58528546,95225741,-36697195,나이지리아,2019-06
2019-06-30,58311850,23046279,35265571,캄보디아,2019-06
2019-06-30,57646510,228059456,-170412946,오만,2019-06
2019-06-30,51671289,8529397,43141892,요르단,2019-06
2019-06-30,51003784,753985339,-702981555,쿠웨이트,2019-06
2019-06-30,50842128,80145710,-29303582,아일랜드,2019-06
2019-06-30,46166356,17749459,28416897,모로코,2019-06
2019-06-30,44270547,53766714,-9496167,덴마크,2019-06
2019-06-30,42503484,39647878,2855606,미얀마,2019-06
2019-06-30,41908252,44521054,-2612802,우크라이나,2019-06
2019-06-30,39123227,32544541,6578686,리비아,2019-06
2019-06-30,37293747,136546548,-99252801,에쿠아도르,2019-06
2019-06-30,35018184,108914898,-73896714,알제리,2019-06
2019-06-30,33605861,21888103,11717758,포루투갈,2019-06
2019-06-30,32493064,4075009,28418055,튀니지,2019-06
2019-06-30,31824671,5675507,26149164,리투아니아,2019-06
2019-06-30,29069350,92221011,-63151661,아르헨티나,2019-06
2019-06-30,28797517,1228425999,-1199628482,카타르,2019-06
2019-06-30,28605242,2564488,26040754,몽골,2019-06
2019-06-30,27600881,93913022,-66312141,핀란드,2019-06
2019-06-30,26846233,3292745,23553488,크로아티아,2019-06
2019-06-30,25984636,60190986,-34206350,바레인,2019-06
2019-06-30,20085772,6236233,13849539,도미니카 공화국,2019-06
2019-06-30,18746980,20806959,-2059979,푸에르토리코,2019-06
2019-06-30,16824523,5088198,11736325,과테말라,2019-06
2019-06-30,15968912,3344378,12624534,가나,2019-06
2019-06-30,15879625,7428437,8451188,스리랑카,2019-06
2019-06-30,15249657,784363,14465294,이란,2019-06
2019-06-30,14513629,1903031,12610598,레바논,2019-06
2019-06-30,14350898,9961145,4389753,불가리아,2019-06
2019-06-30,11570949,16338510,-4767561,온두라스,2019-06
2019-06-30,11256550,8574174,2682376,우루과이,2019-06
2019-06-30,11176026,20924482,-9748456,세르비아,2019-06
2019-06-30,10843542,11816845,-973303,트리니다드 토바고,2019-06
2019-06-30,10649118,5223600,5425518,에스토니아,2019-06
2019-06-30,10254470,640457,9614013,탄자니아,2019-06
2019-06-30,10090557,1167903,8922654,코트디봐르,2019-06
2019-06-30,9880989,601366,9279623,브루나이,2019-06
2019-06-30,9700324,4061336,5638988,케냐,2019-06
2019-06-30,9613478,5463872,4149606,에티오피아,2019-06
2019-06-30,9467417,2806326,6661091,라오스,2019-06
2019-06-30,8696789,706960,7989829,파라과이,2019-06
2019-06-30,8446475,4789,8441686,키르기스스탄,2019-06
2019-06-30,8194472,5676509,2517963,엘살바도르,2019-06
2019-06-30,7918004,553690,7364314,아이티,2019-06
2019-06-30,7660772,13966,7646806,시리아,2019-06
2019-06-30,7465139,1819277,5645862,예맨,2019-06
2019-06-30,7390018,8131082,-741064,라트비아,2019-06
2019-06-30,6973209,10020657,-3047448,코스타리카,2019-06
2019-06-30,6945606,349499,6596107,괌,2019-06
2019-06-30,6775253,1572631,5202622,조지아,2019-06
2019-06-30,6185767,2865354,3320413,몰타,2019-06
2019-06-30,6123023,2219468,3903555,수단,2019-06
2019-06-30,5718042,113007,5605035,앙골라,2019-06
2019-06-30,5161096,26896,5134200,아제르바이잔,2019-06
2019-06-30,5159467,494,5158973,아프카니스탄,2019-06
2019-06-30,4918264,199212,4719052,쿠바,2019-06
2019-06-30,4510036,130874,4379162,네팔,2019-06
2019-06-30,4391620,79964,4311656,팔레스타인 해방기구,2019-06
2019-06-30,4352259,649120,3703139,베닝,2019-06
2019-06-30,4316391,5487568,-1171177,세네갈,2019-06
2019-06-30,4169788,480859,3688929,모리셔스,2019-06
2019-06-30,4047766,89638,3958128,르완다,2019-06
2019-06-30,3955706,31645645,-27689939,모잠비크,2019-06
2019-06-30,3704091,86655329,-82951238,기타국,2019-06
2019-06-30,3656830,2459443,1197387,벨라루스,2019-06
2019-06-30,3585100,97,3585003,불령 리유니온 코모도 제도,2019-06
2019-06-30,3569806,37076280,-33506474,콩고민주공화국,2019-06
2019-06-30,3548747,403766,3144981,지부티,2019-06
2019-06-30,3510718,1405698,2105020,니카라과,2019-06
2019-06-30,3425370,404218,3021152,콩고,2019-06
2019-06-30,3379800,252194,3127606,사모아,2019-06
2019-06-30,3359889,21750098,-18390209,파푸아 뉴기니,2019-06
2019-06-30,3302379,34039737,-30737358,볼리비아,2019-06
2019-06-30,3179683,820970,2358713,피지,2019-06
2019-06-30,2938503,97983,2840520,니제르,2019-06
2019-06-30,2859070,191299,2667771,자마이카,2019-06
2019-06-30,2847646,541006,2306640,마카오,2019-06
2019-06-30,2824324,161154,2663170,불령 폴리네시아,2019-06
2019-06-30,2543794,499560,2044234,베네주엘라,2019-06
2019-06-30,2351677,16895,2334782,말리,2019-06
2019-06-30,2278336,938778,1339558,몰도바,2019-06
2019-06-30,2245717,394212,1851505,사이프러스,2019-06
2019-06-30,2218047,29,2218018,타지크,2019-06
2019-06-30,2096762,11880227,-9783465,뉴 칼레도니아,2019-06
2019-06-30,1923699,825064,1098635,아이슬란드,2019-06
2019-06-30,1804216,8848365,-7044149,마다카스카르,2019-06
2019-06-30,1737416,243261,1494155,세이쉘,2019-06
2019-06-30,1665583,250,1665333,부르키나 파소,2019-06
2019-06-30,1572339,553848,1018491,솔로몬 군도,2019-06
2019-06-30,1479342,4562866,-3083524,모리타니,2019-06
2019-06-30,1469172,4325008,-2855836,기니,2019-06
2019-06-30,1448337,4862267,-3413930,룩셈부르그,2019-06
2019-06-30,1413832,207592,1206240,카메룬,2019-06
2019-06-30,1370780,75523156,-74152376,가봉,2019-06
2019-06-30,1338790,181436,1157354,북마리아나 군도,2019-06
2019-06-30,1331497,500460,831037,짐바브웨,2019-06
2019-06-30,1321052,0,1321052,마티니크,2019-06
2019-06-30,1303127,3277109,-1973982,잠비아,2019-06
2019-06-30,1298453,177958,1120495,마세도니아,2019-06
2019-06-30,1182194,504544,677650,리히텐슈타인,2019-06
2019-06-30,1149732,36216,1113516,팔라우,2019-06
2019-06-30,1149559,484973,664586,시에라 리온,2019-06
2019-06-30,1071292,327,1070965,과델로프,2019-06
2019-06-30,1038214,0,1038214,큐라소,2019-06
2019-06-30,1014866,173,1014693,아루바,2019-06
2019-06-30,987309,663073,324236,우간다,2019-06
2019-06-30,929113,83140,845973,보츠와나,2019-06
2019-06-30,918613,257333,661280,알바니아,2019-06
2019-06-30,884916,206409,678507,소말리아,2019-06
2019-06-30,876226,695060,181166,수리남,2019-06
2019-06-30,870253,120768,749485,가이아나,2019-06
2019-06-30,849442,493007,356435,아르메니아,2019-06
2019-06-30,698728,617,698111,영령 캐이맨 군도,2019-06
2019-06-30,697479,260,697219,불령 가이아나,2019-06
2019-06-30,678237,32242,645995,바베이도스,2019-06
2019-06-30,646110,0,646110,버뮤다,2019-06
2019-06-30,558522,190,558332,투르크멘,2019-06
2019-06-30,528671,212230,316441,말라위,2019-06
2019-06-30,471312,70545,400767,감비아,2019-06
2019-06-30,427207,1666,425541,마이크로네시아,2019-06
2019-06-30,409993,41743,368250,몰디브,2019-06
2019-06-30,408112,3586,404526,몬테네그로,2019-06
2019-06-30,388785,0,388785,안티가 바부다,2019-06
2019-06-30,378941,275,378666,티모르,2019-06
2019-06-30,353818,7309,346509,나미비아,2019-06
2019-06-30,315627,636,314991,그레나다,2019-06
2019-06-30,309321,24930,284391,벨리제,2019-06
2019-06-30,297538,53930,243608,아메리칸 사모아,2019-06
2019-06-30,281974,0,281974,세인트 마틴,2019-06
2019-06-30,257775,14,257761,카보 베르데,2019-06
2019-06-30,252936,0,252936,세인트 루시아,2019-06
2019-06-30,245986,5008,240978,도미니카,2019-06
2019-06-30,244771,17,244754,영령 버진군도,2019-06
2019-06-30,244317,0,244317,지브랄타,2019-06
2019-06-30,207202,1324,205878,남수단,2019-06
2019-06-30,200738,1430763,-1230025,보스니아-헤르체고비나,2019-06
2019-06-30,178606,5610,172996,부룬디,2019-06
2019-06-30,172292,1615878,-1443586,바누아투,2019-06
2019-06-30,162836,855010,-692174,키리바티,2019-06
2019-06-30,156119,0,156119,부탄,2019-06
2019-06-30,125335,4282116,-4156781,스와질랜드,2019-06
2019-06-30,124379,0,124379,적도 기니,2019-06
2019-06-30,124146,1502,122644,세인트 키츠 네비스,2019-06
2019-06-30,88230,0,88230,투발루,2019-06
2019-06-30,85504,0,85504,투르크 & 카이코스 군도,2019-06
2019-06-30,54515,683,53832,세인트 빈센트 그레나딘,2019-06
2019-06-30,53081,195485,-142404,통가,2019-06
2019-06-30,44721,0,44721,나우루,2019-06
2019-06-30,43927,17436154,-17392227,에리트리아,2019-06
2019-06-30,43196,0,43196,챠드,2019-06
2019-06-30,40399,482151,-441752,기네비소,2019-06
2019-06-30,37463,0,37463,네덜란드 열도,2019-06
2019-06-30,16250,128602,-112352,산마리노,2019-06
2019-06-30,11471,0,11471,왈라스 & 퓨투나 군도,2019-06
2019-06-30,9878,0,9878,포클랜드 군도,2019-06
2019-06-30,9178,0,9178,앙귈라,2019-06
2019-06-30,8751,18646,-9895,토켈라우,2019-06
2019-06-30,7440,71655,-64215,중앙아프리카공화국,2019-06
2019-06-30,6358,41947,-35589,세인트 헬레나,2019-06
2019-06-30,5882,8804,-2922,미령 버진군도,2019-06
2019-06-30,5411,0,5411,쿡 아일랜드,2019-06
2019-06-30,5352,34418,-29066,모나코,2019-06
2019-06-30,2232,0,2232,상토메 프린스페,2019-06
2019-06-30,643,0,643,세인트 바르탤르미,2019-06
2019-06-30,60,119,-59,저어지,2019-06
2019-06-30,0,98,-98,코스 군도,2019-06
2019-06-30,0,20,-20,크리스마스 아일랜드,2019-06
2019-06-30,0,89012,-89012,파로에 군도,2019-06
2019-06-30,0,308,-308,남조지아 & 남샌드위치 군도,2019-06
2019-06-30,0,2714,-2714,레소토,2019-06
2019-06-30,0,399,-399,피트카이른,2019-06
2019-06-30,0,186,-186,맨섬,2019-06
2019-06-30,0,167,-167,안도라,2019-06
2019-06-30,0,3036,-3036,니우에,2019-06
2019-06-30,0,1497,-1497,몬트세라트,2019-06
2019-06-30,0,11030,-11030,건지,2019-06
2019-07-31,11444066676,9392845568,2051221108,중국,2019-07
2019-07-31,6113229620,5383261298,729968322,미국,2019-07
2019-07-31,4220824208,1807002102,2413822106,베트남,2019-07
2019-07-31,2761539257,160270314,2601268943,홍콩,2019-07
2019-07-31,2545211759,4203610340,-1658398581,일본,2019-07
2019-07-31,1367289664,449309710,917979954,인도,2019-07
2019-07-31,1162373000,1356088079,-193715079,대만,2019-07
2019-07-31,1061854386,678675389,383178997,싱가포르,2019-07
2019-07-31,985029719,552651845,432377874,멕시코,2019-07
2019-07-31,843932770,1799034447,-955101677,호주,2019-07
2019-07-31,783142888,328980006,454162882,필리핀,2019-07
2019-07-31,733401910,711539083,21862827,말레이시아,2019-07
2019-07-31,685975571,1312236074,-626260503,러시아 연방,2019-07
2019-07-31,663350859,727865981,-64515122,인도네시아,2019-07
2019-07-31,657745543,1951887207,-1294141664,독일,2019-07
2019-07-31,654737165,489134992,165602173,태국,2019-07
2019-07-31,551542339,443989000,107553339,캐나다,2019-07
2019-07-31,474839611,112941827,361897784,튀르키예,2019-07
2019-07-31,463497402,61453205,402044197,폴란드,2019-07
2019-07-31,451660790,296563717,155097073,영국,2019-07
2019-07-31,425147714,324558113,100589601,브라질,2019-07
2019-07-31,373795968,420217816,-46421848,네덜란드,2019-07
2019-07-31,358418841,1878079118,-1519660277,사우디아라비아,2019-07
2019-07-31,333922227,615423455,-281501228,이탈리아,2019-07
2019-07-31,295063474,832036148,-536972674,아랍에미리트 연합,2019-07
2019-07-31,293652635,522980951,-229328316,프랑스,2019-07
2019-07-31,267703345,404517993,-136814648,스페인,2019-07
2019-07-31,245433240,114441362,130991878,벨기에,2019-07
2019-07-31,223075564,76218271,146857293,그리스,2019-07
2019-07-31,222804841,230558179,-7753338,카자흐스탄,2019-07
2019-07-31,217704364,84251520,133452844,체코공화국,2019-07
2019-07-31,209162709,24171056,184991653,슬로바키아,2019-07
2019-07-31,185894665,2040159,183854506,우즈베키스탄,2019-07
2019-07-31,169634874,5467967,164166907,토고,2019-07
2019-07-31,169466325,46234110,123232215,헝가리,2019-07
2019-07-31,168660756,2134580,166526176,파나마,2019-07
2019-07-31,159914381,11585233,148329148,마샬군도,2019-07
2019-07-31,154974050,12312798,142661252,이집트,2019-07
2019-07-31,142371143,474815244,-332444101,이라크,2019-07
2019-07-31,138840153,9971113,128869040,슬로베니아,2019-07
2019-07-31,121994614,3005410,118989204,몰타,2019-07
2019-07-31,109432551,150528763,-41096212,스웨덴,2019-07
2019-07-31,103562210,458862,103103348,라이베리아,2019-07
2019-07-31,101345038,401031549,-299686511,칠레,2019-07
2019-07-31,94946147,121138345,-26192198,뉴질랜드,2019-07
2019-07-31,91831144,93860933,-2029789,콜롬비아,2019-07
2019-07-31,80232507,76023776,4208731,이스라엘,2019-07
2019-07-31,79874130,31452346,48421784,방글라데시,2019-07
2019-07-31,77768655,161611596,-83842941,남아프리카공화국,2019-07
2019-07-31,77751457,126317884,-48566427,노르웨이,2019-07
2019-07-31,74164359,26279769,47884590,파키스탄,2019-07
2019-07-31,69236297,35729270,33507027,캄보디아,2019-07
2019-07-31,67178370,794570265,-727391895,쿠웨이트,2019-07
2019-07-31,66454645,115106261,-48651616,오스트리아,2019-07
2019-07-31,65884897,236103881,-170218984,페루,2019-07
2019-07-31,61289321,40042854,21246467,나이지리아,2019-07
2019-07-31,57431764,291099808,-233668044,스위스,2019-07
2019-07-31,53214309,780865,52433444,피지,2019-07
2019-07-31,52968080,69392370,-16424290,리비아,2019-07
2019-07-31,51581309,63353861,-11772552,미얀마,2019-07
2019-07-31,47618492,6928429,40690063,요르단,2019-07
2019-07-31,46220371,35324212,10896159,루마니아,2019-07
2019-07-31,45673116,86263463,-40590347,덴마크,2019-07
2019-07-31,45210405,227194113,-181983708,오만,2019-07
2019-07-31,43375310,321911,43053399,괌,2019-07
2019-07-31,39899249,25726764,14172485,포루투갈,2019-07
2019-07-31,35886803,19461810,16424993,우크라이나,2019-07
2019-07-31,32665097,10385316,22279781,에쿠아도르,2019-07
2019-07-31,30701150,165509223,-134808073,아르헨티나,2019-07
2019-07-31,29861159,107179545,-77318386,핀란드,2019-07
2019-07-31,28943028,107043374,-78100346,아일랜드,2019-07
2019-07-31,27766258,168069980,-140303722,알제리,2019-07
2019-07-31,27216088,22532564,4683524,바레인,2019-07
2019-07-31,26092128,3933642,22158486,몽골,2019-07
2019-07-31,25158969,13126040,12032929,모로코,2019-07
2019-07-31,23615496,5785528,17829968,리투아니아,2019-07
2019-07-31,23528130,971396742,-947868612,카타르,2019-07
2019-07-31,23239042,8344807,14894235,도미니카 공화국,2019-07
2019-07-31,22780832,12060980,10719852,스리랑카,2019-07
2019-07-31,21890912,1841837,20049075,크로아티아,2019-07
2019-07-31,20703042,6416925,14286117,과테말라,2019-07
2019-07-31,20689868,1740026,18949842,이란,2019-07
2019-07-31,15580202,4679848,10900354,가나,2019-07
2019-07-31,15212553,33659224,-18446671,세르비아,2019-07
2019-07-31,15150387,15629069,-478682,우루과이,2019-07
2019-07-31,15144123,21931522,-6787399,푸에르토리코,2019-07
2019-07-31,15077144,2442614,12634530,엘살바도르,2019-07
2019-07-31,14980515,18061617,-3081102,불가리아,2019-07
2019-07-31,14881071,4637140,10243931,케냐,2019-07
2019-07-31,14780931,1391897,13389034,레바논,2019-07
2019-07-31,13691870,628707,13063163,탄자니아,2019-07
2019-07-31,13147520,9767083,3380437,코스타리카,2019-07
2019-07-31,12592976,2125303,10467673,예맨,2019-07
2019-07-31,12325129,793392,11531737,코트디봐르,2019-07
2019-07-31,12113867,2563507,9550360,브루나이,2019-07
2019-07-31,11926630,4125448,7801182,튀니지,2019-07
2019-07-31,11630972,3635,11627337,시리아,2019-07
2019-07-31,10746323,5658062,5088261,에티오피아,2019-07
2019-07-31,10485929,6917508,3568421,온두라스,2019-07
2019-07-31,9721170,78140,9643030,키르기스스탄,2019-07
2019-07-31,9675897,39661534,-29985637,수단,2019-07
2019-07-31,8485300,2233528,6251772,조지아,2019-07
2019-07-31,8433599,223322445,-214888846,기타국,2019-07
2019-07-31,7635574,12528961,-4893387,트리니다드 토바고,2019-07
2019-07-31,7238791,18249,7220542,팔라우,2019-07
2019-07-31,7141268,1594198,5547070,파라과이,2019-07
2019-07-31,5736813,15144039,-9407226,라트비아,2019-07
2019-07-31,5530391,5776830,-246439,세네갈,2019-07
2019-07-31,5500536,4889602,610934,라오스,2019-07
2019-07-31,5370864,2014585,3356279,니카라과,2019-07
2019-07-31,5073869,5267843,-193974,에스토니아,2019-07
2019-07-31,5012718,1809,5010909,쿠바,2019-07
2019-07-31,4508386,40069,4468317,아제르바이잔,2019-07
2019-07-31,4438374,347582,4090792,사이프러스,2019-07
2019-07-31,4395431,949573,3445858,벨라루스,2019-07
2019-07-31,4320636,1282489,3038147,베닝,2019-07
2019-07-31,4269815,498251,3771564,모리셔스,2019-07
2019-07-31,4228995,194511,4034484,아이티,2019-07
2019-07-31,3996957,287805,3709152,네팔,2019-07
2019-07-31,3641415,42791,3598624,불령 폴리네시아,2019-07
2019-07-31,3566548,704319,2862229,앙골라,2019-07
2019-07-31,3558583,24318196,-20759613,파푸아 뉴기니,2019-07
2019-07-31,3448169,284781,3163388,소말리아,2019-07
2019-07-31,3294421,642086,2652335,지부티,2019-07
2019-07-31,3197598,317697,2879901,사모아,2019-07
2019-07-31,3004345,10480306,-7475961,볼리비아,2019-07
2019-07-31,2782760,162286,2620474,모잠비크,2019-07
2019-07-31,2776680,1642648,1134032,부르키나 파소,2019-07
2019-07-31,2618097,278733,2339364,말라위,2019-07
2019-07-31,2533194,4066289,-1533095,마다카스카르,2019-07
2019-07-31,2422369,997831,1424538,콩고,2019-07
2019-07-31,2331595,161,2331434,아프카니스탄,2019-07
2019-07-31,2273340,0,2273340,팔레스타인 해방기구,2019-07
2019-07-31,2237110,6165437,-3928327,룩셈부르그,2019-07
2019-07-31,2194783,462,2194321,마티니크,2019-07
2019-07-31,2137191,255748,1881443,마카오,2019-07
2019-07-31,2103339,100942,2002397,자마이카,2019-07
2019-07-31,2082637,19547118,-17464481,뉴 칼레도니아,2019-07
2019-07-31,2063234,221966,1841268,아메리칸 사모아,2019-07
2019-07-31,1863260,3538860,-1675600,기니,2019-07
2019-07-31,1805849,0,1805849,세인트 마틴,2019-07
2019-07-31,1752719,37901841,-36149122,콩고민주공화국,2019-07
2019-07-31,1611091,0,1611091,타지크,2019-07
2019-07-31,1569384,0,1569384,과델로프,2019-07
2019-07-31,1540005,376809,1163196,알바니아,2019-07
2019-07-31,1527621,400653,1126968,수리남,2019-07
2019-07-31,1520365,71138,1449227,카메룬,2019-07
2019-07-31,1454090,27264,1426826,마이크로네시아,2019-07
2019-07-31,1450109,16217,1433892,키리바티,2019-07
2019-07-31,1386795,6865,1379930,불령 리유니온 코모도 제도,2019-07
2019-07-31,1358984,41181,1317803,가이아나,2019-07
2019-07-31,1288326,858910,429416,리히텐슈타인,2019-07
2019-07-31,1254926,22041,1232885,도미니카,2019-07
2019-07-31,1243443,2323868,-1080425,아이슬란드,2019-07
2019-07-31,1189661,2282937,-1093276,마세도니아,2019-07
2019-07-31,1095048,1099696,-4648,아르메니아,2019-07
2019-07-31,1077636,6222240,-5144604,잠비아,2019-07
2019-07-31,1049396,659679,389717,짐바브웨,2019-07
2019-07-31,1040065,1120,1038945,바하마,2019-07
2019-07-31,1026519,1236648,-210129,베네주엘라,2019-07
2019-07-31,1000556,380684,619872,북마리아나 군도,2019-07
2019-07-31,992334,1696194,-703860,몰도바,2019-07
2019-07-31,919297,170892,748405,가봉,2019-07
2019-07-31,885298,48644,836654,우간다,2019-07
2019-07-31,820610,61214,759396,몰디브,2019-07
2019-07-31,794807,920226,-125419,시에라 리온,2019-07
2019-07-31,787360,0,787360,니제르,2019-07
2019-07-31,777079,216396,560683,솔로몬 군도,2019-07
2019-07-31,720963,1150310,-429347,세이쉘,2019-07
2019-07-31,717816,14288,703528,말리,2019-07
2019-07-31,712018,1500,710518,영령 캐이맨 군도,2019-07
2019-07-31,648434,0,648434,아루바,2019-07
2019-07-31,559329,0,559329,투르크멘,2019-07
2019-07-31,492273,100,492173,안티가 바부다,2019-07
2019-07-31,472945,2998999,-2526054,모리타니,2019-07
2019-07-31,427852,0,427852,불령 가이아나,2019-07
2019-07-31,391891,23613,368278,보츠와나,2019-07
2019-07-31,367016,207788,159228,르완다,2019-07
2019-07-31,358002,1702465,-1344463,보스니아-헤르체고비나,2019-07
2019-07-31,339244,1160,338084,티모르,2019-07
2019-07-31,336260,581,335679,버뮤다,2019-07
2019-07-31,314892,3430685,-3115793,바누아투,2019-07
2019-07-31,307265,7786198,-7478933,나미비아,2019-07
2019-07-31,285916,0,285916,세인트 루시아,2019-07
2019-07-31,247330,0,247330,벨리제,2019-07
2019-07-31,223017,1428716,-1205699,감비아,2019-07
2019-07-31,220778,0,220778,영령 버진군도,2019-07
2019-07-31,191157,11879,179278,그레나다,2019-07
2019-07-31,190400,26270,164130,몬테네그로,2019-07
2019-07-31,184578,0,184578,큐라소,2019-07
2019-07-31,114893,43729,71164,바베이도스,2019-07
2019-07-31,104868,0,104868,네덜란드 열도,2019-07
2019-07-31,103911,484,103427,에리트리아,2019-07
2019-07-31,99615,97017,2598,모나코,2019-07
2019-07-31,96207,4631700,-4535493,스와질랜드,2019-07
2019-07-31,95735,372,95363,부탄,2019-07
2019-07-31,94357,0,94357,남수단,2019-07
2019-07-31,65304,0,65304,지브랄타,2019-07
2019-07-31,65262,1474,63788,세인트 빈센트 그레나딘,2019-07
2019-07-31,55959,0,55959,챠드,2019-07
2019-07-31,55210,1466,53744,통가,2019-07
2019-07-31,54846,0,54846,기네비소,2019-07
2019-07-31,51680,583279,-531599,적도 기니,2019-07
2019-07-31,41707,0,41707,투르크 & 카이코스 군도,2019-07
2019-07-31,33704,53860,-20156,부룬디,2019-07
2019-07-31,26759,0,26759,앙귈라,2019-07
2019-07-31,17893,6226,11667,코모로스,2019-07
2019-07-31,6888,1709,5179,레소토,2019-07
2019-07-31,6121,28,6093,카보 베르데,2019-07
2019-07-31,5504,3477,2027,상토메 프린스페,2019-07
2019-07-31,5100,11248,-6148,노폴크 아일랜드,2019-07
2019-07-31,4691,26618,-21927,중앙아프리카공화국,2019-07
2019-07-31,2266,86018,-83752,쿡 아일랜드,2019-07
2019-07-31,1718,23020,-21302,안도라,2019-07
2019-07-31,1715,212,1503,파로에 군도,2019-07
2019-07-31,1502,0,1502,세인트 바르탤르미,2019-07
2019-07-31,1260,0,1260,세인트마틴(생마르탱),2019-07
2019-07-31,285,6708,-6423,미령 버진군도,2019-07
2019-07-31,38,5843,-5805,세인트 키츠 네비스,2019-07
2019-07-31,38,2906,-2868,그린랜드,2019-07
2019-07-31,0,6746,-6746,자이르,2019-07
2019-07-31,0,180,-180,몬트세라트,2019-07
2019-07-31,0,2167,-2167,세인트 헬레나,2019-07
2019-07-31,0,2871,-2871,니우에,2019-07
2019-07-31,0,50043,-50043,산마리노,2019-07
2019-07-31,0,12,-12,크리스마스 아일랜드,2019-07
2019-07-31,0,1338,-1338,토켈라우,2019-07
2019-07-31,0,180,-180,메요트,2019-07
2019-07-31,0,18626,-18626,나우루,2019-07
2019-07-31,0,121,-121,영령 인도양,2019-07
2019-08-31,11287793374,8312967754,2974825620,중국,2019-08
2019-08-31,5619802922,5175083349,444719573,미국,2019-08
2019-08-31,4484556281,1989497396,2495058885,베트남,2019-08
2019-08-31,2578175500,138092254,2440083246,홍콩,2019-08
2019-08-31,2243164653,3886996994,-1643832341,일본,2019-08
2019-08-31,1358374097,1315183520,43190577,대만,2019-08
2019-08-31,1284406484,465467443,818939041,인도,2019-08
2019-08-31,1283150326,489800868,793349458,싱가포르,2019-08
2019-08-31,871472698,470065953,401406745,멕시코,2019-08
2019-08-31,798939155,743106336,55832819,말레이시아,2019-08
2019-08-31,650595732,1827950769,-1177355037,독일,2019-08
2019-08-31,645902380,291530299,354372081,필리핀,2019-08
2019-08-31,637942852,1272998428,-635055576,러시아 연방,2019-08
2019-08-31,617439780,402954914,214484866,태국,2019-08
2019-08-31,615541503,2158988661,-1543447158,호주,2019-08
2019-08-31,603004243,691679404,-88675161,인도네시아,2019-08
2019-08-31,407400720,397522084,9878636,브라질,2019-08
2019-08-31,405702644,577336276,-171633632,캐나다,2019-08
2019-08-31,399730607,62047873,337682734,튀르키예,2019-08
2019-08-31,390101168,79921672,310179496,폴란드,2019-08
2019-08-31,387065030,13773,387051257,마샬군도,2019-08
2019-08-31,338068569,456000570,-117932001,영국,2019-08
2019-08-31,326404572,2259301545,-1932896973,사우디아라비아,2019-08
2019-08-31,323108163,16227924,306880239,파나마,2019-08
2019-08-31,307044190,797291496,-490247306,아랍에미리트 연합,2019-08
2019-08-31,301570880,365114745,-63543865,네덜란드,2019-08
2019-08-31,291362450,540726199,-249363749,이탈리아,2019-08
2019-08-31,275580592,494662309,-219081717,프랑스,2019-08
2019-08-31,264006383,114727481,149278902,노르웨이,2019-08
2019-08-31,220046805,38254523,181792282,헝가리,2019-08
2019-08-31,212088849,135962355,76126494,스페인,2019-08
2019-08-31,199413772,57796621,141617151,체코공화국,2019-08
2019-08-31,189431870,113961951,75469919,벨기에,2019-08
2019-08-31,184361362,1405471,182955891,우즈베키스탄,2019-08
2019-08-31,179657840,41219406,138438434,슬로바키아,2019-08
2019-08-31,164848451,546575701,-381727250,이라크,2019-08
2019-08-31,154968404,8406299,146562105,슬로베니아,2019-08
2019-08-31,151169217,104069247,47099970,뉴질랜드,2019-08
2019-08-31,114932044,83748551,31183493,이스라엘,2019-08
2019-08-31,90101972,247286145,-157184173,칠레,2019-08
2019-08-31,90017465,40225545,49791920,방글라데시,2019-08
2019-08-31,89990363,117077952,-27087589,스웨덴,2019-08
2019-08-31,87761461,169679244,-81917783,카자흐스탄,2019-08
2019-08-31,86146339,20757624,65388715,이집트,2019-08
2019-08-31,75350133,161956830,-86606697,오스트리아,2019-08
2019-08-31,70500387,75380571,-4880184,콜롬비아,2019-08
2019-08-31,67909009,139342258,-71433249,남아프리카공화국,2019-08
2019-08-31,64043397,3985504,60057893,몰타,2019-08
2019-08-31,63610650,26172041,37438609,파키스탄,2019-08
2019-08-31,55710713,29046682,26664031,캄보디아,2019-08
2019-08-31,55248357,93501604,-38253247,아일랜드,2019-08
2019-08-31,55218671,20081667,35137004,나이지리아,2019-08
2019-08-31,54335829,4744807,49591022,토고,2019-08
2019-08-31,53360494,50751666,2608828,그리스,2019-08
2019-08-31,50080383,194588118,-144507735,페루,2019-08
2019-08-31,48290180,35627575,12662605,루마니아,2019-08
2019-08-31,47868162,7547447,40320715,요르단,2019-08
2019-08-31,46637749,60319066,-13681317,미얀마,2019-08
2019-08-31,44538176,1027863500,-983325324,쿠웨이트,2019-08
2019-08-31,43852862,2593922,41258940,리비아,2019-08
2019-08-31,41968660,26257584,15711076,포루투갈,2019-08
2019-08-31,39333335,232653156,-193319821,스위스,2019-08
2019-08-31,34876315,10841566,24034749,에쿠아도르,2019-08
2019-08-31,31707759,1362810929,-1331103170,카타르,2019-08
2019-08-31,31054646,639290,30415356,피지,2019-08
2019-08-31,30750931,65339119,-34588188,덴마크,2019-08
2019-08-31,28016478,174827282,-146810804,오만,2019-08
2019-08-31,26794873,100206705,-73411832,아르헨티나,2019-08
2019-08-31,26491673,190092820,-163601147,알제리,2019-08
2019-08-31,26339075,30472215,-4133140,우크라이나,2019-08
2019-08-31,25357998,58811055,-33453057,바레인,2019-08
2019-08-31,23782624,708852,23073772,이란,2019-08
2019-08-31,22767307,6863703,15903604,리투아니아,2019-08
2019-08-31,22511415,107420690,-84909275,핀란드,2019-08
2019-08-31,21951474,4475023,17476451,몽골,2019-08
2019-08-31,21837622,19887429,1950193,푸에르토리코,2019-08
2019-08-31,21334389,3759883,17574506,튀니지,2019-08
2019-08-31,20250593,8532175,11718418,도미니카 공화국,2019-08
2019-08-31,18854573,17422891,1431682,모로코,2019-08
2019-08-31,17469243,5603850,11865393,과테말라,2019-08
2019-08-31,15013035,9595138,5417897,스리랑카,2019-08
2019-08-31,14447482,1083465,13364017,레바논,2019-08
2019-08-31,13226272,17642117,-4415845,불가리아,2019-08
2019-08-31,12766142,10153708,2612434,코스타리카,2019-08
2019-08-31,12657726,4784480,7873246,크로아티아,2019-08
2019-08-31,12580232,2692488,9887744,가나,2019-08
2019-08-31,12070193,4721007,7349186,케냐,2019-08
2019-08-31,11429210,4767731,6661479,온두라스,2019-08
2019-08-31,10684546,8659348,2025198,우루과이,2019-08
2019-08-31,10372755,112259,10260496,시리아,2019-08
2019-08-31,9969204,40720,9928484,키르기스스탄,2019-08
2019-08-31,8866388,518154,8348234,탄자니아,2019-08
2019-08-31,8441038,446369,7994669,파라과이,2019-08
2019-08-31,8414273,2409135,6005138,엘살바도르,2019-08
2019-08-31,8207452,1287839,6919613,수단,2019-08
2019-08-31,8078132,27645253,-19567121,모잠비크,2019-08
2019-08-31,7476897,20079141,-12602244,세르비아,2019-08
2019-08-31,7310299,1953089,5357210,조지아,2019-08
2019-08-31,6625372,5990912,634460,에티오피아,2019-08
2019-08-31,6449392,29652,6419740,코트디봐르,2019-08
2019-08-31,6365616,4234461,2131155,에스토니아,2019-08
2019-08-31,6333991,287070,6046921,괌,2019-08
2019-08-31,6117620,3140871,2976749,예맨,2019-08
2019-08-31,5909049,2533144,3375905,라오스,2019-08
2019-08-31,4956252,1155785,3800467,니카라과,2019-08
2019-08-31,4799217,26347,4772870,아제르바이잔,2019-08
2019-08-31,4718701,330805,4387896,지부티,2019-08
2019-08-31,4623426,21700980,-17077554,트리니다드 토바고,2019-08
2019-08-31,4561987,458556,4103431,브루나이,2019-08
2019-08-31,4557347,5250728,-693381,세네갈,2019-08
2019-08-31,4219423,61724,4157699,앙골라,2019-08
2019-08-31,4172898,374754,3798144,모리셔스,2019-08
2019-08-31,3889194,396216,3492978,네팔,2019-08
2019-08-31,3802022,131554702,-127752680,기타국,2019-08
2019-08-31,3705927,55853867,-52147940,파푸아 뉴기니,2019-08
2019-08-31,3639931,18239,3621692,과델로프,2019-08
2019-08-31,3288214,8050611,-4762397,라트비아,2019-08
2019-08-31,3236481,48516111,-45279630,볼리비아,2019-08
2019-08-31,3194226,5544,3188682,팔레스타인 해방기구,2019-08
2019-08-31,3165450,219777,2945673,쿠바,2019-08
2019-08-31,3094637,522234,2572403,사모아,2019-08
2019-08-31,3043799,210873,2832926,자마이카,2019-08
2019-08-31,3037489,581976,2455513,베닝,2019-08
2019-08-31,3025131,3806436,-781305,벨라루스,2019-08
2019-08-31,3015080,9785472,-6770392,마다카스카르,2019-08
2019-08-31,2837781,413290,2424491,키리바티,2019-08
2019-08-31,2757611,239501,2518110,마카오,2019-08
2019-08-31,2712177,100407,2611770,아이티,2019-08
2019-08-31,2539796,991,2538805,아프카니스탄,2019-08
2019-08-31,2372657,228,2372429,타지크,2019-08
2019-08-31,2335726,573419,1762307,콩고,2019-08
2019-08-31,2315945,645156,1670789,사이프러스,2019-08
2019-08-31,2173643,79286,2094357,카메룬,2019-08
2019-08-31,2105405,22615,2082790,마티니크,2019-08
2019-08-31,2102057,377859,1724198,알바니아,2019-08
2019-08-31,2020294,4981491,-2961197,기니,2019-08
2019-08-31,2018658,117,2018541,불령 리유니온 코모도 제도,2019-08
2019-08-31,1727955,0,1727955,부르키나 파소,2019-08
2019-08-31,1613914,1044974,568940,세이쉘,2019-08
2019-08-31,1560439,5500631,-3940192,룩셈부르그,2019-08
2019-08-31,1471796,168376,1303420,우간다,2019-08
2019-08-31,1445203,1042041,403162,베네주엘라,2019-08
2019-08-31,1384759,236678,1148081,북마리아나 군도,2019-08
2019-08-31,1382030,945743,436287,소말리아,2019-08
2019-08-31,1221071,1647632,-426561,몰도바,2019-08
2019-08-31,1204193,19338,1184855,바베이도스,2019-08
2019-08-31,1190118,1048962,141156,아이슬란드,2019-08
2019-08-31,1136917,1050016,86901,리히텐슈타인,2019-08
2019-08-31,1116384,2855,1113529,도미니카,2019-08
2019-08-31,1102174,3342781,-2240607,모리타니,2019-08
2019-08-31,1077025,0,1077025,아루바,2019-08
2019-08-31,1041466,1754,1039712,바하마,2019-08
2019-08-31,1030875,64733,966142,가이아나,2019-08
2019-08-31,1015741,4214834,-3199093,잠비아,2019-08
2019-08-31,1012225,312197,700028,르완다,2019-08
2019-08-31,1006154,17403372,-16397218,뉴 칼레도니아,2019-08
2019-08-31,983728,428902,554826,마이크로네시아,2019-08
2019-08-31,942225,37285192,-36342967,콩고민주공화국,2019-08
2019-08-31,926984,151377,775607,불령 폴리네시아,2019-08
2019-08-31,891112,1735709,-844597,아르메니아,2019-08
2019-08-31,787124,453132,333992,수리남,2019-08
2019-08-31,706803,181,706622,안티가 바부다,2019-08
2019-08-31,684571,97024,587547,가봉,2019-08
2019-08-31,650105,0,650105,세인트 마틴,2019-08
2019-08-31,608770,12534598,-11925828,나미비아,2019-08
2019-08-31,575483,923304,-347821,바누아투,2019-08
2019-08-31,521478,224122,297356,말라위,2019-08
2019-08-31,488396,42648,445748,보츠와나,2019-08
2019-08-31,479975,1571372,-1091397,보스니아-헤르체고비나,2019-08
2019-08-31,467174,220,466954,몰디브,2019-08
2019-08-31,456598,278354,178244,솔로몬 군도,2019-08
2019-08-31,446176,500,445676,버뮤다,2019-08
2019-08-31,348747,19086,329661,팔라우,2019-08
2019-08-31,342565,275341,67224,짐바브웨,2019-08
2019-08-31,341281,210448,130833,마세도니아,2019-08
2019-08-31,332275,0,332275,불령 가이아나,2019-08
2019-08-31,325349,1830,323519,말리,2019-08
2019-08-31,297624,8615,289009,나우루,2019-08
2019-08-31,297428,92972,204456,아메리칸 사모아,2019-08
2019-08-31,250346,0,250346,세인트 루시아,2019-08
2019-08-31,246365,12656,233709,영령 캐이맨 군도,2019-08
2019-08-31,237295,57867,179428,라이베리아,2019-08
2019-08-31,206142,248,205894,부탄,2019-08
2019-08-31,174520,1217693,-1043173,감비아,2019-08
2019-08-31,168362,96321,72041,벨리제,2019-08
2019-08-31,162737,391,162346,티모르,2019-08
2019-08-31,155090,1570,153520,투르크멘,2019-08
2019-08-31,134990,0,134990,큐라소,2019-08
2019-08-31,124994,0,124994,그레나다,2019-08
2019-08-31,121568,1707,119861,몬테네그로,2019-08
2019-08-31,121170,0,121170,지브랄타,2019-08
2019-08-31,112648,2428978,-2316330,스와질랜드,2019-08
2019-08-31,100632,0,100632,메요트,2019-08
2019-08-31,98847,7831764,-7732917,에리트리아,2019-08
2019-08-31,96226,42,96184,세인트 키츠 네비스,2019-08
2019-08-31,93189,23,93166,네덜란드 열도,2019-08
2019-08-31,92615,1427022,-1334407,시에라 리온,2019-08
2019-08-31,90283,0,90283,카보 베르데,2019-08
2019-08-31,80373,0,80373,투발루,2019-08
2019-08-31,72375,20,72355,챠드,2019-08
2019-08-31,52752,208,52544,세인트 빈센트 그레나딘,2019-08
2019-08-31,44173,0,44173,영령 버진군도,2019-08
2019-08-31,29705,112273,-82568,코모로스,2019-08
2019-08-31,27124,61953,-34829,중앙아프리카공화국,2019-08
2019-08-31,23750,2378807,-2355057,니제르,2019-08
2019-08-31,19698,0,19698,왈라스 & 퓨투나 군도,2019-08
2019-08-31,15915,11019,4896,부룬디,2019-08
2019-08-31,15799,175856,-160057,기네비소,2019-08
2019-08-31,13612,11123,2489,미령 버진군도,2019-08
2019-08-31,9780,104,9676,앙귈라,2019-08
2019-08-31,9138,19956,-10818,통가,2019-08
2019-08-31,8078,20869,-12791,모나코,2019-08
2019-08-31,7588,0,7588,투르크 & 카이코스 군도,2019-08
2019-08-31,1528,0,1528,세인트 바르탤르미,2019-08
2019-08-31,761,1023,-262,상토메 프린스페,2019-08
2019-08-31,749,32374556,-32373807,적도 기니,2019-08
2019-08-31,240,14872,-14632,안도라,2019-08
2019-08-31,234,16,218,저어지,2019-08
2019-08-31,87,0,87,세인트마틴(생마르탱),2019-08
2019-08-31,73,144952,-144879,그린랜드,2019-08
2019-08-31,0,17,-17,마이너 아우틀링 합중국 군도,2019-08
2019-08-31,0,766,-766,자이르,2019-08
2019-08-31,0,144,-144,코스 군도,2019-08
2019-08-31,0,18698,-18698,토켈라우,2019-08
2019-08-31,0,3401,-3401,몬트세라트,2019-08
2019-08-31,0,1133,-1133,레소토,2019-08
2019-08-31,0,59125,-59125,쿡 아일랜드,2019-08
2019-08-31,0,7428,-7428,노폴크 아일랜드,2019-08
2019-08-31,0,4412,-4412,니우에,2019-08
2019-08-31,0,2275633,-2275633,세인트 헬레나,2019-08
2019-08-31,0,3662,-3662,남조지아 & 남샌드위치 군도,2019-08
2019-08-31,0,151611,-151611,산마리노,2019-08
2019-08-31,0,31,-31,맨섬,2019-08
2019-08-31,0,650,-650,교황청,2019-08
2019-09-30,11362385855,8197067603,3165318252,중국,2019-09
2019-09-30,5690676178,4758785112,931891066,미국,2019-09
2019-09-30,4229158129,2185353667,2043804462,베트남,2019-09
2019-09-30,2825991654,125628544,2700363110,홍콩,2019-09
2019-09-30,2310566270,3822451270,-1511885000,일본,2019-09
2019-09-30,1322316633,1341140654,-18824021,대만,2019-09
2019-09-30,1149114330,458360010,690754320,인도,2019-09
2019-09-30,925187787,543508138,381679649,싱가포르,2019-09
2019-09-30,886425661,519903433,366522228,멕시코,2019-09
2019-09-30,744023053,761825937,-17802884,말레이시아,2019-09
2019-09-30,699790924,1562557889,-862766965,독일,2019-09
2019-09-30,680766915,998326260,-317559345,러시아 연방,2019-09
2019-09-30,662282485,404788423,257494062,태국,2019-09
2019-09-30,646315683,257691202,388624481,필리핀,2019-09
2019-09-30,597690759,700857083,-103166324,인도네시아,2019-09
2019-09-30,592563286,1443034276,-850470990,호주,2019-09
2019-09-30,449676018,56747917,392928101,폴란드,2019-09
2019-09-30,438605257,77369154,361236103,튀르키예,2019-09
2019-09-30,417543664,27284,417516380,마샬군도,2019-09
2019-09-30,375181721,409969467,-34787746,캐나다,2019-09
2019-09-30,365310148,338498780,26811368,브라질,2019-09
2019-09-30,359589682,252206789,107382893,영국,2019-09
2019-09-30,321590039,1511360433,-1189770394,사우디아라비아,2019-09
2019-09-30,319408921,52146,319356775,바하마,2019-09
2019-09-30,307347387,174057220,133290167,네덜란드,2019-09
2019-09-30,299922634,465689446,-165766812,프랑스,2019-09
2019-09-30,263562599,490336130,-226773531,아랍에미리트 연합,2019-09
2019-09-30,262068894,177935450,84133444,카자흐스탄,2019-09
2019-09-30,258676739,523666369,-264989630,이탈리아,2019-09
2019-09-30,225820624,136773174,89047450,스페인,2019-09
2019-09-30,214053655,7894001,206159654,그리스,2019-09
2019-09-30,211953397,1343724,210609673,우즈베키스탄,2019-09
2019-09-30,208201311,107979913,100221398,벨기에,2019-09
2019-09-30,203881388,5183690,198697698,몰타,2019-09
2019-09-30,200600523,41562913,159037610,헝가리,2019-09
2019-09-30,186008151,67854047,118154104,체코공화국,2019-09
2019-09-30,170386031,27723049,142662982,슬로바키아,2019-09
2019-09-30,169134351,6077436,163056915,토고,2019-09
2019-09-30,160770052,405807143,-245037091,이라크,2019-09
2019-09-30,148653787,44306973,104346814,콜롬비아,2019-09
2019-09-30,146589385,82793204,63796181,노르웨이,2019-09
2019-09-30,140753812,10371012,130382800,슬로베니아,2019-09
2019-09-30,140566641,39245528,101321113,방글라데시,2019-09
2019-09-30,117366991,84449587,32917404,이스라엘,2019-09
2019-09-30,107886396,14512782,93373614,파나마,2019-09
2019-09-30,102181066,77647904,24533162,뉴질랜드,2019-09
2019-09-30,94903774,104606988,-9703214,스웨덴,2019-09
2019-09-30,89558169,1012957069,-923398900,쿠웨이트,2019-09
2019-09-30,87712324,138425813,-50713489,오스트리아,2019-09
2019-09-30,85767230,81671810,4095420,이집트,2019-09
2019-09-30,81548273,279226752,-197678479,칠레,2019-09
2019-09-30,74196979,8991275,65205704,에쿠아도르,2019-09
2019-09-30,73167490,232492940,-159325450,남아프리카공화국,2019-09
2019-09-30,70565036,84263127,-13698091,아일랜드,2019-09
2019-09-30,60234631,123532568,-63297937,페루,2019-09
2019-09-30,58617016,19534257,39082759,파키스탄,2019-09
2019-09-30,54797948,241219565,-186421617,스위스,2019-09
2019-09-30,54079066,28798526,25280540,캄보디아,2019-09
2019-09-30,53533739,194866712,-141332973,오만,2019-09
2019-09-30,46617580,132651679,-86034099,나이지리아,2019-09
2019-09-30,46466915,39194982,7271933,루마니아,2019-09
2019-09-30,46106860,75487496,-29380636,미얀마,2019-09
2019-09-30,46078276,1752922,44325354,리비아,2019-09
2019-09-30,45421274,21417116,24004158,포루투갈,2019-09
2019-09-30,43585986,5652163,37933823,요르단,2019-09
2019-09-30,36147707,63488556,-27340849,덴마크,2019-09
2019-09-30,32647362,4241844,28405518,몽골,2019-09
2019-09-30,30953972,23892353,7061619,우크라이나,2019-09
2019-09-30,29668190,1007386054,-977717864,카타르,2019-09
2019-09-30,28829174,6951414,21877760,리투아니아,2019-09
2019-09-30,28705741,194051801,-165346060,알제리,2019-09
2019-09-30,28293120,95608316,-67315196,핀란드,2019-09
2019-09-30,27006946,20475884,6531062,푸에르토리코,2019-09
2019-09-30,23177545,84473557,-61296012,아르헨티나,2019-09
2019-09-30,22099804,5170291,16929513,도미니카 공화국,2019-09
2019-09-30,21863111,38069694,-16206583,바레인,2019-09
2019-09-30,20937104,3380301,17556803,튀니지,2019-09
2019-09-30,20635566,6347151,14288415,과테말라,2019-09
2019-09-30,20559922,394255,20165667,이란,2019-09
2019-09-30,19789626,7114371,12675255,스리랑카,2019-09
2019-09-30,18877300,12284684,6592616,모로코,2019-09
2019-09-30,15723783,1135847,14587936,레바논,2019-09
2019-09-30,13770261,1099029,12671232,수단,2019-09
2019-09-30,13427566,2161755,11265811,엘살바도르,2019-09
2019-09-30,13194177,554068,12640109,탄자니아,2019-09
2019-09-30,12640906,2922832,9718074,케냐,2019-09
2019-09-30,12473866,3488619,8985247,가나,2019-09
2019-09-30,11652624,14151367,-2498743,불가리아,2019-09
2019-09-30,10368801,3827992,6540809,온두라스,2019-09
2019-09-30,10231804,8482741,1749063,코스타리카,2019-09
2019-09-30,10130384,168941,9961443,라이베리아,2019-09
2019-09-30,9865453,4261077,5604376,우루과이,2019-09
2019-09-30,9641251,3083,9638168,키르기스스탄,2019-09
2019-09-30,9411951,250340,9161611,모리셔스,2019-09
2019-09-30,9179143,16573745,-7394602,세르비아,2019-09
2019-09-30,8381356,14252577,-5871221,트리니다드 토바고,2019-09
2019-09-30,8371391,3802537,4568854,예맨,2019-09
2019-09-30,8324611,677326,7647285,조지아,2019-09
2019-09-30,8317118,4022986,4294132,크로아티아,2019-09
2019-09-30,6893312,25621507,-18728195,모잠비크,2019-09
2019-09-30,6883655,124506,6759149,파라과이,2019-09
2019-09-30,6606525,2091441,4515084,라오스,2019-09
2019-09-30,6474993,4837752,1637241,에스토니아,2019-09
2019-09-30,5950280,547109,5403171,사이프러스,2019-09
2019-09-30,5752708,290989,5461719,괌,2019-09
2019-09-30,5714912,5483696,231216,에티오피아,2019-09
2019-09-30,5576796,46793,5530003,팔레스타인 해방기구,2019-09
2019-09-30,5502022,77318544,-71816522,브루나이,2019-09
2019-09-30,5350974,4919,5346055,시리아,2019-09
2019-09-30,5056145,174572053,-169515908,기타국,2019-09
2019-09-30,4881114,7807334,-2926220,라트비아,2019-09
2019-09-30,4760520,1408643,3351877,니카라과,2019-09
2019-09-30,4332025,62396,4269629,아이티,2019-09
2019-09-30,4268564,143528,4125036,코트디봐르,2019-09
2019-09-30,4131113,4489068,-357955,세네갈,2019-09
2019-09-30,3936173,384824,3551349,네팔,2019-09
2019-09-30,3886413,69109276,-65222863,파푸아 뉴기니,2019-09
2019-09-30,3673015,12456,3660559,아프카니스탄,2019-09
2019-09-30,3548839,1608403,1940436,앙골라,2019-09
2019-09-30,3546189,360907,3185282,자마이카,2019-09
2019-09-30,3422142,1859951,1562191,기니,2019-09
2019-09-30,3361916,627994,2733922,벨라루스,2019-09
2019-09-30,3345188,0,3345188,지부티,2019-09
2019-09-30,3200503,675138,2525365,아제르바이잔,2019-09
2019-09-30,3105605,12883,3092722,베닝,2019-09
2019-09-30,2887523,328891,2558632,마카오,2019-09
2019-09-30,2710260,41943,2668317,불령 리유니온 코모도 제도,2019-09
2019-09-30,2521548,27455556,-24934008,콩고민주공화국,2019-09
2019-09-30,2494594,258618,2235976,쿠바,2019-09
2019-09-30,2475476,145100,2330376,피지,2019-09
2019-09-30,2358156,22975497,-20617341,뉴 칼레도니아,2019-09
2019-09-30,2348236,1815294,532942,베네주엘라,2019-09
2019-09-30,2291742,450681,1841061,사모아,2019-09
2019-09-30,2101572,10918374,-8816802,마다카스카르,2019-09
2019-09-30,1914971,0,1914971,타지크,2019-09
2019-09-30,1853559,92538,1761021,카메룬,2019-09
2019-09-30,1798086,891,1797195,소말리아,2019-09
2019-09-30,1721761,33057596,-31335835,볼리비아,2019-09
2019-09-30,1681616,1102762,578854,부르키나 파소,2019-09
2019-09-30,1649042,351834,1297208,수리남,2019-09
2019-09-30,1462870,317937,1144933,알바니아,2019-09
2019-09-30,1358581,0,1358581,세인트 마틴,2019-09
2019-09-30,1321833,67618,1254215,가이아나,2019-09
2019-09-30,1320191,72135,1248056,바베이도스,2019-09
2019-09-30,1309769,97131,1212638,불령 폴리네시아,2019-09
2019-09-30,1280596,1986957,-706361,몰도바,2019-09
2019-09-30,1204437,7425,1197012,마티니크,2019-09
2019-09-30,1202335,285197,917138,북마리아나 군도,2019-09
2019-09-30,1200013,391997,808016,콩고,2019-09
2019-09-30,1190092,7248179,-6058087,룩셈부르그,2019-09
2019-09-30,1137604,30342,1107262,불령 가이아나,2019-09
2019-09-30,1053127,1799504,-746377,잠비아,2019-09
2019-09-30,1024992,24459,1000533,과델로프,2019-09
2019-09-30,1009842,800,1009042,영령 캐이맨 군도,2019-09
2019-09-30,958311,45121,913190,가봉,2019-09
2019-09-30,943561,483923,459638,세이쉘,2019-09
2019-09-30,936378,786,935592,아루바,2019-09
2019-09-30,833578,514637,318941,리히텐슈타인,2019-09
2019-09-30,799165,0,799165,버뮤다,2019-09
2019-09-30,795060,1391,793669,몰디브,2019-09
2019-09-30,789146,1758012,-968866,모리타니,2019-09
2019-09-30,760059,0,760059,큐라소,2019-09
2019-09-30,751534,4975453,-4223919,키리바티,2019-09
2019-09-30,711333,771354,-60021,아이슬란드,2019-09
2019-09-30,701844,577258,124586,우간다,2019-09
2019-09-30,673743,1466955,-793212,아르메니아,2019-09
2019-09-30,656033,1428340,-772307,말리,2019-09
2019-09-30,611983,0,611983,투르크멘,2019-09
2019-09-30,583187,252447,330740,마세도니아,2019-09
2019-09-30,560640,223832,336808,짐바브웨,2019-09
2019-09-30,454381,15463387,-15009006,나미비아,2019-09
2019-09-30,429127,702974,-273847,시에라 리온,2019-09
2019-09-30,386859,23662,363197,팔라우,2019-09
2019-09-30,384811,46600,338211,마이크로네시아,2019-09
2019-09-30,384656,0,384656,세인트 바르탤르미,2019-09
2019-09-30,374085,92065,282020,르완다,2019-09
2019-09-30,372323,13538,358785,보츠와나,2019-09
2019-09-30,320707,0,320707,지브랄타,2019-09
2019-09-30,312623,925567,-612944,솔로몬 군도,2019-09
2019-09-30,307437,153856,153581,스와질랜드,2019-09
2019-09-30,284119,0,284119,세인트 루시아,2019-09
2019-09-30,240591,5625,234966,세인트 빈센트 그레나딘,2019-09
2019-09-30,214116,3163,210953,벨리제,2019-09
2019-09-30,208811,1090128,-881317,바누아투,2019-09
2019-09-30,201401,76018,125383,말라위,2019-09
2019-09-30,195650,0,195650,그레나다,2019-09
2019-09-30,177820,2927567,-2749747,보스니아-헤르체고비나,2019-09
2019-09-30,160727,220722,-59995,아메리칸 사모아,2019-09
2019-09-30,155720,5653,150067,카보 베르데,2019-09
2019-09-30,155560,4072018,-3916458,안티가 바부다,2019-09
2019-09-30,154128,1004,153124,도미니카,2019-09
2019-09-30,149957,59166,90791,몬테네그로,2019-09
2019-09-30,143299,0,143299,부탄,2019-09
2019-09-30,121533,0,121533,메요트,2019-09
2019-09-30,121482,296,121186,세인트 키츠 네비스,2019-09
2019-09-30,119820,332553,-212733,감비아,2019-09
2019-09-30,88613,31490,57123,중앙아프리카공화국,2019-09
2019-09-30,72893,620,72273,챠드,2019-09
2019-09-30,65975,73108,-7133,티모르,2019-09
2019-09-30,63630,879792,-816162,적도 기니,2019-09
2019-09-30,47142,756,46386,네덜란드 열도,2019-09
2019-09-30,43731,7402880,-7359149,에리트리아,2019-09
2019-09-30,37310,0,37310,니제르,2019-09
2019-09-30,36294,341,35953,투르크 & 카이코스 군도,2019-09
2019-09-30,23630,18993,4637,토켈라우,2019-09
2019-09-30,23600,134211,-110611,통가,2019-09
2019-09-30,23529,54569,-31040,기네비소,2019-09
2019-09-30,20956,206,20750,코모로스,2019-09
2019-09-30,14550,0,14550,왈라스 & 퓨투나 군도,2019-09
2019-09-30,12093,1473,10620,부룬디,2019-09
2019-09-30,9651,4530,5121,미령 버진군도,2019-09
2019-09-30,8500,0,8500,상토메 프린스페,2019-09
2019-09-30,5300,0,5300,앙귈라,2019-09
2019-09-30,2825,539,2286,안타티카,2019-09
2019-09-30,2674,0,2674,영령 버진군도,2019-09
2019-09-30,1256,4936,-3680,안도라,2019-09
2019-09-30,855,226437,-225582,모나코,2019-09
2019-09-30,217,3240,-3023,파로에 군도,2019-09
2019-09-30,52,0,52,그린랜드,2019-09
2019-09-30,0,324886,-324886,산마리노,2019-09
2019-09-30,0,82,-82,건지,2019-09
2019-09-30,0,1951,-1951,몬트세라트,2019-09
2019-09-30,0,112695,-112695,쿡 아일랜드,2019-09
2019-09-30,0,12667,-12667,레소토,2019-09
2019-09-30,0,898,-898,코스 군도,2019-09
2019-09-30,0,272,-272,나우루,2019-09
2019-09-30,0,3043,-3043,피트카이른,2019-09
2019-09-30,0,880,-880,저어지,2019-09
2019-09-30,0,418,-418,마이너 아우틀링 합중국 군도,2019-09
2019-09-30,0,284,-284,교황청,2019-09
2019-09-30,0,892,-892,맨섬,2019-09
2019-10-31,12243753683,9215893210,3027860473,중국,2019-10
2019-10-31,6357758160,4963126514,1394631646,미국,2019-10
2019-10-31,4209044967,1997409239,2211635728,베트남,2019-10
2019-10-31,2478883744,120952015,2357931729,홍콩,2019-10
2019-10-31,2372581195,3816085823,-1443504628,일본,2019-10
2019-10-31,1602219435,1332577440,269641995,대만,2019-10
2019-10-31,1155432477,463396911,692035566,인도,2019-10
2019-10-31,962189521,595769579,366419942,싱가포르,2019-10
2019-10-31,911523058,544518513,367004545,멕시코,2019-10
2019-10-31,773672826,872728065,-99055239,말레이시아,2019-10
2019-10-31,769706034,1828088140,-1058382106,독일,2019-10
2019-10-31,709471570,1793847402,-1084375832,호주,2019-10
2019-10-31,678570139,689176668,-10606529,인도네시아,2019-10
2019-10-31,642155862,453104962,189050900,태국,2019-10
2019-10-31,635309221,1461677097,-826367876,러시아 연방,2019-10
2019-10-31,612362491,303354023,309008468,필리핀,2019-10
2019-10-31,533391951,73346283,460045668,폴란드,2019-10
2019-10-31,484138973,78222525,405916448,튀르키예,2019-10
2019-10-31,468325020,499270332,-30945312,캐나다,2019-10
2019-10-31,420344477,30418,420314059,마샬군도,2019-10
2019-10-31,380896881,468308083,-87411202,브라질,2019-10
2019-10-31,372159362,299211307,72948055,영국,2019-10
2019-10-31,365036009,1570484989,-1205448980,사우디아라비아,2019-10
2019-10-31,318373399,4168,318369231,바하마,2019-10
2019-10-31,314709514,970119615,-655410101,아랍에미리트 연합,2019-10
2019-10-31,280603327,163404672,117198655,네덜란드,2019-10
2019-10-31,255976461,493675760,-237699299,이탈리아,2019-10
2019-10-31,254439435,480959480,-226520045,프랑스,2019-10
2019-10-31,241185447,42776924,198408523,헝가리,2019-10
2019-10-31,229727804,97575254,132152550,슬로바키아,2019-10
2019-10-31,212141476,47286972,164854504,그리스,2019-10
2019-10-31,209297035,1542308,207754727,우즈베키스탄,2019-10
2019-10-31,204395093,401688377,-197293284,이라크,2019-10
2019-10-31,187859819,5351899,182507920,파나마,2019-10
2019-10-31,184522129,165743479,18778650,스페인,2019-10
2019-10-31,169272315,71794357,97477958,체코공화국,2019-10
2019-10-31,167294569,108667068,58627501,벨기에,2019-10
2019-10-31,158155846,14202465,143953381,슬로베니아,2019-10
2019-10-31,153898484,92236422,61662062,뉴질랜드,2019-10
2019-10-31,136573578,593718440,-457144862,쿠웨이트,2019-10
2019-10-31,133350554,96767955,36582599,노르웨이,2019-10
2019-10-31,114732355,7936318,106796037,이집트,2019-10
2019-10-31,111516882,51400309,60116573,콜롬비아,2019-10
2019-10-31,106506725,56404989,50101736,이스라엘,2019-10
2019-10-31,101798518,339310992,-237512474,칠레,2019-10
2019-10-31,98195029,35747545,62447484,방글라데시,2019-10
2019-10-31,96900365,89129390,7770975,카자흐스탄,2019-10
2019-10-31,93187168,80733402,12453766,미얀마,2019-10
2019-10-31,88506817,145786353,-57279536,오스트리아,2019-10
2019-10-31,86819461,148039293,-61219832,스웨덴,2019-10
2019-10-31,72984836,31120642,41864194,파키스탄,2019-10
2019-10-31,67608648,0,67608648,영령 캐이맨 군도,2019-10
2019-10-31,65988565,102135915,-36147350,아일랜드,2019-10
2019-10-31,63637625,222397388,-158759763,오만,2019-10
2019-10-31,62421136,22643490,39777646,캄보디아,2019-10
2019-10-31,60655734,9889454,50766280,나이지리아,2019-10
2019-10-31,60282886,221062124,-160779238,남아프리카공화국,2019-10
2019-10-31,59067009,258908588,-199841579,페루,2019-10
2019-10-31,58977795,2581686,56396109,토고,2019-10
2019-10-31,57809605,257564784,-199755179,스위스,2019-10
2019-10-31,56237508,751998,55485510,리비아,2019-10
2019-10-31,52738659,1662257,51076402,피지,2019-10
2019-10-31,52205141,42346161,9858980,루마니아,2019-10
2019-10-31,49481864,10047210,39434654,요르단,2019-10
2019-10-31,48109624,155502,47954122,라이베리아,2019-10
2019-10-31,39530401,20998495,18531906,포루투갈,2019-10
2019-10-31,35139493,72277980,-37138487,덴마크,2019-10
2019-10-31,31574871,15882000,15692871,푸에르토리코,2019-10
2019-10-31,30506057,5300343,25205714,리투아니아,2019-10
2019-10-31,29321276,9538154,19783122,모로코,2019-10
2019-10-31,28447411,7394279,21053132,에쿠아도르,2019-10
2019-10-31,27939910,774160431,-746220521,카타르,2019-10
2019-10-31,27529719,54492184,-26962465,우크라이나,2019-10
2019-10-31,27092959,113755459,-86662500,알제리,2019-10
2019-10-31,25390869,4525130,20865739,괌,2019-10
2019-10-31,24522256,4046335,20475921,몽골,2019-10
2019-10-31,23475192,7124609,16350583,도미니카 공화국,2019-10
2019-10-31,23057237,6842722,16214515,과테말라,2019-10
2019-10-31,22212718,41345046,-19132328,바레인,2019-10
2019-10-31,21469113,102800536,-81331423,핀란드,2019-10
2019-10-31,19075985,68943231,-49867246,아르헨티나,2019-10
2019-10-31,18715959,1373148,17342811,이란,2019-10
2019-10-31,18007281,7218571,10788710,스리랑카,2019-10
2019-10-31,17346118,1387327,15958791,수단,2019-10
2019-10-31,17102463,2350,17100113,시리아,2019-10
2019-10-31,16625817,33255272,-16629455,불가리아,2019-10
2019-10-31,16413222,4218602,12194620,가나,2019-10
2019-10-31,16388979,3519664,12869315,케냐,2019-10
2019-10-31,15298689,12668,15286021,키르기스스탄,2019-10
2019-10-31,14996787,4017315,10979472,온두라스,2019-10
2019-10-31,14567201,3002697,11564504,엘살바도르,2019-10
2019-10-31,13727417,438146,13289271,탄자니아,2019-10
2019-10-31,13448735,21130994,-7682259,세르비아,2019-10
2019-10-31,11794336,2218250,9576086,크로아티아,2019-10
2019-10-31,11549686,10326822,1222864,코스타리카,2019-10
2019-10-31,10008185,2257863,7750322,레바논,2019-10
2019-10-31,9064427,9525777,-461350,우루과이,2019-10
2019-10-31,8912986,1236205,7676781,조지아,2019-10
2019-10-31,8593622,3353398,5240224,예맨,2019-10
2019-10-31,8428357,49199828,-40771471,트리니다드 토바고,2019-10
2019-10-31,7873625,12110780,-4237155,파라과이,2019-10
2019-10-31,7162238,25732382,-18570144,모잠비크,2019-10
2019-10-31,7153445,3110878,4042567,튀니지,2019-10
2019-10-31,6874073,32001,6842072,아제르바이잔,2019-10
2019-10-31,6870726,502100,6368626,코트디봐르,2019-10
2019-10-31,6749232,158334628,-151585396,기타국,2019-10
2019-10-31,6434090,1609285,4824805,니카라과,2019-10
2019-10-31,5964724,7991117,-2026393,라트비아,2019-10
2019-10-31,5215850,190228,5025622,사이프러스,2019-10
2019-10-31,5008279,4426498,581781,몰타,2019-10
2019-10-31,4969214,5884840,-915626,에티오피아,2019-10
2019-10-31,4880752,406184,4474568,모리셔스,2019-10
2019-10-31,4708028,434087,4273941,말리,2019-10
2019-10-31,4703816,2898181,1805635,세네갈,2019-10
2019-10-31,4636169,53338244,-48702075,파푸아 뉴기니,2019-10
2019-10-31,4598077,4009060,589017,라오스,2019-10
2019-10-31,4559361,489265,4070096,네팔,2019-10
2019-10-31,4543841,2853,4540988,부르키나 파소,2019-10
2019-10-31,4522383,6595,4515788,아프카니스탄,2019-10
2019-10-31,4503699,21338129,-16834430,콩고민주공화국,2019-10
2019-10-31,4490451,60634816,-56144365,브루나이,2019-10
2019-10-31,4452699,1303895,3148804,앙골라,2019-10
2019-10-31,4219797,3155841,1063956,벨라루스,2019-10
2019-10-31,4101247,7054582,-2953335,에스토니아,2019-10
2019-10-31,4088803,188139,3900664,아이티,2019-10
2019-10-31,3370665,0,3370665,팔레스타인 해방기구,2019-10
2019-10-31,3191818,528364,2663454,우간다,2019-10
2019-10-31,3021989,11509177,-8487188,마다카스카르,2019-10
2019-10-31,2936266,42020364,-39084098,볼리비아,2019-10
2019-10-31,2851467,2035755,815712,기니,2019-10
2019-10-31,2801508,646183,2155325,베네주엘라,2019-10
2019-10-31,2793345,0,2793345,타지크,2019-10
2019-10-31,2784259,226973,2557286,자마이카,2019-10
2019-10-31,2755717,1164052,1591665,세이쉘,2019-10
2019-10-31,2498515,293299,2205216,알바니아,2019-10
2019-10-31,2432407,4313921,-1881514,룩셈부르그,2019-10
2019-10-31,2329626,140466,2189160,수리남,2019-10
2019-10-31,2225221,149892,2075329,마카오,2019-10
2019-10-31,2080466,0,2080466,세인트 마틴,2019-10
2019-10-31,2076715,147862,1928853,사모아,2019-10
2019-10-31,2034761,1938,2032823,불령 리유니온 코모도 제도,2019-10
2019-10-31,2026484,28738994,-26712510,뉴 칼레도니아,2019-10
2019-10-31,1926896,0,1926896,불령 폴리네시아,2019-10
2019-10-31,1760046,269414,1490632,카메룬,2019-10
2019-10-31,1735736,1376499,359237,아이슬란드,2019-10
2019-10-31,1407572,1323435,84137,지부티,2019-10
2019-10-31,1399934,0,1399934,마티니크,2019-10
2019-10-31,1367951,15178,1352773,과델로프,2019-10
2019-10-31,1333219,247734,1085485,북마리아나 군도,2019-10
2019-10-31,1311612,477678,833934,콩고,2019-10
2019-10-31,1297873,1747270,-449397,잠비아,2019-10
2019-10-31,1220910,0,1220910,가이아나,2019-10
2019-10-31,1164727,1769787,-605060,몰도바,2019-10
2019-10-31,1162463,1021820,140643,소말리아,2019-10
2019-10-31,1157644,3643281,-2485637,아르메니아,2019-10
2019-10-31,1078531,960100,118431,아메리칸 사모아,2019-10
2019-10-31,1051680,168195,883485,키리바티,2019-10
2019-10-31,930997,4596766,-3665769,리히텐슈타인,2019-10
2019-10-31,891386,157090,734296,가봉,2019-10
2019-10-31,711365,504854,206511,쿠바,2019-10
2019-10-31,696043,3014879,-2318836,모리타니,2019-10
2019-10-31,677249,205898,471351,말라위,2019-10
2019-10-31,673729,1159576,-485847,안티가 바부다,2019-10
2019-10-31,618333,51196,567137,바베이도스,2019-10
2019-10-31,540006,944,539062,몰디브,2019-10
2019-10-31,536737,0,536737,투르크멘,2019-10
2019-10-31,535464,220,535244,버뮤다,2019-10
2019-10-31,533686,4352112,-3818426,나미비아,2019-10
2019-10-31,532929,38800,494129,마이크로네시아,2019-10
2019-10-31,493214,487121,6093,베닝,2019-10
2019-10-31,489395,1152563,-663168,시에라 리온,2019-10
2019-10-31,483833,10097,473736,부탄,2019-10
2019-10-31,461729,0,461729,아루바,2019-10
2019-10-31,447197,349706,97491,마세도니아,2019-10
2019-10-31,437590,357168,80422,솔로몬 군도,2019-10
2019-10-31,391466,216313,175153,바누아투,2019-10
2019-10-31,366791,191865,174926,르완다,2019-10
2019-10-31,357475,51072,306403,도미니카,2019-10
2019-10-31,325071,2728,322343,벨리제,2019-10
2019-10-31,324245,0,324245,나우루,2019-10
2019-10-31,323432,0,323432,상토메 프린스페,2019-10
2019-10-31,315911,3310603,-2994692,보스니아-헤르체고비나,2019-10
2019-10-31,297664,60492,237172,보츠와나,2019-10
2019-10-31,264362,284983,-20621,감비아,2019-10
2019-10-31,262989,22745,240244,니제르,2019-10
2019-10-31,241875,118023,123852,티모르,2019-10
2019-10-31,237734,8121,229613,세인트 빈센트 그레나딘,2019-10
2019-10-31,229885,100,229785,팔라우,2019-10
2019-10-31,216588,495251,-278663,짐바브웨,2019-10
2019-10-31,181115,0,181115,에리트리아,2019-10
2019-10-31,180790,0,180790,지브랄타,2019-10
2019-10-31,165916,435,165481,챠드,2019-10
2019-10-31,143359,0,143359,그레나다,2019-10
2019-10-31,129243,0,129243,카보 베르데,2019-10
2019-10-31,121184,14,121170,세인트 루시아,2019-10
2019-10-31,98108,269,97839,몬테네그로,2019-10
2019-10-31,91869,0,91869,불령 가이아나,2019-10
2019-10-31,85196,42,85154,세인트 키츠 네비스,2019-10
2019-10-31,80167,0,80167,큐라소,2019-10
2019-10-31,60881,321161,-260280,스와질랜드,2019-10
2019-10-31,48262,0,48262,네덜란드 열도,2019-10
2019-10-31,37322,500644,-463322,적도 기니,2019-10
2019-10-31,35388,0,35388,남수단,2019-10
2019-10-31,34517,477,34040,투르크 & 카이코스 군도,2019-10
2019-10-31,33385,35086,-1701,안도라,2019-10
2019-10-31,31234,0,31234,영령 버진군도,2019-10
2019-10-31,25789,0,25789,세인트 바르탤르미,2019-10
2019-10-31,21769,5569,16200,코모로스,2019-10
2019-10-31,19814,0,19814,왈라스 & 퓨투나 군도,2019-10
2019-10-31,15551,454,15097,앙귈라,2019-10
2019-10-31,14818,21313,-6495,모나코,2019-10
2019-10-31,11140,620134,-608994,산마리노,2019-10
2019-10-31,7048,492,6556,부룬디,2019-10
2019-10-31,3955,0,3955,파로에 군도,2019-10
2019-10-31,3666,9472,-5806,중앙아프리카공화국,2019-10
2019-10-31,3403,0,3403,기네비소,2019-10
2019-10-31,1914,0,1914,쿡 아일랜드,2019-10
2019-10-31,587,11469,-10882,미령 버진군도,2019-10
2019-10-31,581,54364,-53783,그린랜드,2019-10
2019-10-31,20,11,9,저어지,2019-10
2019-10-31,0,11,-11,코스 군도,2019-10
2019-10-31,0,2931,-2931,메요트,2019-10
2019-10-31,0,6428,-6428,니우에,2019-10
2019-10-31,0,39,-39,영령 인도양,2019-10
2019-10-31,0,245,-245,피트카이른,2019-10
2019-10-31,0,387,-387,세인트 헬레나,2019-10
2019-10-31,0,9909,-9909,몬트세라트,2019-10
2019-10-31,0,537761,-537761,안타티카,2019-10
2019-10-31,0,9047,-9047,토켈라우,2019-10
2019-10-31,0,53570,-53570,통가,2019-10
2019-10-31,0,25,-25,크리스마스 아일랜드,2019-10
2019-10-31,0,18638,-18638,레소토,2019-10
2019-11-30,11888954728,8966003816,2922950912,중국,2019-11
2019-11-30,6265034318,5273128737,991905581,미국,2019-11
2019-11-30,4052033453,1600624663,2451408790,베트남,2019-11
2019-11-30,2454636357,161673600,2292962757,홍콩,2019-11
2019-11-30,2410613103,3523164293,-1112551190,일본,2019-11
2019-11-30,1119454250,1358674473,-239220223,대만,2019-11
2019-11-30,1038294244,462663696,575630548,인도,2019-11
2019-11-30,793338481,470302481,323036000,싱가포르,2019-11
2019-11-30,766331481,435419676,330911805,멕시코,2019-11
2019-11-30,671583700,384252039,287331661,태국,2019-11
2019-11-30,662622696,1601725784,-939103088,독일,2019-11
2019-11-30,660666753,1479839142,-819172389,호주,2019-11
2019-11-30,642695723,273030527,369665196,필리핀,2019-11
2019-11-30,612984129,620690281,-7706152,인도네시아,2019-11
2019-11-30,598023405,756641154,-158617749,말레이시아,2019-11
2019-11-30,594626586,1248107814,-653481228,러시아 연방,2019-11
2019-11-30,476470986,119096851,357374135,카자흐스탄,2019-11
2019-11-30,460465852,61441944,399023908,폴란드,2019-11
2019-11-30,409870236,124189537,285680699,튀르키예,2019-11
2019-11-30,393447097,503393444,-109946347,캐나다,2019-11
2019-11-30,352246346,259652528,92593818,네덜란드,2019-11
2019-11-30,331280570,1682832945,-1351552375,사우디아라비아,2019-11
2019-11-30,317972016,465989284,-148017268,브라질,2019-11
2019-11-30,305557258,835384200,-529826942,아랍에미리트 연합,2019-11
2019-11-30,299790643,310478498,-10687855,영국,2019-11
2019-11-30,241430222,544107433,-302677211,이탈리아,2019-11
2019-11-30,237141897,1175517,235966380,우즈베키스탄,2019-11
2019-11-30,237012318,459131722,-222119404,프랑스,2019-11
2019-11-30,223422126,95930646,127491480,벨기에,2019-11
2019-11-30,221074072,66441888,154632184,이스라엘,2019-11
2019-11-30,214034368,46187088,167847280,헝가리,2019-11
2019-11-30,202634504,354043295,-151408791,스페인,2019-11
2019-11-30,174651854,16006,174635848,마샬군도,2019-11
2019-11-30,173796928,74473537,99323391,슬로바키아,2019-11
2019-11-30,163667730,2569230,161098500,파나마,2019-11
2019-11-30,161397780,77754404,83643376,체코공화국,2019-11
2019-11-30,139393894,77771659,61622235,뉴질랜드,2019-11
2019-11-30,135835250,9723835,126111415,슬로베니아,2019-11
2019-11-30,131461033,827509028,-696047995,이라크,2019-11
2019-11-30,131050421,5000889,126049532,토고,2019-11
2019-11-30,130643625,66857010,63786615,콜롬비아,2019-11
2019-11-30,123488242,27270475,96217767,방글라데시,2019-11
2019-11-30,113119629,222872,112896757,라이베리아,2019-11
2019-11-30,111414212,33793960,77620252,그리스,2019-11
2019-11-30,105319821,928013794,-822693973,쿠웨이트,2019-11
2019-11-30,104122698,25885398,78237300,이집트,2019-11
2019-11-30,98797579,174180816,-75383237,스웨덴,2019-11
2019-11-30,77365151,178662243,-101297092,오만,2019-11
2019-11-30,68642249,205180758,-136538509,칠레,2019-11
2019-11-30,65710960,128013433,-62302473,남아프리카공화국,2019-11
2019-11-30,62440556,19828608,42611948,파키스탄,2019-11
2019-11-30,62411061,111555231,-49144170,오스트리아,2019-11
2019-11-30,62247121,123479640,-61232519,아일랜드,2019-11
2019-11-30,59274082,0,59274082,지브랄타,2019-11
2019-11-30,57393473,250820,57142653,리비아,2019-11
2019-11-30,54723812,253690521,-198966709,스위스,2019-11
2019-11-30,53656100,24914546,28741554,캄보디아,2019-11
2019-11-30,53560110,192097190,-138537080,페루,2019-11
2019-11-30,53089657,38866939,14222718,미얀마,2019-11
2019-11-30,52550823,1099646,51451177,피지,2019-11
2019-11-30,51784119,70553540,-18769421,덴마크,2019-11
2019-11-30,51321925,103920231,-52598306,노르웨이,2019-11
2019-11-30,50739598,72309880,-21570282,나이지리아,2019-11
2019-11-30,50571363,18759039,31812324,포루투갈,2019-11
2019-11-30,46088516,34401222,11687294,루마니아,2019-11
2019-11-30,42739854,20583482,22156372,바레인,2019-11
2019-11-30,42043421,3986991,38056430,요르단,2019-11
2019-11-30,34617791,147333638,-112715847,알제리,2019-11
2019-11-30,32995073,0,32995073,영령 캐이맨 군도,2019-11
2019-11-30,32876015,76470172,-43594157,핀란드,2019-11
2019-11-30,29442759,4453297,24989462,튀니지,2019-11
2019-11-30,27552177,20788685,6763492,우크라이나,2019-11
2019-11-30,25652163,15974387,9677776,모로코,2019-11
2019-11-30,23973917,71259970,-47286053,아르헨티나,2019-11
2019-11-30,21968950,7820251,14148699,에쿠아도르,2019-11
2019-11-30,21610677,7844139,13766538,도미니카 공화국,2019-11
2019-11-30,21151555,10865,21140690,코트디봐르,2019-11
2019-11-30,20016695,2363010,17653685,몽골,2019-11
2019-11-30,19981947,19875251,106696,푸에르토리코,2019-11
2019-11-30,19285137,6356817,12928320,스리랑카,2019-11
2019-11-30,18739824,1051315934,-1032576110,카타르,2019-11
2019-11-30,16527403,5038968,11488435,과테말라,2019-11
2019-11-30,15679544,4985846,10693698,가나,2019-11
2019-11-30,14433181,5751306,8681875,리투아니아,2019-11
2019-11-30,14052395,2236926,11815469,수단,2019-11
2019-11-30,13984347,580594,13403753,이란,2019-11
2019-11-30,13664565,1711640,11952925,엘살바도르,2019-11
2019-11-30,13372567,28506161,-15133594,불가리아,2019-11
2019-11-30,13156409,6990,13149419,시리아,2019-11
2019-11-30,13134492,39675,13094817,아제르바이잔,2019-11
2019-11-30,12597184,15274393,-2677209,세르비아,2019-11
2019-11-30,11785423,5296,11780127,키르기스스탄,2019-11
2019-11-30,11543552,2924493,8619059,탄자니아,2019-11
2019-11-30,11171135,358524,10812611,괌,2019-11
2019-11-30,9945341,2633635,7311706,케냐,2019-11
2019-11-30,8954462,4576318,4378144,에스토니아,2019-11
2019-11-30,8894943,2889481,6005462,온두라스,2019-11
2019-11-30,8894373,4103320,4791053,예맨,2019-11
2019-11-30,8853197,1321677,7531520,크로아티아,2019-11
2019-11-30,8045430,7106310,939120,코스타리카,2019-11
2019-11-30,7444414,18003142,-10558728,파라과이,2019-11
2019-11-30,7281940,8729840,-1447900,우루과이,2019-11
2019-11-30,6860358,4433345,2427013,에티오피아,2019-11
2019-11-30,6721293,1186286,5535007,조지아,2019-11
2019-11-30,5654616,25321210,-19666594,트리니다드 토바고,2019-11
2019-11-30,5277982,6392634,-1114652,라트비아,2019-11
2019-11-30,5158061,1650231,3507830,니카라과,2019-11
2019-11-30,4996301,3501291,1495010,세네갈,2019-11
2019-11-30,4890719,1218966,3671753,아이슬란드,2019-11
2019-11-30,4859020,1882777,2976243,레바논,2019-11
2019-11-30,4387659,2399768,1987891,라오스,2019-11
2019-11-30,4281228,24176583,-19895355,모잠비크,2019-11
2019-11-30,4253341,270692,3982649,알바니아,2019-11
2019-11-30,4239780,0,4239780,팔레스타인 해방기구,2019-11
2019-11-30,3955263,2306852,1648411,벨라루스,2019-11
2019-11-30,3725773,95291,3630482,팔라우,2019-11
2019-11-30,3591291,4311958,-720667,몰타,2019-11
2019-11-30,3582192,306432562,-302850370,기타국,2019-11
2019-11-30,3566524,0,3566524,타지크,2019-11
2019-11-30,3372811,1957,3370854,아프카니스탄,2019-11
2019-11-30,3106676,289825,2816851,자마이카,2019-11
2019-11-30,3073087,19809538,-16736451,브루나이,2019-11
2019-11-30,3041601,482368,2559233,사이프러스,2019-11
2019-11-30,3041501,176498,2865003,마카오,2019-11
2019-11-30,3027454,13388260,-10360806,마다카스카르,2019-11
2019-11-30,3011771,189943,2821828,르완다,2019-11
2019-11-30,2966654,276718,2689936,네팔,2019-11
2019-11-30,2942824,706666,2236158,앙골라,2019-11
2019-11-30,2772484,233859,2538625,아이티,2019-11
2019-11-30,2709895,57717432,-55007537,파푸아 뉴기니,2019-11
2019-11-30,2632504,18,2632486,불령 폴리네시아,2019-11
2019-11-30,2589681,53171,2536510,사모아,2019-11
2019-11-30,2331770,1289,2330481,부르키나 파소,2019-11
2019-11-30,2221553,1685024,536529,잠비아,2019-11
2019-11-30,2152921,476340,1676581,모리셔스,2019-11
2019-11-30,2098939,648785,1450154,지부티,2019-11
2019-11-30,2011333,677423,1333910,쿠바,2019-11
2019-11-30,1772130,4058720,-2286590,룩셈부르그,2019-11
2019-11-30,1753420,39328488,-37575068,콩고민주공화국,2019-11
2019-11-30,1704210,972232,731978,우간다,2019-11
2019-11-30,1618426,346014,1272412,소말리아,2019-11
2019-11-30,1514468,47264,1467204,불령 리유니온 코모도 제도,2019-11
2019-11-30,1421344,34273334,-32851990,뉴 칼레도니아,2019-11
2019-11-30,1418665,621078,797587,시에라 리온,2019-11
2019-11-30,1411583,1761866,-350283,솔로몬 군도,2019-11
2019-11-30,1388651,2142560,-753909,기니,2019-11
2019-11-30,1380270,2932676,-1552406,베네주엘라,2019-11
2019-11-30,1331130,248165,1082965,카메룬,2019-11
2019-11-30,1293314,193713,1099601,콩고,2019-11
2019-11-30,1215998,157488,1058510,북마리아나 군도,2019-11
2019-11-30,1112579,2695234,-1582655,리히텐슈타인,2019-11
2019-11-30,1087927,725798,362129,세이쉘,2019-11
2019-11-30,1074937,465,1074472,말리,2019-11
2019-11-30,1059625,247098,812527,수리남,2019-11
2019-11-30,1044079,55,1044024,가이아나,2019-11
2019-11-30,986253,38204908,-37218655,볼리비아,2019-11
2019-11-30,984469,0,984469,아루바,2019-11
2019-11-30,981695,109130,872565,마세도니아,2019-11
2019-11-30,980512,1530040,-549528,몰도바,2019-11
2019-11-30,979525,50473,929052,바베이도스,2019-11
2019-11-30,941616,1524,940092,바하마,2019-11
2019-11-30,882366,0,882366,세인트 마틴,2019-11
2019-11-30,854305,18451,835854,과델로프,2019-11
2019-11-30,844915,28342450,-27497535,가봉,2019-11
2019-11-30,809879,649354,160525,바누아투,2019-11
2019-11-30,796587,0,796587,버뮤다,2019-11
2019-11-30,789132,3444380,-2655248,아르메니아,2019-11
2019-11-30,756764,0,756764,안티가 바부다,2019-11
2019-11-30,699848,0,699848,큐라소,2019-11
2019-11-30,688030,22360,665670,베닝,2019-11
2019-11-30,598294,6741,591553,아메리칸 사모아,2019-11
2019-11-30,582980,168532,414448,키리바티,2019-11
2019-11-30,570617,21610,549007,마티니크,2019-11
2019-11-30,539046,22316,516730,마이크로네시아,2019-11
2019-11-30,514824,6154,508670,나미비아,2019-11
2019-11-30,501812,2653670,-2151858,보스니아-헤르체고비나,2019-11
2019-11-30,427217,194013,233204,짐바브웨,2019-11
2019-11-30,384757,909,383848,불령 가이아나,2019-11
2019-11-30,369962,132830,237132,말라위,2019-11
2019-11-30,305690,2379371,-2073681,모리타니,2019-11
2019-11-30,284463,47,284416,투르크멘,2019-11
2019-11-30,273122,0,273122,세인트 루시아,2019-11
2019-11-30,264695,534,264161,감비아,2019-11
2019-11-30,254344,0,254344,투르크 & 카이코스 군도,2019-11
2019-11-30,248232,21574,226658,몰디브,2019-11
2019-11-30,240795,852,239943,벨리제,2019-11
2019-11-30,180719,64854,115865,보츠와나,2019-11
2019-11-30,175415,1938,173477,상토메 프린스페,2019-11
2019-11-30,172321,0,172321,기네비소,2019-11
2019-11-30,169102,285786,-116684,스와질랜드,2019-11
2019-11-30,166516,0,166516,세인트 바르탤르미,2019-11
2019-11-30,154756,52110,102646,몬테네그로,2019-11
2019-11-30,153521,8113,145408,부룬디,2019-11
2019-11-30,146466,0,146466,네덜란드 열도,2019-11
2019-11-30,138958,0,138958,카보 베르데,2019-11
2019-11-30,118109,0,118109,부탄,2019-11
2019-11-30,96996,30,96966,니제르,2019-11
2019-11-30,81393,0,81393,그레나다,2019-11
2019-11-30,70611,4400,66211,도미니카,2019-11
2019-11-30,44412,0,44412,세인트 빈센트 그레나딘,2019-11
2019-11-30,34400,715,33685,남수단,2019-11
2019-11-30,33882,0,33882,세인트마틴(생마르탱),2019-11
2019-11-30,28152,5463,22689,안도라,2019-11
2019-11-30,24965,63,24902,세인트 키츠 네비스,2019-11
2019-11-30,24130,157,23973,투발루,2019-11
2019-11-30,20007,494,19513,챠드,2019-11
2019-11-30,15962,224,15738,나우루,2019-11
2019-11-30,13976,0,13976,메요트,2019-11
2019-11-30,12499,0,12499,왈라스 & 퓨투나 군도,2019-11
2019-11-30,12450,413128,-400678,산마리노,2019-11
2019-11-30,10575,10060,515,티모르,2019-11
2019-11-30,6870,43280,-36410,중앙아프리카공화국,2019-11
2019-11-30,6371,109,6262,코모로스,2019-11
2019-11-30,5697,0,5697,영령 버진군도,2019-11
2019-11-30,4018,1402371,-1398353,통가,2019-11
2019-11-30,3153,15832793,-15829640,에리트리아,2019-11
2019-11-30,2975,121028,-118053,모나코,2019-11
2019-11-30,2500,32478767,-32476267,적도 기니,2019-11
2019-11-30,2408,0,2408,토켈라우,2019-11
2019-11-30,886,66,820,앙귈라,2019-11
2019-11-30,385,1885,-1500,미령 버진군도,2019-11
2019-11-30,120,12432,-12312,레소토,2019-11
2019-11-30,116,0,116,건지,2019-11
2019-11-30,76,12873,-12797,그린랜드,2019-11
2019-11-30,0,3182,-3182,남조지아 & 남샌드위치 군도,2019-11
2019-11-30,0,200,-200,맨섬,2019-11
2019-11-30,0,4774,-4774,몬트세라트,2019-11
2019-11-30,0,56294,-56294,쿡 아일랜드,2019-11
2019-11-30,0,200,-200,크리스마스 아일랜드,2019-11
2019-12-31,12296985639,9023873253,3273112386,중국,2019-12
2019-12-31,6418400063,5871142613,547257450,미국,2019-12
2019-12-31,3879351714,1520814052,2358537662,베트남,2019-12
2019-12-31,2609214538,113191743,2496022795,홍콩,2019-12
2019-12-31,2296481406,3925129661,-1628648255,일본,2019-12
2019-12-31,1447151645,1503713633,-56561988,대만,2019-12
2019-12-31,1098868193,690901830,407966363,싱가포르,2019-12
2019-12-31,1080149702,526574710,553574992,인도,2019-12
2019-12-31,811510528,616240601,195269927,멕시코,2019-12
2019-12-31,789672115,1956462864,-1166790749,독일,2019-12
2019-12-31,706420905,941947911,-235527006,말레이시아,2019-12
2019-12-31,661613387,272368793,389244594,필리핀,2019-12
2019-12-31,618956943,1982869760,-1363912817,호주,2019-12
2019-12-31,598639565,66753407,531886158,폴란드,2019-12
2019-12-31,593367441,422480360,170887081,태국,2019-12
2019-12-31,571978396,1239236678,-667258282,러시아 연방,2019-12
2019-12-31,567729827,676472304,-108742477,인도네시아,2019-12
2019-12-31,456863351,125676380,331186971,튀르키예,2019-12
2019-12-31,389962968,363875144,26087824,영국,2019-12
2019-12-31,373822060,411757972,-37935912,캐나다,2019-12
2019-12-31,366086284,1526644438,-1160558154,사우디아라비아,2019-12
2019-12-31,362563870,424653691,-62089821,브라질,2019-12
2019-12-31,333966175,1125058115,-791091940,아랍에미리트 연합,2019-12
2019-12-31,333858085,425194206,-91336121,네덜란드,2019-12
2019-12-31,318562124,587248681,-268686557,이탈리아,2019-12
2019-12-31,281410434,492748629,-211338195,프랑스,2019-12
2019-12-31,244418839,1775206,242643633,우즈베키스탄,2019-12
2019-12-31,238581560,158874248,79707312,스페인,2019-12
2019-12-31,231548106,89170612,142377494,카자흐스탄,2019-12
2019-12-31,222255265,80375712,141879553,마샬군도,2019-12
2019-12-31,210203793,37358024,172845769,헝가리,2019-12
2019-12-31,210079393,134516301,75563092,벨기에,2019-12
2019-12-31,205720389,7506908,198213481,파나마,2019-12
2019-12-31,190317312,26966783,163350529,슬로바키아,2019-12
2019-12-31,181515982,170283151,11232831,노르웨이,2019-12
2019-12-31,170510689,225754,170284935,라이베리아,2019-12
2019-12-31,163602185,928789146,-765186961,쿠웨이트,2019-12
2019-12-31,158209322,769123080,-610913758,이라크,2019-12
2019-12-31,156123159,78437798,77685361,체코공화국,2019-12
2019-12-31,136022639,64965364,71057275,이집트,2019-12
2019-12-31,124426241,27751793,96674448,방글라데시,2019-12
2019-12-31,117365558,10768343,106597215,슬로베니아,2019-12
2019-12-31,111286101,72778546,38507555,이스라엘,2019-12
2019-12-31,106912518,97279709,9632809,뉴질랜드,2019-12
2019-12-31,97178381,136873236,-39694855,알제리,2019-12
2019-12-31,95107793,233660625,-138552832,오만,2019-12
2019-12-31,95016371,46059329,48957042,콜롬비아,2019-12
2019-12-31,88744581,144321407,-55576826,스웨덴,2019-12
2019-12-31,83747009,89085343,-5338334,아일랜드,2019-12
2019-12-31,83737346,206024579,-122287233,칠레,2019-12
2019-12-31,75798307,38546535,37251772,파키스탄,2019-12
2019-12-31,69418538,196857257,-127438719,남아프리카공화국,2019-12
2019-12-31,67419747,165790378,-98370631,오스트리아,2019-12
2019-12-31,66797058,39302495,27494563,미얀마,2019-12
2019-12-31,65033454,168831980,-103798526,페루,2019-12
2019-12-31,61604388,29416134,32188254,캄보디아,2019-12
2019-12-31,60655272,66934422,-6279150,나이지리아,2019-12
2019-12-31,57921369,2700744,55220625,토고,2019-12
2019-12-31,52859676,79698211,-26838535,바레인,2019-12
2019-12-31,52393756,2455627,49938129,리비아,2019-12
2019-12-31,49804279,41013345,8790934,루마니아,2019-12
2019-12-31,46897839,9697490,37200349,요르단,2019-12
2019-12-31,46748793,24192573,22556220,포루투갈,2019-12
2019-12-31,38759051,88843277,-50084226,덴마크,2019-12
2019-12-31,37155130,246418171,-209263041,스위스,2019-12
2019-12-31,32995010,1158662309,-1125667299,카타르,2019-12
2019-12-31,32784547,10985045,21799502,그리스,2019-12
2019-12-31,31403396,27505621,3897775,우크라이나,2019-12
2019-12-31,30194629,15798736,14395893,푸에르토리코,2019-12
2019-12-31,29401937,10325853,19076084,모로코,2019-12
2019-12-31,28523499,68533404,-40009905,핀란드,2019-12
2019-12-31,26379846,6205243,20174603,리투아니아,2019-12
2019-12-31,25909631,7780337,18129294,에쿠아도르,2019-12
2019-12-31,24876089,2902977,21973112,세네갈,2019-12
2019-12-31,23785976,116258937,-92472961,아르헨티나,2019-12
2019-12-31,23533161,7706274,15826887,도미니카 공화국,2019-12
2019-12-31,23350497,8052738,15297759,스리랑카,2019-12
2019-12-31,22731903,858539,21873364,이란,2019-12
2019-12-31,22401769,53047,22348722,코트디봐르,2019-12
2019-12-31,20738254,4750418,15987836,과테말라,2019-12
2019-12-31,20265013,4658031,15606982,가나,2019-12
2019-12-31,16305670,1220806,15084864,몽골,2019-12
2019-12-31,15389517,43511601,-28122084,불가리아,2019-12
2019-12-31,15354853,1242399,14112454,수단,2019-12
2019-12-31,14220092,3159286,11060806,케냐,2019-12
2019-12-31,14085554,2139033,11946521,크로아티아,2019-12
2019-12-31,13088084,333,13087751,아제르바이잔,2019-12
2019-12-31,12617383,34319,12583064,시리아,2019-12
2019-12-31,12603956,13453374,-849418,세르비아,2019-12
2019-12-31,10909095,7515282,3393813,튀니지,2019-12
2019-12-31,10635191,6187423,4447768,예맨,2019-12
2019-12-31,10614006,24591000,-13976994,파라과이,2019-12
2019-12-31,10479096,1801315,8677781,엘살바도르,2019-12
2019-12-31,9618482,718664,8899818,탄자니아,2019-12
2019-12-31,9474546,2444853,7029693,온두라스,2019-12
2019-12-31,9177195,5411279,3765916,에티오피아,2019-12
2019-12-31,8465762,10686135,-2220373,우루과이,2019-12
2019-12-31,8282040,9375550,-1093510,코스타리카,2019-12
2019-12-31,8020802,1873124,6147678,아이슬란드,2019-12
2019-12-31,7812755,13751892,-5939137,트리니다드 토바고,2019-12
2019-12-31,7330381,6067919,1262462,에스토니아,2019-12
2019-12-31,7296106,7041710,254396,라트비아,2019-12
2019-12-31,7011370,7098057,-86687,벨라루스,2019-12
2019-12-31,6923381,561105,6362276,브루나이,2019-12
2019-12-31,6877977,1807082,5070895,니카라과,2019-12
2019-12-31,6673861,356248,6317613,키르기스스탄,2019-12
2019-12-31,6619429,129101168,-122481739,기타국,2019-12
2019-12-31,6573139,2708724,3864415,라오스,2019-12
2019-12-31,6549031,1880315,4668716,조지아,2019-12
2019-12-31,6444677,1839817,4604860,레바논,2019-12
2019-12-31,5450819,25173354,-19722535,파푸아 뉴기니,2019-12
2019-12-31,5143740,823750,4319990,괌,2019-12
2019-12-31,4736648,1469614,3267034,피지,2019-12
2019-12-31,4595886,410345,4185541,모잠비크,2019-12
2019-12-31,4412244,0,4412244,타지크,2019-12
2019-12-31,4170381,918279,3252102,사이프러스,2019-12
2019-12-31,4065101,11725007,-7659906,마다카스카르,2019-12
2019-12-31,3898298,4096803,-198505,몰타,2019-12
2019-12-31,3618845,30406473,-26787628,콩고민주공화국,2019-12
2019-12-31,3297528,6415,3291113,아프카니스탄,2019-12
2019-12-31,3223807,804598,2419209,지부티,2019-12
2019-12-31,2959032,5492285,-2533253,룩셈부르그,2019-12
2019-12-31,2853152,36363357,-33510205,카메룬,2019-12
2019-12-31,2743774,165197,2578577,팔레스타인 해방기구,2019-12
2019-12-31,2730997,575692,2155305,아이티,2019-12
2019-12-31,2669154,33651818,-30982664,뉴 칼레도니아,2019-12
2019-12-31,2659754,1574105,1085649,앙골라,2019-12
2019-12-31,2574002,5743909,-3169907,기니,2019-12
2019-12-31,2506183,1118945,1387238,모리셔스,2019-12
2019-12-31,2482019,361240,2120779,세이쉘,2019-12
2019-12-31,2349042,1355395,993647,베네주엘라,2019-12
2019-12-31,2334738,262,2334476,부르키나 파소,2019-12
2019-12-31,2308812,394729,1914083,자마이카,2019-12
2019-12-31,2193357,223697,1969660,마카오,2019-12
2019-12-31,2129931,2610,2127321,투르크멘,2019-12
2019-12-31,2039866,1969960,69906,아르메니아,2019-12
2019-12-31,1922269,241760,1680509,네팔,2019-12
2019-12-31,1794897,23584,1771313,사모아,2019-12
2019-12-31,1778027,78985,1699042,쿠바,2019-12
2019-12-31,1656769,39330504,-37673735,볼리비아,2019-12
2019-12-31,1563150,675931,887219,잠비아,2019-12
2019-12-31,1529046,268143,1260903,가이아나,2019-12
2019-12-31,1507945,131391,1376554,아메리칸 사모아,2019-12
2019-12-31,1387953,878675,509278,통가,2019-12
2019-12-31,1386920,333349,1053571,알바니아,2019-12
2019-12-31,1270372,982259,288113,몰도바,2019-12
2019-12-31,1258098,2541,1255557,소말리아,2019-12
2019-12-31,1232377,578,1231799,불령 폴리네시아,2019-12
2019-12-31,1154922,104056,1050866,북마리아나 군도,2019-12
2019-12-31,1124152,888,1123264,몰디브,2019-12
2019-12-31,1092023,287,1091736,과델로프,2019-12
2019-12-31,1087203,1905748,-818545,리히텐슈타인,2019-12
2019-12-31,1035666,0,1035666,아루바,2019-12
2019-12-31,1011859,50593,961266,바베이도스,2019-12
2019-12-31,926086,242443,683643,콩고,2019-12
2019-12-31,915003,0,915003,큐라소,2019-12
2019-12-31,912767,2435,910332,불령 리유니온 코모도 제도,2019-12
2019-12-31,910020,0,910020,세인트 마틴,2019-12
2019-12-31,859092,0,859092,마티니크,2019-12
2019-12-31,830376,510660,319716,수리남,2019-12
2019-12-31,775222,84635,690587,짐바브웨,2019-12
2019-12-31,752741,2548937,-1796196,말리,2019-12
2019-12-31,730247,3137493,-2407246,팔라우,2019-12
2019-12-31,656659,236,656423,바하마,2019-12
2019-12-31,601890,0,601890,세인트 루시아,2019-12
2019-12-31,577355,2474200,-1896845,모리타니,2019-12
2019-12-31,558959,2107347,-1548388,보스니아-헤르체고비나,2019-12
2019-12-31,525074,422754,102320,솔로몬 군도,2019-12
2019-12-31,498857,55158,443699,티모르,2019-12
2019-12-31,489930,153880,336050,우간다,2019-12
2019-12-31,472487,192840,279647,르완다,2019-12
2019-12-31,461416,128,461288,불령 가이아나,2019-12
2019-12-31,451912,500,451412,버뮤다,2019-12
2019-12-31,432404,0,432404,벨리제,2019-12
2019-12-31,404490,0,404490,메요트,2019-12
2019-12-31,392777,1371655,-978878,마세도니아,2019-12
2019-12-31,351436,18,351418,영령 캐이맨 군도,2019-12
2019-12-31,345003,52707010,-52362007,가봉,2019-12
2019-12-31,294434,1893,292541,마이크로네시아,2019-12
2019-12-31,279342,2249980,-1970638,시에라 리온,2019-12
2019-12-31,272298,39408,232890,나미비아,2019-12
2019-12-31,238237,0,238237,코모로스,2019-12
2019-12-31,224297,46000,178297,안티가 바부다,2019-12
2019-12-31,218077,42614,175463,보츠와나,2019-12
2019-12-31,212264,78090,134174,베닝,2019-12
2019-12-31,200232,90375,109857,몬테네그로,2019-12
2019-12-31,196223,1644667,-1448444,바누아투,2019-12
2019-12-31,191714,146,191568,부탄,2019-12
2019-12-31,187273,45296,141977,말라위,2019-12
2019-12-31,184208,9673,174535,도미니카,2019-12
2019-12-31,179010,41977,137033,부룬디,2019-12
2019-12-31,154829,0,154829,지브랄타,2019-12
2019-12-31,139214,1076,138138,키리바티,2019-12
2019-12-31,133650,171326,-37676,스와질랜드,2019-12
2019-12-31,133188,33,133155,영령 버진군도,2019-12
2019-12-31,121665,191,121474,네덜란드 열도,2019-12
2019-12-31,110714,0,110714,세인트 바르탤르미,2019-12
2019-12-31,104826,0,104826,투르크 & 카이코스 군도,2019-12
2019-12-31,73312,142,73170,니제르,2019-12
2019-12-31,67713,0,67713,그레나다,2019-12
2019-12-31,55761,329,55432,세인트 키츠 네비스,2019-12
2019-12-31,47811,174828,-127017,감비아,2019-12
2019-12-31,46197,369,45828,앙귈라,2019-12
2019-12-31,44593,36,44557,챠드,2019-12
2019-12-31,43310,1300,42010,몬트세라트,2019-12
2019-12-31,33667,0,33667,남수단,2019-12
2019-12-31,32780,0,32780,카보 베르데,2019-12
2019-12-31,31156,0,31156,에리트리아,2019-12
2019-12-31,23832,328385,-304553,기네비소,2019-12
2019-12-31,21083,0,21083,세인트 빈센트 그레나딘,2019-12
2019-12-31,19331,2521,16810,나우루,2019-12
2019-12-31,17478,56482,-39004,쿡 아일랜드,2019-12
2019-12-31,10110,943641,-933531,산마리노,2019-12
2019-12-31,4275,26907,-22632,레소토,2019-12
2019-12-31,3738,13870,-10132,미령 버진군도,2019-12
2019-12-31,1712,18115,-16403,안도라,2019-12
2019-12-31,600,187038,-186438,모나코,2019-12
2019-12-31,400,0,400,적도 기니,2019-12
2019-12-31,198,0,198,포클랜드 군도,2019-12
2019-12-31,141,0,141,세인트마틴(생마르탱),2019-12
2019-12-31,118,0,118,그린랜드,2019-12
2019-12-31,10,0,10,저어지,2019-12
2019-12-31,10,8791,-8781,파로에 군도,2019-12
2019-12-31,0,261,-261,코스 군도,2019-12
2019-12-31,0,408,-408,피트카이른,2019-12
2019-12-31,0,1228,-1228,상토메 프린스페,2019-12
2019-12-31,0,26280,-26280,니우에,2019-12
2019-12-31,0,667,-667,안타티카,2019-12
2019-12-31,0,5491,-5491,맨섬,2019-12
2019-12-31,0,103,-103,세인트 헬레나,2019-12
2019-12-31,0,26,-26,중앙아프리카공화국,2019-12
2019-12-31,0,1497,-1497,토켈라우,2019-12
2019-12-31,0,181,-181,왈라스 & 퓨투나 군도,2019-12
2019-12-31,0,35,-35,마이너 아우틀링 합중국 군도,2019-12
2020-01-31,9642031236,9428226017,213805219,중국,2020-01
2020-01-31,5740347386,5577075697,163271689,미국,2020-01
2020-01-31,4081500059,1846197866,2235302193,베트남,2020-01
2020-01-31,2434952964,3163260348,-728307384,일본,2020-01
2020-01-31,2278461122,969919160,1308541962,말레이시아,2020-01
2020-01-31,2193755203,127274450,2066480753,홍콩,2020-01
2020-01-31,1227490246,566831964,660658282,인도,2020-01
2020-01-31,1172396249,1384238983,-211842734,대만,2020-01
2020-01-31,1084770997,884790666,199980331,싱가포르,2020-01
2020-01-31,728794972,1349395292,-620600320,독일,2020-01
2020-01-31,720072435,647584028,72488407,멕시코,2020-01
2020-01-31,715651970,257010968,458641002,필리핀,2020-01
2020-01-31,605975907,430109790,175866117,태국,2020-01
2020-01-31,588782330,682742711,-93960381,인도네시아,2020-01
2020-01-31,573333955,152500,573181455,라이베리아,2020-01
2020-01-31,553670773,1928576659,-1374905886,호주,2020-01
2020-01-31,523531313,1265685490,-742154177,러시아 연방,2020-01
2020-01-31,462733668,106969553,355764115,튀르키예,2020-01
2020-01-31,443419096,60840162,382578934,폴란드,2020-01
2020-01-31,435432282,278457514,156974768,캐나다,2020-01
2020-01-31,407092412,166842240,240250172,카자흐스탄,2020-01
2020-01-31,369322400,539167951,-169845551,프랑스,2020-01
2020-01-31,360346255,376344364,-15998109,영국,2020-01
2020-01-31,347917710,889128973,-541211263,아랍에미리트 연합,2020-01
2020-01-31,319524503,346728185,-27203682,브라질,2020-01
2020-01-31,290157682,557214351,-267056669,이탈리아,2020-01
2020-01-31,279562125,225664303,53897822,네덜란드,2020-01
2020-01-31,255847987,2018583061,-1762735074,사우디아라비아,2020-01
2020-01-31,249539170,144368654,105170516,벨기에,2020-01
2020-01-31,224981781,38815515,186166266,헝가리,2020-01
2020-01-31,219318525,14152221,205166304,슬로바키아,2020-01
2020-01-31,196940718,12360611,184580107,파나마,2020-01
2020-01-31,189000237,181846005,7154232,스페인,2020-01
2020-01-31,187257575,76499003,110758572,체코공화국,2020-01
2020-01-31,185041020,4237667,180803353,몰타,2020-01
2020-01-31,163403331,30311,163373020,마샬군도,2020-01
2020-01-31,138417728,97537620,40880108,뉴질랜드,2020-01
2020-01-31,137013447,972435,136041012,우즈베키스탄,2020-01
2020-01-31,132699548,703829723,-571130175,이라크,2020-01
2020-01-31,112495844,46897022,65598822,이집트,2020-01
2020-01-31,112195365,3898630,108296735,토고,2020-01
2020-01-31,95945744,41084308,54861436,방글라데시,2020-01
2020-01-31,94701808,88430292,6271516,이스라엘,2020-01
2020-01-31,83879889,128295156,-44415267,오스트리아,2020-01
2020-01-31,73457282,316601520,-243144238,칠레,2020-01
2020-01-31,68971124,15461118,53510006,파키스탄,2020-01
2020-01-31,66921401,135669187,-68747786,스웨덴,2020-01
2020-01-31,65448422,14984753,50463669,슬로베니아,2020-01
2020-01-31,65181083,27460246,37720837,콜롬비아,2020-01
2020-01-31,56386154,137948515,-81562361,남아프리카공화국,2020-01
2020-01-31,50837462,329233758,-278396296,오만,2020-01
2020-01-31,50699981,26615839,24084142,포루투갈,2020-01
2020-01-31,50101289,96033104,-45931815,아일랜드,2020-01
2020-01-31,48421604,8813510,39608094,요르단,2020-01
2020-01-31,48316548,89314807,-40998259,아르헨티나,2020-01
2020-01-31,46427564,31724138,14703426,캄보디아,2020-01
2020-01-31,42003485,36376947,5626538,미얀마,2020-01
2020-01-31,41730748,211822938,-170092190,나이지리아,2020-01
2020-01-31,41439647,304692934,-263253287,페루,2020-01
2020-01-31,41173699,2576392,38597307,리비아,2020-01
2020-01-31,39120270,109123404,-70003134,노르웨이,2020-01
2020-01-31,37953379,34745776,3207603,루마니아,2020-01
2020-01-31,37659850,692479951,-654820101,쿠웨이트,2020-01
2020-01-31,34737233,185044069,-150306836,알제리,2020-01
2020-01-31,31335801,1955342,29380459,가나,2020-01
2020-01-31,30790543,233303086,-202512543,스위스,2020-01
2020-01-31,30255394,14246975,16008419,모로코,2020-01
2020-01-31,29163574,12801677,16361897,에쿠아도르,2020-01
2020-01-31,28985838,82205076,-53219238,덴마크,2020-01
2020-01-31,26761897,1086995920,-1060234023,카타르,2020-01
2020-01-31,25015556,1102267,23913289,피지,2020-01
2020-01-31,24168378,62548523,-38380145,핀란드,2020-01
2020-01-31,21984936,81526774,-59541838,그리스,2020-01
2020-01-31,21639055,6930725,14708330,리투아니아,2020-01
2020-01-31,20851669,45168713,-24317044,우크라이나,2020-01
2020-01-31,17557506,18199211,-641705,푸에르토리코,2020-01
2020-01-31,16321237,18080643,-1759406,스리랑카,2020-01
2020-01-31,16196673,5940213,10256460,도미니카 공화국,2020-01
2020-01-31,15685171,2504113,13181058,케냐,2020-01
2020-01-31,15117668,23997034,-8879366,바레인,2020-01
2020-01-31,14789482,751121,14038361,이란,2020-01
2020-01-31,14713268,2316603,12396665,몽골,2020-01
2020-01-31,14314446,2174961,12139485,엘살바도르,2020-01
2020-01-31,14296136,4959491,9336645,과테말라,2020-01
2020-01-31,13827776,1576955,12250821,탄자니아,2020-01
2020-01-31,12287478,2153319,10134159,크로아티아,2020-01
2020-01-31,12153151,34662662,-22509511,불가리아,2020-01
2020-01-31,10919738,2111953,8807785,수단,2020-01
2020-01-31,9296431,3567036,5729395,온두라스,2020-01
2020-01-31,9191054,6827907,2363147,튀니지,2020-01
2020-01-31,9014341,3187598,5826743,예맨,2020-01
2020-01-31,8907768,7322000,1585768,코스타리카,2020-01
2020-01-31,8188581,11781916,-3593335,세르비아,2020-01
2020-01-31,7661453,5762284,1899169,라오스,2020-01
2020-01-31,7534995,32889274,-25354279,모잠비크,2020-01
2020-01-31,7251043,3869214,3381829,에티오피아,2020-01
2020-01-31,7008566,22556058,-15547492,파라과이,2020-01
2020-01-31,6659286,373648,6285638,괌,2020-01
2020-01-31,6372494,1208725,5163769,조지아,2020-01
2020-01-31,6012901,8050711,-2037810,에스토니아,2020-01
2020-01-31,5884369,1194159,4690210,아이슬란드,2020-01
2020-01-31,5874732,2689657,3185075,레바논,2020-01
2020-01-31,5733858,4539,5729319,시리아,2020-01
2020-01-31,5470999,859909,4611090,아제르바이잔,2020-01
2020-01-31,5405770,648,5405122,키르기스스탄,2020-01
2020-01-31,5391733,74573,5317160,코트디봐르,2020-01
2020-01-31,5185797,16631968,-11446171,파푸아 뉴기니,2020-01
2020-01-31,5155085,47,5155038,말리,2020-01
2020-01-31,4866481,23106985,-18240504,브루나이,2020-01
2020-01-31,4584016,10809503,-6225487,사이프러스,2020-01
2020-01-31,4487029,872254,3614775,니카라과,2020-01
2020-01-31,4306631,1520947,2785684,벨라루스,2020-01
2020-01-31,4223104,28380309,-24157205,앙골라,2020-01
2020-01-31,4078529,12048371,-7969842,트리니다드 토바고,2020-01
2020-01-31,3942020,14220384,-10278364,우루과이,2020-01
2020-01-31,3803494,2115247,1688247,세네갈,2020-01
2020-01-31,3706414,6369536,-2663122,라트비아,2020-01
2020-01-31,3624741,1380984,2243757,쿠바,2020-01
2020-01-31,3437040,114586,3322454,사모아,2020-01
2020-01-31,3322562,1386,3321176,부르키나 파소,2020-01
2020-01-31,3197767,0,3197767,타지크,2020-01
2020-01-31,3162852,5665775,-2502923,마다카스카르,2020-01
2020-01-31,2646705,177283,2469422,르완다,2020-01
2020-01-31,2538390,136997,2401393,네팔,2020-01
2020-01-31,2460897,178503,2282394,마카오,2020-01
2020-01-31,2421372,240544,2180828,아이티,2020-01
2020-01-31,2317445,58083,2259362,아프카니스탄,2020-01
2020-01-31,2231803,221474,2010329,자마이카,2020-01
2020-01-31,2200225,706806,1493419,지부티,2020-01
2020-01-31,2185392,6885690,-4700298,룩셈부르그,2020-01
2020-01-31,2008532,4406408,-2397876,기니,2020-01
2020-01-31,1959031,24473092,-22514061,콩고민주공화국,2020-01
2020-01-31,1912415,10296855,-8384440,뉴 칼레도니아,2020-01
2020-01-31,1884619,842761,1041858,모리셔스,2020-01
2020-01-31,1777854,20,1777834,불령 리유니온 코모도 제도,2020-01
2020-01-31,1701869,94227,1607642,북마리아나 군도,2020-01
2020-01-31,1678580,72960,1605620,팔레스타인 해방기구,2020-01
2020-01-31,1437336,17168761,-15731425,볼리비아,2020-01
2020-01-31,1421407,0,1421407,과델로프,2020-01
2020-01-31,1407111,188321,1218790,카메룬,2020-01
2020-01-31,1400517,6366,1394151,니제르,2020-01
2020-01-31,1388576,1038,1387538,마티니크,2020-01
2020-01-31,1339407,235074,1104333,알바니아,2020-01
2020-01-31,1316057,600632,715425,콩고,2020-01
2020-01-31,1195537,338732,856805,가이아나,2020-01
2020-01-31,1072737,1054197,18540,베네주엘라,2020-01
2020-01-31,1071095,627512,443583,짐바브웨,2020-01
2020-01-31,1038996,907067,131929,리히텐슈타인,2020-01
2020-01-31,1025011,817186,207825,몰도바,2020-01
2020-01-31,997176,139625182,-138628006,기타국,2020-01
2020-01-31,977726,799730,177996,수리남,2020-01
2020-01-31,971236,699817,271419,아르메니아,2020-01
2020-01-31,961561,383120,578441,소말리아,2020-01
2020-01-31,909332,0,909332,불령 폴리네시아,2020-01
2020-01-31,833812,2135,831677,바하마,2020-01
2020-01-31,801658,153970,647688,세이쉘,2020-01
2020-01-31,759063,0,759063,세인트 마틴,2020-01
2020-01-31,624332,4313144,-3688812,가봉,2020-01
2020-01-31,617748,70731,547017,잠비아,2020-01
2020-01-31,564260,703739,-139479,바누아투,2020-01
2020-01-31,546286,90951,455335,키리바티,2020-01
2020-01-31,483236,42970,440266,팔라우,2020-01
2020-01-31,472061,0,472061,안티가 바부다,2020-01
2020-01-31,454292,3146,451146,불령 가이아나,2020-01
2020-01-31,405316,65974,339342,부룬디,2020-01
2020-01-31,389240,67879,321361,바베이도스,2020-01
2020-01-31,384400,135830,248570,베닝,2020-01
2020-01-31,384196,98844,285352,말라위,2020-01
2020-01-31,328051,1357188,-1029137,모리타니,2020-01
2020-01-31,324984,62,324922,마이크로네시아,2020-01
2020-01-31,309339,493999,-184660,우간다,2020-01
2020-01-31,295654,1701665,-1406011,보스니아-헤르체고비나,2020-01
2020-01-31,281827,20,281807,큐라소,2020-01
2020-01-31,281059,135,280924,아루바,2020-01
2020-01-31,251285,0,251285,몰디브,2020-01
2020-01-31,239236,0,239236,영령 버진군도,2020-01
2020-01-31,229261,49,229212,벨리제,2020-01
2020-01-31,226066,188132,37934,마세도니아,2020-01
2020-01-31,220434,425618,-205184,나미비아,2020-01
2020-01-31,217228,0,217228,카보 베르데,2020-01
2020-01-31,216830,0,216830,그레나다,2020-01
2020-01-31,215409,340519,-125110,솔로몬 군도,2020-01
2020-01-31,201142,0,201142,부탄,2020-01
2020-01-31,196075,769,195306,투르크멘,2020-01
2020-01-31,171612,15534,156078,아메리칸 사모아,2020-01
2020-01-31,142803,254,142549,버뮤다,2020-01
2020-01-31,137666,34263,103403,보츠와나,2020-01
2020-01-31,132488,0,132488,영령 캐이맨 군도,2020-01
2020-01-31,127645,1775282,-1647637,시에라 리온,2020-01
2020-01-31,106634,0,106634,나우루,2020-01
2020-01-31,98221,317598,-219377,감비아,2020-01
2020-01-31,81693,36347901,-36266208,적도 기니,2020-01
2020-01-31,73397,235053,-161656,스와질랜드,2020-01
2020-01-31,65741,0,65741,지브랄타,2020-01
2020-01-31,61785,209,61576,세인트 바르탤르미,2020-01
2020-01-31,54410,1983,52427,세인트 빈센트 그레나딘,2020-01
2020-01-31,53752,227,53525,몬테네그로,2020-01
2020-01-31,52175,34792,17383,티모르,2020-01
2020-01-31,49841,172157,-122316,모나코,2020-01
2020-01-31,43059,1175,41884,챠드,2020-01
2020-01-31,42620,0,42620,남수단,2020-01
2020-01-31,39485,0,39485,네덜란드 열도,2020-01
2020-01-31,31868,1705,30163,도미니카,2020-01
2020-01-31,24366,12992,11374,안도라,2020-01
2020-01-31,24225,788562,-764337,산마리노,2020-01
2020-01-31,12105,262,11843,앙귈라,2020-01
2020-01-31,9419,0,9419,상토메 프린스페,2020-01
2020-01-31,7931,1655,6276,투르크 & 카이코스 군도,2020-01
2020-01-31,7860,0,7860,포클랜드 군도,2020-01
2020-01-31,6891,0,6891,왈라스 & 퓨투나 군도,2020-01
2020-01-31,6590,134294,-127704,통가,2020-01
2020-01-31,5547,23036,-17489,미령 버진군도,2020-01
2020-01-31,4362,0,4362,그린랜드,2020-01
2020-01-31,1657,2119,-462,세인트 키츠 네비스,2020-01
2020-01-31,1293,0,1293,투발루,2020-01
2020-01-31,290,0,290,저어지,2020-01
2020-01-31,200,31911,-31711,중앙아프리카공화국,2020-01
2020-01-31,0,206142,-206142,기네비소,2020-01
2020-01-31,0,2352,-2352,건지,2020-01
2020-01-31,0,180,-180,마이너 아우틀링 합중국 군도,2020-01
2020-01-31,0,21,-21,토켈라우,2020-01
2020-01-31,0,655,-655,파로에 군도,2020-01
2020-01-31,0,12127,-12127,레소토,2020-01
2020-01-31,0,85,-85,노폴크 아일랜드,2020-01
2020-01-31,0,165,-165,보빗군도,2020-01
2020-01-31,0,1063,-1063,코모로스,2020-01
2020-01-31,0,9910,-9910,니우에,2020-01
2020-01-31,0,6769063,-6769063,에리트리아,2020-01
2020-01-31,0,1036,-1036,크리스마스 아일랜드,2020-01
2020-02-29,8824933471,5553040853,3271892618,중국,2020-02
2020-02-29,5931571874,5435011596,496560278,미국,2020-02
2020-02-29,3931516792,1498132964,2433383828,베트남,2020-02
2020-02-29,2546965586,129395494,2417570092,홍콩,2020-02
2020-02-29,2265044812,3771978681,-1506933869,일본,2020-02
2020-02-29,1384858554,515486883,869371671,인도,2020-02
2020-02-29,1140564308,567146370,573417938,싱가포르,2020-02
2020-02-29,1066633844,1328060126,-261426282,대만,2020-02
2020-02-29,733407408,507379754,226027654,멕시코,2020-02
2020-02-29,685742640,841726712,-155984072,말레이시아,2020-02
2020-02-29,646411511,445459437,200952074,태국,2020-02
2020-02-29,639403857,236643483,402760374,필리핀,2020-02
2020-02-29,601157337,679342770,-78185433,인도네시아,2020-02
2020-02-29,592074427,1530818213,-938743786,독일,2020-02
2020-02-29,583194051,70147611,513046440,튀르키예,2020-02
2020-02-29,540899242,1225829233,-684929991,러시아 연방,2020-02
2020-02-29,459049363,1315473987,-856424624,호주,2020-02
2020-02-29,383705272,380692511,3012761,캐나다,2020-02
2020-02-29,377895607,271234587,106661020,영국,2020-02
2020-02-29,370017178,62860848,307156330,폴란드,2020-02
2020-02-29,360011533,267654162,92357371,브라질,2020-02
2020-02-29,356531806,333994463,22537343,네덜란드,2020-02
2020-02-29,340594046,968635816,-628041770,아랍에미리트 연합,2020-02
2020-02-29,300907432,81887904,219019528,카자흐스탄,2020-02
2020-02-29,295928127,260809,295667318,라이베리아,2020-02
2020-02-29,271475911,1745582082,-1474106171,사우디아라비아,2020-02
2020-02-29,265142350,499635905,-234493555,이탈리아,2020-02
2020-02-29,252241123,145424522,106816601,벨기에,2020-02
2020-02-29,250183313,33536445,216646868,슬로바키아,2020-02
2020-02-29,232756068,34004173,198751895,헝가리,2020-02
2020-02-29,227401132,65825073,161576059,체코공화국,2020-02
2020-02-29,223524561,421047127,-197522566,프랑스,2020-02
2020-02-29,193546996,77229,193469767,마샬군도,2020-02
2020-02-29,192282495,131008997,61273498,스페인,2020-02
2020-02-29,184937495,46469,184891026,버뮤다,2020-02
2020-02-29,160502344,891848,159610496,우즈베키스탄,2020-02
2020-02-29,157138024,804793407,-647655383,쿠웨이트,2020-02
2020-02-29,154212789,172921889,-18709100,노르웨이,2020-02
2020-02-29,145037151,2781678,142255473,토고,2020-02
2020-02-29,144452862,53903331,90549531,파나마,2020-02
2020-02-29,140442708,83923743,56518965,뉴질랜드,2020-02
2020-02-29,118574576,667837162,-549262586,이라크,2020-02
2020-02-29,107367547,38798150,68569397,방글라데시,2020-02
2020-02-29,103049992,24257147,78792845,파키스탄,2020-02
2020-02-29,92876606,48747414,44129192,이집트,2020-02
2020-02-29,89983934,83477814,6506120,이스라엘,2020-02
2020-02-29,88488252,116046125,-27557873,오스트리아,2020-02
2020-02-29,79795873,7110798,72685075,슬로베니아,2020-02
2020-02-29,65788477,46083461,19705016,미얀마,2020-02
2020-02-29,64563230,0,64563230,지브랄타,2020-02
2020-02-29,62224792,288853924,-226629132,오만,2020-02
2020-02-29,57239541,112528199,-55288658,스웨덴,2020-02
2020-02-29,54140907,247350915,-193210008,칠레,2020-02
2020-02-29,53073324,56040372,-2967048,콜롬비아,2020-02
2020-02-29,53072720,102343217,-49270497,남아프리카공화국,2020-02
2020-02-29,52607736,5836002,46771734,몰타,2020-02
2020-02-29,51224138,31153342,20070796,캄보디아,2020-02
2020-02-29,50986623,224586167,-173599544,스위스,2020-02
2020-02-29,49248378,114133663,-64885285,나이지리아,2020-02
2020-02-29,46867238,2126256,44740982,리비아,2020-02
2020-02-29,45830597,266511042,-220680445,페루,2020-02
2020-02-29,43365139,47833352,-4468213,루마니아,2020-02
2020-02-29,40840435,8688748,32151687,요르단,2020-02
2020-02-29,37431794,79746221,-42314427,아르헨티나,2020-02
2020-02-29,35521397,104967438,-69446041,아일랜드,2020-02
2020-02-29,32510612,28688053,3822559,포루투갈,2020-02
2020-02-29,31356143,113612028,-82255885,우크라이나,2020-02
2020-02-29,31064135,5215233,25848902,리투아니아,2020-02
2020-02-29,28471661,67203482,-38731821,덴마크,2020-02
2020-02-29,28384163,47864874,-19480711,바레인,2020-02
2020-02-29,25178481,1259857,23918624,몽골,2020-02
2020-02-29,23041226,121949837,-98908611,그리스,2020-02
2020-02-29,22830790,105737517,-82906727,알제리,2020-02
2020-02-29,22165913,12272100,9893813,모로코,2020-02
2020-02-29,21682892,163748,21519144,괌,2020-02
2020-02-29,20908138,3761659,17146479,과테말라,2020-02
2020-02-29,20273477,919356888,-899083411,카타르,2020-02
2020-02-29,20074763,61265810,-41191047,핀란드,2020-02
2020-02-29,19666081,1294077,18372004,솔로몬 군도,2020-02
2020-02-29,18170135,1360503,16809632,이란,2020-02
2020-02-29,18035412,5376919,12658493,도미니카 공화국,2020-02
2020-02-29,16742460,106463,16635997,불령 폴리네시아,2020-02
2020-02-29,16257520,1641389,14616131,수단,2020-02
2020-02-29,15308314,12095881,3212433,탄자니아,2020-02
2020-02-29,15177935,6582639,8595296,에쿠아도르,2020-02
2020-02-29,14234051,2265837,11968214,가나,2020-02
2020-02-29,14162721,6566240,7596481,스리랑카,2020-02
2020-02-29,13564159,2608776,10955383,케냐,2020-02
2020-02-29,13405695,5992760,7412935,온두라스,2020-02
2020-02-29,12557173,21619351,-9062178,푸에르토리코,2020-02
2020-02-29,12178366,13369682,-1191316,불가리아,2020-02
2020-02-29,11862161,497,11861664,아제르바이잔,2020-02
2020-02-29,10413164,1795005,8618159,에티오피아,2020-02
2020-02-29,10318670,2961027,7357643,예맨,2020-02
2020-02-29,9516044,1731302,7784742,엘살바도르,2020-02
2020-02-29,9420510,16515858,-7095348,세르비아,2020-02
2020-02-29,9129372,300915,8828457,코트디봐르,2020-02
2020-02-29,8714593,7129860,1584733,코스타리카,2020-02
2020-02-29,8701921,3168528,5533393,라오스,2020-02
2020-02-29,8487402,1720544,6766858,조지아,2020-02
2020-02-29,7910174,9164887,-1254713,우루과이,2020-02
2020-02-29,7405306,11482025,-4076719,니카라과,2020-02
2020-02-29,7049614,7394191,-344577,튀니지,2020-02
2020-02-29,7029049,19382974,-12353925,파라과이,2020-02
2020-02-29,6942222,390,6941832,키르기스스탄,2020-02
2020-02-29,6790000,0,6790000,불령 남부지역,2020-02
2020-02-29,6311386,479261,5832125,레바논,2020-02
2020-02-29,6216738,3200,6213538,시리아,2020-02
2020-02-29,6017409,9835798,-3818389,트리니다드 토바고,2020-02
2020-02-29,5857452,500364,5357088,말리,2020-02
2020-02-29,5700362,22309069,-16608707,파푸아 뉴기니,2020-02
2020-02-29,5473909,4835,5469074,아프카니스탄,2020-02
2020-02-29,5211156,190101,5021055,아이티,2020-02
2020-02-29,5084871,4262356,822515,크로아티아,2020-02
2020-02-29,4928576,6270841,-1342265,에스토니아,2020-02
2020-02-29,4261058,529885,3731173,지부티,2020-02
2020-02-29,4055171,6935871,-2880700,기니,2020-02
2020-02-29,3950032,699990,3250042,모잠비크,2020-02
2020-02-29,3918588,5372092,-1453504,라트비아,2020-02
2020-02-29,3805737,1333244,2472493,아이슬란드,2020-02
2020-02-29,3728632,179332,3549300,팔레스타인 해방기구,2020-02
2020-02-29,3695411,6821551,-3126140,벨라루스,2020-02
2020-02-29,3525461,0,3525461,타지크,2020-02
2020-02-29,3518445,2136365,1382080,세네갈,2020-02
2020-02-29,3485426,131085,3354341,네팔,2020-02
2020-02-29,2861776,111289,2750487,사모아,2020-02
2020-02-29,2744206,0,2744206,부르키나 파소,2020-02
2020-02-29,2722701,608487,2114214,모리셔스,2020-02
2020-02-29,2532122,15695917,-13163795,마다카스카르,2020-02
2020-02-29,2429271,28542164,-26112893,콩고민주공화국,2020-02
2020-02-29,2427814,15620262,-13192448,앙골라,2020-02
2020-02-29,2416281,127240,2289041,자마이카,2020-02
2020-02-29,2237013,451596,1785417,피지,2020-02
2020-02-29,2169807,191794,1978013,마카오,2020-02
2020-02-29,1975445,3717882,-1742437,말라위,2020-02
2020-02-29,1859074,133910,1725164,르완다,2020-02
2020-02-29,1844831,131592014,-129747183,기타국,2020-02
2020-02-29,1765915,4981740,-3215825,룩셈부르그,2020-02
2020-02-29,1625598,1751,1623847,불령 리유니온 코모도 제도,2020-02
2020-02-29,1560097,16874360,-15314263,사이프러스,2020-02
2020-02-29,1437930,374107,1063823,브루나이,2020-02
2020-02-29,1342858,15786276,-14443418,뉴 칼레도니아,2020-02
2020-02-29,1322642,307,1322335,투르크멘,2020-02
2020-02-29,1290967,906322,384645,베네주엘라,2020-02
2020-02-29,1187353,1085750,101603,몰도바,2020-02
2020-02-29,1178036,2237493,-1059457,짐바브웨,2020-02
2020-02-29,1153109,72261,1080848,잠비아,2020-02
2020-02-29,1143390,238283,905107,세이쉘,2020-02
2020-02-29,1098491,141140,957351,가이아나,2020-02
2020-02-29,1015402,215956,799446,카메룬,2020-02
2020-02-29,993474,339952,653522,알바니아,2020-02
2020-02-29,971004,216382,754622,소말리아,2020-02
2020-02-29,962581,22943,939638,바하마,2020-02
2020-02-29,955197,888541,66656,리히텐슈타인,2020-02
2020-02-29,944379,2798770,-1854391,가봉,2020-02
2020-02-29,933788,642,933146,몰디브,2020-02
2020-02-29,912726,167318,745408,북마리아나 군도,2020-02
2020-02-29,895323,1081930,-186607,모리타니,2020-02
2020-02-29,883374,622188,261186,우간다,2020-02
2020-02-29,814109,999395,-185286,아르메니아,2020-02
2020-02-29,764488,0,764488,과델로프,2020-02
2020-02-29,724450,0,724450,마티니크,2020-02
2020-02-29,688644,479277,209367,마세도니아,2020-02
2020-02-29,683292,465122,218170,콩고,2020-02
2020-02-29,663576,39129181,-38465605,볼리비아,2020-02
2020-02-29,598662,25834,572828,바베이도스,2020-02
2020-02-29,523426,128,523298,키리바티,2020-02
2020-02-29,485023,34214,450809,팔라우,2020-02
2020-02-29,465265,29061,436204,마이크로네시아,2020-02
2020-02-29,446451,14609,431842,아메리칸 사모아,2020-02
2020-02-29,446278,11239,435039,쿠바,2020-02
2020-02-29,416876,0,416876,큐라소,2020-02
2020-02-29,398874,0,398874,영령 캐이맨 군도,2020-02
2020-02-29,391696,351977,39719,수리남,2020-02
2020-02-29,378925,354,378571,아루바,2020-02
2020-02-29,326103,1941383,-1615280,보스니아-헤르체고비나,2020-02
2020-02-29,325028,2288396,-1963368,시에라 리온,2020-02
2020-02-29,322741,1354,321387,남수단,2020-02
2020-02-29,307029,19502146,-19195117,나미비아,2020-02
2020-02-29,267788,25250,242538,베닝,2020-02
2020-02-29,253176,753088,-499912,바누아투,2020-02
2020-02-29,240416,0,240416,세인트 마틴,2020-02
2020-02-29,219567,32811,186756,티모르,2020-02
2020-02-29,217533,4061,213472,벨리제,2020-02
2020-02-29,214422,133458,80964,스와질랜드,2020-02
2020-02-29,175862,591,175271,투르크 & 카이코스 군도,2020-02
2020-02-29,173313,385,172928,그레나다,2020-02
2020-02-29,164068,107401,56667,몬테네그로,2020-02
2020-02-29,154331,341,153990,부탄,2020-02
2020-02-29,151516,5329,146187,네덜란드 열도,2020-02
2020-02-29,146911,0,146911,도미니카,2020-02
2020-02-29,139165,0,139165,중앙아프리카공화국,2020-02
2020-02-29,128883,0,128883,앙귈라,2020-02
2020-02-29,128371,0,128371,세인트 루시아,2020-02
2020-02-29,122222,666,121556,안도라,2020-02
2020-02-29,105433,0,105433,세인트 바르탤르미,2020-02
2020-02-29,84245,108,84137,코모로스,2020-02
2020-02-29,58407,0,58407,카보 베르데,2020-02
2020-02-29,55571,2741,52830,안티가 바부다,2020-02
2020-02-29,54044,549222,-495178,감비아,2020-02
2020-02-29,53451,173,53278,상토메 프린스페,2020-02
2020-02-29,47032,0,47032,불령 가이아나,2020-02
2020-02-29,43819,35217,8602,모나코,2020-02
2020-02-29,42689,3231,39458,세인트 빈센트 그레나딘,2020-02
2020-02-29,25194,23403,1791,보츠와나,2020-02
2020-02-29,20563,40,20523,영령 버진군도,2020-02
2020-02-29,14507,0,14507,적도 기니,2020-02
2020-02-29,10587,1140,9447,챠드,2020-02
2020-02-29,9505,69770,-60265,부룬디,2020-02
2020-02-29,8831,16778,-7947,미령 버진군도,2020-02
2020-02-29,7606,26857,-19251,통가,2020-02
2020-02-29,5693,5718,-25,니제르,2020-02
2020-02-29,3323,619,2704,안타티카,2020-02
2020-02-29,2588,9425,-6837,레소토,2020-02
2020-02-29,1793,1144,649,세인트 키츠 네비스,2020-02
2020-02-29,1450,6310,-4860,건지,2020-02
2020-02-29,509,0,509,포클랜드 군도,2020-02
2020-02-29,406,0,406,투발루,2020-02
2020-02-29,20,500,-480,맨섬,2020-02
2020-02-29,0,5285902,-5285902,에리트리아,2020-02
2020-02-29,0,3606,-3606,영령 인도양,2020-02
2020-02-29,0,241069,-241069,기네비소,2020-02
2020-02-29,0,1172,-1172,토켈라우,2020-02
2020-02-29,0,26524,-26524,산마리노,2020-02
2020-02-29,0,3,-3,몬트세라트,2020-02
2020-02-29,0,15076,-15076,마이너 아우틀링 합중국 군도,2020-02
2020-02-29,0,6307,-6307,니우에,2020-02
2020-02-29,0,192,-192,저어지,2020-02
2020-03-31,10643503407,8955780764,1687722643,중국,2020-03
2020-03-31,7281215108,5371870729,1909344379,미국,2020-03
2020-03-31,3998333951,1907886750,2090447201,베트남,2020-03
2020-03-31,3172786959,117348145,3055438814,홍콩,2020-03
2020-03-31,2485052839,4390046094,-1904993255,일본,2020-03
2020-03-31,1257871678,1478779025,-220907347,대만,2020-03
2020-03-31,1226091637,499806871,726284766,인도,2020-03
2020-03-31,980415815,637271560,343144255,싱가포르,2020-03
2020-03-31,891396934,1994861121,-1103464187,독일,2020-03
2020-03-31,840423408,580616451,259806957,멕시코,2020-03
2020-03-31,698704609,767340238,-68635629,말레이시아,2020-03
2020-03-31,608860279,126043054,482817225,튀르키예,2020-03
2020-03-31,596527088,460703262,135823826,태국,2020-03
2020-03-31,588487380,755775757,-167288377,인도네시아,2020-03
2020-03-31,580220996,1295145974,-714924978,러시아 연방,2020-03
2020-03-31,576913901,304816894,272097007,필리핀,2020-03
2020-03-31,572797240,1571817301,-999020061,호주,2020-03
2020-03-31,527049710,376058995,150990715,캐나다,2020-03
2020-03-31,469918661,75375939,394542722,폴란드,2020-03
2020-03-31,410513191,331509964,79003227,영국,2020-03
2020-03-31,398899093,814538565,-415639472,네덜란드,2020-03
2020-03-31,376710348,1593871350,-1217161002,사우디아라비아,2020-03
2020-03-31,368414556,561024216,-192609660,아랍에미리트 연합,2020-03
2020-03-31,358588118,400124710,-41536592,브라질,2020-03
2020-03-31,339556171,12516642,327039529,몰타,2020-03
2020-03-31,324108518,277199,323831319,버뮤다,2020-03
2020-03-31,306783645,535658888,-228875243,이탈리아,2020-03
2020-03-31,260301492,125566306,134735186,벨기에,2020-03
2020-03-31,257614819,51096319,206518500,헝가리,2020-03
2020-03-31,249853312,499317718,-249464406,프랑스,2020-03
2020-03-31,233664952,68638575,165026377,체코공화국,2020-03
2020-03-31,232163356,152812177,79351179,스페인,2020-03
2020-03-31,227753814,1453408,226300406,우즈베키스탄,2020-03
2020-03-31,213075216,64993498,148081718,그리스,2020-03
2020-03-31,207488903,14053067,193435836,카자흐스탄,2020-03
2020-03-31,206668999,36167610,170501389,슬로바키아,2020-03
2020-03-31,143022209,98288700,44733509,아일랜드,2020-03
2020-03-31,130551246,50420761,80130485,방글라데시,2020-03
2020-03-31,124486478,96760785,27725693,이스라엘,2020-03
2020-03-31,118840564,45541376,73299188,이집트,2020-03
2020-03-31,117730641,62077,117668564,마샬군도,2020-03
2020-03-31,110762857,416196748,-305433891,쿠웨이트,2020-03
2020-03-31,103407963,220470,103187493,라이베리아,2020-03
2020-03-31,98794314,29148313,69646001,파키스탄,2020-03
2020-03-31,94966482,336807622,-241841140,칠레,2020-03
2020-03-31,94652508,139054447,-44401939,오스트리아,2020-03
2020-03-31,87946627,374679048,-286732421,이라크,2020-03
2020-03-31,85112865,85416155,-303290,뉴질랜드,2020-03
2020-03-31,81823150,216947715,-135124565,오만,2020-03
2020-03-31,75664517,2778800,72885717,토고,2020-03
2020-03-31,66862501,45454092,21408409,미얀마,2020-03
2020-03-31,63563796,11020866,52542930,슬로베니아,2020-03
2020-03-31,61709677,91896694,-30187017,남아프리카공화국,2020-03
2020-03-31,57848786,54824584,3024202,나이지리아,2020-03
2020-03-31,57770738,139233375,-81462637,스웨덴,2020-03
2020-03-31,57739226,290328134,-232588908,페루,2020-03
2020-03-31,56311178,24136409,32174769,콜롬비아,2020-03
2020-03-31,54619809,4935579,49684230,요르단,2020-03
2020-03-31,54408992,60232103,-5823111,루마니아,2020-03
2020-03-31,50216392,210617289,-160400897,스위스,2020-03
2020-03-31,50197000,30974667,19222333,캄보디아,2020-03
2020-03-31,47605846,22521556,25084290,파나마,2020-03
2020-03-31,44506202,48142888,-3636686,아르헨티나,2020-03
2020-03-31,42617287,7482861,35134426,에쿠아도르,2020-03
2020-03-31,41666749,1776941,39889808,리비아,2020-03
2020-03-31,36993229,34005398,2987831,포루투갈,2020-03
2020-03-31,36160151,76836784,-40676633,덴마크,2020-03
2020-03-31,35509918,96777526,-61267608,노르웨이,2020-03
2020-03-31,34033183,93003756,-58970573,알제리,2020-03
2020-03-31,33244771,100987162,-67742391,우크라이나,2020-03
2020-03-31,33050094,73919458,-40869364,바레인,2020-03
2020-03-31,32998380,2294067,30704313,피지,2020-03
2020-03-31,32126079,393123,31732956,지부티,2020-03
2020-03-31,27593671,690847414,-663253743,카타르,2020-03
2020-03-31,25198234,6203883,18994351,리투아니아,2020-03
2020-03-31,22732426,7413787,15318639,과테말라,2020-03
2020-03-31,22018849,13448209,8570640,모로코,2020-03
2020-03-31,20906120,79672329,-58766209,핀란드,2020-03
2020-03-31,20758181,1647265,19110916,몽골,2020-03
2020-03-31,19162886,2747198,16415688,케냐,2020-03
2020-03-31,16991427,4033988,12957439,가나,2020-03
2020-03-31,16341529,23820017,-7478488,푸에르토리코,2020-03
2020-03-31,16236819,9773771,6463048,스리랑카,2020-03
2020-03-31,16025493,12827260,3198233,코스타리카,2020-03
2020-03-31,15901207,15799579,101628,앙골라,2020-03
2020-03-31,15110729,6523285,8587444,도미니카 공화국,2020-03
2020-03-31,14735069,6554146,8180923,온두라스,2020-03
2020-03-31,14110377,578138,13532239,이란,2020-03
2020-03-31,13885875,510480,13375395,수단,2020-03
2020-03-31,13791515,16361518,-2570003,불가리아,2020-03
2020-03-31,13611585,4097969,9513616,예맨,2020-03
2020-03-31,12657895,1964665,10693230,탄자니아,2020-03
2020-03-31,12455865,21378207,-8922342,세르비아,2020-03
2020-03-31,11876501,745627,11130874,조지아,2020-03
2020-03-31,11768513,14097502,-2328989,파라과이,2020-03
2020-03-31,11306477,7845527,3460950,에스토니아,2020-03
2020-03-31,11284049,7730231,3553818,튀니지,2020-03
2020-03-31,10694376,318733,10375643,괌,2020-03
2020-03-31,10121305,165431,9955874,사모아,2020-03
2020-03-31,9878424,208174,9670250,코트디봐르,2020-03
2020-03-31,9834398,2813968,7020430,에티오피아,2020-03
2020-03-31,9719637,158239,9561398,팔레스타인 해방기구,2020-03
2020-03-31,8686669,801016,7885653,니카라과,2020-03
2020-03-31,8375684,1863109,6512575,크로아티아,2020-03
2020-03-31,7585054,16314116,-8729062,엘살바도르,2020-03
2020-03-31,7491740,79494,7412246,아이티,2020-03
2020-03-31,7491465,9852156,-2360691,트리니다드 토바고,2020-03
2020-03-31,7034608,847857,6186751,모잠비크,2020-03
2020-03-31,6883036,336167,6546869,네팔,2020-03
2020-03-31,6735240,3804186,2931054,라오스,2020-03
2020-03-31,6531605,747650,5783955,레바논,2020-03
2020-03-31,6033206,7899025,-1865819,우루과이,2020-03
2020-03-31,5927832,6787870,-860038,라트비아,2020-03
2020-03-31,5707404,7636,5699768,키르기스스탄,2020-03
2020-03-31,5379191,22456948,-17077757,파푸아 뉴기니,2020-03
2020-03-31,5346701,331798,5014903,아제르바이잔,2020-03
2020-03-31,5270809,4855052,415757,벨라루스,2020-03
2020-03-31,5095379,2221219,2874160,세네갈,2020-03
2020-03-31,4628882,3862,4625020,시리아,2020-03
2020-03-31,4105612,49083027,-44977415,브루나이,2020-03
2020-03-31,3934239,1006119,2928120,부르키나 파소,2020-03
2020-03-31,3721873,32135076,-28413203,콩고민주공화국,2020-03
2020-03-31,3621911,331829,3290082,타지크,2020-03
2020-03-31,3360835,20375,3340460,아프카니스탄,2020-03
2020-03-31,3039737,147330427,-144290690,기타국,2020-03
2020-03-31,2937191,19554077,-16616886,볼리비아,2020-03
2020-03-31,2928986,3189715,-260729,모리셔스,2020-03
2020-03-31,2917222,485441,2431781,콩고,2020-03
2020-03-31,2347853,12596566,-10248713,마다카스카르,2020-03
2020-03-31,2268463,1613931,654532,보스니아-헤르체고비나,2020-03
2020-03-31,2218181,16649670,-14431489,사이프러스,2020-03
2020-03-31,2084288,4049095,-1964807,룩셈부르그,2020-03
2020-03-31,2005075,48865,1956210,가이아나,2020-03
2020-03-31,1990366,411202,1579164,우간다,2020-03
2020-03-31,1923094,430445,1492649,자마이카,2020-03
2020-03-31,1864961,8675901,-6810940,기니,2020-03
2020-03-31,1795115,218672,1576443,카메룬,2020-03
2020-03-31,1784614,860569,924045,베네주엘라,2020-03
2020-03-31,1648536,2505,1646031,불령 리유니온 코모도 제도,2020-03
2020-03-31,1647929,228854,1419075,소말리아,2020-03
2020-03-31,1486251,62280704,-60794453,가봉,2020-03
2020-03-31,1468054,101451,1366603,북마리아나 군도,2020-03
2020-03-31,1413503,707733,705770,수리남,2020-03
2020-03-31,1410118,34985,1375133,마카오,2020-03
2020-03-31,1295203,278628,1016575,세이쉘,2020-03
2020-03-31,1211937,3588694,-2376757,잠비아,2020-03
2020-03-31,1177537,151228,1026309,불령 폴리네시아,2020-03
2020-03-31,1167064,824161,342903,리히텐슈타인,2020-03
2020-03-31,1159119,23098,1136021,마티니크,2020-03
2020-03-31,1139645,2214384,-1074739,시에라 리온,2020-03
2020-03-31,1121289,265,1121024,키리바티,2020-03
2020-03-31,1098949,1064332,34617,몰도바,2020-03
2020-03-31,1097204,406794,690410,알바니아,2020-03
2020-03-31,1095703,26171516,-25075813,뉴 칼레도니아,2020-03
2020-03-31,1029118,2213225,-1184107,아이슬란드,2020-03
2020-03-31,922731,618712,304019,솔로몬 군도,2020-03
2020-03-31,917350,4835987,-3918637,아르메니아,2020-03
2020-03-31,813733,1212288,-398555,짐바브웨,2020-03
2020-03-31,813149,249929,563220,쿠바,2020-03
2020-03-31,800677,191603,609074,말리,2020-03
2020-03-31,799324,1448152,-648828,말라위,2020-03
2020-03-31,796094,219787,576307,아메리칸 사모아,2020-03
2020-03-31,778873,1718187,-939314,모리타니,2020-03
2020-03-31,761880,0,761880,세인트 마틴,2020-03
2020-03-31,674447,47151,627296,바베이도스,2020-03
2020-03-31,631353,16948,614405,과델로프,2020-03
2020-03-31,618650,39188,579462,보츠와나,2020-03
2020-03-31,614176,53213,560963,르완다,2020-03
2020-03-31,609268,682748,-73480,바누아투,2020-03
2020-03-31,590992,24970,566022,베닝,2020-03
2020-03-31,563556,905149,-341593,영령 캐이맨 군도,2020-03
2020-03-31,558620,190909,367711,마세도니아,2020-03
2020-03-31,488630,1240,487390,중앙아프리카공화국,2020-03
2020-03-31,469922,352888,117034,감비아,2020-03
2020-03-31,469623,0,469623,불령 가이아나,2020-03
2020-03-31,456810,3375,453435,몰디브,2020-03
2020-03-31,404688,21667,383021,마이크로네시아,2020-03
2020-03-31,402911,0,402911,투르크멘,2020-03
2020-03-31,397054,12,397042,세인트 루시아,2020-03
2020-03-31,390677,4883,385794,벨리제,2020-03
2020-03-31,304705,0,304705,메요트,2020-03
2020-03-31,263787,31557,232230,팔라우,2020-03
2020-03-31,259805,429,259376,아루바,2020-03
2020-03-31,246674,6561,240113,바하마,2020-03
2020-03-31,245975,359,245616,큐라소,2020-03
2020-03-31,200602,1835,198767,몬테네그로,2020-03
2020-03-31,199957,261,199696,네덜란드 열도,2020-03
2020-03-31,197705,160972,36733,스와질랜드,2020-03
2020-03-31,168102,138,167964,투르크 & 카이코스 군도,2020-03
2020-03-31,160609,4759,155850,도미니카,2020-03
2020-03-31,149242,56133,93109,코모로스,2020-03
2020-03-31,142486,137,142349,부탄,2020-03
2020-03-31,141689,6588,135101,안티가 바부다,2020-03
2020-03-31,120340,0,120340,적도 기니,2020-03
2020-03-31,117810,269117,-151307,기네비소,2020-03
2020-03-31,111812,0,111812,영령 버진군도,2020-03
2020-03-31,100775,0,100775,앙귈라,2020-03
2020-03-31,89153,0,89153,그레나다,2020-03
2020-03-31,81394,300,81094,지브랄타,2020-03
2020-03-31,72333,397,71936,통가,2020-03
2020-03-31,69040,306,68734,세인트 키츠 네비스,2020-03
2020-03-31,56612,6275685,-6219073,나미비아,2020-03
2020-03-31,47763,3,47760,카보 베르데,2020-03
2020-03-31,45128,4220,40908,티모르,2020-03
2020-03-31,39359,60,39299,니제르,2020-03
2020-03-31,24418,0,24418,남수단,2020-03
2020-03-31,24390,1928,22462,상토메 프린스페,2020-03
2020-03-31,22000,2192,19808,토켈라우,2020-03
2020-03-31,20641,39785,-19144,부룬디,2020-03
2020-03-31,14939,0,14939,나우루,2020-03
2020-03-31,10243,0,10243,포클랜드 군도,2020-03
2020-03-31,9750,0,9750,쿡 아일랜드,2020-03
2020-03-31,5641,0,5641,영령 인도양,2020-03
2020-03-31,3053,25276,-22223,레소토,2020-03
2020-03-31,2640,1791,849,안도라,2020-03
2020-03-31,2263,0,2263,세인트 바르탤르미,2020-03
2020-03-31,1710,32375,-30665,모나코,2020-03
2020-03-31,790,5876,-5086,미령 버진군도,2020-03
2020-03-31,84,0,84,세인트 빈센트 그레나딘,2020-03
2020-03-31,28,415112,-415084,산마리노,2020-03
2020-03-31,0,192,-192,안타티카,2020-03
2020-03-31,0,9,-9,크리스마스 아일랜드,2020-03
2020-03-31,0,67957,-67957,그린랜드,2020-03
2020-03-31,0,100,-100,맨섬,2020-03
2020-03-31,0,184,-184,저어지,2020-03
2020-03-31,0,25750,-25750,마이너 아우틀링 합중국 군도,2020-03
2020-03-31,0,3801,-3801,불령 남부지역,2020-03
2020-03-31,0,35,-35,보빗군도,2020-03
2020-03-31,0,69,-69,몬트세라트,2020-03
2020-03-31,0,112,-112,피트카이른,2020-03
2020-03-31,0,138,-138,세인트 헬레나,2020-03
2020-03-31,0,622,-622,파로에 군도,2020-03
2020-03-31,0,179,-179,노폴크 아일랜드,2020-03
2020-03-31,0,12131,-12131,챠드,2020-03
2020-03-31,0,2945,-2945,건지,2020-03
2020-03-31,0,31,-31,에리트리아,2020-03
2020-04-30,10151494828,9626467217,525027611,중국,2020-04
2020-04-30,5277225836,5041815934,235409902,미국,2020-04
2020-04-30,2713976274,1565455623,1148520651,베트남,2020-04
2020-04-30,2379361597,150857619,2228503978,홍콩,2020-04
2020-04-30,1984660364,3988576159,-2003915795,일본,2020-04
2020-04-30,1251015054,1265527432,-14512378,대만,2020-04
2020-04-30,785609518,1854688396,-1069078878,독일,2020-04
2020-04-30,748962422,637987043,110975379,싱가포르,2020-04
2020-04-30,585309504,205329953,379979551,필리핀,2020-04
2020-04-30,531139381,439571999,91567382,인도,2020-04
2020-04-30,530738830,469334565,61404265,멕시코,2020-04
2020-04-30,514879278,420978429,93900849,태국,2020-04
2020-04-30,508540036,577542072,-69002036,말레이시아,2020-04
2020-04-30,446236511,644138766,-197902255,인도네시아,2020-04
2020-04-30,426822732,725113081,-298290349,러시아 연방,2020-04
2020-04-30,386090654,1536406912,-1150316258,호주,2020-04
2020-04-30,379668603,111307555,268361048,튀르키예,2020-04
2020-04-30,367430900,300836568,66594332,영국,2020-04
2020-04-30,346698285,67298096,279400189,폴란드,2020-04
2020-04-30,337775643,320886530,16889113,네덜란드,2020-04
2020-04-30,293790918,406216551,-112425633,캐나다,2020-04
2020-04-30,278415614,916152309,-637736695,사우디아라비아,2020-04
2020-04-30,272924714,335381964,-62457250,아랍에미리트 연합,2020-04
2020-04-30,253148331,95095032,158053299,체코공화국,2020-04
2020-04-30,236664945,333474689,-96809744,브라질,2020-04
2020-04-30,231563194,111825712,119737482,벨기에,2020-04
2020-04-30,227195197,436601339,-209406142,프랑스,2020-04
2020-04-30,215239708,399772443,-184532735,이탈리아,2020-04
2020-04-30,212825611,60042975,152782636,헝가리,2020-04
2020-04-30,198452517,10028945,188423572,파나마,2020-04
2020-04-30,184006518,317,184006201,버뮤다,2020-04
2020-04-30,183673506,5865766,177807740,몰타,2020-04
2020-04-30,166825240,153222782,13602458,스페인,2020-04
2020-04-30,147723569,884045,146839524,우즈베키스탄,2020-04
2020-04-30,138640384,119201685,19438699,슬로바키아,2020-04
2020-04-30,133679984,75380218,58299766,이스라엘,2020-04
2020-04-30,125212047,83607803,41604244,아일랜드,2020-04
2020-04-30,106073204,420569358,-314496154,쿠웨이트,2020-04
2020-04-30,88502249,144550915,-56048666,오만,2020-04
2020-04-30,83701644,5318544,78383100,토고,2020-04
2020-04-30,80594697,33617629,46977068,이집트,2020-04
2020-04-30,79690567,75650,79614917,마샬군도,2020-04
2020-04-30,71652721,116402154,-44749433,오스트리아,2020-04
2020-04-30,69980341,325925668,-255945327,이라크,2020-04
2020-04-30,61586483,143041424,-81454941,스웨덴,2020-04
2020-04-30,54496301,9490836,45005465,슬로베니아,2020-04
2020-04-30,53777133,87924121,-34146988,콜롬비아,2020-04
2020-04-30,51241014,13802496,37438518,파키스탄,2020-04
2020-04-30,50156005,35224336,14931669,방글라데시,2020-04
2020-04-30,49466387,117825253,-68358866,뉴질랜드,2020-04
2020-04-30,49319580,33693482,15626098,미얀마,2020-04
2020-04-30,46355264,63045354,-16690090,나이지리아,2020-04
2020-04-30,44298935,47898423,-3599488,루마니아,2020-04
2020-04-30,42290734,175165053,-132874319,남아프리카공화국,2020-04
2020-04-30,40528354,302589528,-262061174,칠레,2020-04
2020-04-30,39062026,197694324,-158632298,스위스,2020-04
2020-04-30,38173349,169002,38004347,라이베리아,2020-04
2020-04-30,35544393,76463180,-40918787,덴마크,2020-04
2020-04-30,35543832,20345955,15197877,캄보디아,2020-04
2020-04-30,34319996,55408479,-21088483,카자흐스탄,2020-04
2020-04-30,31817735,525960,31291775,리비아,2020-04
2020-04-30,31575975,237996623,-206420648,페루,2020-04
2020-04-30,31420193,703002273,-671582080,카타르,2020-04
2020-04-30,29198244,92311426,-63113182,우크라이나,2020-04
2020-04-30,25965251,28035277,-2070026,바레인,2020-04
2020-04-30,24360090,2850,24357240,맨섬,2020-04
2020-04-30,22876415,715189,22161226,몽골,2020-04
2020-04-30,22243485,25009341,-2765856,포루투갈,2020-04
2020-04-30,21845427,6701135,15144292,요르단,2020-04
2020-04-30,20824000,6769294,14054706,리투아니아,2020-04
2020-04-30,20718461,3236048,17482413,예맨,2020-04
2020-04-30,20500359,13874764,6625595,모로코,2020-04
2020-04-30,19946183,105187315,-85241132,노르웨이,2020-04
2020-04-30,18472076,67017406,-48545330,핀란드,2020-04
2020-04-30,18284832,64050573,-45765741,알제리,2020-04
2020-04-30,17412321,24171462,-6759141,세르비아,2020-04
2020-04-30,16915076,48327878,-31412802,아르헨티나,2020-04
2020-04-30,16166303,30511517,-14345214,그리스,2020-04
2020-04-30,16049374,3394282,12655092,과테말라,2020-04
2020-04-30,15715562,184780,15530782,피지,2020-04
2020-04-30,14950617,4192665,10757952,가나,2020-04
2020-04-30,14014925,1469162,12545763,케냐,2020-04
2020-04-30,13934311,6774812,7159499,에쿠아도르,2020-04
2020-04-30,13304729,1104200,12200529,이란,2020-04
2020-04-30,12838251,162506,12675745,모잠비크,2020-04
2020-04-30,11787285,6745495,5041790,도미니카 공화국,2020-04
2020-04-30,11483796,8116264,3367532,불가리아,2020-04
2020-04-30,11325985,953337,10372648,수단,2020-04
2020-04-30,10532125,646062,9886063,코트디봐르,2020-04
2020-04-30,10426546,171850,10254696,괌,2020-04
2020-04-30,9644578,2219927,7424651,탄자니아,2020-04
2020-04-30,9641177,8640081,1001096,온두라스,2020-04
2020-04-30,8620206,2923994,5696212,에티오피아,2020-04
2020-04-30,8555325,7007371,1547954,파라과이,2020-04
2020-04-30,8328321,7532601,795720,에스토니아,2020-04
2020-04-30,7706860,771826,6935034,레바논,2020-04
2020-04-30,7595346,1215534,6379812,조지아,2020-04
2020-04-30,6736232,16791121,-10054889,엘살바도르,2020-04
2020-04-30,6457836,11,6457825,소말리아,2020-04
2020-04-30,6438644,4397768,2040876,니카라과,2020-04
2020-04-30,6385801,44716621,-38330820,콩고민주공화국,2020-04
2020-04-30,6334975,26558286,-20223311,코스타리카,2020-04
2020-04-30,6009277,2329474,3679803,세네갈,2020-04
2020-04-30,5924052,5749627,174425,스리랑카,2020-04
2020-04-30,5599340,34641995,-29042655,브루나이,2020-04
2020-04-30,5048540,5016927,31613,튀니지,2020-04
2020-04-30,4993855,4717254,276601,벨라루스,2020-04
2020-04-30,4950066,1946664,3003402,크로아티아,2020-04
2020-04-30,4773341,2431889,2341452,아이슬란드,2020-04
2020-04-30,4531051,8205568,-3674517,라트비아,2020-04
2020-04-30,4502130,19902,4482228,아제르바이잔,2020-04
2020-04-30,4455407,693823,3761584,아이티,2020-04
2020-04-30,3879642,0,3879642,팔레스타인 해방기구,2020-04
2020-04-30,3862822,630183,3232639,카메룬,2020-04
2020-04-30,3643192,1201,3641991,시리아,2020-04
2020-04-30,3583583,192201,3391382,말리,2020-04
2020-04-30,3416415,1008846,2407569,부르키나 파소,2020-04
2020-04-30,3383651,11383656,-8000005,앙골라,2020-04
2020-04-30,3347071,5025624,-1678553,마다카스카르,2020-04
2020-04-30,3095763,562503,2533260,지부티,2020-04
2020-04-30,2876350,18575471,-15699121,푸에르토리코,2020-04
2020-04-30,2824619,5902704,-3078085,기니,2020-04
2020-04-30,2597926,9150856,-6552930,트리니다드 토바고,2020-04
2020-04-30,2576219,57910,2518309,네팔,2020-04
2020-04-30,2563233,141734,2421499,북마리아나 군도,2020-04
2020-04-30,2338754,10202219,-7863465,우루과이,2020-04
2020-04-30,2279890,34633853,-32353963,파푸아 뉴기니,2020-04
2020-04-30,2263871,102895,2160976,가봉,2020-04
2020-04-30,1957384,176,1957208,키르기스스탄,2020-04
2020-04-30,1890406,62213,1828193,아프카니스탄,2020-04
2020-04-30,1884851,738571,1146280,사이프러스,2020-04
2020-04-30,1848737,132136,1716601,사모아,2020-04
2020-04-30,1842298,1036144,806154,모리셔스,2020-04
2020-04-30,1796815,144,1796671,타지크,2020-04
2020-04-30,1773180,76984,1696196,팔라우,2020-04
2020-04-30,1676327,739137,937190,키리바티,2020-04
2020-04-30,1634035,4496871,-2862836,라오스,2020-04
2020-04-30,1597460,197790,1399670,자마이카,2020-04
2020-04-30,1475966,121659,1354307,마카오,2020-04
2020-04-30,1461660,6856383,-5394723,룩셈부르그,2020-04
2020-04-30,1387207,28276348,-26889141,볼리비아,2020-04
2020-04-30,1340566,23777979,-22437413,뉴 칼레도니아,2020-04
2020-04-30,1329423,888744,440679,베네주엘라,2020-04
2020-04-30,1171278,250153,921125,세이쉘,2020-04
2020-04-30,1143668,1118815,24853,아르메니아,2020-04
2020-04-30,1103874,149056,954818,불령 폴리네시아,2020-04
2020-04-30,1091858,177281,914577,잠비아,2020-04
2020-04-30,1053109,138944,914165,우간다,2020-04
2020-04-30,1038809,149393,889416,알바니아,2020-04
2020-04-30,988971,0,988971,가이아나,2020-04
2020-04-30,945881,207316,738565,르완다,2020-04
2020-04-30,909229,37,909192,마이크로네시아,2020-04
2020-04-30,897712,883181,14531,쿠바,2020-04
2020-04-30,854091,449600,404491,콩고,2020-04
2020-04-30,842365,1943012,-1100647,짐바브웨,2020-04
2020-04-30,771778,1028230,-256452,솔로몬 군도,2020-04
2020-04-30,679539,0,679539,부탄,2020-04
2020-04-30,655430,718327,-62897,리히텐슈타인,2020-04
2020-04-30,642238,1010433,-368195,나미비아,2020-04
2020-04-30,607540,68,607472,베닝,2020-04
2020-04-30,554171,0,554171,투르크멘,2020-04
2020-04-30,532616,809143,-276527,몰도바,2020-04
2020-04-30,494947,6347,488600,티모르,2020-04
2020-04-30,474942,131,474811,불령 리유니온 코모도 제도,2020-04
2020-04-30,464412,1896576,-1432164,보스니아-헤르체고비나,2020-04
2020-04-30,463322,0,463322,세인트 마틴,2020-04
2020-04-30,436104,43210,392894,아메리칸 사모아,2020-04
2020-04-30,432184,218,431966,아루바,2020-04
2020-04-30,424938,1824601,-1399663,수리남,2020-04
2020-04-30,423047,428296,-5249,마세도니아,2020-04
2020-04-30,416587,1411647,-995060,말라위,2020-04
2020-04-30,415457,89251496,-88836039,기타국,2020-04
2020-04-30,388598,2723261,-2334663,모리타니,2020-04
2020-04-30,384934,0,384934,바하마,2020-04
2020-04-30,369314,26260,343054,보츠와나,2020-04
2020-04-30,343159,2888,340271,몬테네그로,2020-04
2020-04-30,342911,88,342823,큐라소,2020-04
2020-04-30,333215,0,333215,과델로프,2020-04
2020-04-30,312277,373,311904,안티가 바부다,2020-04
2020-04-30,298443,0,298443,영령 캐이맨 군도,2020-04
2020-04-30,295353,1755414,-1460061,니제르,2020-04
2020-04-30,289938,309,289629,몰디브,2020-04
2020-04-30,249044,1447519,-1198475,시에라 리온,2020-04
2020-04-30,235983,75397,160586,바베이도스,2020-04
2020-04-30,218213,3408,214805,벨리제,2020-04
2020-04-30,209181,1208702,-999521,바누아투,2020-04
2020-04-30,164904,276955,-112051,감비아,2020-04
2020-04-30,156108,0,156108,마티니크,2020-04
2020-04-30,129360,44128,85232,스와질랜드,2020-04
2020-04-30,126103,477,125626,세인트 키츠 네비스,2020-04
2020-04-30,100839,0,100839,불령 가이아나,2020-04
2020-04-30,84502,0,84502,나우루,2020-04
2020-04-30,73563,0,73563,세인트 빈센트 그레나딘,2020-04
2020-04-30,65107,15,65092,에리트리아,2020-04
2020-04-30,64593,0,64593,중앙아프리카공화국,2020-04
2020-04-30,61008,242,60766,카보 베르데,2020-04
2020-04-30,53506,46,53460,투르크 & 카이코스 군도,2020-04
2020-04-30,53023,2107,50916,안도라,2020-04
2020-04-30,44082,0,44082,세인트 루시아,2020-04
2020-04-30,38640,607,38033,앙귈라,2020-04
2020-04-30,35985,5639,30346,그레나다,2020-04
2020-04-30,34451,88934,-54483,모나코,2020-04
2020-04-30,31072,208,30864,영령 버진군도,2020-04
2020-04-30,24751,100,24651,네덜란드 열도,2020-04
2020-04-30,18157,2228,15929,지브랄타,2020-04
2020-04-30,17520,0,17520,남수단,2020-04
2020-04-30,11753,0,11753,왈라스 & 퓨투나 군도,2020-04
2020-04-30,9704,0,9704,파로에 군도,2020-04
2020-04-30,9635,2795,6840,코모로스,2020-04
2020-04-30,9554,10327,-773,미령 버진군도,2020-04
2020-04-30,6410,18603,-12193,도미니카,2020-04
2020-04-30,6400,0,6400,서사하라,2020-04
2020-04-30,5149,6196,-1047,남조지아 & 남샌드위치 군도,2020-04
2020-04-30,3720,165,3555,챠드,2020-04
2020-04-30,888,484649,-483761,기네비소,2020-04
2020-04-30,402,0,402,투발루,2020-04
2020-04-30,200,52594171,-52593971,적도 기니,2020-04
2020-04-30,24,0,24,그린랜드,2020-04
2020-04-30,0,436,-436,불령 남부지역,2020-04
2020-04-30,0,14139,-14139,부룬디,2020-04
2020-04-30,0,200,-200,세인트 헬레나,2020-04
2020-04-30,0,624123,-624123,산마리노,2020-04
2020-04-30,0,214,-214,몬트세라트,2020-04
2020-04-30,0,5638,-5638,레소토,2020-04
2020-04-30,0,5468,-5468,상토메 프린스페,2020-04
2020-04-30,0,2398,-2398,코스 군도,2020-04
2020-04-30,0,934,-934,교황청,2020-04
2020-04-30,0,3278456,-3278456,안타티카,2020-04
2020-04-30,0,208,-208,보빗군도,2020-04
2020-04-30,0,9500,-9500,니우에,2020-04
2020-04-30,0,241,-241,토켈라우,2020-04
2020-04-30,0,11942,-11942,통가,2020-04
2020-04-30,0,678,-678,마이너 아우틀링 합중국 군도,2020-04
2020-04-30,0,355,-355,건지,2020-04
2020-05-31,10743735243,8993975940,1749759303,중국,2020-05
2020-05-31,4589357750,4292823652,296534098,미국,2020-05
2020-05-31,2917842478,1631141787,1286700691,베트남,2020-05
2020-05-31,2362302297,189347734,2172954563,홍콩,2020-05
2020-05-31,1781736895,3104977500,-1323240605,일본,2020-05
2020-05-31,1207889670,1259314177,-51424507,대만,2020-05
2020-05-31,783720797,31699,783689098,마샬군도,2020-05
2020-05-31,729780202,1725030007,-995249805,독일,2020-05
2020-05-31,665958803,568827499,97131304,싱가포르,2020-05
2020-05-31,518614956,204002647,314612309,필리핀,2020-05
2020-05-31,431528518,591758994,-160230476,말레이시아,2020-05
2020-05-31,395078692,259904635,135174057,인도,2020-05
2020-05-31,388511695,74936987,313574708,폴란드,2020-05
2020-05-31,374880631,531316388,-156435757,멕시코,2020-05
2020-05-31,366597520,721795504,-355197984,러시아 연방,2020-05
2020-05-31,363560319,369513842,-5953523,영국,2020-05
2020-05-31,357444173,392691568,-35247395,태국,2020-05
2020-05-31,332019847,553942635,-221922788,인도네시아,2020-05
2020-05-31,316934301,116388329,200545972,튀르키예,2020-05
2020-05-31,283204543,104420755,178783788,뉴질랜드,2020-05
2020-05-31,281510221,909282452,-627772231,네덜란드,2020-05
2020-05-31,273014656,32910558,240104098,카자흐스탄,2020-05
2020-05-31,268931101,1395909283,-1126978182,호주,2020-05
2020-05-31,257466796,740665239,-483198443,사우디아라비아,2020-05
2020-05-31,240202453,57655847,182546606,헝가리,2020-05
2020-05-31,221310176,178575816,42734360,아랍에미리트 연합,2020-05
2020-05-31,208193509,421835613,-213642104,브라질,2020-05
2020-05-31,206938615,377859982,-170921367,캐나다,2020-05
2020-05-31,198231060,405421670,-207190610,이탈리아,2020-05
2020-05-31,163032553,394930296,-231897743,프랑스,2020-05
2020-05-31,162421725,87420234,75001491,벨기에,2020-05
2020-05-31,145718183,22903377,122814806,파나마,2020-05
2020-05-31,132642070,74251657,58390413,체코공화국,2020-05
2020-05-31,124633184,23613340,101019844,포루투갈,2020-05
2020-05-31,119081291,2477387,116603904,우즈베키스탄,2020-05
2020-05-31,113881699,131307676,-17425977,스페인,2020-05
2020-05-31,90332219,84326775,6005444,이스라엘,2020-05
2020-05-31,80758797,11593255,69165542,이집트,2020-05
2020-05-31,75416660,69796312,5620348,아일랜드,2020-05
2020-05-31,72457894,125724436,-53266542,노르웨이,2020-05
2020-05-31,67971122,99041986,-31070864,슬로바키아,2020-05
2020-05-31,66458112,123703325,-57245213,스웨덴,2020-05
2020-05-31,66069729,14946448,51123281,방글라데시,2020-05
2020-05-31,62104788,109380810,-47276022,오스트리아,2020-05
2020-05-31,60008422,430721226,-370712804,쿠웨이트,2020-05
2020-05-31,55005093,10009598,44995495,바레인,2020-05
2020-05-31,50010532,152593903,-102583371,오만,2020-05
2020-05-31,46850844,11830992,35019852,파키스탄,2020-05
2020-05-31,44873551,90457766,-45584215,이라크,2020-05
2020-05-31,43214453,187376501,-144162048,스위스,2020-05
2020-05-31,42190169,9449889,32740280,슬로베니아,2020-05
2020-05-31,39711165,73460385,-33749220,덴마크,2020-05
2020-05-31,39420499,267147681,-227727182,칠레,2020-05
2020-05-31,38018762,34638288,3380474,나이지리아,2020-05
2020-05-31,36206539,21440177,14766362,미얀마,2020-05
2020-05-31,36114306,60553805,-24439499,남아프리카공화국,2020-05
2020-05-31,31695664,25830468,5865196,캄보디아,2020-05
2020-05-31,31550267,44317842,-12767575,루마니아,2020-05
2020-05-31,31137541,56461227,-25323686,콜롬비아,2020-05
2020-05-31,27223165,1918545,25304620,토고,2020-05
2020-05-31,26416636,585308679,-558892043,카타르,2020-05
2020-05-31,24504050,2970541,21533509,요르단,2020-05
2020-05-31,23669695,7433798,16235897,에쿠아도르,2020-05
2020-05-31,23645942,79260097,-55614155,페루,2020-05
2020-05-31,21958544,88550169,-66591625,우크라이나,2020-05
2020-05-31,19492764,645159,18847605,몽골,2020-05
2020-05-31,18399342,8478698,9920644,리투아니아,2020-05
2020-05-31,15738492,57722581,-41984089,핀란드,2020-05
2020-05-31,15470321,28836302,-13365981,그리스,2020-05
2020-05-31,14770200,3935411,10834789,케냐,2020-05
2020-05-31,14505908,651985,13853923,이란,2020-05
2020-05-31,14147063,6371757,7775306,에스토니아,2020-05
2020-05-31,13740755,1944789,11795966,가나,2020-05
2020-05-31,13202605,14549750,-1347145,모로코,2020-05
2020-05-31,12544414,600805,11943609,리비아,2020-05
2020-05-31,12367082,1991405,10375677,탄자니아,2020-05
2020-05-31,11992914,53880442,-41887528,알제리,2020-05
2020-05-31,11954738,231499253,-219544515,기타국,2020-05
2020-05-31,10979661,3270339,7709322,예맨,2020-05
2020-05-31,10935853,5939816,4996037,도미니카 공화국,2020-05
2020-05-31,10119718,24617685,-14497967,아르헨티나,2020-05
2020-05-31,9592002,7446333,2145669,과테말라,2020-05
2020-05-31,9403797,14629162,-5225365,불가리아,2020-05
2020-05-31,8005901,12812515,-4806614,세르비아,2020-05
2020-05-31,7266832,290757,6976075,코트디봐르,2020-05
2020-05-31,7233533,3525117,3708416,튀니지,2020-05
2020-05-31,6912895,785796,6127099,수단,2020-05
2020-05-31,6896831,1270864,5625967,레바논,2020-05
2020-05-31,6613346,7069750,-456404,에티오피아,2020-05
2020-05-31,6555579,18732924,-12177345,푸에르토리코,2020-05
2020-05-31,6370751,914289,5456462,크로아티아,2020-05
2020-05-31,6360597,5122737,1237860,스리랑카,2020-05
2020-05-31,6066496,20475124,-14408628,코스타리카,2020-05
2020-05-31,5960501,2379362,3581139,엘살바도르,2020-05
2020-05-31,5893548,1399542,4494006,파라과이,2020-05
2020-05-31,5487479,27827237,-22339758,브루나이,2020-05
2020-05-31,5175441,214220,4961221,아이티,2020-05
2020-05-31,5062978,29978077,-24915099,콩고민주공화국,2020-05
2020-05-31,4679170,3990,4675180,시리아,2020-05
2020-05-31,4564204,92201,4472003,괌,2020-05
2020-05-31,4471228,9566150,-5094922,라트비아,2020-05
2020-05-31,4441350,525305,3916045,지부티,2020-05
2020-05-31,4156575,2056456,2100119,세네갈,2020-05
2020-05-31,4111889,1179,4110710,키르기스스탄,2020-05
2020-05-31,4008700,10892749,-6884049,몰타,2020-05
2020-05-31,3813807,30426145,-26612338,파푸아 뉴기니,2020-05
2020-05-31,3771937,22412637,-18640700,온두라스,2020-05
2020-05-31,3752866,18790170,-15037304,니카라과,2020-05
2020-05-31,3528622,4356018,-827396,라오스,2020-05
2020-05-31,3489353,424341,3065012,조지아,2020-05
2020-05-31,3409680,286033,3123647,우간다,2020-05
2020-05-31,3303619,45002,3258617,아제르바이잔,2020-05
2020-05-31,3255370,371625,2883745,모잠비크,2020-05
2020-05-31,3211423,0,3211423,적도 기니,2020-05
2020-05-31,3128068,37543,3090525,사모아,2020-05
2020-05-31,2917419,205637,2711782,팔레스타인 해방기구,2020-05
2020-05-31,2760588,62121,2698467,모리셔스,2020-05
2020-05-31,2598934,2710205,-111271,벨라루스,2020-05
2020-05-31,2562583,962304,1600279,부르키나 파소,2020-05
2020-05-31,2561675,13660214,-11098539,우루과이,2020-05
2020-05-31,2411372,28026,2383346,네팔,2020-05
2020-05-31,2260147,319,2259828,불령 리유니온 코모도 제도,2020-05
2020-05-31,1990362,2490898,-500536,사이프러스,2020-05
2020-05-31,1826210,4825213,-2999003,볼리비아,2020-05
2020-05-31,1813979,6826144,-5012165,앙골라,2020-05
2020-05-31,1771007,2937013,-1166006,마다카스카르,2020-05
2020-05-31,1735690,495641,1240049,베네주엘라,2020-05
2020-05-31,1685387,36635426,-34950039,카메룬,2020-05
2020-05-31,1663316,1729216,-65900,아르메니아,2020-05
2020-05-31,1629374,54104,1575270,북마리아나 군도,2020-05
2020-05-31,1534797,6143603,-4608806,트리니다드 토바고,2020-05
2020-05-31,1461324,147631,1313693,르완다,2020-05
2020-05-31,1429656,19353090,-17923434,뉴 칼레도니아,2020-05
2020-05-31,1419975,467555,952420,자마이카,2020-05
2020-05-31,1398890,0,1398890,투르크멘,2020-05
2020-05-31,1282440,274543,1007897,소말리아,2020-05
2020-05-31,1230917,346944,883973,콩고,2020-05
2020-05-31,1111262,229271,881991,세이쉘,2020-05
2020-05-31,1071315,136543,934772,알바니아,2020-05
2020-05-31,1040828,4847115,-3806287,기니,2020-05
2020-05-31,1023034,287982,735052,가이아나,2020-05
2020-05-31,1018252,831115,187137,짐바브웨,2020-05
2020-05-31,940782,122019,818763,마카오,2020-05
2020-05-31,933024,398757,534267,잠비아,2020-05
2020-05-31,917183,82,917101,타지크,2020-05
2020-05-31,851913,58478,793435,아프카니스탄,2020-05
2020-05-31,850081,27139,822942,중앙아프리카공화국,2020-05
2020-05-31,836240,465531,370709,몰도바,2020-05
2020-05-31,807030,124564,682466,아메리칸 사모아,2020-05
2020-05-31,738022,2161153,-1423131,시에라 리온,2020-05
2020-05-31,732115,1543806,-811691,마세도니아,2020-05
2020-05-31,692482,397,692085,키리바티,2020-05
2020-05-31,672638,6158708,-5486070,룩셈부르그,2020-05
2020-05-31,664900,90,664810,마티니크,2020-05
2020-05-31,659326,211353,447973,피지,2020-05
2020-05-31,625397,0,625397,부탄,2020-05
2020-05-31,600410,78,600332,몬테네그로,2020-05
2020-05-31,558375,0,558375,과델로프,2020-05
2020-05-31,550614,521021,29593,감비아,2020-05
2020-05-31,525449,2726,522723,지브랄타,2020-05
2020-05-31,490373,2328,488045,안티가 바부다,2020-05
2020-05-31,459627,996469,-536842,리히텐슈타인,2020-05
2020-05-31,456994,0,456994,버뮤다,2020-05
2020-05-31,455028,53841,401187,마이크로네시아,2020-05
2020-05-31,411803,0,411803,큐라소,2020-05
2020-05-31,389838,7296133,-6906295,말라위,2020-05
2020-05-31,348983,11,348972,베닝,2020-05
2020-05-31,340386,50680,289706,보츠와나,2020-05
2020-05-31,340088,806951,-466863,수리남,2020-05
2020-05-31,338005,181282,156723,가봉,2020-05
2020-05-31,337089,3151186,-2814097,쿠바,2020-05
2020-05-31,336626,16662,319964,바베이도스,2020-05
2020-05-31,326336,1455253,-1128917,아이슬란드,2020-05
2020-05-31,322115,1083082,-760967,모리타니,2020-05
2020-05-31,320510,5010,315500,나미비아,2020-05
2020-05-31,310910,976,309934,아루바,2020-05
2020-05-31,287174,166707,120467,스와질랜드,2020-05
2020-05-31,266743,0,266743,그레나다,2020-05
2020-05-31,264571,19617,244954,라이베리아,2020-05
2020-05-31,260578,1044860,-784282,보스니아-헤르체고비나,2020-05
2020-05-31,259956,580179,-320223,바누아투,2020-05
2020-05-31,238200,0,238200,메요트,2020-05
2020-05-31,237525,0,237525,상토메 프린스페,2020-05
2020-05-31,232722,0,232722,몰디브,2020-05
2020-05-31,223082,46328,176754,불령 폴리네시아,2020-05
2020-05-31,221854,2344446,-2122592,솔로몬 군도,2020-05
2020-05-31,206071,0,206071,카보 베르데,2020-05
2020-05-31,197938,7734,190204,팔라우,2020-05
2020-05-31,196846,849,195997,말리,2020-05
2020-05-31,173913,3117,170796,바하마,2020-05
2020-05-31,165336,0,165336,도미니카,2020-05
2020-05-31,138865,16034,122831,부룬디,2020-05
2020-05-31,117565,12,117553,네덜란드 열도,2020-05
2020-05-31,103732,0,103732,세인트 마틴,2020-05
2020-05-31,100951,25,100926,세인트 키츠 네비스,2020-05
2020-05-31,94423,0,94423,불령 가이아나,2020-05
2020-05-31,86686,0,86686,세인트 루시아,2020-05
2020-05-31,85960,0,85960,나우루,2020-05
2020-05-31,85502,20302,65200,벨리제,2020-05
2020-05-31,81357,0,81357,영령 캐이맨 군도,2020-05
2020-05-31,72558,0,72558,티모르,2020-05
2020-05-31,71825,0,71825,에리트리아,2020-05
2020-05-31,60993,403,60590,코모로스,2020-05
2020-05-31,60650,12918,47732,레소토,2020-05
2020-05-31,58490,0,58490,세인트 빈센트 그레나딘,2020-05
2020-05-31,52522,2479,50043,안도라,2020-05
2020-05-31,50758,186416,-135658,니제르,2020-05
2020-05-31,46677,84,46593,챠드,2020-05
2020-05-31,35762,0,35762,투르크 & 카이코스 군도,2020-05
2020-05-31,32944,0,32944,남수단,2020-05
2020-05-31,28820,313,28507,앙귈라,2020-05
2020-05-31,27872,40,27832,투발루,2020-05
2020-05-31,4500,108629,-104129,통가,2020-05
2020-05-31,3228,0,3228,영령 버진군도,2020-05
2020-05-31,1531,0,1531,미령 버진군도,2020-05
2020-05-31,965,0,965,세인트 바르탤르미,2020-05
2020-05-31,300,0,300,쿡 아일랜드,2020-05
2020-05-31,50,11,39,파로에 군도,2020-05
2020-05-31,0,5744,-5744,보빗군도,2020-05
2020-05-31,0,641,-641,세인트 헬레나,2020-05
2020-05-31,0,912,-912,건지,2020-05
2020-05-31,0,55,-55,왈라스 & 퓨투나 군도,2020-05
2020-05-31,0,398,-398,몬트세라트,2020-05
2020-05-31,0,586,-586,니우에,2020-05
2020-05-31,0,7392,-7392,안타티카,2020-05
2020-05-31,0,403,-403,크리스마스 아일랜드,2020-05
2020-05-31,0,81990,-81990,기네비소,2020-05
2020-05-31,0,20508,-20508,토켈라우,2020-05
2020-05-31,0,111612,-111612,산마리노,2020-05
2020-05-31,0,14574,-14574,그린랜드,2020-05
2020-05-31,0,79265,-79265,모나코,2020-05
2020-06-30,11443239696,8925691245,2517548451,중국,2020-06
2020-06-30,5735514639,4597451366,1138063273,미국,2020-06
2020-06-30,3503966589,1586423505,1917543084,베트남,2020-06
2020-06-30,2337610130,108243523,2229366607,홍콩,2020-06
2020-06-30,1849842809,3574090840,-1724248031,일본,2020-06
2020-06-30,1348432019,1332354133,16077886,대만,2020-06
2020-06-30,918583868,737909412,180674456,싱가포르,2020-06
2020-06-30,652474732,1714182691,-1061707959,독일,2020-06
2020-06-30,583518908,308682797,274836111,인도,2020-06
2020-06-30,560728432,239474573,321253859,필리핀,2020-06
2020-06-30,532941114,362692272,170248842,멕시코,2020-06
2020-06-30,471841637,649029716,-177188079,말레이시아,2020-06
2020-06-30,457251182,436196785,21054397,태국,2020-06
2020-06-30,432385444,43005717,389379727,카자흐스탄,2020-06
2020-06-30,424722950,288190461,136532489,영국,2020-06
2020-06-30,420056111,622940212,-202884101,러시아 연방,2020-06
2020-06-30,415239898,1288294169,-873054271,호주,2020-06
2020-06-30,401297578,588364878,-187067300,인도네시아,2020-06
2020-06-30,386083722,33648,386050074,마샬군도,2020-06
2020-06-30,375584522,466183835,-90599313,캐나다,2020-06
2020-06-30,365695774,52301159,313394615,폴란드,2020-06
2020-06-30,319077472,129443551,189633921,튀르키예,2020-06
2020-06-30,306902800,295949173,10953627,아랍에미리트 연합,2020-06
2020-06-30,296824364,542841047,-246016683,네덜란드,2020-06
2020-06-30,273063527,104114961,168948566,노르웨이,2020-06
2020-06-30,269948770,456540814,-186592044,프랑스,2020-06
2020-06-30,260659408,244833973,15825435,브라질,2020-06
2020-06-30,240444318,915062429,-674618111,사우디아라비아,2020-06
2020-06-30,225276530,148544986,76731544,벨기에,2020-06
2020-06-30,199599855,68149733,131450122,헝가리,2020-06
2020-06-30,199177940,562287427,-363109487,이탈리아,2020-06
2020-06-30,180825071,609246,180215825,파나마,2020-06
2020-06-30,154185263,151407914,2777349,스페인,2020-06
2020-06-30,151557990,2111187,149446803,우즈베키스탄,2020-06
2020-06-30,129516048,102586,129413462,라이베리아,2020-06
2020-06-30,127194453,76369595,50824858,이스라엘,2020-06
2020-06-30,109467762,108293260,1174502,체코공화국,2020-06
2020-06-30,97532070,125974685,-28442615,스웨덴,2020-06
2020-06-30,95136590,107450911,-12314321,뉴질랜드,2020-06
2020-06-30,87974433,35646497,52327936,이집트,2020-06
2020-06-30,85972994,80670317,5302677,그리스,2020-06
2020-06-30,80877461,117579770,-36702309,아일랜드,2020-06
2020-06-30,78444620,230001696,-151557076,스위스,2020-06
2020-06-30,76792132,13265772,63526360,파키스탄,2020-06
2020-06-30,75995097,92341525,-16346428,슬로바키아,2020-06
2020-06-30,73500071,103260339,-29760268,오스트리아,2020-06
2020-06-30,63533084,18621014,44912070,방글라데시,2020-06
2020-06-30,59808176,8320817,51487359,슬로베니아,2020-06
2020-06-30,58789667,60189387,-1399720,남아프리카공화국,2020-06
2020-06-30,51137956,83590029,-32452073,덴마크,2020-06
2020-06-30,50720311,182500299,-131779988,오만,2020-06
2020-06-30,46360004,22032788,24327216,캄보디아,2020-06
2020-06-30,44340522,29455344,14885178,미얀마,2020-06
2020-06-30,40171738,266356336,-226184598,칠레,2020-06
2020-06-30,39341827,104418339,-65076512,이라크,2020-06
2020-06-30,37638941,241759913,-204120972,페루,2020-06
2020-06-30,36208037,27938267,8269770,포루투갈,2020-06
2020-06-30,32953705,9537213,23416492,바레인,2020-06
2020-06-30,31844533,423261346,-391416813,카타르,2020-06
2020-06-30,30828982,91124069,-60295087,콜롬비아,2020-06
2020-06-30,29797800,7198266,22599534,요르단,2020-06
2020-06-30,29494451,279206980,-249712529,기타국,2020-06
2020-06-30,29083775,43672209,-14588434,루마니아,2020-06
2020-06-30,28224141,41554154,-13330013,우크라이나,2020-06
2020-06-30,27272189,73882430,-46610241,나이지리아,2020-06
2020-06-30,27246065,76802746,-49556681,핀란드,2020-06
2020-06-30,25122641,467107566,-441984925,쿠웨이트,2020-06
2020-06-30,24381220,2554719,21826501,몽골,2020-06
2020-06-30,22622825,7574259,15048566,리투아니아,2020-06
2020-06-30,20436451,13971174,6465277,모로코,2020-06
2020-06-30,18825688,60663518,-41837830,알제리,2020-06
2020-06-30,18806742,16566,18790176,세인트 키츠 네비스,2020-06
2020-06-30,18687711,3661015,15026696,케냐,2020-06
2020-06-30,18652497,4073360,14579137,가나,2020-06
2020-06-30,14499501,193,14499308,투르크멘,2020-06
2020-06-30,14367712,28859462,-14491750,아르헨티나,2020-06
2020-06-30,13653265,1181167,12472098,이란,2020-06
2020-06-30,13352366,7531539,5820827,스리랑카,2020-06
2020-06-30,13174266,6575736,6598530,에쿠아도르,2020-06
2020-06-30,13086729,1519651,11567078,리비아,2020-06
2020-06-30,12688644,651931,12036713,수단,2020-06
2020-06-30,12656112,14890650,-2234538,세르비아,2020-06
2020-06-30,12614890,5826828,6788062,과테말라,2020-06
2020-06-30,12600299,4445393,8154906,도미니카 공화국,2020-06
2020-06-30,11100122,3071422,8028700,예맨,2020-06
2020-06-30,10440424,7224981,3215443,탄자니아,2020-06
2020-06-30,10172768,5876634,4296134,에스토니아,2020-06
2020-06-30,10112360,8401478,1710882,에티오피아,2020-06
2020-06-30,9666673,9808321,-141648,코스타리카,2020-06
2020-06-30,9618559,26808639,-17190080,불가리아,2020-06
2020-06-30,9591037,11551406,-1960369,브루나이,2020-06
2020-06-30,8551862,142801,8409061,아이티,2020-06
2020-06-30,7959109,32296824,-24337715,푸에르토리코,2020-06
2020-06-30,7706120,97734596,-90028476,파푸아 뉴기니,2020-06
2020-06-30,7527938,1756854,5771084,조지아,2020-06
2020-06-30,7356064,6781104,574960,튀니지,2020-06
2020-06-30,7098943,250070,6848873,코트디봐르,2020-06
2020-06-30,7067632,4523845,2543787,온두라스,2020-06
2020-06-30,6712526,32690,6679836,키르기스스탄,2020-06
2020-06-30,6562267,7359238,-796971,엘살바도르,2020-06
2020-06-30,6422801,9810519,-3387718,라트비아,2020-06
2020-06-30,6377172,31546845,-25169673,콩고민주공화국,2020-06
2020-06-30,5937912,1860211,4077701,레바논,2020-06
2020-06-30,5676371,4523504,1152867,벨라루스,2020-06
2020-06-30,5418955,954318,4464637,파라과이,2020-06
2020-06-30,5150140,10751994,-5601854,몰타,2020-06
2020-06-30,5111114,76582,5034532,괌,2020-06
2020-06-30,5110622,113395,4997227,아제르바이잔,2020-06
2020-06-30,4785300,31464,4753836,시리아,2020-06
2020-06-30,4646657,14782591,-10135934,니카라과,2020-06
2020-06-30,4623830,4011694,612136,세네갈,2020-06
2020-06-30,4341990,147488,4194502,네팔,2020-06
2020-06-30,4256703,102,4256601,팔레스타인 해방기구,2020-06
2020-06-30,4243120,9280570,-5037450,우루과이,2020-06
2020-06-30,4187255,23906,4163349,사모아,2020-06
2020-06-30,3689515,1414130,2275385,크로아티아,2020-06
2020-06-30,3402190,8841588,-5439398,트리니다드 토바고,2020-06
2020-06-30,3116646,531919,2584727,우간다,2020-06
2020-06-30,3038447,17878849,-14840402,볼리비아,2020-06
2020-06-30,3021063,2527737,493326,아이슬란드,2020-06
2020-06-30,3002263,16469467,-13467204,모잠비크,2020-06
2020-06-30,2918176,82922,2835254,지부티,2020-06
2020-06-30,2738235,3007916,-269681,라오스,2020-06
2020-06-30,2587569,379923,2207646,피지,2020-06
2020-06-30,2550535,6723405,-4172870,마다카스카르,2020-06
2020-06-30,2349191,2403189,-53998,기니,2020-06
2020-06-30,2314560,490377,1824183,모리셔스,2020-06
2020-06-30,2312072,2174,2309898,앙골라,2020-06
2020-06-30,2213086,612140,1600946,베네주엘라,2020-06
2020-06-30,2137740,1481,2136259,타지크,2020-06
2020-06-30,2075539,107242,1968297,사이프러스,2020-06
2020-06-30,2062744,685492,1377252,잠비아,2020-06
2020-06-30,1928574,2703591,-775017,쿠바,2020-06
2020-06-30,1817742,1533804,283938,부르키나 파소,2020-06
2020-06-30,1771954,1342858,429096,시에라 리온,2020-06
2020-06-30,1770012,6520,1763492,바하마,2020-06
2020-06-30,1701822,38734,1663088,카메룬,2020-06
2020-06-30,1678807,89486,1589321,아프카니스탄,2020-06
2020-06-30,1636423,21088,1615335,아메리칸 사모아,2020-06
2020-06-30,1597720,18366097,-16768377,뉴 칼레도니아,2020-06
2020-06-30,1525204,1118218,406986,짐바브웨,2020-06
2020-06-30,1487472,54604,1432868,마카오,2020-06
2020-06-30,1360564,106121,1254443,가이아나,2020-06
2020-06-30,1317837,36186,1281651,자마이카,2020-06
2020-06-30,1264121,276314,987807,알바니아,2020-06
2020-06-30,1190870,1207046,-16176,몰도바,2020-06
2020-06-30,1107503,85,1107418,불령 리유니온 코모도 제도,2020-06
2020-06-30,1100725,38979,1061746,북마리아나 군도,2020-06
2020-06-30,1072282,364093,708189,세이쉘,2020-06
2020-06-30,1026842,3417173,-2390331,토고,2020-06
2020-06-30,1019948,29976,989972,니제르,2020-06
2020-06-30,1013293,552079,461214,콩고,2020-06
2020-06-30,984070,7114967,-6130897,룩셈부르그,2020-06
2020-06-30,960301,1681622,-721321,아르메니아,2020-06
2020-06-30,891551,0,891551,마티니크,2020-06
2020-06-30,853075,0,853075,불령 폴리네시아,2020-06
2020-06-30,812755,46349,766406,베닝,2020-06
2020-06-30,799390,903303,-103913,리히텐슈타인,2020-06
2020-06-30,747447,116392,631055,나미비아,2020-06
2020-06-30,735824,0,735824,몰디브,2020-06
2020-06-30,721592,17662,703930,중앙아프리카공화국,2020-06
2020-06-30,719136,1567019,-847883,모리타니,2020-06
2020-06-30,706388,958,705430,부탄,2020-06
2020-06-30,679207,2823309,-2144102,보스니아-헤르체고비나,2020-06
2020-06-30,582203,129991,452212,르완다,2020-06
2020-06-30,558067,440427,117640,솔로몬 군도,2020-06
2020-06-30,553836,691,553145,마이크로네시아,2020-06
2020-06-30,511337,500,510837,버뮤다,2020-06
2020-06-30,495981,1681849,-1185868,말라위,2020-06
2020-06-30,490568,356,490212,과델로프,2020-06
2020-06-30,489270,453,488817,소말리아,2020-06
2020-06-30,374239,0,374239,벨리제,2020-06
2020-06-30,370514,267661,102853,키리바티,2020-06
2020-06-30,354937,923914,-568977,수리남,2020-06
2020-06-30,338442,0,338442,네덜란드 열도,2020-06
2020-06-30,332170,692,331478,말리,2020-06
2020-06-30,274844,165088,109756,가봉,2020-06
2020-06-30,255458,0,255458,메요트,2020-06
2020-06-30,240956,12752,228204,세인트 빈센트 그레나딘,2020-06
2020-06-30,239433,3628,235805,부룬디,2020-06
2020-06-30,232552,1031051,-798499,바누아투,2020-06
2020-06-30,211108,0,211108,세인트 마틴,2020-06
2020-06-30,183005,15152,167853,팔라우,2020-06
2020-06-30,171770,424778,-253008,감비아,2020-06
2020-06-30,170849,0,170849,큐라소,2020-06
2020-06-30,162480,117031,45449,마세도니아,2020-06
2020-06-30,153665,84106,69559,스와질랜드,2020-06
2020-06-30,145207,15615,129592,도미니카,2020-06
2020-06-30,143075,4467,138608,아루바,2020-06
2020-06-30,139873,2295,137578,챠드,2020-06
2020-06-30,121039,77743,43296,바베이도스,2020-06
2020-06-30,119862,27513,92349,보츠와나,2020-06
2020-06-30,93488,0,93488,남수단,2020-06
2020-06-30,69416,0,69416,영령 버진군도,2020-06
2020-06-30,67535,0,67535,몬테네그로,2020-06
2020-06-30,57165,0,57165,세인트 루시아,2020-06
2020-06-30,55952,68217,-12265,적도 기니,2020-06
2020-06-30,44312,6323063,-6278751,불령 가이아나,2020-06
2020-06-30,37674,146202,-108528,기네비소,2020-06
2020-06-30,35255,1,35254,지브랄타,2020-06
2020-06-30,29735,178034,-148299,산마리노,2020-06
2020-06-30,29352,0,29352,나우루,2020-06
2020-06-30,23281,115,23166,투르크 & 카이코스 군도,2020-06
2020-06-30,18212,0,18212,코모로스,2020-06
2020-06-30,17211,99642,-82431,모나코,2020-06
2020-06-30,7780,565,7215,상토메 프린스페,2020-06
2020-06-30,5575,7,5568,안티가 바부다,2020-06
2020-06-30,3200,5026,-1826,미령 버진군도,2020-06
2020-06-30,3025,6033558,-6030533,에리트리아,2020-06
2020-06-30,1355,0,1355,세인트 바르탤르미,2020-06
2020-06-30,1343,0,1343,쿡 아일랜드,2020-06
2020-06-30,993,4148,-3155,안도라,2020-06
2020-06-30,745,48786,-48041,통가,2020-06
2020-06-30,720,0,720,포클랜드 군도,2020-06
2020-06-30,634,0,634,카보 베르데,2020-06
2020-06-30,582,0,582,티모르,2020-06
2020-06-30,527,0,527,저어지,2020-06
2020-06-30,126,1673,-1547,앙귈라,2020-06
2020-06-30,50,0,50,그린랜드,2020-06
2020-06-30,23,9551,-9528,건지,2020-06
2020-06-30,0,489,-489,몬트세라트,2020-06
2020-06-30,0,364,-364,토켈라우,2020-06
2020-06-30,0,104,-104,그레나다,2020-06
2020-06-30,0,816,-816,남조지아 & 남샌드위치 군도,2020-06
2020-06-30,0,228,-228,코스 군도,2020-06
2020-06-30,0,6559,-6559,레소토,2020-06
2020-06-30,0,16251,-16251,마이너 아우틀링 합중국 군도,2020-06
2020-06-30,0,45165,-45165,투발루,2020-06
2020-06-30,0,55675,-55675,니우에,2020-06
2020-06-30,0,370,-370,맨섬,2020-06
2020-06-30,0,94,-94,세인트 헬레나,2020-06
2020-07-31,11726183448,9184552907,2541630541,중국,2020-07
2020-07-31,6596978783,4445079053,2151899730,미국,2020-07
2020-07-31,4203037693,1785497873,2417539820,베트남,2020-07
2020-07-31,2034337542,133119069,1901218473,홍콩,2020-07
2020-07-31,1999257195,3862249204,-1862992009,일본,2020-07
2020-07-31,1303771442,1610887190,-307115748,대만,2020-07
2020-07-31,819471880,1565051363,-745579483,독일,2020-07
2020-07-31,787008217,343832086,443176131,인도,2020-07
2020-07-31,704486481,41978,704444503,마샬군도,2020-07
2020-07-31,692257681,480157236,212100445,멕시코,2020-07
2020-07-31,599202112,810025474,-210823362,러시아 연방,2020-07
2020-07-31,593034965,260593292,332441673,필리핀,2020-07
2020-07-31,587549621,379638753,207910868,캐나다,2020-07
2020-07-31,586850620,871066516,-284215896,싱가포르,2020-07
2020-07-31,559759734,691647760,-131888026,말레이시아,2020-07
2020-07-31,558757701,1423646010,-864888309,호주,2020-07
2020-07-31,534345994,436803072,97542922,태국,2020-07
2020-07-31,500517509,105671593,394845916,튀르키예,2020-07
2020-07-31,446563661,711513647,-264949986,인도네시아,2020-07
2020-07-31,445281134,68981444,376299690,폴란드,2020-07
2020-07-31,387831882,302079362,85752520,영국,2020-07
2020-07-31,357595299,565796788,-208201489,아랍에미리트 연합,2020-07
2020-07-31,338072716,308269583,29803133,브라질,2020-07
2020-07-31,288983483,457916291,-168932808,네덜란드,2020-07
2020-07-31,258929367,664022931,-405093564,이탈리아,2020-07
2020-07-31,246872556,148799374,98073182,벨기에,2020-07
2020-07-31,225554703,618354687,-392799984,프랑스,2020-07
2020-07-31,208564171,81302514,127261657,체코공화국,2020-07
2020-07-31,204410891,97859618,106551273,노르웨이,2020-07
2020-07-31,198304451,1622489557,-1424185106,사우디아라비아,2020-07
2020-07-31,185233340,1689886,183543454,파나마,2020-07
2020-07-31,184445472,51529744,132915728,헝가리,2020-07
2020-07-31,183522265,0,183522265,버뮤다,2020-07
2020-07-31,168672942,190406127,-21733185,스페인,2020-07
2020-07-31,165445229,1432822,164012407,우즈베키스탄,2020-07
2020-07-31,162361358,51424,162309934,라이베리아,2020-07
2020-07-31,141640448,29684110,111956338,포루투갈,2020-07
2020-07-31,135001781,58719234,76282547,슬로바키아,2020-07
2020-07-31,116608601,116430467,178134,뉴질랜드,2020-07
2020-07-31,109446146,28316738,81129408,방글라데시,2020-07
2020-07-31,104287405,103316216,971189,이스라엘,2020-07
2020-07-31,99622697,24650654,74972043,파키스탄,2020-07
2020-07-31,94464898,123450515,-28985617,오스트리아,2020-07
2020-07-31,89323510,49120079,40203431,이집트,2020-07
2020-07-31,88619637,221936911,-133317274,스위스,2020-07
2020-07-31,83196235,66393905,16802330,그리스,2020-07
2020-07-31,73210719,12209475,61001244,몰타,2020-07
2020-07-31,70293371,130176642,-59883271,카자흐스탄,2020-07
2020-07-31,63749308,167969722,-104220414,스웨덴,2020-07
2020-07-31,60105282,10163772,49941510,슬로베니아,2020-07
2020-07-31,58046290,39960134,18086156,루마니아,2020-07
2020-07-31,50470422,277725352,-227254930,이라크,2020-07
2020-07-31,49494441,25747613,23746828,캄보디아,2020-07
2020-07-31,49036520,202095526,-153059006,남아프리카공화국,2020-07
2020-07-31,46141539,43737209,2404330,미얀마,2020-07
2020-07-31,44722619,340595280,-295872661,칠레,2020-07
2020-07-31,44450863,85029295,-40578432,덴마크,2020-07
2020-07-31,42531466,213163612,-170632146,오만,2020-07
2020-07-31,41947941,65915101,-23967160,콜롬비아,2020-07
2020-07-31,38524630,16912166,21612464,우크라이나,2020-07
2020-07-31,35673359,4530038,31143321,나이지리아,2020-07
2020-07-31,35003106,6371545,28631561,토고,2020-07
2020-07-31,34802263,17223567,17578696,바레인,2020-07
2020-07-31,32892818,93363574,-60470756,아일랜드,2020-07
2020-07-31,31512018,7159591,24352427,요르단,2020-07
2020-07-31,29708521,472283603,-442575082,카타르,2020-07
2020-07-31,29631123,257552362,-227921239,페루,2020-07
2020-07-31,28182782,294697,27888085,피지,2020-07
2020-07-31,23187711,2154675,21033036,몽골,2020-07
2020-07-31,22275892,1210018,21065874,리비아,2020-07
2020-07-31,21804065,68287902,-46483837,아르헨티나,2020-07
2020-07-31,21769150,3443777,18325373,가나,2020-07
2020-07-31,21441590,4006482,17435108,케냐,2020-07
2020-07-31,20479359,9736442,10742917,모로코,2020-07
2020-07-31,20256615,80351401,-60094786,핀란드,2020-07
2020-07-31,19218514,8091577,11126937,에쿠아도르,2020-07
2020-07-31,18987426,6591451,12395975,리투아니아,2020-07
2020-07-31,18566781,332288259,-313721478,쿠웨이트,2020-07
2020-07-31,18109080,9198780,8910300,브루나이,2020-07
2020-07-31,17995747,17431980,563767,세르비아,2020-07
2020-07-31,17531181,26015754,-8484573,푸에르토리코,2020-07
2020-07-31,16978212,8154965,8823247,과테말라,2020-07
2020-07-31,16007085,1035103,14971982,이란,2020-07
2020-07-31,14682469,206432,14476037,괌,2020-07
2020-07-31,14506465,0,14506465,투르크멘,2020-07
2020-07-31,14292486,58289452,-43996966,알제리,2020-07
2020-07-31,13966613,113540,13853073,네팔,2020-07
2020-07-31,13706020,0,13706020,세인트 키츠 네비스,2020-07
2020-07-31,13622379,4369237,9253142,예맨,2020-07
2020-07-31,13216657,5176824,8039833,도미니카 공화국,2020-07
2020-07-31,12943511,8700649,4242862,스리랑카,2020-07
2020-07-31,11612529,15369496,-3756967,불가리아,2020-07
2020-07-31,11249149,3358737,7890412,탄자니아,2020-07
2020-07-31,11213813,5956856,5256957,튀니지,2020-07
2020-07-31,10620581,509409,10111172,수단,2020-07
2020-07-31,9732436,17058659,-7326223,코스타리카,2020-07
2020-07-31,8579138,506000,8073138,아제르바이잔,2020-07
2020-07-31,8504217,1944089,6560128,조지아,2020-07
2020-07-31,8262166,122743,8139423,코트디봐르,2020-07
2020-07-31,7644274,8248616,-604342,에티오피아,2020-07
2020-07-31,7538035,619843,6918192,카메룬,2020-07
2020-07-31,7458745,2079733,5379012,벨라루스,2020-07
2020-07-31,7052515,1394688,5657827,파라과이,2020-07
2020-07-31,6652954,8238158,-1585204,에스토니아,2020-07
2020-07-31,6449492,8120590,-1671098,온두라스,2020-07
2020-07-31,6204227,14766577,-8562350,앙골라,2020-07
2020-07-31,5810627,2209428,3601199,크로아티아,2020-07
2020-07-31,5596417,183948,5412469,아이티,2020-07
2020-07-31,5580976,2548,5578428,키르기스스탄,2020-07
2020-07-31,5565787,4172864,1392923,레바논,2020-07
2020-07-31,5544740,5269154,275586,우루과이,2020-07
2020-07-31,5242636,541019,4701617,모잠비크,2020-07
2020-07-31,4973636,10751578,-5777942,라트비아,2020-07
2020-07-31,4966031,261985,4704046,지부티,2020-07
2020-07-31,4559603,15259860,-10700257,니카라과,2020-07
2020-07-31,4361466,6209273,-1847807,세네갈,2020-07
2020-07-31,4174288,315580803,-311406515,기타국,2020-07
2020-07-31,3868331,4687498,-819167,엘살바도르,2020-07
2020-07-31,3808430,17220068,-13411638,사이프러스,2020-07
2020-07-31,3713397,63043,3650354,쿠바,2020-07
2020-07-31,3491965,4122524,-630559,파푸아 뉴기니,2020-07
2020-07-31,3384981,2265,3382716,시리아,2020-07
2020-07-31,3186223,54038,3132185,사모아,2020-07
2020-07-31,3141341,62650,3078691,부르키나 파소,2020-07
2020-07-31,3124924,0,3124924,타지크,2020-07
2020-07-31,3124499,9109183,-5984684,트리니다드 토바고,2020-07
2020-07-31,3091438,5162036,-2070598,볼리비아,2020-07
2020-07-31,3001222,959293,2041929,아이슬란드,2020-07
2020-07-31,2983876,1453590,1530286,나미비아,2020-07
2020-07-31,2945290,76069,2869221,아프카니스탄,2020-07
2020-07-31,2709736,651106,2058630,우간다,2020-07
2020-07-31,2578251,2747,2575504,불령 리유니온 코모도 제도,2020-07
2020-07-31,2446934,39478,2407456,불령 폴리네시아,2020-07
2020-07-31,2318170,4667594,-2349424,기니,2020-07
2020-07-31,2208573,1074677,1133896,마다카스카르,2020-07
2020-07-31,2088271,377388,1710883,모리셔스,2020-07
2020-07-31,2000673,1461025,539648,아르메니아,2020-07
2020-07-31,1757161,575045,1182116,알바니아,2020-07
2020-07-31,1663609,142072,1521537,베네주엘라,2020-07
2020-07-31,1521764,32161,1489603,잠비아,2020-07
2020-07-31,1510655,1877047,-366392,마카오,2020-07
2020-07-31,1503486,175,1503311,콩고,2020-07
2020-07-31,1493845,8733,1485112,팔레스타인 해방기구,2020-07
2020-07-31,1444510,8207757,-6763247,룩셈부르그,2020-07
2020-07-31,1390913,1908622,-517709,짐바브웨,2020-07
2020-07-31,1176363,395830,780533,마세도니아,2020-07
2020-07-31,1174367,40255562,-39081195,콩고민주공화국,2020-07
2020-07-31,1159182,19993939,-18834757,뉴 칼레도니아,2020-07
2020-07-31,1156156,3372214,-2216058,라오스,2020-07
2020-07-31,1066114,239883,826231,소말리아,2020-07
2020-07-31,1029309,816126,213183,리히텐슈타인,2020-07
2020-07-31,974048,38629,935419,가이아나,2020-07
2020-07-31,928988,50634,878354,북마리아나 군도,2020-07
2020-07-31,905931,1514336,-608405,몰도바,2020-07
2020-07-31,885614,550648,334966,세이쉘,2020-07
2020-07-31,852620,230441,622179,아메리칸 사모아,2020-07
2020-07-31,804090,1648,802442,말리,2020-07
2020-07-31,744770,4852,739918,마이크로네시아,2020-07
2020-07-31,703061,327582,375479,자마이카,2020-07
2020-07-31,673509,178509,495000,말라위,2020-07
2020-07-31,670337,1209966,-539629,보스니아-헤르체고비나,2020-07
2020-07-31,574421,12593,561828,티모르,2020-07
2020-07-31,568301,49514,518787,키리바티,2020-07
2020-07-31,504148,1650,502498,바하마,2020-07
2020-07-31,503054,457121,45933,바누아투,2020-07
2020-07-31,498064,51418,446646,바베이도스,2020-07
2020-07-31,455426,21857,433569,부룬디,2020-07
2020-07-31,452016,114897,337119,르완다,2020-07
2020-07-31,447175,3321093,-2873918,모리타니,2020-07
2020-07-31,441061,100,440961,팔라우,2020-07
2020-07-31,430933,0,430933,큐라소,2020-07
2020-07-31,417416,0,417416,베닝,2020-07
2020-07-31,416365,2000766,-1584401,솔로몬 군도,2020-07
2020-07-31,410096,1369,408727,몬테네그로,2020-07
2020-07-31,385943,0,385943,부탄,2020-07
2020-07-31,351488,0,351488,세인트 마틴,2020-07
2020-07-31,350614,42850,307764,보츠와나,2020-07
2020-07-31,341669,5077,336592,마티니크,2020-07
2020-07-31,335126,880,334246,벨리제,2020-07
2020-07-31,328765,1460256,-1131491,시에라 리온,2020-07
2020-07-31,313332,320079,-6747,가봉,2020-07
2020-07-31,306531,119721,186810,스와질랜드,2020-07
2020-07-31,304320,1210677,-906357,수리남,2020-07
2020-07-31,287969,60027,227942,몰디브,2020-07
2020-07-31,284943,0,284943,적도 기니,2020-07
2020-07-31,273470,11216,262254,도미니카,2020-07
2020-07-31,226717,0,226717,허드 앤 맥도날드 군도,2020-07
2020-07-31,217216,675,216541,아루바,2020-07
2020-07-31,209856,0,209856,불령 가이아나,2020-07
2020-07-31,180121,0,180121,상토메 프린스페,2020-07
2020-07-31,172041,0,172041,과델로프,2020-07
2020-07-31,113251,7363678,-7250427,에리트리아,2020-07
2020-07-31,109615,2636,106979,네덜란드 열도,2020-07
2020-07-31,94096,264391,-170295,모나코,2020-07
2020-07-31,90750,5545,85205,니제르,2020-07
2020-07-31,86619,3435,83184,안티가 바부다,2020-07
2020-07-31,83427,523614,-440187,감비아,2020-07
2020-07-31,81675,0,81675,세인트 루시아,2020-07
2020-07-31,70744,0,70744,챠드,2020-07
2020-07-31,66815,1635,65180,영령 버진군도,2020-07
2020-07-31,66109,12,66097,그레나다,2020-07
2020-07-31,50855,0,50855,세인트 빈센트 그레나딘,2020-07
2020-07-31,48614,0,48614,나우루,2020-07
2020-07-31,46910,0,46910,투르크 & 카이코스 군도,2020-07
2020-07-31,35025,0,35025,남수단,2020-07
2020-07-31,34374,337651,-303277,기네비소,2020-07
2020-07-31,27608,294999,-267391,산마리노,2020-07
2020-07-31,26440,803,25637,카보 베르데,2020-07
2020-07-31,23866,172,23694,지브랄타,2020-07
2020-07-31,23005,4283,18722,건지,2020-07
2020-07-31,19511,0,19511,메요트,2020-07
2020-07-31,15015,0,15015,코모로스,2020-07
2020-07-31,13000,26657,-13657,중앙아프리카공화국,2020-07
2020-07-31,9369,8694,675,안도라,2020-07
2020-07-31,8308,55,8253,영령 캐이맨 군도,2020-07
2020-07-31,4001,0,4001,세인트 바르탤르미,2020-07
2020-07-31,3397,4982,-1585,미령 버진군도,2020-07
2020-07-31,2907,7603,-4696,통가,2020-07
2020-07-31,795,0,795,몬트세라트,2020-07
2020-07-31,642,1350,-708,앙귈라,2020-07
2020-07-31,0,1423,-1423,니우에,2020-07
2020-07-31,0,513,-513,맨섬,2020-07
2020-07-31,0,487,-487,토켈라우,2020-07
2020-07-31,0,48,-48,스발비드 군도,2020-07
2020-07-31,0,15478,-15478,쿡 아일랜드,2020-07
2020-07-31,0,9311,-9311,세인트 헬레나,2020-07
2020-07-31,0,12860,-12860,그린랜드,2020-07
2020-07-31,0,3089,-3089,레소토,2020-07
2020-07-31,0,188,-188,교황청,2020-07
2020-07-31,0,878,-878,코스 군도,2020-07
2020-08-31,10937537712,8259962824,2677574888,중국,2020-08
2020-08-31,5581925095,4614339911,967585184,미국,2020-08
2020-08-31,4107144926,1850549957,2256594969,베트남,2020-08
2020-08-31,2150968919,141011109,2009957810,홍콩,2020-08
2020-08-31,1761392723,3538571067,-1777178344,일본,2020-08
2020-08-31,1413334783,1494592729,-81257946,대만,2020-08
2020-08-31,858405283,370371401,488033882,인도,2020-08
2020-08-31,711139617,669746804,41392813,싱가포르,2020-08
2020-08-31,637646216,1412838538,-775192322,독일,2020-08
2020-08-31,635885935,328661387,307224548,멕시코,2020-08
2020-08-31,574612348,711193349,-136581001,말레이시아,2020-08
2020-08-31,566775329,213218489,353556840,필리핀,2020-08
2020-08-31,562582098,1207179206,-644597108,호주,2020-08
2020-08-31,541161476,391215078,149946398,태국,2020-08
2020-08-31,505635382,674786737,-169151355,러시아 연방,2020-08
2020-08-31,446190817,371370753,74820064,캐나다,2020-08
2020-08-31,438342707,59605575,378737132,폴란드,2020-08
2020-08-31,422523786,67383291,355140495,튀르키예,2020-08
2020-08-31,415223086,478443849,-63220763,인도네시아,2020-08
2020-08-31,325480246,181526029,143954217,네덜란드,2020-08
2020-08-31,300320009,407823683,-107503674,아랍에미리트 연합,2020-08
2020-08-31,293807287,311260841,-17453554,브라질,2020-08
2020-08-31,266440587,12639790,253800797,몰타,2020-08
2020-08-31,265113222,40762926,224350296,헝가리,2020-08
2020-08-31,263558250,1115022549,-851464299,사우디아라비아,2020-08
2020-08-31,251772620,468836114,-217063494,영국,2020-08
2020-08-31,250474314,303250,250171064,마샬군도,2020-08
2020-08-31,243985524,60651332,183334192,체코공화국,2020-08
2020-08-31,233384719,586829675,-353444956,이탈리아,2020-08
2020-08-31,210823392,303044,210520348,라이베리아,2020-08
2020-08-31,196886768,491888199,-295001431,프랑스,2020-08
2020-08-31,195598360,135312694,60285666,노르웨이,2020-08
2020-08-31,185206739,152659531,32547208,스페인,2020-08
2020-08-31,159895738,100946509,58949229,벨기에,2020-08
2020-08-31,143932489,44177700,99754789,슬로바키아,2020-08
2020-08-31,109380743,200,109380543,바하마,2020-08
2020-08-31,103767527,99148048,4619479,뉴질랜드,2020-08
2020-08-31,98397286,207661324,-109264038,오스트리아,2020-08
2020-08-31,90587438,98379758,-7792320,이스라엘,2020-08
2020-08-31,86405478,15142682,71262796,파키스탄,2020-08
2020-08-31,79585461,4056544,75528917,토고,2020-08
2020-08-31,78475559,1122100,77353459,우즈베키스탄,2020-08
2020-08-31,78011719,30343312,47668407,이집트,2020-08
2020-08-31,73028364,536110923,-463082559,이라크,2020-08
2020-08-31,72203934,213523476,-141319542,스위스,2020-08
2020-08-31,64889722,85132527,-20242805,아일랜드,2020-08
2020-08-31,60788908,153260912,-92472004,카자흐스탄,2020-08
2020-08-31,60562007,34597778,25964229,방글라데시,2020-08
2020-08-31,52763001,8631273,44131728,슬로베니아,2020-08
2020-08-31,52175643,62063200,-9887557,콜롬비아,2020-08
2020-08-31,51988814,308347179,-256358365,칠레,2020-08
2020-08-31,51688827,142905111,-91216284,스웨덴,2020-08
2020-08-31,49288378,51216958,-1928580,미얀마,2020-08
2020-08-31,48814014,159015160,-110201146,남아프리카공화국,2020-08
2020-08-31,43672716,31134749,12537967,포루투갈,2020-08
2020-08-31,42685918,84335009,-41649091,오만,2020-08
2020-08-31,42563995,8737272,33826723,요르단,2020-08
2020-08-31,41422365,30711814,10710551,캄보디아,2020-08
2020-08-31,37525130,25102468,12422662,나이지리아,2020-08
2020-08-31,34559879,47220745,-12660866,루마니아,2020-08
2020-08-31,32906541,85028177,-52121636,페루,2020-08
2020-08-31,29284124,81422263,-52138139,덴마크,2020-08
2020-08-31,28589695,16769564,11820131,바레인,2020-08
2020-08-31,28078294,500782762,-472704468,쿠웨이트,2020-08
2020-08-31,26586277,11321915,15264362,우크라이나,2020-08
2020-08-31,25500305,17262334,8237971,푸에르토리코,2020-08
2020-08-31,23634582,1573208,22061374,몽골,2020-08
2020-08-31,22811857,81819020,-59007163,아르헨티나,2020-08
2020-08-31,20733473,2620122,18113351,리비아,2020-08
2020-08-31,20392928,566471622,-546078694,카타르,2020-08
2020-08-31,20170877,3501464,16669413,케냐,2020-08
2020-08-31,20117316,4259332,15857984,가나,2020-08
2020-08-31,19182232,9426913,9755319,모로코,2020-08
2020-08-31,18957240,83177757,-64220517,알제리,2020-08
2020-08-31,18703924,69365360,-50661436,핀란드,2020-08
2020-08-31,18337039,6517298,11819741,리투아니아,2020-08
2020-08-31,18047283,12747851,5299432,세르비아,2020-08
2020-08-31,17936454,102938312,-85001858,그리스,2020-08
2020-08-31,17856926,7144431,10712495,에쿠아도르,2020-08
2020-08-31,15073816,12066219,3007597,과테말라,2020-08
2020-08-31,14250755,0,14250755,투르크멘,2020-08
2020-08-31,13891430,10811132,3080298,스리랑카,2020-08
2020-08-31,13261372,6985530,6275842,도미니카 공화국,2020-08
2020-08-31,12732307,20281560,-7549253,불가리아,2020-08
2020-08-31,12523647,469619,12054028,이란,2020-08
2020-08-31,11473357,7754510,3718847,탄자니아,2020-08
2020-08-31,10723381,6203875,4519506,에스토니아,2020-08
2020-08-31,10579686,15538825,-4959139,코스타리카,2020-08
2020-08-31,9679115,8279,9670836,수단,2020-08
2020-08-31,9350506,6263525,3086981,튀니지,2020-08
2020-08-31,9306113,4059108,5247005,온두라스,2020-08
2020-08-31,8897983,2829312,6068671,예맨,2020-08
2020-08-31,8840303,8189507,650796,에티오피아,2020-08
2020-08-31,8469446,166359,8303087,조지아,2020-08
2020-08-31,8261028,586966,7674062,코트디봐르,2020-08
2020-08-31,7271860,670,7271190,키르기스스탄,2020-08
2020-08-31,6901551,3524428,3377123,파나마,2020-08
2020-08-31,6757002,6433881,323121,세네갈,2020-08
2020-08-31,6625970,12739453,-6113483,우루과이,2020-08
2020-08-31,5554376,2388,5551988,마티니크,2020-08
2020-08-31,5283967,1103948,4180019,니카라과,2020-08
2020-08-31,5231628,1189505,4042123,파라과이,2020-08
2020-08-31,5128253,0,5128253,타지크,2020-08
2020-08-31,5037443,1878369,3159074,엘살바도르,2020-08
2020-08-31,4965794,25967733,-21001939,파푸아 뉴기니,2020-08
2020-08-31,4762521,362,4762159,부탄,2020-08
2020-08-31,4507659,1558684,2948975,레바논,2020-08
2020-08-31,4311599,10134699,-5823100,라트비아,2020-08
2020-08-31,4302270,673003,3629267,벨라루스,2020-08
2020-08-31,4277892,1760270,2517622,크로아티아,2020-08
2020-08-31,4237760,6908722,-2670962,트리니다드 토바고,2020-08
2020-08-31,4227559,332971,3894588,아이티,2020-08
2020-08-31,4129981,1069758,3060223,마다카스카르,2020-08
2020-08-31,4117084,20490486,-16373402,모잠비크,2020-08
2020-08-31,3980199,9566,3970633,아제르바이잔,2020-08
2020-08-31,3759396,41496,3717900,불령 리유니온 코모도 제도,2020-08
2020-08-31,3663275,368808,3294467,우간다,2020-08
2020-08-31,3595689,191761,3403928,지부티,2020-08
2020-08-31,3586299,145045,3441254,사모아,2020-08
2020-08-31,3451442,7597732,-4146290,앙골라,2020-08
2020-08-31,3434641,15064683,-11630042,브루나이,2020-08
2020-08-31,3143603,265683,2877920,사이프러스,2020-08
2020-08-31,3029352,1251,3028101,시리아,2020-08
2020-08-31,3010398,166448,2843950,괌,2020-08
2020-08-31,2748339,648198,2100141,모리셔스,2020-08
2020-08-31,2595683,281971,2313712,아이슬란드,2020-08
2020-08-31,2574713,0,2574713,부르키나 파소,2020-08
2020-08-31,2384291,32713,2351578,보츠와나,2020-08
2020-08-31,2320426,135035,2185391,네팔,2020-08
2020-08-31,2182871,126688,2056183,불령 폴리네시아,2020-08
2020-08-31,2174374,87711,2086663,르완다,2020-08
2020-08-31,2076672,3070920,-994248,라오스,2020-08
2020-08-31,2043569,192049,1851520,팔레스타인 해방기구,2020-08
2020-08-31,1978539,379412884,-377434345,기타국,2020-08
2020-08-31,1976587,58069,1918518,카메룬,2020-08
2020-08-31,1871005,36077985,-34206980,콩고민주공화국,2020-08
2020-08-31,1793493,24863192,-23069699,볼리비아,2020-08
2020-08-31,1686024,1002998,683026,베네주엘라,2020-08
2020-08-31,1599200,233184,1366016,아프카니스탄,2020-08
2020-08-31,1587113,3383572,-1796459,기니,2020-08
2020-08-31,1534046,596401,937645,콩고,2020-08
2020-08-31,1487285,533822,953463,마세도니아,2020-08
2020-08-31,1467726,133287,1334439,북마리아나 군도,2020-08
2020-08-31,1463682,366013,1097669,짐바브웨,2020-08
2020-08-31,1449692,4133691,-2683999,룩셈부르그,2020-08
2020-08-31,1445550,334190,1111360,피지,2020-08
2020-08-31,1435751,94707,1341044,가이아나,2020-08
2020-08-31,1340425,0,1340425,말리,2020-08
2020-08-31,1297841,1960737,-662896,잠비아,2020-08
2020-08-31,1257514,1518008,-260494,몰도바,2020-08
2020-08-31,1236076,232160,1003916,소말리아,2020-08
2020-08-31,1201981,123148,1078833,마카오,2020-08
2020-08-31,1185523,2085713,-900190,아르메니아,2020-08
2020-08-31,1185276,6440,1178836,과델로프,2020-08
2020-08-31,1161466,300,1161166,네덜란드 열도,2020-08
2020-08-31,1155976,262930,893046,자마이카,2020-08
2020-08-31,1152725,847427,305298,시에라 리온,2020-08
2020-08-31,1127807,373992,753815,알바니아,2020-08
2020-08-31,1112117,883798,228319,리히텐슈타인,2020-08
2020-08-31,1080595,20522265,-19441670,뉴 칼레도니아,2020-08
2020-08-31,953554,173436,780118,아메리칸 사모아,2020-08
2020-08-31,901859,2405027,-1503168,나우루,2020-08
2020-08-31,901702,1074287,-172585,보스니아-헤르체고비나,2020-08
2020-08-31,881323,535055,346268,가봉,2020-08
2020-08-31,877527,160557,716970,세이쉘,2020-08
2020-08-31,715096,4224,710872,마이크로네시아,2020-08
2020-08-31,642834,2436280,-1793446,모리타니,2020-08
2020-08-31,528143,333307,194836,솔로몬 군도,2020-08
2020-08-31,375086,947987,-572901,키리바티,2020-08
2020-08-31,366991,433399,-66408,수리남,2020-08
2020-08-31,347917,138837,209080,바베이도스,2020-08
2020-08-31,347620,0,347620,불령 가이아나,2020-08
2020-08-31,340943,0,340943,세인트 마틴,2020-08
2020-08-31,310949,0,310949,베닝,2020-08
2020-08-31,309017,436521,-127504,감비아,2020-08
2020-08-31,288669,612,288057,아루바,2020-08
2020-08-31,266026,555,265471,세인트 키츠 네비스,2020-08
2020-08-31,255433,1208665,-953232,바누아투,2020-08
2020-08-31,243912,31079,212833,팔라우,2020-08
2020-08-31,233349,731291,-497942,쿠바,2020-08
2020-08-31,211845,0,211845,큐라소,2020-08
2020-08-31,208635,286528,-77893,몬테네그로,2020-08
2020-08-31,206724,0,206724,버뮤다,2020-08
2020-08-31,197511,0,197511,몰디브,2020-08
2020-08-31,174169,66531,107638,말라위,2020-08
2020-08-31,123156,128681,-5525,벨리제,2020-08
2020-08-31,114997,3239,111758,니제르,2020-08
2020-08-31,101616,268,101348,지브랄타,2020-08
2020-08-31,94587,18507,76080,도미니카,2020-08
2020-08-31,77939,0,77939,남수단,2020-08
2020-08-31,61657,125080,-63423,나미비아,2020-08
2020-08-31,54029,0,54029,챠드,2020-08
2020-08-31,49716,148,49568,영령 버진군도,2020-08
2020-08-31,47404,330,47074,안티가 바부다,2020-08
2020-08-31,44096,0,44096,세인트 빈센트 그레나딘,2020-08
2020-08-31,33100,11399,21701,레소토,2020-08
2020-08-31,28492,0,28492,투발루,2020-08
2020-08-31,27945,168016,-140071,스와질랜드,2020-08
2020-08-31,21471,114919,-93448,세인트 루시아,2020-08
2020-08-31,16494,194,16300,부룬디,2020-08
2020-08-31,15880,19623,-3743,통가,2020-08
2020-08-31,14719,205,14514,세인트 바르탤르미,2020-08
2020-08-31,14640,351,14289,코모로스,2020-08
2020-08-31,12429,0,12429,영령 캐이맨 군도,2020-08
2020-08-31,9800,0,9800,상토메 프린스페,2020-08
2020-08-31,8849,3443,5406,티모르,2020-08
2020-08-31,7824,7038,786,미령 버진군도,2020-08
2020-08-31,7264,2235,5029,그레나다,2020-08
2020-08-31,2580,485454,-482874,산마리노,2020-08
2020-08-31,2511,0,2511,메요트,2020-08
2020-08-31,2462,248,2214,투르크 & 카이코스 군도,2020-08
2020-08-31,1900,15015,-13115,모나코,2020-08
2020-08-31,1530,0,1530,보네르 신트외스타티위스,2020-08
2020-08-31,1197,30788284,-30787087,적도 기니,2020-08
2020-08-31,928,940,-12,앙귈라,2020-08
2020-08-31,660,0,660,저어지,2020-08
2020-08-31,465,0,465,세인트마틴(생마르탱),2020-08
2020-08-31,37,275,-238,카보 베르데,2020-08
2020-08-31,10,858,-848,그린랜드,2020-08
2020-08-31,6,0,6,에리트리아,2020-08
2020-08-31,0,4,-4,쿡 아일랜드,2020-08
2020-08-31,0,584,-584,교황청,2020-08
2020-08-31,0,24920,-24920,중앙아프리카공화국,2020-08
2020-08-31,0,1,-1,서사하라,2020-08
2020-08-31,0,1507,-1507,토켈라우,2020-08
2020-08-31,0,6133,-6133,안도라,2020-08
2020-08-31,0,19,-19,세인트 헬레나,2020-08
2020-08-31,0,13750,-13750,건지,2020-08
2020-08-31,0,94240,-94240,기네비소,2020-08
2020-08-31,0,105,-105,불령 남부지역,2020-08
2020-08-31,0,180,-180,몬트세라트,2020-08
2020-09-30,12185274325,9166601415,3018672910,중국,2020-09
2020-09-30,6997553830,4654363073,2343190757,미국,2020-09
2020-09-30,4796012203,1970095488,2825916715,베트남,2020-09
2020-09-30,3005224076,98767349,2906456727,홍콩,2020-09
2020-09-30,2156620830,3872130237,-1715509407,일본,2020-09
2020-09-30,1524871482,1610958308,-86086826,대만,2020-09
2020-09-30,1471347296,414204517,1057142779,인도,2020-09
2020-09-30,855044186,1782569976,-927525790,독일,2020-09
2020-09-30,779386453,673599664,105786789,멕시코,2020-09
2020-09-30,759781162,689290015,70491147,싱가포르,2020-09
2020-09-30,739204049,739779700,-575651,말레이시아,2020-09
2020-09-30,691551133,749833892,-58282759,러시아 연방,2020-09
2020-09-30,670009145,235530993,434478152,필리핀,2020-09
2020-09-30,623736226,1705439897,-1081703671,호주,2020-09
2020-09-30,602661066,418809405,183851661,태국,2020-09
2020-09-30,586442725,72655188,513787537,폴란드,2020-09
2020-09-30,578455408,116316487,462138921,튀르키예,2020-09
2020-09-30,541873669,359239824,182633845,캐나다,2020-09
2020-09-30,533789205,601018843,-67229638,인도네시아,2020-09
2020-09-30,458620940,35428,458585512,마샬군도,2020-09
2020-09-30,401137429,379442210,21695219,브라질,2020-09
2020-09-30,370216719,12697045,357519674,몰타,2020-09
2020-09-30,354657323,334291109,20366214,영국,2020-09
2020-09-30,334503036,71151216,263351820,체코공화국,2020-09
2020-09-30,327969728,1163346025,-835376297,사우디아라비아,2020-09
2020-09-30,322703484,524452327,-201748843,네덜란드,2020-09
2020-09-30,291622245,448875163,-157252918,아랍에미리트 연합,2020-09
2020-09-30,285738134,611237042,-325498908,이탈리아,2020-09
2020-09-30,285308864,482617655,-197308791,프랑스,2020-09
2020-09-30,244958362,65533860,179424502,헝가리,2020-09
2020-09-30,236688815,24859327,211829488,슬로바키아,2020-09
2020-09-30,233627687,170434685,63193002,스페인,2020-09
2020-09-30,210586679,117116,210469563,라이베리아,2020-09
2020-09-30,195429904,136236253,59193651,벨기에,2020-09
2020-09-30,146302541,77482607,68819934,아일랜드,2020-09
2020-09-30,138030235,184539951,-46509716,노르웨이,2020-09
2020-09-30,135994996,1549523,134445473,우즈베키스탄,2020-09
2020-09-30,125949183,95752890,30196293,이스라엘,2020-09
2020-09-30,113907813,139001153,-25093340,오스트리아,2020-09
2020-09-30,106558590,23652370,82906220,파키스탄,2020-09
2020-09-30,101555599,103269165,-1713566,뉴질랜드,2020-09
2020-09-30,98072887,8239837,89833050,슬로베니아,2020-09
2020-09-30,97886192,18674982,79211210,이집트,2020-09
2020-09-30,83238249,154631144,-71392895,카자흐스탄,2020-09
2020-09-30,82966837,50498139,32468698,그리스,2020-09
2020-09-30,79937131,234691943,-154754812,스위스,2020-09
2020-09-30,77466147,350496667,-273030520,이라크,2020-09
2020-09-30,75209427,45587657,29621770,방글라데시,2020-09
2020-09-30,73064750,307102743,-234037993,칠레,2020-09
2020-09-30,66798928,119324068,-52525140,스웨덴,2020-09
2020-09-30,65725823,4254149,61471674,토고,2020-09
2020-09-30,55359856,97489091,-42129235,오만,2020-09
2020-09-30,55118785,55100368,18417,미얀마,2020-09
2020-09-30,54607040,27694692,26912348,캄보디아,2020-09
2020-09-30,54040344,189559336,-135518992,남아프리카공화국,2020-09
2020-09-30,46084280,32614878,13469402,포루투갈,2020-09
2020-09-30,45659358,218966790,-173307432,페루,2020-09
2020-09-30,45480903,35732414,9748489,콜롬비아,2020-09
2020-09-30,43374939,11540594,31834345,요르단,2020-09
2020-09-30,42555930,8594734,33961196,에쿠아도르,2020-09
2020-09-30,42337381,72760552,-30423171,덴마크,2020-09
2020-09-30,41683596,39226922,2456674,우크라이나,2020-09
2020-09-30,40146230,43668167,-3521937,루마니아,2020-09
2020-09-30,39243842,46841638,-7597796,나이지리아,2020-09
2020-09-30,38883871,64963623,-26079752,핀란드,2020-09
2020-09-30,37523788,51729058,-14205270,바레인,2020-09
2020-09-30,36747574,12,36747562,영령 캐이맨 군도,2020-09
2020-09-30,29690569,15843623,13846946,세르비아,2020-09
2020-09-30,28733180,27923485,809695,푸에르토리코,2020-09
2020-09-30,28488586,2373044,26115542,몽골,2020-09
2020-09-30,26053805,2501469,23552336,리비아,2020-09
2020-09-30,25900959,448564040,-422663081,카타르,2020-09
2020-09-30,25599142,474167212,-448568070,쿠웨이트,2020-09
2020-09-30,23783013,17612104,6170909,모로코,2020-09
2020-09-30,22800432,91407272,-68606840,아르헨티나,2020-09
2020-09-30,20535230,1414730,19120500,가나,2020-09
2020-09-30,19780709,8887176,10893533,리투아니아,2020-09
2020-09-30,19206818,5741355,13465463,도미니카 공화국,2020-09
2020-09-30,18795573,16898134,1897439,스리랑카,2020-09
2020-09-30,17549878,6653295,10896583,과테말라,2020-09
2020-09-30,17263653,7021012,10242641,탄자니아,2020-09
2020-09-30,16917299,503,16916796,투르크멘,2020-09
2020-09-30,15520952,99603212,-84082260,알제리,2020-09
2020-09-30,15077261,995795,14081466,수단,2020-09
2020-09-30,15034042,1589590,13444452,브루나이,2020-09
2020-09-30,14734091,4018426,10715665,케냐,2020-09
2020-09-30,14061348,89133647,-75072299,파나마,2020-09
2020-09-30,13976332,11904225,2072107,불가리아,2020-09
2020-09-30,13678918,4963575,8715343,예맨,2020-09
2020-09-30,13516221,1746981,11769240,엘살바도르,2020-09
2020-09-30,12277712,331343,11946369,이란,2020-09
2020-09-30,12036475,5642129,6394346,에스토니아,2020-09
2020-09-30,10779028,5133132,5645896,에티오피아,2020-09
2020-09-30,10206717,8066932,2139785,우루과이,2020-09
2020-09-30,10112993,1780536,8332457,조지아,2020-09
2020-09-30,9720603,5913901,3806702,튀니지,2020-09
2020-09-30,9303838,92257,9211581,키르기스스탄,2020-09
2020-09-30,8156627,544724,7611903,피지,2020-09
2020-09-30,7699177,50548,7648629,괌,2020-09
2020-09-30,7615572,515486,7100086,니카라과,2020-09
2020-09-30,7446934,1833955,5612979,크로아티아,2020-09
2020-09-30,7428784,3086,7425698,아메리칸 사모아,2020-09
2020-09-30,7186233,19,7186214,타지크,2020-09
2020-09-30,7046407,1626355,5420052,온두라스,2020-09
2020-09-30,7044767,1971930,5072837,레바논,2020-09
2020-09-30,7007139,0,7007139,쿠바,2020-09
2020-09-30,6946643,645494,6301149,모리셔스,2020-09
2020-09-30,6806437,264296,6542141,코트디봐르,2020-09
2020-09-30,6759278,1377722,5381556,파라과이,2020-09
2020-09-30,6615273,206424,6408849,아제르바이잔,2020-09
2020-09-30,6585172,246406,6338766,아이티,2020-09
2020-09-30,6117493,10020332,-3902839,코스타리카,2020-09
2020-09-30,6084342,5524,6078818,불령 리유니온 코모도 제도,2020-09
2020-09-30,5918074,7727939,-1809865,라트비아,2020-09
2020-09-30,4890662,341765,4548897,네팔,2020-09
2020-09-30,4806522,4446052,360470,세네갈,2020-09
2020-09-30,4735089,2320860,2414229,벨라루스,2020-09
2020-09-30,4726843,10570102,-5843259,모잠비크,2020-09
2020-09-30,4541896,1382094,3159802,나미비아,2020-09
2020-09-30,4513509,73806,4439703,사모아,2020-09
2020-09-30,4241519,493072,3748447,지부티,2020-09
2020-09-30,3978638,419885814,-415907176,기타국,2020-09
2020-09-30,3793045,758632,3034413,마다카스카르,2020-09
2020-09-30,3609719,6858464,-3248745,트리니다드 토바고,2020-09
2020-09-30,3465369,702,3464667,부르키나 파소,2020-09
2020-09-30,3376782,43751675,-40374893,콩고민주공화국,2020-09
2020-09-30,3330914,68275179,-64944265,파푸아 뉴기니,2020-09
2020-09-30,3132142,2396,3129746,시리아,2020-09
2020-09-30,3048132,2414,3045718,불령 폴리네시아,2020-09
2020-09-30,2931137,12792348,-9861211,사이프러스,2020-09
2020-09-30,2928185,2108613,819572,베네주엘라,2020-09
2020-09-30,2883975,28903483,-26019508,뉴 칼레도니아,2020-09
2020-09-30,2829782,527148,2302634,알바니아,2020-09
2020-09-30,2543713,586949,1956764,우간다,2020-09
2020-09-30,2543084,1663061,880023,잠비아,2020-09
2020-09-30,2483776,3008189,-524413,라오스,2020-09
2020-09-30,2457515,61,2457454,과델로프,2020-09
2020-09-30,2378462,1259,2377203,앙골라,2020-09
2020-09-30,2371942,290671,2081271,카메룬,2020-09
2020-09-30,2254018,93480,2160538,가이아나,2020-09
2020-09-30,2233195,104270,2128925,아프카니스탄,2020-09
2020-09-30,2186273,57256,2129017,마카오,2020-09
2020-09-30,2060544,37382242,-35321698,볼리비아,2020-09
2020-09-30,1982681,198407,1784274,짐바브웨,2020-09
2020-09-30,1687257,252762,1434495,콩고,2020-09
2020-09-30,1533939,8149839,-6615900,룩셈부르그,2020-09
2020-09-30,1443697,2430173,-986476,몰도바,2020-09
2020-09-30,1327306,72960,1254346,팔레스타인 해방기구,2020-09
2020-09-30,1311557,656457,655100,리히텐슈타인,2020-09
2020-09-30,1280203,4001341,-2721138,기니,2020-09
2020-09-30,1272417,159959,1112458,말라위,2020-09
2020-09-30,1228604,433825,794779,소말리아,2020-09
2020-09-30,1175483,45485000,-44309517,가봉,2020-09
2020-09-30,1092659,188078,904581,북마리아나 군도,2020-09
2020-09-30,1076297,76178,1000119,보츠와나,2020-09
2020-09-30,1045122,0,1045122,베닝,2020-09
2020-09-30,1025460,2919138,-1893678,아르메니아,2020-09
2020-09-30,1005223,95992,909231,르완다,2020-09
2020-09-30,917293,311930,605363,말리,2020-09
2020-09-30,893060,17949,875111,마이크로네시아,2020-09
2020-09-30,879384,0,879384,세인트 마틴,2020-09
2020-09-30,828705,47196,781509,솔로몬 군도,2020-09
2020-09-30,805471,5324,800147,바하마,2020-09
2020-09-30,742380,332240,410140,아이슬란드,2020-09
2020-09-30,718278,4179621,-3461343,모리타니,2020-09
2020-09-30,695313,0,695313,마티니크,2020-09
2020-09-30,646699,519307,127392,마세도니아,2020-09
2020-09-30,644267,136713,507554,자마이카,2020-09
2020-09-30,569166,510281,58885,수리남,2020-09
2020-09-30,549204,1851,547353,몰디브,2020-09
2020-09-30,520162,0,520162,지브랄타,2020-09
2020-09-30,508940,2877588,-2368648,보스니아-헤르체고비나,2020-09
2020-09-30,507297,69,507228,부탄,2020-09
2020-09-30,485533,391131,94402,세이쉘,2020-09
2020-09-30,485268,0,485268,메요트,2020-09
2020-09-30,420553,946176,-525623,시에라 리온,2020-09
2020-09-30,342505,5294,337211,도미니카,2020-09
2020-09-30,331019,65,330954,벨리제,2020-09
2020-09-30,236657,76,236581,몬테네그로,2020-09
2020-09-30,236599,380,236219,아루바,2020-09
2020-09-30,229170,42814,186356,키리바티,2020-09
2020-09-30,227094,113380,113714,중앙아프리카공화국,2020-09
2020-09-30,221699,14288,207411,바베이도스,2020-09
2020-09-30,215951,31330,184621,세인트 루시아,2020-09
2020-09-30,207627,172,207455,영령 버진군도,2020-09
2020-09-30,137628,203,137425,팔라우,2020-09
2020-09-30,129065,516,128549,버뮤다,2020-09
2020-09-30,106139,6885318,-6779179,에리트리아,2020-09
2020-09-30,102720,813105,-710385,바누아투,2020-09
2020-09-30,101293,0,101293,그레나다,2020-09
2020-09-30,90710,212,90498,티모르,2020-09
2020-09-30,90373,149,90224,카보 베르데,2020-09
2020-09-30,87598,263229,-175631,감비아,2020-09
2020-09-30,86707,31061,55646,스와질랜드,2020-09
2020-09-30,79938,131035,-51097,모나코,2020-09
2020-09-30,70249,610,69639,큐라소,2020-09
2020-09-30,62362,1233560,-1171198,나우루,2020-09
2020-09-30,54262,439,53823,투르크 & 카이코스 군도,2020-09
2020-09-30,27704,6237,21467,세인트 키츠 네비스,2020-09
2020-09-30,24506,0,24506,불령 가이아나,2020-09
2020-09-30,22477,330,22147,안티가 바부다,2020-09
2020-09-30,20717,2862,17855,챠드,2020-09
2020-09-30,17115,16180,935,통가,2020-09
2020-09-30,14159,0,14159,왈라스 & 퓨투나 군도,2020-09
2020-09-30,14073,20319,-6246,부룬디,2020-09
2020-09-30,11359,218,11141,코모로스,2020-09
2020-09-30,10402,730,9672,네덜란드 열도,2020-09
2020-09-30,9027,25662,-16635,세인트 빈센트 그레나딘,2020-09
2020-09-30,5410,39750,-34340,적도 기니,2020-09
2020-09-30,4800,281673,-276873,산마리노,2020-09
2020-09-30,4411,0,4411,상토메 프린스페,2020-09
2020-09-30,3125,48059,-44934,니제르,2020-09
2020-09-30,1899,0,1899,세인트 바르탤르미,2020-09
2020-09-30,1650,104534,-102884,그린랜드,2020-09
2020-09-30,1463,0,1463,남조지아 & 남샌드위치 군도,2020-09
2020-09-30,1176,2622,-1446,안도라,2020-09
2020-09-30,994,0,994,포클랜드 군도,2020-09
2020-09-30,678,5396,-4718,미령 버진군도,2020-09
2020-09-30,587,268,319,보네르 신트외스타티위스,2020-09
2020-09-30,433,0,433,저어지,2020-09
2020-09-30,110,1428,-1318,앙귈라,2020-09
2020-09-30,30,0,30,마이너 아우틀링 합중국 군도,2020-09
2020-09-30,0,445,-445,세인트 헬레나,2020-09
2020-09-30,0,1198054,-1198054,안타티카,2020-09
2020-09-30,0,10953,-10953,레소토,2020-09
2020-09-30,0,18626,-18626,니우에,2020-09
2020-09-30,0,923,-923,코스 군도,2020-09
2020-09-30,0,225,-225,교황청,2020-09
2020-09-30,0,13048,-13048,토켈라우,2020-09
2020-09-30,0,15195,-15195,건지,2020-09
2020-09-30,0,738,-738,맨섬,2020-09
2020-09-30,0,91,-91,알랜드 군도,2020-09
2020-09-30,0,1120,-1120,몬트세라트,2020-09
2020-09-30,0,185,-185,파로에 군도,2020-09
2020-10-31,11527355549,9622283980,1905071569,중국,2020-10
2020-10-31,6562208994,4363457911,2198751083,미국,2020-10
2020-10-31,4508943206,1777303858,2731639348,베트남,2020-10
2020-10-31,2731820714,85635595,2646185119,홍콩,2020-10
2020-10-31,1924047355,3992664442,-2068617087,일본,2020-10
2020-10-31,1551769451,1713655429,-161885978,대만,2020-10
2020-10-31,1079872523,393033847,686838676,인도,2020-10
2020-10-31,789161170,835235273,-46074103,러시아 연방,2020-10
2020-10-31,783261602,1805393269,-1022131667,독일,2020-10
2020-10-31,760945307,585182534,175762773,멕시코,2020-10
2020-10-31,653090064,702518358,-49428294,말레이시아,2020-10
2020-10-31,644141613,294630404,349511209,캐나다,2020-10
2020-10-31,617775188,445658050,172117138,태국,2020-10
2020-10-31,592940273,1728019228,-1135078955,호주,2020-10
2020-10-31,586413671,674735728,-88322057,싱가포르,2020-10
2020-10-31,573001219,305988472,267012747,필리핀,2020-10
2020-10-31,512900092,72578957,440321135,폴란드,2020-10
2020-10-31,487889305,596969956,-109080651,인도네시아,2020-10
2020-10-31,454847193,137063359,317783834,튀르키예,2020-10
2020-10-31,401680184,423159568,-21479384,영국,2020-10
2020-10-31,355573253,363590035,-8016782,브라질,2020-10
2020-10-31,353137621,442501810,-89364189,네덜란드,2020-10
2020-10-31,324587276,304404288,20182988,아랍에미리트 연합,2020-10
2020-10-31,294133659,1283,294132376,바하마,2020-10
2020-10-31,292977566,559477519,-266499953,이탈리아,2020-10
2020-10-31,280766920,39316059,241450861,슬로바키아,2020-10
2020-10-31,280554371,99232,280455139,마샬군도,2020-10
2020-10-31,277700791,70286974,207413817,헝가리,2020-10
2020-10-31,250325698,507013732,-256688034,프랑스,2020-10
2020-10-31,249922262,1399662750,-1149740488,사우디아라비아,2020-10
2020-10-31,248951342,74673479,174277863,체코공화국,2020-10
2020-10-31,234210904,154287086,79923818,스페인,2020-10
2020-10-31,222094302,126088552,96005750,벨기에,2020-10
2020-10-31,198094019,36828234,161265785,그리스,2020-10
2020-10-31,184621919,80757151,103864768,이스라엘,2020-10
2020-10-31,146379515,87149414,59230101,노르웨이,2020-10
2020-10-31,121278401,87766236,33512165,뉴질랜드,2020-10
2020-10-31,120369529,7306874,113062655,이집트,2020-10
2020-10-31,114668997,221884967,-107215970,칠레,2020-10
2020-10-31,114103916,2118237,111985679,우즈베키스탄,2020-10
2020-10-31,105518017,23227944,82290073,파키스탄,2020-10
2020-10-31,104174916,204053437,-99878521,스웨덴,2020-10
2020-10-31,98039499,34226218,63813281,방글라데시,2020-10
2020-10-31,95423521,11253155,84170366,몰타,2020-10
2020-10-31,91494748,120837768,-29343020,오스트리아,2020-10
2020-10-31,73146279,7758125,65388154,라이베리아,2020-10
2020-10-31,72025712,134272959,-62247247,남아프리카공화국,2020-10
2020-10-31,63374504,145571700,-82197196,이라크,2020-10
2020-10-31,63264407,7143085,56121322,슬로베니아,2020-10
2020-10-31,63124339,9659026,53465313,토고,2020-10
2020-10-31,60098165,6223007,53875158,에쿠아도르,2020-10
2020-10-31,53981877,19534952,34446925,파나마,2020-10
2020-10-31,53651201,77256801,-23605600,콜롬비아,2020-10
2020-10-31,53413537,16676400,36737137,나이지리아,2020-10
2020-10-31,51708811,105268610,-53559799,아일랜드,2020-10
2020-10-31,51306675,7406684,43899991,튀니지,2020-10
2020-10-31,50261335,242271560,-192010225,스위스,2020-10
2020-10-31,50017911,20930578,29087333,캄보디아,2020-10
2020-10-31,48010388,302901116,-254890728,페루,2020-10
2020-10-31,47625222,5005980,42619242,요르단,2020-10
2020-10-31,46623808,27870207,18753601,포루투갈,2020-10
2020-10-31,46124836,39304214,6820622,푸에르토리코,2020-10
2020-10-31,42286897,15501715,26785182,카자흐스탄,2020-10
2020-10-31,41735807,42450364,-714557,루마니아,2020-10
2020-10-31,39982564,80718146,-40735582,바레인,2020-10
2020-10-31,38960478,46814461,-7853983,미얀마,2020-10
2020-10-31,36914996,21582495,15332501,우크라이나,2020-10
2020-10-31,34344921,81859053,-47514132,덴마크,2020-10
2020-10-31,32958095,18168521,14789574,모로코,2020-10
2020-10-31,30517922,442541706,-412023784,쿠웨이트,2020-10
2020-10-31,28445927,505925902,-477479975,카타르,2020-10
2020-10-31,28153597,105836634,-77683037,아르헨티나,2020-10
2020-10-31,26272573,140220068,-113947495,오만,2020-10
2020-10-31,25615137,3130864,22484273,리비아,2020-10
2020-10-31,22929894,1562809,21367085,몽골,2020-10
2020-10-31,22403097,2495168,19907929,세르비아,2020-10
2020-10-31,20192645,6056036,14136609,과테말라,2020-10
2020-10-31,18842770,48207736,-29364966,알제리,2020-10
2020-10-31,18368614,78861226,-60492612,핀란드,2020-10
2020-10-31,18361825,1091761,17270064,코트디봐르,2020-10
2020-10-31,17373260,6421125,10952135,도미니카 공화국,2020-10
2020-10-31,17150191,2535147,14615044,가나,2020-10
2020-10-31,17077449,13307817,3769632,불가리아,2020-10
2020-10-31,16926044,365634,16560410,탄자니아,2020-10
2020-10-31,16642547,2201866,14440681,엘살바도르,2020-10
2020-10-31,16561633,169201,16392432,이란,2020-10
2020-10-31,16371061,4183847,12187214,케냐,2020-10
2020-10-31,15213058,7740872,7472186,스리랑카,2020-10
2020-10-31,15144691,6824482,8320209,리투아니아,2020-10
2020-10-31,11323948,2606113,8717835,예맨,2020-10
2020-10-31,11113511,1987387,9126124,수단,2020-10
2020-10-31,9920570,15849714,-5929144,앙골라,2020-10
2020-10-31,9604912,898105,8706807,니카라과,2020-10
2020-10-31,9170186,0,9170186,투발루,2020-10
2020-10-31,9143432,2324620,6818812,온두라스,2020-10
2020-10-31,8782126,11708899,-2926773,우루과이,2020-10
2020-10-31,8538691,2293050,6245641,파라과이,2020-10
2020-10-31,7921084,54319,7866765,키르기스스탄,2020-10
2020-10-31,7861327,2652,7858675,타지크,2020-10
2020-10-31,7698537,7872249,-173712,코스타리카,2020-10
2020-10-31,7693751,7987314,-293563,에스토니아,2020-10
2020-10-31,7647814,1265905,6381909,레바논,2020-10
2020-10-31,7595011,5596990,1998021,트리니다드 토바고,2020-10
2020-10-31,6975009,290337353,-283362344,기타국,2020-10
2020-10-31,6720746,1110539,5610207,조지아,2020-10
2020-10-31,6643708,9703914,-3060206,라트비아,2020-10
2020-10-31,6539348,6885802,-346454,에티오피아,2020-10
2020-10-31,6055735,4319294,1736441,세네갈,2020-10
2020-10-31,6053373,1828571,4224802,크로아티아,2020-10
2020-10-31,5406820,27093,5379727,아제르바이잔,2020-10
2020-10-31,5034318,329917,4704401,괌,2020-10
2020-10-31,4481902,359574,4122328,아이티,2020-10
2020-10-31,4269842,101067,4168775,사모아,2020-10
2020-10-31,3948651,38767646,-34818995,브루나이,2020-10
2020-10-31,3798592,439321,3359271,우간다,2020-10
2020-10-31,3790439,2978109,812330,라오스,2020-10
2020-10-31,3718608,4425,3714183,시리아,2020-10
2020-10-31,3569096,203081,3366015,모잠비크,2020-10
2020-10-31,3372231,415226,2957005,모리셔스,2020-10
2020-10-31,3090010,231552,2858458,아프카니스탄,2020-10
2020-10-31,2963324,1844064,1119260,벨라루스,2020-10
2020-10-31,2949484,245143,2704341,알바니아,2020-10
2020-10-31,2912681,31477,2881204,부르키나 파소,2020-10
2020-10-31,2830669,33968443,-31137774,콩고민주공화국,2020-10
2020-10-31,2817583,60929715,-58112132,파푸아 뉴기니,2020-10
2020-10-31,2673765,82901,2590864,가이아나,2020-10
2020-10-31,2587903,1090656,1497247,마다카스카르,2020-10
2020-10-31,2493957,312702,2181255,네팔,2020-10
2020-10-31,2478239,2612473,-134234,기니,2020-10
2020-10-31,2376138,124220,2251918,불령 폴리네시아,2020-10
2020-10-31,2373328,451020,1922308,지부티,2020-10
2020-10-31,2145187,18,2145169,마티니크,2020-10
2020-10-31,2079632,1707452,372180,잠비아,2020-10
2020-10-31,2019418,62329,1957089,마카오,2020-10
2020-10-31,1938956,2321872,-382916,베네주엘라,2020-10
2020-10-31,1875539,14473291,-12597752,카메룬,2020-10
2020-10-31,1859580,123375,1736205,자마이카,2020-10
2020-10-31,1762282,600687,1161595,사이프러스,2020-10
2020-10-31,1734505,0,1734505,팔레스타인 해방기구,2020-10
2020-10-31,1731610,2394729,-663119,몰도바,2020-10
2020-10-31,1711931,161109,1550822,아이슬란드,2020-10
2020-10-31,1703189,9752808,-8049619,룩셈부르그,2020-10
2020-10-31,1629649,2146750,-517101,콩고,2020-10
2020-10-31,1568556,4028,1564528,불령 리유니온 코모도 제도,2020-10
2020-10-31,1535018,172807,1362211,피지,2020-10
2020-10-31,1471294,570955,900339,소말리아,2020-10
2020-10-31,1470639,597842,872797,말라위,2020-10
2020-10-31,1361501,21696428,-20334927,뉴 칼레도니아,2020-10
2020-10-31,1337321,2451325,-1114004,보스니아-헤르체고비나,2020-10
2020-10-31,1250534,4054342,-2803808,아르메니아,2020-10
2020-10-31,1215993,31491986,-30275993,볼리비아,2020-10
2020-10-31,1144209,657582,486627,시에라 리온,2020-10
2020-10-31,1139408,57990,1081418,쿠바,2020-10
2020-10-31,1129491,0,1129491,베닝,2020-10
2020-10-31,1114459,116859,997600,아메리칸 사모아,2020-10
2020-10-31,1063460,104703,958757,북마리아나 군도,2020-10
2020-10-31,982354,955250,27104,리히텐슈타인,2020-10
2020-10-31,894518,41315,853203,마이크로네시아,2020-10
2020-10-31,842900,38635475,-37792575,가봉,2020-10
2020-10-31,768571,890,767681,투르크멘,2020-10
2020-10-31,758119,407,757712,키리바티,2020-10
2020-10-31,745596,213684,531912,세이쉘,2020-10
2020-10-31,701759,191,701568,티모르,2020-10
2020-10-31,590670,1734540,-1143870,모리타니,2020-10
2020-10-31,564840,232209,332631,르완다,2020-10
2020-10-31,546934,17320,529614,바베이도스,2020-10
2020-10-31,492784,868399,-375615,마세도니아,2020-10
2020-10-31,491841,6373,485468,과델로프,2020-10
2020-10-31,489674,13412,476262,짐바브웨,2020-10
2020-10-31,427218,7901,419317,몰디브,2020-10
2020-10-31,381815,942933,-561118,바누아투,2020-10
2020-10-31,378991,0,378991,지브랄타,2020-10
2020-10-31,362215,56,362159,세인트 루시아,2020-10
2020-10-31,344121,46462,297659,팔라우,2020-10
2020-10-31,335073,0,335073,벨리제,2020-10
2020-10-31,316931,0,316931,세인트 마틴,2020-10
2020-10-31,314173,1111,313062,말리,2020-10
2020-10-31,273743,550348,-276605,솔로몬 군도,2020-10
2020-10-31,264035,2238,261797,도미니카,2020-10
2020-10-31,263010,43694871,-43431861,아루바,2020-10
2020-10-31,230095,0,230095,남수단,2020-10
2020-10-31,224853,0,224853,그레나다,2020-10
2020-10-31,224836,742,224094,챠드,2020-10
2020-10-31,217070,167782,49288,감비아,2020-10
2020-10-31,200973,148,200825,부탄,2020-10
2020-10-31,194452,21646,172806,니제르,2020-10
2020-10-31,180435,0,180435,큐라소,2020-10
2020-10-31,179267,12879,166388,부룬디,2020-10
2020-10-31,151773,1373831,-1222058,나미비아,2020-10
2020-10-31,150223,0,150223,영령 버진군도,2020-10
2020-10-31,132172,0,132172,영령 캐이맨 군도,2020-10
2020-10-31,130383,584382,-453999,수리남,2020-10
2020-10-31,117498,9405444,-9287946,에리트리아,2020-10
2020-10-31,116630,81998,34632,보츠와나,2020-10
2020-10-31,114457,38531,75926,스와질랜드,2020-10
2020-10-31,93594,0,93594,메요트,2020-10
2020-10-31,92982,31874,61108,몬테네그로,2020-10
2020-10-31,86711,10383,76328,보네르 신트외스타티위스,2020-10
2020-10-31,77641,12,77629,버뮤다,2020-10
2020-10-31,72132,29759,42373,코모로스,2020-10
2020-10-31,68568,260419,-191851,모나코,2020-10
2020-10-31,60501,0,60501,세인트 빈센트 그레나딘,2020-10
2020-10-31,52286,87,52199,카보 베르데,2020-10
2020-10-31,44879,0,44879,세인트마틴(생마르탱),2020-10
2020-10-31,27810,1573,26237,네덜란드 열도,2020-10
2020-10-31,27289,0,27289,안티가 바부다,2020-10
2020-10-31,25016,140,24876,투르크 & 카이코스 군도,2020-10
2020-10-31,16700,1835274,-1818574,산마리노,2020-10
2020-10-31,14676,207,14469,나우루,2020-10
2020-10-31,13935,0,13935,적도 기니,2020-10
2020-10-31,13641,0,13641,불령 가이아나,2020-10
2020-10-31,9418,2354,7064,앙귈라,2020-10
2020-10-31,8753,9314,-561,세인트 키츠 네비스,2020-10
2020-10-31,8171,88822,-80651,기네비소,2020-10
2020-10-31,5104,8938,-3834,미령 버진군도,2020-10
2020-10-31,2256,0,2256,상토메 프린스페,2020-10
2020-10-31,2249,0,2249,세인트 바르탤르미,2020-10
2020-10-31,1351,2528,-1177,토켈라우,2020-10
2020-10-31,1324,0,1324,포클랜드 군도,2020-10
2020-10-31,1194,5079,-3885,안도라,2020-10
2020-10-31,694,0,694,남조지아 & 남샌드위치 군도,2020-10
2020-10-31,382,0,382,중앙아프리카공화국,2020-10
2020-10-31,73,17757,-17684,건지,2020-10
2020-10-31,0,545,-545,피트카이른,2020-10
2020-10-31,0,79370,-79370,통가,2020-10
2020-10-31,0,688,-688,마이너 아우틀링 합중국 군도,2020-10
2020-10-31,0,1283,-1283,세인트 헬레나,2020-10
2020-10-31,0,479,-479,몬트세라트,2020-10
2020-10-31,0,15682,-15682,쿡 아일랜드,2020-10
2020-10-31,0,313,-313,그린랜드,2020-10
2020-10-31,0,300,-300,맨섬,2020-10
2020-10-31,0,14,-14,안타티카,2020-10
2020-10-31,0,18363,-18363,레소토,2020-10
2020-10-31,0,4019,-4019,코스 군도,2020-10
2020-10-31,0,2944,-2944,니우에,2020-10
2020-11-30,12029854423,10286166518,1743687905,중국,2020-11
2020-11-30,6664272439,4188104463,2476167976,미국,2020-11
2020-11-30,4506085066,1458043215,3048041851,베트남,2020-11
2020-11-30,2635980263,103142646,2532837617,홍콩,2020-11
2020-11-30,2122869801,4054281539,-1931411738,일본,2020-11
2020-11-30,1593029188,1650614864,-57585676,대만,2020-11
2020-11-30,1133714288,375149762,758564526,인도,2020-11
2020-11-30,977415237,1995902643,-1018487406,독일,2020-11
2020-11-30,770640919,598506552,172134367,멕시코,2020-11
2020-11-30,736473485,729464758,7008727,싱가포르,2020-11
2020-11-30,700983238,436479472,264503766,태국,2020-11
2020-11-30,699099769,808647618,-109547849,러시아 연방,2020-11
2020-11-30,664588702,708691138,-44102436,말레이시아,2020-11
2020-11-30,619124853,282265393,336859460,필리핀,2020-11
2020-11-30,611232882,627890020,-16657138,인도네시아,2020-11
2020-11-30,584046748,1715032941,-1130986193,호주,2020-11
2020-11-30,577316930,78856906,498460024,폴란드,2020-11
2020-11-30,523281086,334809123,188471963,캐나다,2020-11
2020-11-30,446070578,91449028,354621550,튀르키예,2020-11
2020-11-30,403976104,386152408,17823696,영국,2020-11
2020-11-30,357095163,681206265,-324111102,네덜란드,2020-11
2020-11-30,334832288,1117734954,-782902666,사우디아라비아,2020-11
2020-11-30,332948648,506764352,-173815704,브라질,2020-11
2020-11-30,331053313,610203458,-279150145,이탈리아,2020-11
2020-11-30,270520338,72327085,198193253,헝가리,2020-11
2020-11-30,251757914,3796310,247961604,몰타,2020-11
2020-11-30,251663186,267529358,-15866172,아랍에미리트 연합,2020-11
2020-11-30,247756952,497963580,-250206628,프랑스,2020-11
2020-11-30,237228688,76310582,160918106,체코공화국,2020-11
2020-11-30,220120496,134424618,85695878,벨기에,2020-11
2020-11-30,216580277,190741899,25838378,스페인,2020-11
2020-11-30,199533949,146123263,53410686,슬로바키아,2020-11
2020-11-30,183091082,65253,183025829,마샬군도,2020-11
2020-11-30,181878496,701,181877795,버뮤다,2020-11
2020-11-30,163394683,133699,163260984,라이베리아,2020-11
2020-11-30,153533114,67775812,85757302,이스라엘,2020-11
2020-11-30,122378969,268583518,-146204549,칠레,2020-11
2020-11-30,116143452,151545577,-35402125,스웨덴,2020-11
2020-11-30,116142855,92641048,23501807,뉴질랜드,2020-11
2020-11-30,115875050,7240449,108634601,이집트,2020-11
2020-11-30,105914427,281433958,-175519531,이라크,2020-11
2020-11-30,104725594,17194938,87530656,파키스탄,2020-11
2020-11-30,101505182,153656117,-52150935,오스트리아,2020-11
2020-11-30,88292244,1629585,86662659,우즈베키스탄,2020-11
2020-11-30,82989839,2357810,80632029,토고,2020-11
2020-11-30,79745675,25035004,54710671,방글라데시,2020-11
2020-11-30,74578365,10069843,64508522,슬로베니아,2020-11
2020-11-30,66297075,271954402,-205657327,스위스,2020-11
2020-11-30,65229271,5693282,59535989,에쿠아도르,2020-11
2020-11-30,61190304,29090259,32100045,미얀마,2020-11
2020-11-30,60781907,189054441,-128272534,남아프리카공화국,2020-11
2020-11-30,53158207,124960049,-71801842,아일랜드,2020-11
2020-11-30,50431258,24787119,25644139,캄보디아,2020-11
2020-11-30,49562722,39622278,9940444,콜롬비아,2020-11
2020-11-30,49218444,7720341,41498103,요르단,2020-11
2020-11-30,47274817,56090662,-8815845,카자흐스탄,2020-11
2020-11-30,45161118,34725212,10435906,포루투갈,2020-11
2020-11-30,43537255,33366582,10170673,파나마,2020-11
2020-11-30,43047451,23936619,19110832,푸에르토리코,2020-11
2020-11-30,41970159,45050414,-3080255,나이지리아,2020-11
2020-11-30,41910181,210360823,-168450642,페루,2020-11
2020-11-30,36854456,32233670,4620786,우크라이나,2020-11
2020-11-30,35601491,3061148,32540343,케냐,2020-11
2020-11-30,34887328,220229380,-185342052,노르웨이,2020-11
2020-11-30,34194628,40019726,-5825098,루마니아,2020-11
2020-11-30,31556716,111401802,-79845086,아르헨티나,2020-11
2020-11-30,30593015,557771520,-527178505,카타르,2020-11
2020-11-30,29817679,73883736,-44066057,덴마크,2020-11
2020-11-30,28035022,5265090,22769932,세르비아,2020-11
2020-11-30,26896064,13555836,13340228,바레인,2020-11
2020-11-30,25831077,1432876,24398201,크로아티아,2020-11
2020-11-30,25335296,481700,24853596,리비아,2020-11
2020-11-30,25288997,150296286,-125007289,오만,2020-11
2020-11-30,25102570,370515126,-345412556,쿠웨이트,2020-11
2020-11-30,24931122,16765867,8165255,모로코,2020-11
2020-11-30,24879550,2194917,22684633,몽골,2020-11
2020-11-30,20882992,764693,20118299,이란,2020-11
2020-11-30,20218923,66266767,-46047844,그리스,2020-11
2020-11-30,19152390,81545824,-62393434,핀란드,2020-11
2020-11-30,18951015,6318480,12632535,리투아니아,2020-11
2020-11-30,18692580,2474413,16218167,엘살바도르,2020-11
2020-11-30,18659197,6522281,12136916,과테말라,2020-11
2020-11-30,18247340,25405043,-7157703,알제리,2020-11
2020-11-30,18083781,1580982,16502799,가나,2020-11
2020-11-30,18064659,6729063,11335596,스리랑카,2020-11
2020-11-30,16588499,6432148,10156351,도미니카 공화국,2020-11
2020-11-30,16033088,1059952,14973136,코트디봐르,2020-11
2020-11-30,15718750,30924076,-15205326,앙골라,2020-11
2020-11-30,14919834,18447842,-3528008,불가리아,2020-11
2020-11-30,14685407,265237,14420170,괌,2020-11
2020-11-30,12868713,15837013,-2968300,튀니지,2020-11
2020-11-30,12611488,50738956,-38127468,모잠비크,2020-11
2020-11-30,11036890,1302070,9734820,탄자니아,2020-11
2020-11-30,10430271,5055498,5374773,피지,2020-11
2020-11-30,10139076,10251731,-112655,코스타리카,2020-11
2020-11-30,8843139,1079561,7763578,조지아,2020-11
2020-11-30,8682723,1022262,7660461,레바논,2020-11
2020-11-30,8668165,3435053,5233112,예맨,2020-11
2020-11-30,8552897,12853588,-4300691,우루과이,2020-11
2020-11-30,8384674,5888067,2496607,에티오피아,2020-11
2020-11-30,8217195,223928,7993267,수단,2020-11
2020-11-30,7900431,1966386,5934045,온두라스,2020-11
2020-11-30,7794658,154328,7640330,콩고,2020-11
2020-11-30,7591660,1161774,6429886,니카라과,2020-11
2020-11-30,6957581,268402,6689179,키르기스스탄,2020-11
2020-11-30,6945602,2489946,4455656,브루나이,2020-11
2020-11-30,6798818,336022,6462796,네팔,2020-11
2020-11-30,6697518,2173102,4524416,파라과이,2020-11
2020-11-30,5466508,9967236,-4500728,에스토니아,2020-11
2020-11-30,5406807,3263827,2142980,라오스,2020-11
2020-11-30,5372271,411006,4961265,아제르바이잔,2020-11
2020-11-30,4932154,3185,4928969,시리아,2020-11
2020-11-30,4571017,0,4571017,팔레스타인 해방기구,2020-11
2020-11-30,4092414,7055661,-2963247,라트비아,2020-11
2020-11-30,4007512,4083858,-76346,벨라루스,2020-11
2020-11-30,3909348,6284341,-2374993,트리니다드 토바고,2020-11
2020-11-30,3872415,54880263,-51007848,콩고민주공화국,2020-11
2020-11-30,3835936,1488279,2347657,마다카스카르,2020-11
2020-11-30,3761063,2044923,1716140,세네갈,2020-11
2020-11-30,3724809,5131,3719678,타지크,2020-11
2020-11-30,3659156,964568,2694588,알바니아,2020-11
2020-11-30,3481826,129143,3352683,가이아나,2020-11
2020-11-30,3360346,73860971,-70500625,파푸아 뉴기니,2020-11
2020-11-30,2952234,6313,2945921,아프카니스탄,2020-11
2020-11-30,2913031,291217,2621814,지부티,2020-11
2020-11-30,2685362,483012,2202350,아이티,2020-11
2020-11-30,2638354,2581274,57080,아르메니아,2020-11
2020-11-30,2605938,18542495,-15936557,뉴 칼레도니아,2020-11
2020-11-30,2528032,381280,2146752,모리셔스,2020-11
2020-11-30,2517419,584235,1933184,사이프러스,2020-11
2020-11-30,2258133,171851,2086282,사모아,2020-11
2020-11-30,2170232,1015388,1154844,잠비아,2020-11
2020-11-30,2158147,74707,2083440,마카오,2020-11
2020-11-30,2076948,0,2076948,부탄,2020-11
2020-11-30,2070251,2305496,-235245,몰도바,2020-11
2020-11-30,2056023,1194,2054829,투르크멘,2020-11
2020-11-30,2052620,23957843,-21905223,볼리비아,2020-11
2020-11-30,2033408,502425,1530983,짐바브웨,2020-11
2020-11-30,2008181,115854,1892327,카메룬,2020-11
2020-11-30,1991337,265596,1725741,나미비아,2020-11
2020-11-30,1911822,50664,1861158,불령 폴리네시아,2020-11
2020-11-30,1900900,102332,1798568,북마리아나 군도,2020-11
2020-11-30,1745023,28555,1716468,르완다,2020-11
2020-11-30,1715268,2513590,-798322,보스니아-헤르체고비나,2020-11
2020-11-30,1712804,103784,1609020,말라위,2020-11
2020-11-30,1667452,329931558,-328264106,기타국,2020-11
2020-11-30,1624764,1572282,52482,우간다,2020-11
2020-11-30,1569602,2320023,-750421,기니,2020-11
2020-11-30,1558789,545348,1013441,아이슬란드,2020-11
2020-11-30,1523680,0,1523680,몰디브,2020-11
2020-11-30,1492366,1535,1490831,부르키나 파소,2020-11
2020-11-30,1414145,1018606,395539,키리바티,2020-11
2020-11-30,1322512,776111,546401,리히텐슈타인,2020-11
2020-11-30,1216552,43273,1173279,아메리칸 사모아,2020-11
2020-11-30,1179893,474690,705203,자마이카,2020-11
2020-11-30,1114076,0,1114076,베닝,2020-11
2020-11-30,1102119,0,1102119,세인트 마틴,2020-11
2020-11-30,1084619,4979351,-3894732,룩셈부르그,2020-11
2020-11-30,1055249,0,1055249,마티니크,2020-11
2020-11-30,984910,15416,969494,불령 리유니온 코모도 제도,2020-11
2020-11-30,978152,836155,141997,바누아투,2020-11
2020-11-30,793545,1564684,-771139,베네주엘라,2020-11
2020-11-30,594272,396098,198174,소말리아,2020-11
2020-11-30,580913,2280758,-1699845,마세도니아,2020-11
2020-11-30,557891,333579,224312,수리남,2020-11
2020-11-30,508740,0,508740,큐라소,2020-11
2020-11-30,478158,52652,425506,마이크로네시아,2020-11
2020-11-30,466780,124945,341835,쿠바,2020-11
2020-11-30,449288,4333306,-3884018,모리타니,2020-11
2020-11-30,441660,0,441660,지브랄타,2020-11
2020-11-30,427192,335921,91271,세이쉘,2020-11
2020-11-30,424427,3887,420540,말리,2020-11
2020-11-30,373309,0,373309,팔라우,2020-11
2020-11-30,368048,292832,75216,가봉,2020-11
2020-11-30,364907,1652278,-1287371,솔로몬 군도,2020-11
2020-11-30,349274,150731,198543,중앙아프리카공화국,2020-11
2020-11-30,347714,158695,189019,벨리제,2020-11
2020-11-30,273888,20154,253734,도미니카,2020-11
2020-11-30,240760,121038,119722,감비아,2020-11
2020-11-30,226789,0,226789,메요트,2020-11
2020-11-30,223424,0,223424,과델로프,2020-11
2020-11-30,216524,4006,212518,바하마,2020-11
2020-11-30,208268,0,208268,적도 기니,2020-11
2020-11-30,169220,690,168530,안티가 바부다,2020-11
2020-11-30,168193,19003,149190,세인트 루시아,2020-11
2020-11-30,156673,0,156673,그레나다,2020-11
2020-11-30,149942,49187,100755,바베이도스,2020-11
2020-11-30,144978,421022,-276044,시에라 리온,2020-11
2020-11-30,100034,0,100034,남조지아 & 남샌드위치 군도,2020-11
2020-11-30,95452,9288776,-9193324,에리트리아,2020-11
2020-11-30,93460,12,93448,세인트 빈센트 그레나딘,2020-11
2020-11-30,84342,0,84342,불령 가이아나,2020-11
2020-11-30,76967,66842,10125,코모로스,2020-11
2020-11-30,76050,0,76050,영령 캐이맨 군도,2020-11
2020-11-30,73127,194,72933,네덜란드 열도,2020-11
2020-11-30,68225,166556,-98331,스와질랜드,2020-11
2020-11-30,56457,1,56456,부룬디,2020-11
2020-11-30,53838,178022,-124184,몬테네그로,2020-11
2020-11-30,51328,2673,48655,나우루,2020-11
2020-11-30,48777,32011,16766,보츠와나,2020-11
2020-11-30,44251,237215,-192964,티모르,2020-11
2020-11-30,43697,708,42989,아루바,2020-11
2020-11-30,41851,7043,34808,세인트 키츠 네비스,2020-11
2020-11-30,40938,350834,-309896,통가,2020-11
2020-11-30,25150,39468,-14318,레소토,2020-11
2020-11-30,23554,366,23188,코스 군도,2020-11
2020-11-30,21173,6994,14179,미령 버진군도,2020-11
2020-11-30,20887,490,20397,영령 버진군도,2020-11
2020-11-30,15972,344,15628,챠드,2020-11
2020-11-30,8785,708,8077,투르크 & 카이코스 군도,2020-11
2020-11-30,8439,29640,-21201,니제르,2020-11
2020-11-30,6700,112,6588,왈라스 & 퓨투나 군도,2020-11
2020-11-30,5712,68,5644,카보 베르데,2020-11
2020-11-30,3009,2392,617,앙귈라,2020-11
2020-11-30,2763,18394,-15631,안도라,2020-11
2020-11-30,2445,0,2445,세인트 바르탤르미,2020-11
2020-11-30,2400,73110,-70710,산마리노,2020-11
2020-11-30,1890,83034,-81144,모나코,2020-11
2020-11-30,1832,0,1832,투발루,2020-11
2020-11-30,1827,0,1827,쿡 아일랜드,2020-11
2020-11-30,1559,835,724,포클랜드 군도,2020-11
2020-11-30,220,33805,-33585,기네비소,2020-11
2020-11-30,33,0,33,보네르 신트외스타티위스,2020-11
2020-11-30,10,870,-860,마이너 아우틀링 합중국 군도,2020-11
2020-11-30,0,756,-756,세인트 헬레나,2020-11
2020-11-30,0,472,-472,불령 남부지역,2020-11
2020-11-30,0,18354,-18354,건지,2020-11
2020-11-30,0,1273,-1273,영령 인도양,2020-11
2020-11-30,0,127183,-127183,파로에 군도,2020-11
2020-11-30,0,1643,-1643,보빗군도,2020-11
2020-11-30,0,3759,-3759,니우에,2020-11
2020-11-30,0,935,-935,상토메 프린스페,2020-11
2020-11-30,0,505,-505,맨섬,2020-11
2020-12-31,12710301396,10881894969,1828406427,중국,2020-12
2020-12-31,7157647338,4910784135,2246863203,미국,2020-12
2020-12-31,5242213207,1701860561,3540352646,베트남,2020-12
2020-12-31,3102676601,156251064,2946425537,홍콩,2020-12
2020-12-31,2332172653,4710209420,-2378036767,일본,2020-12
2020-12-31,1774431458,1708030439,66401019,대만,2020-12
2020-12-31,1258791319,413849109,844942210,인도,2020-12
2020-12-31,1235324402,82474,1235241928,마샬군도,2020-12
2020-12-31,1123165631,1950186289,-827020658,독일,2020-12
2020-12-31,908472905,769755131,138717774,싱가포르,2020-12
2020-12-31,869425706,590848504,278577202,멕시코,2020-12
2020-12-31,860222124,674551918,185670206,인도네시아,2020-12
2020-12-31,812076987,941416747,-129339760,말레이시아,2020-12
2020-12-31,757190395,895155816,-137965421,러시아 연방,2020-12
2020-12-31,694810115,87880405,606929710,폴란드,2020-12
2020-12-31,677268256,481428917,195839339,태국,2020-12
2020-12-31,610686372,1891324983,-1280638611,호주,2020-12
2020-12-31,507868663,341081695,166786968,필리핀,2020-12
2020-12-31,498458251,389533815,108924436,캐나다,2020-12
2020-12-31,478457034,353387858,125069176,브라질,2020-12
2020-12-31,471653948,138899646,332754302,튀르키예,2020-12
2020-12-31,388531589,795184353,-406652764,네덜란드,2020-12
2020-12-31,362986190,518221483,-155235293,영국,2020-12
2020-12-31,344295766,659193742,-314897976,이탈리아,2020-12
2020-12-31,327334051,142133902,185200149,벨기에,2020-12
2020-12-31,315676636,67839502,247837134,헝가리,2020-12
2020-12-31,276865400,91199649,185665751,체코공화국,2020-12
2020-12-31,274357256,535417905,-261060649,프랑스,2020-12
2020-12-31,269758979,469615343,-199856364,아랍에미리트 연합,2020-12
2020-12-31,256176169,163818010,92358159,슬로바키아,2020-12
2020-12-31,246948187,1631448737,-1384500550,사우디아라비아,2020-12
2020-12-31,214420985,169037956,45383029,스페인,2020-12
2020-12-31,191219284,9538812,181680472,몰타,2020-12
2020-12-31,184402685,1439,184401246,버뮤다,2020-12
2020-12-31,178289117,1518556,176770561,우즈베키스탄,2020-12
2020-12-31,172931404,154015,172777389,라이베리아,2020-12
2020-12-31,151684278,1964625,149719653,파나마,2020-12
2020-12-31,148681773,105027856,43653917,노르웨이,2020-12
2020-12-31,140166111,10782432,129383679,이집트,2020-12
2020-12-31,124700651,14588130,110112521,파키스탄,2020-12
2020-12-31,117026408,359888705,-242862297,칠레,2020-12
2020-12-31,112329528,85853255,26476273,뉴질랜드,2020-12
2020-12-31,111178270,156684128,-45505858,스웨덴,2020-12
2020-12-31,105288524,127020040,-21731516,이스라엘,2020-12
2020-12-31,96704847,26059930,70644917,방글라데시,2020-12
2020-12-31,91934629,170671168,-78736539,오스트리아,2020-12
2020-12-31,91067340,8574901,82492439,슬로베니아,2020-12
2020-12-31,85080111,64652866,20427245,그리스,2020-12
2020-12-31,73256795,190007896,-116751101,남아프리카공화국,2020-12
2020-12-31,71328855,409787360,-338458505,이라크,2020-12
2020-12-31,65840803,280990538,-215149735,스위스,2020-12
2020-12-31,64995461,88833020,-23837559,아일랜드,2020-12
2020-12-31,60290321,60239756,50565,콜롬비아,2020-12
2020-12-31,59789237,26178563,33610674,캄보디아,2020-12
2020-12-31,56149711,23558194,32591517,푸에르토리코,2020-12
2020-12-31,55690654,39292476,16398178,루마니아,2020-12
2020-12-31,53706863,27408190,26298673,미얀마,2020-12
2020-12-31,49275578,260952601,-211677023,페루,2020-12
2020-12-31,48458463,22554088,25904375,우크라이나,2020-12
2020-12-31,48006666,59654603,-11647937,나이지리아,2020-12
2020-12-31,42884311,74145560,-31261249,포루투갈,2020-12
2020-12-31,41311341,1820540,39490801,토고,2020-12
2020-12-31,40682055,69364239,-28682184,핀란드,2020-12
2020-12-31,39745042,602351883,-562606841,카타르,2020-12
2020-12-31,38926533,81064965,-42138432,덴마크,2020-12
2020-12-31,38437921,186426728,-147988807,카자흐스탄,2020-12
2020-12-31,38079169,1063,38078106,바하마,2020-12
2020-12-31,36507788,176636517,-140128729,오만,2020-12
2020-12-31,35719348,475712047,-439992699,쿠웨이트,2020-12
2020-12-31,35362165,4518861,30843304,요르단,2020-12
2020-12-31,34662574,7162370,27500204,에쿠아도르,2020-12
2020-12-31,32957048,116215325,-83258277,아르헨티나,2020-12
2020-12-31,30357318,608618,29748700,리비아,2020-12
2020-12-31,27875447,26976534,898913,알제리,2020-12
2020-12-31,24568804,1918225,22650579,예맨,2020-12
2020-12-31,24516210,2419998,22096212,세네갈,2020-12
2020-12-31,23389491,45855252,-22465761,바레인,2020-12
2020-12-31,22276037,12413499,9862538,세르비아,2020-12
2020-12-31,21163335,18132299,3031036,모로코,2020-12
2020-12-31,20750561,7165398,13585163,스리랑카,2020-12
2020-12-31,20636738,1537814,19098924,몽골,2020-12
2020-12-31,19555359,207957,19347402,이란,2020-12
2020-12-31,18655403,5794102,12861301,과테말라,2020-12
2020-12-31,18465440,15482110,2983330,불가리아,2020-12
2020-12-31,18177032,5957544,12219488,리투아니아,2020-12
2020-12-31,17184876,4420225,12764651,가나,2020-12
2020-12-31,17100410,5813420,11286990,도미니카 공화국,2020-12
2020-12-31,16206618,3581824,12624794,에티오피아,2020-12
2020-12-31,16023604,1278239,14745365,케냐,2020-12
2020-12-31,15251193,504671,14746522,수단,2020-12
2020-12-31,13862952,7965659,5897293,튀니지,2020-12
2020-12-31,13591762,11842506,1749256,에스토니아,2020-12
2020-12-31,12424188,18628526,-6204338,앙골라,2020-12
2020-12-31,12415599,389645,12025954,솔로몬 군도,2020-12
2020-12-31,12014338,1802688,10211650,엘살바도르,2020-12
2020-12-31,11135345,11143334,-7989,코스타리카,2020-12
2020-12-31,10162442,1523032,8639410,조지아,2020-12
2020-12-31,9981304,1391746,8589558,온두라스,2020-12
2020-12-31,9041370,294700,8746670,탄자니아,2020-12
2020-12-31,8840903,651941,8188962,니카라과,2020-12
2020-12-31,8398395,3351078,5047317,우루과이,2020-12
2020-12-31,7982683,265603,7717080,아이티,2020-12
2020-12-31,7550289,671,7549618,말리,2020-12
2020-12-31,7510260,10207137,-2696877,파라과이,2020-12
2020-12-31,7007090,348696,6658394,네팔,2020-12
2020-12-31,6982547,1629275,5353272,크로아티아,2020-12
2020-12-31,6775291,42850504,-36075213,콩고민주공화국,2020-12
2020-12-31,6580123,2678920,3901203,레바논,2020-12
2020-12-31,6406867,273112,6133755,코트디봐르,2020-12
2020-12-31,6321449,398915,5922534,아제르바이잔,2020-12
2020-12-31,6269786,46755,6223031,키르기스스탄,2020-12
2020-12-31,5505519,78365069,-72859550,파푸아 뉴기니,2020-12
2020-12-31,5042683,2399983,2642700,카메룬,2020-12
2020-12-31,5023811,6835187,-1811376,라트비아,2020-12
2020-12-31,5001870,77836,4924034,보츠와나,2020-12
2020-12-31,4960943,230112,4730831,괌,2020-12
2020-12-31,4690824,1447101,3243723,모잠비크,2020-12
2020-12-31,4650972,29741541,-25090569,트리니다드 토바고,2020-12
2020-12-31,4564539,4735448,-170909,벨라루스,2020-12
2020-12-31,4079718,3461,4076257,부르키나 파소,2020-12
2020-12-31,3883398,3568578,314820,라오스,2020-12
2020-12-31,3879346,2876,3876470,시리아,2020-12
2020-12-31,3851700,0,3851700,타지크,2020-12
2020-12-31,3832458,96142,3736316,말라위,2020-12
2020-12-31,3809495,408490,3401005,알바니아,2020-12
2020-12-31,3419430,1759377,1660053,브루나이,2020-12
2020-12-31,3309835,32844,3276991,자마이카,2020-12
2020-12-31,3140515,26749293,-23608778,기니,2020-12
2020-12-31,3063873,117014,2946859,사모아,2020-12
2020-12-31,2964566,34037156,-31072590,뉴 칼레도니아,2020-12
2020-12-31,2809486,249509,2559977,콩고,2020-12
2020-12-31,2600566,56060,2544506,팔레스타인 해방기구,2020-12
2020-12-31,2342986,481675,1861311,모리셔스,2020-12
2020-12-31,2221269,352758,1868511,세이쉘,2020-12
2020-12-31,2165455,592617,1572838,사이프러스,2020-12
2020-12-31,2126451,948,2125503,투르크멘,2020-12
2020-12-31,2078182,68476,2009706,마카오,2020-12
2020-12-31,2069650,240640,1829010,지부티,2020-12
2020-12-31,2043496,4177415,-2133919,룩셈부르그,2020-12
2020-12-31,1983240,2865820,-882580,아르메니아,2020-12
2020-12-31,1921037,1727763,193274,몰도바,2020-12
2020-12-31,1824818,48,1824770,부탄,2020-12
2020-12-31,1753897,396665,1357232,르완다,2020-12
2020-12-31,1740293,40043754,-38303461,볼리비아,2020-12
2020-12-31,1714645,0,1714645,마티니크,2020-12
2020-12-31,1705188,418051,1287137,짐바브웨,2020-12
2020-12-31,1593277,478484,1114793,우간다,2020-12
2020-12-31,1540211,1027942,512269,피지,2020-12
2020-12-31,1530299,327239390,-325709091,기타국,2020-12
2020-12-31,1474382,92867,1381515,아프카니스탄,2020-12
2020-12-31,1380971,99807,1281164,가이아나,2020-12
2020-12-31,1372864,658429,714435,마다카스카르,2020-12
2020-12-31,1258538,108305,1150233,과델로프,2020-12
2020-12-31,1245698,161115,1084583,소말리아,2020-12
2020-12-31,1218244,1034362,183882,리히텐슈타인,2020-12
2020-12-31,1113310,46312,1066998,불령 폴리네시아,2020-12
2020-12-31,1079568,80900,998668,북마리아나 군도,2020-12
2020-12-31,1079080,30896,1048184,니제르,2020-12
2020-12-31,996081,2561,993520,불령 리유니온 코모도 제도,2020-12
2020-12-31,935640,3792235,-2856595,잠비아,2020-12
2020-12-31,815848,2526346,-1710498,보스니아-헤르체고비나,2020-12
2020-12-31,780701,2498009,-1717308,베네주엘라,2020-12
2020-12-31,769397,884437,-115040,마세도니아,2020-12
2020-12-31,725268,26882,698386,베닝,2020-12
2020-12-31,619544,0,619544,마이크로네시아,2020-12
2020-12-31,575515,209,575306,불령 가이아나,2020-12
2020-12-31,560121,0,560121,세인트 마틴,2020-12
2020-12-31,515213,27935,487278,키리바티,2020-12
2020-12-31,503007,342470,160537,쿠바,2020-12
2020-12-31,485455,2462,482993,도미니카,2020-12
2020-12-31,468701,26370613,-25901912,적도 기니,2020-12
2020-12-31,422694,9475823,-9053129,가봉,2020-12
2020-12-31,416870,112949,303921,바베이도스,2020-12
2020-12-31,413913,0,413913,세인트 루시아,2020-12
2020-12-31,386007,0,386007,큐라소,2020-12
2020-12-31,385056,1795471,-1410415,시에라 리온,2020-12
2020-12-31,375689,1759302,-1383613,모리타니,2020-12
2020-12-31,372691,69687,303004,아메리칸 사모아,2020-12
2020-12-31,361949,7836,354113,몰디브,2020-12
2020-12-31,337762,121,337641,나우루,2020-12
2020-12-31,303686,418250,-114564,아이슬란드,2020-12
2020-12-31,294120,1526618,-1232498,나미비아,2020-12
2020-12-31,286566,638,285928,챠드,2020-12
2020-12-31,269754,124020,145734,감비아,2020-12
2020-12-31,250896,0,250896,영령 캐이맨 군도,2020-12
2020-12-31,249958,2019480,-1769522,바누아투,2020-12
2020-12-31,215334,40160535,-39945201,아루바,2020-12
2020-12-31,212629,23372,189257,벨리제,2020-12
2020-12-31,181747,0,181747,에리트리아,2020-12
2020-12-31,166388,16,166372,카보 베르데,2020-12
2020-12-31,164528,1565885,-1401357,수리남,2020-12
2020-12-31,161552,27487,134065,팔라우,2020-12
2020-12-31,136905,0,136905,그레나다,2020-12
2020-12-31,133868,76003,57865,부룬디,2020-12
2020-12-31,103683,10324,93359,스와질랜드,2020-12
2020-12-31,97315,0,97315,남수단,2020-12
2020-12-31,83522,600,82922,지브랄타,2020-12
2020-12-31,81972,2742398,-2660426,몬테네그로,2020-12
2020-12-31,77988,2574,75414,안티가 바부다,2020-12
2020-12-31,71071,27345364,-27274293,티모르,2020-12
2020-12-31,44275,0,44275,영령 버진군도,2020-12
2020-12-31,36263,0,36263,세인트 빈센트 그레나딘,2020-12
2020-12-31,27041,2159,24882,네덜란드 열도,2020-12
2020-12-31,23176,4733,18443,투발루,2020-12
2020-12-31,20185,30347,-10162,모나코,2020-12
2020-12-31,12264,106,12158,중앙아프리카공화국,2020-12
2020-12-31,8590,5096,3494,레소토,2020-12
2020-12-31,5448,31349,-25901,코모로스,2020-12
2020-12-31,3916,113,3803,세인트 키츠 네비스,2020-12
2020-12-31,3644,0,3644,세인트 바르탤르미,2020-12
2020-12-31,3025,299253,-296228,파로에 군도,2020-12
2020-12-31,2400,647646,-645246,산마리노,2020-12
2020-12-31,1302,13931,-12629,안도라,2020-12
2020-12-31,950,257140,-256190,기네비소,2020-12
2020-12-31,720,4025,-3305,미령 버진군도,2020-12
2020-12-31,626,0,626,저어지,2020-12
2020-12-31,514,2702,-2188,보네르 신트외스타티위스,2020-12
2020-12-31,492,0,492,맨섬,2020-12
2020-12-31,302,14494,-14192,건지,2020-12
2020-12-31,265,0,265,세인트마틴(생마르탱),2020-12
2020-12-31,160,3094,-2934,상토메 프린스페,2020-12
2020-12-31,148,488,-340,앙귈라,2020-12
2020-12-31,0,966,-966,안타티카,2020-12
2020-12-31,0,280,-280,토켈라우,2020-12
2020-12-31,0,59,-59,마이너 아우틀링 합중국 군도,2020-12
2020-12-31,0,594054,-594054,통가,2020-12
2020-12-31,0,503,-503,몬트세라트,2020-12
2020-12-31,0,349,-349,보빗군도,2020-12
2020-12-31,0,274,-274,포클랜드 군도,2020-12
2020-12-31,0,6647,-6647,니우에,2020-12
2020-12-31,0,235,-235,투르크 & 카이코스 군도,2020-12
2020-12-31,0,371,-371,세인트 헬레나,2020-12
2020-12-31,0,113452,-113452,자이르,2020-12
2021-01-31,11787036611,10763267560,1023769051,중국,2021-01
2021-01-31,8412354594,5018161658,3394192936,미국,2021-01
2021-01-31,4642317898,2035501071,2606816827,베트남,2021-01
2021-01-31,2441564805,237068899,2204495906,홍콩,2021-01
2021-01-31,2237046015,3947394976,-1710348961,일본,2021-01
2021-01-31,1597108081,1782007168,-184899087,대만,2021-01
2021-01-31,1271503385,560709442,710793943,인도,2021-01
2021-01-31,1045344176,1577173173,-531828997,독일,2021-01
2021-01-31,808676179,594801448,213874731,멕시코,2021-01
2021-01-31,720599887,280756761,439843126,필리핀,2021-01
2021-01-31,666383759,1001029597,-334645838,러시아 연방,2021-01
2021-01-31,651387260,455622837,195764423,태국,2021-01
2021-01-31,640336981,715622703,-75285722,말레이시아,2021-01
2021-01-31,630651505,1023343407,-392691902,싱가포르,2021-01
2021-01-31,621424691,1827010231,-1205585540,호주,2021-01
2021-01-31,563976799,724585948,-160609149,인도네시아,2021-01
2021-01-31,539440022,20241,539419781,마샬군도,2021-01
2021-01-31,535344467,79804709,455539758,폴란드,2021-01
2021-01-31,514733813,378747536,135986277,캐나다,2021-01
2021-01-31,476254317,117021566,359232751,튀르키예,2021-01
2021-01-31,440973138,486412935,-45439797,브라질,2021-01
2021-01-31,414097692,539259801,-125162109,영국,2021-01
2021-01-31,395533150,826998363,-431465213,네덜란드,2021-01
2021-01-31,383709039,141573321,242135718,벨기에,2021-01
2021-01-31,338750157,143415,338606742,라이베리아,2021-01
2021-01-31,308971028,590851052,-281880024,이탈리아,2021-01
2021-01-31,279231273,465159400,-185928127,프랑스,2021-01
2021-01-31,274996916,453657406,-178660490,아랍에미리트 연합,2021-01
2021-01-31,261036214,44790252,216245962,헝가리,2021-01
2021-01-31,247656354,4552179,243104175,몰타,2021-01
2021-01-31,228630650,80402316,148228334,체코공화국,2021-01
2021-01-31,227812404,1302923974,-1075111570,사우디아라비아,2021-01
2021-01-31,225463416,166358484,59104932,스페인,2021-01
2021-01-31,223707846,62873679,160834167,슬로바키아,2021-01
2021-01-31,151875108,167968637,-16093529,스웨덴,2021-01
2021-01-31,132973411,114149277,18824134,뉴질랜드,2021-01
2021-01-31,131258787,215973063,-84714276,이스라엘,2021-01
2021-01-31,124475243,14243835,110231408,파키스탄,2021-01
2021-01-31,122048578,38725197,83323381,이집트,2021-01
2021-01-31,118623944,1428696,117195248,우즈베키스탄,2021-01
2021-01-31,107316668,452839163,-345522495,칠레,2021-01
2021-01-31,104649428,237927502,-133278074,노르웨이,2021-01
2021-01-31,102000929,37439369,64561560,방글라데시,2021-01
2021-01-31,99440554,168772211,-69331657,오스트리아,2021-01
2021-01-31,91603405,7234804,84368601,슬로베니아,2021-01
2021-01-31,85763698,161377653,-75613955,남아프리카공화국,2021-01
2021-01-31,70310041,458483641,-388173600,이라크,2021-01
2021-01-31,63134672,93468839,-30334167,아일랜드,2021-01
2021-01-31,56972465,19813734,37158731,콜롬비아,2021-01
2021-01-31,53367791,272168956,-218801165,스위스,2021-01
2021-01-31,52264187,32699285,19564902,캄보디아,2021-01
2021-01-31,50617764,32972816,17644948,미얀마,2021-01
2021-01-31,48029929,30004600,18025329,포루투갈,2021-01
2021-01-31,46672701,333653891,-286981190,페루,2021-01
2021-01-31,46512787,571632119,-525119332,쿠웨이트,2021-01
2021-01-31,43976667,9641062,34335605,우크라이나,2021-01
2021-01-31,43817220,30276828,13540392,루마니아,2021-01
2021-01-31,43348595,98314544,-54965949,나이지리아,2021-01
2021-01-31,41674973,51305546,-9630573,파나마,2021-01
2021-01-31,40001209,6032993,33968216,요르단,2021-01
2021-01-31,39816486,74027625,-34211139,덴마크,2021-01
2021-01-31,38812841,937222552,-898409711,카타르,2021-01
2021-01-31,37157092,22,37157070,영령 캐이맨 군도,2021-01
2021-01-31,32801602,7846364,24955238,에쿠아도르,2021-01
2021-01-31,32712969,222717775,-190004806,카자흐스탄,2021-01
2021-01-31,29896069,68155787,-38259718,핀란드,2021-01
2021-01-31,25445702,86619582,-61173880,아르헨티나,2021-01
2021-01-31,24630460,184552237,-159921777,오만,2021-01
2021-01-31,23559602,53666386,-30106784,바레인,2021-01
2021-01-31,22637863,361122,22276741,리비아,2021-01
2021-01-31,22603292,6404559,16198733,도미니카 공화국,2021-01
2021-01-31,21604817,97969931,-76365114,그리스,2021-01
2021-01-31,21426724,1272348,20154376,가나,2021-01
2021-01-31,21170926,3626031,17544895,케냐,2021-01
2021-01-31,20268294,14384767,5883527,스리랑카,2021-01
2021-01-31,19420189,14160728,5259461,모로코,2021-01
2021-01-31,17807030,1889553,15917477,몽골,2021-01
2021-01-31,17416534,30165136,-12748602,푸에르토리코,2021-01
2021-01-31,17080713,7848536,9232177,리투아니아,2021-01
2021-01-31,16858380,7636123,9222257,과테말라,2021-01
2021-01-31,16156142,23313607,-7157465,불가리아,2021-01
2021-01-31,15735344,13762510,1972834,세르비아,2021-01
2021-01-31,15545585,79150531,-63604946,알제리,2021-01
2021-01-31,13827388,7148663,6678725,튀니지,2021-01
2021-01-31,13517739,2218222,11299517,엘살바도르,2021-01
2021-01-31,12160708,1411273,10749435,레바논,2021-01
2021-01-31,11742010,925727,10816283,수단,2021-01
2021-01-31,11470252,3461150,8009102,에티오피아,2021-01
2021-01-31,10373186,1287612,9085574,크로아티아,2021-01
2021-01-31,10253530,491525,9762005,이란,2021-01
2021-01-31,8787480,1168647,7618833,온두라스,2021-01
2021-01-31,8729683,8924974,-195291,우루과이,2021-01
2021-01-31,8614393,9958601,-1344208,코스타리카,2021-01
2021-01-31,8587295,6445042,2142253,탄자니아,2021-01
2021-01-31,8513408,449708,8063700,코트디봐르,2021-01
2021-01-31,8262067,7956013,306054,에스토니아,2021-01
2021-01-31,7515812,272061,7243751,아이티,2021-01
2021-01-31,6925752,1409654,5516098,조지아,2021-01
2021-01-31,6684072,2515156,4168916,예맨,2021-01
2021-01-31,6669505,683677,5985828,니카라과,2021-01
2021-01-31,6555554,1671944,4883610,세네갈,2021-01
2021-01-31,6537111,24757,6512354,키르기스스탄,2021-01
2021-01-31,5233900,195921,5037979,괌,2021-01
2021-01-31,4890577,581968,4308609,모리셔스,2021-01
2021-01-31,4841393,7645667,-2804274,파라과이,2021-01
2021-01-31,4700202,15197,4685005,불령 리유니온 코모도 제도,2021-01
2021-01-31,4596441,11052278,-6455837,볼리비아,2021-01
2021-01-31,4329802,19924551,-15594749,트리니다드 토바고,2021-01
2021-01-31,4195306,23267182,-19071876,모잠비크,2021-01
2021-01-31,3718967,4959,3714008,사모아,2021-01
2021-01-31,3696214,2957675,738539,벨라루스,2021-01
2021-01-31,3564806,241422,3323384,팔레스타인 해방기구,2021-01
2021-01-31,3535768,7575663,-4039895,라트비아,2021-01
2021-01-31,3422163,83209,3338954,아프카니스탄,2021-01
2021-01-31,3354134,14402,3339732,세인트 키츠 네비스,2021-01
2021-01-31,3287986,10173665,-6885679,기니,2021-01
2021-01-31,3260524,0,3260524,아제르바이잔,2021-01
2021-01-31,3152319,4832755,-1680436,라오스,2021-01
2021-01-31,2984334,12,2984322,부르키나 파소,2021-01
2021-01-31,2900626,13430,2887196,타지크,2021-01
2021-01-31,2887242,265852577,-262965335,기타국,2021-01
2021-01-31,2834712,688778,2145934,아이슬란드,2021-01
2021-01-31,2808965,4005,2804960,시리아,2021-01
2021-01-31,2718549,679690,2038859,사이프러스,2021-01
2021-01-31,2658062,202996,2455066,브루나이,2021-01
2021-01-31,2543738,44337,2499401,카메룬,2021-01
2021-01-31,2498717,843967,1654750,파푸아 뉴기니,2021-01
2021-01-31,2247079,872003,1375076,짐바브웨,2021-01
2021-01-31,2138764,1046618,1092146,마다카스카르,2021-01
2021-01-31,2072903,0,2072903,가이아나,2021-01
2021-01-31,2067583,214147,1853436,앙골라,2021-01
2021-01-31,1963761,619537,1344224,알바니아,2021-01
2021-01-31,1952998,738794,1214204,콩고,2021-01
2021-01-31,1952992,152801,1800191,네팔,2021-01
2021-01-31,1950207,48625471,-46675264,콩고민주공화국,2021-01
2021-01-31,1911875,0,1911875,투르크멘,2021-01
2021-01-31,1907770,3554848,-1647078,룩셈부르그,2021-01
2021-01-31,1861820,185851,1675969,자마이카,2021-01
2021-01-31,1821071,8873132,-7052061,잠비아,2021-01
2021-01-31,1725837,134825,1591012,마카오,2021-01
2021-01-31,1536747,110837,1425910,지부티,2021-01
2021-01-31,1473046,43813540,-42340494,아루바,2021-01
2021-01-31,1422300,21936,1400364,피지,2021-01
2021-01-31,1403643,1668480,-264837,토고,2021-01
2021-01-31,1367971,119110,1248861,북마리아나 군도,2021-01
2021-01-31,1366750,3736,1363014,레소토,2021-01
2021-01-31,1361725,10661607,-9299882,뉴 칼레도니아,2021-01
2021-01-31,1341180,6446,1334734,르완다,2021-01
2021-01-31,1313817,0,1313817,과델로프,2021-01
2021-01-31,1296361,1994014,-697653,아르메니아,2021-01
2021-01-31,1286752,149375,1137377,마세도니아,2021-01
2021-01-31,1267077,1663676,-396599,베네주엘라,2021-01
2021-01-31,1142458,0,1142458,부탄,2021-01
2021-01-31,1136074,77228,1058846,우간다,2021-01
2021-01-31,1114024,1244901,-130877,몰도바,2021-01
2021-01-31,1072532,3827,1068705,마티니크,2021-01
2021-01-31,1024079,288114,735965,세이쉘,2021-01
2021-01-31,948619,1191933,-243314,리히텐슈타인,2021-01
2021-01-31,945093,3680538,-2735445,가봉,2021-01
2021-01-31,942830,376426,566404,소말리아,2021-01
2021-01-31,938317,36138,902179,베닝,2021-01
2021-01-31,915155,96872,818283,불령 폴리네시아,2021-01
2021-01-31,770494,229140,541354,아메리칸 사모아,2021-01
2021-01-31,743621,1871624,-1128003,보스니아-헤르체고비나,2021-01
2021-01-31,656014,5034,650980,니제르,2021-01
2021-01-31,637563,938,636625,팔라우,2021-01
2021-01-31,603281,654,602627,몰디브,2021-01
2021-01-31,557783,57,557726,말리,2021-01
2021-01-31,532374,400,531974,버뮤다,2021-01
2021-01-31,511647,1538010,-1026363,모리타니,2021-01
2021-01-31,474630,230126,244504,수리남,2021-01
2021-01-31,457767,363637,94130,말라위,2021-01
2021-01-31,444228,0,444228,안티가 바부다,2021-01
2021-01-31,438410,0,438410,불령 가이아나,2021-01
2021-01-31,434586,246,434340,마이크로네시아,2021-01
2021-01-31,369061,602383,-233322,쿠바,2021-01
2021-01-31,363336,3829,359507,바하마,2021-01
2021-01-31,351161,196256,154905,감비아,2021-01
2021-01-31,313250,1932480,-1619230,솔로몬 군도,2021-01
2021-01-31,296618,177170,119448,시에라 리온,2021-01
2021-01-31,294286,10770,283516,몬테네그로,2021-01
2021-01-31,262906,0,262906,세인트 마틴,2021-01
2021-01-31,249113,179757,69356,바베이도스,2021-01
2021-01-31,233499,0,233499,지브랄타,2021-01
2021-01-31,232117,22749,209368,보츠와나,2021-01
2021-01-31,203631,0,203631,에리트리아,2021-01
2021-01-31,202807,0,202807,키리바티,2021-01
2021-01-31,202108,0,202108,티모르,2021-01
2021-01-31,180721,0,180721,남수단,2021-01
2021-01-31,180486,4512,175974,도미니카,2021-01
2021-01-31,169854,219,169635,앙귈라,2021-01
2021-01-31,164863,0,164863,큐라소,2021-01
2021-01-31,163519,1286502,-1122983,바누아투,2021-01
2021-01-31,160639,91,160548,세인트 루시아,2021-01
2021-01-31,119671,36,119635,벨리제,2021-01
2021-01-31,116496,1246,115250,부룬디,2021-01
2021-01-31,107319,34373,72946,코모로스,2021-01
2021-01-31,98845,0,98845,그레나다,2021-01
2021-01-31,89429,32472,56957,스와질랜드,2021-01
2021-01-31,86736,290284,-203548,나미비아,2021-01
2021-01-31,85192,190,85002,영령 인도양,2021-01
2021-01-31,84192,720,83472,카보 베르데,2021-01
2021-01-31,82901,0,82901,메요트,2021-01
2021-01-31,80720,382864,-302144,기네비소,2021-01
2021-01-31,68962,207,68755,투르크 & 카이코스 군도,2021-01
2021-01-31,53766,0,53766,영령 버진군도,2021-01
2021-01-31,46000,0,46000,투발루,2021-01
2021-01-31,19667,0,19667,보네르 신트외스타티위스,2021-01
2021-01-31,17625,1170489,-1152864,산마리노,2021-01
2021-01-31,14710,2559,12151,네덜란드 열도,2021-01
2021-01-31,12870,0,12870,중앙아프리카공화국,2021-01
2021-01-31,12439,0,12439,왈라스 & 퓨투나 군도,2021-01
2021-01-31,12324,85616,-73292,통가,2021-01
2021-01-31,12032,0,12032,상토메 프린스페,2021-01
2021-01-31,3150,60139,-56989,모나코,2021-01
2021-01-31,2607,144,2463,포클랜드 군도,2021-01
2021-01-31,1582,0,1582,세인트 바르탤르미,2021-01
2021-01-31,1185,0,1185,나우루,2021-01
2021-01-31,875,0,875,적도 기니,2021-01
2021-01-31,681,22626,-21945,안도라,2021-01
2021-01-31,613,0,613,남조지아 & 남샌드위치 군도,2021-01
2021-01-31,430,811,-381,챠드,2021-01
2021-01-31,395,17280628,-17280233,미령 버진군도,2021-01
2021-01-31,325,188,137,그린랜드,2021-01
2021-01-31,30,20928,-20898,건지,2021-01
2021-01-31,21,0,21,저어지,2021-01
2021-01-31,0,6787,-6787,안타티카,2021-01
2021-01-31,0,2928,-2928,세인트 헬레나,2021-01
2021-01-31,0,16,-16,마이너 아우틀링 합중국 군도,2021-01
2021-01-31,0,873,-873,불령 남부지역,2021-01
2021-01-31,0,5945,-5945,니우에,2021-01
2021-01-31,0,3381,-3381,피트카이른,2021-01
2021-01-31,0,150,-150,맨섬,2021-01
2021-01-31,0,299759,-299759,파로에 군도,2021-01
2021-01-31,0,2078,-2078,몬트세라트,2021-01
2021-02-28,11208799453,9021940648,2186858805,중국,2021-02
2021-02-28,6396234633,5761027567,635207066,미국,2021-02
2021-02-28,3907994035,1692219064,2215774971,베트남,2021-02
2021-02-28,2516268543,160001247,2356267296,홍콩,2021-02
2021-02-28,2191909157,4116807325,-1924898168,일본,2021-02
2021-02-28,1677060038,1768674041,-91614003,대만,2021-02
2021-02-28,1286165219,466758578,819406641,인도,2021-02
2021-02-28,1031447260,1436168060,-404720800,독일,2021-02
2021-02-28,782957030,537382681,245574349,멕시코,2021-02
2021-02-28,719891907,784989454,-65097547,말레이시아,2021-02
2021-02-28,698978535,762985838,-64007303,싱가포르,2021-02
2021-02-28,665404488,879840512,-214436024,러시아 연방,2021-02
2021-02-28,642186225,495970717,146215508,태국,2021-02
2021-02-28,625420050,2217455727,-1592035677,호주,2021-02
2021-02-28,608588098,746845679,-138257581,인도네시아,2021-02
2021-02-28,584815914,246998887,337817027,필리핀,2021-02
2021-02-28,572409368,422395125,150014243,캐나다,2021-02
2021-02-28,543524358,71297399,472226959,폴란드,2021-02
2021-02-28,494883763,58307726,436576037,튀르키예,2021-02
2021-02-28,409160846,417248801,-8087955,영국,2021-02
2021-02-28,405543809,141522396,264021413,벨기에,2021-02
2021-02-28,387574184,536480338,-148906154,브라질,2021-02
2021-02-28,385612050,574030465,-188418415,네덜란드,2021-02
2021-02-28,325805888,5701280,320104608,몰타,2021-02
2021-02-28,318604520,567375541,-248771021,이탈리아,2021-02
2021-02-28,288847704,45404992,243442712,헝가리,2021-02
2021-02-28,278553587,27369,278526218,마샬군도,2021-02
2021-02-28,258486702,666146536,-407659834,아랍에미리트 연합,2021-02
2021-02-28,246619824,450580935,-203961111,프랑스,2021-02
2021-02-28,238686729,1590236865,-1351550136,사우디아라비아,2021-02
2021-02-28,224343285,144086774,80256511,스페인,2021-02
2021-02-28,222445862,29736,222416126,바하마,2021-02
2021-02-28,204732002,73441097,131290905,체코공화국,2021-02
2021-02-28,189934709,62696396,127238313,슬로바키아,2021-02
2021-02-28,183864498,535069,183329429,사이프러스,2021-02
2021-02-28,173306939,81103326,92203613,뉴질랜드,2021-02
2021-02-28,139567698,16445299,123122399,파키스탄,2021-02
2021-02-28,119382105,10482834,108899271,슬로베니아,2021-02
2021-02-28,117061831,111587833,5473998,이스라엘,2021-02
2021-02-28,109483125,65947631,43535494,그리스,2021-02
2021-02-28,108325064,200145,108124919,라이베리아,2021-02
2021-02-28,106405810,168664524,-62258714,스웨덴,2021-02
2021-02-28,105645354,1202023,104443331,우즈베키스탄,2021-02
2021-02-28,100434316,44378690,56055626,이집트,2021-02
2021-02-28,94176868,141963800,-47786932,오스트리아,2021-02
2021-02-28,89757319,44489399,45267920,방글라데시,2021-02
2021-02-28,82091968,364711825,-282619857,칠레,2021-02
2021-02-28,81947114,197487079,-115539965,남아프리카공화국,2021-02
2021-02-28,78323052,274128758,-195805706,이라크,2021-02
2021-02-28,73888987,111935879,-38046892,나이지리아,2021-02
2021-02-28,61980273,261321008,-199340735,페루,2021-02
2021-02-28,61639893,93732315,-32092422,아일랜드,2021-02
2021-02-28,52231014,18726789,33504225,콜롬비아,2021-02
2021-02-28,52201893,33352151,18849742,포루투갈,2021-02
2021-02-28,49661811,10637936,39023875,요르단,2021-02
2021-02-28,49368393,135193426,-85825033,카자흐스탄,2021-02
2021-02-28,47438895,264889926,-217451031,스위스,2021-02
2021-02-28,43563278,31993624,11569654,루마니아,2021-02
2021-02-28,41632676,32348542,9284134,캄보디아,2021-02
2021-02-28,41186573,7926460,33260113,에쿠아도르,2021-02
2021-02-28,34427439,68009917,-33582478,덴마크,2021-02
2021-02-28,33366739,22716290,10650449,우크라이나,2021-02
2021-02-28,31492552,1015673135,-984180583,카타르,2021-02
2021-02-28,30466715,304207,30162508,리비아,2021-02
2021-02-28,28591252,987445,27603807,파나마,2021-02
2021-02-28,28514035,53285455,-24771420,아르헨티나,2021-02
2021-02-28,26282180,200897852,-174615672,오만,2021-02
2021-02-28,25867766,37656754,-11788988,미얀마,2021-02
2021-02-28,25611897,461599885,-435987988,쿠웨이트,2021-02
2021-02-28,24236240,48072475,-23836235,핀란드,2021-02
2021-02-28,22185634,1723028,20462606,가나,2021-02
2021-02-28,21534523,667795,20866728,몽골,2021-02
2021-02-28,21103219,757129,20346090,토고,2021-02
2021-02-28,19634665,37104810,-17470145,푸에르토리코,2021-02
2021-02-28,19445170,20916686,-1471516,세르비아,2021-02
2021-02-28,18881834,6219678,12662156,도미니카 공화국,2021-02
2021-02-28,18867529,7311476,11556053,리투아니아,2021-02
2021-02-28,18584631,16416579,2168052,과테말라,2021-02
2021-02-28,18419242,104030010,-85610768,노르웨이,2021-02
2021-02-28,18112311,12139361,5972950,모로코,2021-02
2021-02-28,15370782,8967842,6402940,스리랑카,2021-02
2021-02-28,15053301,388677,14664624,코트디봐르,2021-02
2021-02-28,14721718,1863143,12858575,케냐,2021-02
2021-02-28,14452343,3765347,10686996,기니,2021-02
2021-02-28,14029784,4582997,9446787,엘살바도르,2021-02
2021-02-28,13304006,18021145,-4717139,앙골라,2021-02
2021-02-28,12794669,2205587,10589082,예맨,2021-02
2021-02-28,12341158,1039962,11301196,수단,2021-02
2021-02-28,12115120,160551593,-148436473,알제리,2021-02
2021-02-28,11986450,176372,11810078,네팔,2021-02
2021-02-28,11241373,31986098,-20744725,불가리아,2021-02
2021-02-28,10842136,35982251,-25140115,바레인,2021-02
2021-02-28,10424746,10626663,-201917,코스타리카,2021-02
2021-02-28,9408064,2859,9405205,아제르바이잔,2021-02
2021-02-28,9089518,421467,8668051,조지아,2021-02
2021-02-28,8957086,7150653,1806433,탄자니아,2021-02
2021-02-28,8665342,2788167,5877175,온두라스,2021-02
2021-02-28,8476272,1552992,6923280,세네갈,2021-02
2021-02-28,8127920,794046,7333874,이란,2021-02
2021-02-28,8117816,8963290,-845474,파라과이,2021-02
2021-02-28,7473406,8390270,-916864,튀니지,2021-02
2021-02-28,7296781,3037244,4259537,레바논,2021-02
2021-02-28,7057948,10792376,-3734428,우루과이,2021-02
2021-02-28,6857476,19774,6837702,키르기스스탄,2021-02
2021-02-28,6788520,22275100,-15486580,브루나이,2021-02
2021-02-28,6557917,3091040,3466877,에티오피아,2021-02
2021-02-28,6482775,3788539,2694236,에스토니아,2021-02
2021-02-28,6239503,67271,6172232,불령 리유니온 코모도 제도,2021-02
2021-02-28,5583749,1116855,4466894,크로아티아,2021-02
2021-02-28,5162634,1110,5161524,모잠비크,2021-02
2021-02-28,5053600,285279,4768321,아이티,2021-02
2021-02-28,4861155,10269515,-5408360,니카라과,2021-02
2021-02-28,4857128,131,4856997,타지크,2021-02
2021-02-28,4679580,258175,4421405,괌,2021-02
2021-02-28,4482716,291781,4190935,팔레스타인 해방기구,2021-02
2021-02-28,4423853,6825156,-2401303,라트비아,2021-02
2021-02-28,3960333,3365603,594730,라오스,2021-02
2021-02-28,3828792,79765134,-75936342,파푸아 뉴기니,2021-02
2021-02-28,3714032,701735,3012297,콩고,2021-02
2021-02-28,3528152,64150514,-60622362,콩고민주공화국,2021-02
2021-02-28,3471422,5904587,-2433165,트리니다드 토바고,2021-02
2021-02-28,3399299,10945701,-7546402,벨라루스,2021-02
2021-02-28,3378454,223223,3155231,카메룬,2021-02
2021-02-28,3207100,75821,3131279,부르키나 파소,2021-02
2021-02-28,3007059,184651,2822408,사모아,2021-02
2021-02-28,2871063,170641706,-167770643,기타국,2021-02
2021-02-28,2539861,88,2539773,가이아나,2021-02
2021-02-28,2478514,171276,2307238,피지,2021-02
2021-02-28,2306388,5546748,-3240360,룩셈부르그,2021-02
2021-02-28,2079103,1157,2077946,시리아,2021-02
2021-02-28,2073075,1176766,896309,아이슬란드,2021-02
2021-02-28,2042992,30825019,-28782027,볼리비아,2021-02
2021-02-28,2041287,323460,1717827,지부티,2021-02
2021-02-28,1952920,3005929,-1053009,알바니아,2021-02
2021-02-28,1926726,102396,1824330,아프카니스탄,2021-02
2021-02-28,1761058,5071047,-3309989,뉴 칼레도니아,2021-02
2021-02-28,1700581,602,1699979,말리,2021-02
2021-02-28,1637242,770670,866572,모리셔스,2021-02
2021-02-28,1474108,1706521,-232413,몰도바,2021-02
2021-02-28,1464546,167757,1296789,르완다,2021-02
2021-02-28,1463642,44161,1419481,마카오,2021-02
2021-02-28,1393599,1447712,-54113,베네주엘라,2021-02
2021-02-28,1306848,22,1306826,베닝,2021-02
2021-02-28,1289128,279337,1009791,자마이카,2021-02
2021-02-28,1193501,515323,678178,키리바티,2021-02
2021-02-28,1193416,83986,1109430,소말리아,2021-02
2021-02-28,1162433,1948815,-786382,리히텐슈타인,2021-02
2021-02-28,1119192,462,1118730,몰디브,2021-02
2021-02-28,1069249,572315,496934,마다카스카르,2021-02
2021-02-28,1012359,2842690,-1830331,짐바브웨,2021-02
2021-02-28,991758,607733,384025,우간다,2021-02
2021-02-28,899253,12292,886961,마이크로네시아,2021-02
2021-02-28,865448,152581,712867,세이쉘,2021-02
2021-02-28,835303,58397,776906,불령 폴리네시아,2021-02
2021-02-28,793768,1038661,-244893,마세도니아,2021-02
2021-02-28,780728,3324444,-2543716,잠비아,2021-02
2021-02-28,749637,49310499,-48560862,아루바,2021-02
2021-02-28,745433,1729653,-984220,아르메니아,2021-02
2021-02-28,734513,454,734059,쿠바,2021-02
2021-02-28,727487,242009,485478,가봉,2021-02
2021-02-28,682739,1163462,-480723,시에라 리온,2021-02
2021-02-28,644298,0,644298,마티니크,2021-02
2021-02-28,610259,67381,542878,북마리아나 군도,2021-02
2021-02-28,609852,184615,425237,솔로몬 군도,2021-02
2021-02-28,595040,3919,591121,니제르,2021-02
2021-02-28,545977,33791,512186,바베이도스,2021-02
2021-02-28,545403,333476,211927,수리남,2021-02
2021-02-28,491091,367,490724,투르크멘,2021-02
2021-02-28,440404,1436830,-996426,보스니아-헤르체고비나,2021-02
2021-02-28,439440,312382,127058,모리타니,2021-02
2021-02-28,401455,867220,-465765,바누아투,2021-02
2021-02-28,400898,3304258,-2903360,말라위,2021-02
2021-02-28,371084,1674456,-1303372,부탄,2021-02
2021-02-28,357289,0,357289,과델로프,2021-02
2021-02-28,334286,27413,306873,세인트 루시아,2021-02
2021-02-28,331739,1241,330498,몬테네그로,2021-02
2021-02-28,301713,37426,264287,아메리칸 사모아,2021-02
2021-02-28,279172,759,278413,영령 캐이맨 군도,2021-02
2021-02-28,265274,86094,179180,감비아,2021-02
2021-02-28,235806,0,235806,그레나다,2021-02
2021-02-28,222974,0,222974,큐라소,2021-02
2021-02-28,200870,3079,197791,팔라우,2021-02
2021-02-28,160691,24,160667,버뮤다,2021-02
2021-02-28,159676,229113,-69437,기네비소,2021-02
2021-02-28,158708,47214,111494,도미니카,2021-02
2021-02-28,155021,0,155021,영령 버진군도,2021-02
2021-02-28,140747,4051,136696,벨리제,2021-02
2021-02-28,118986,1656,117330,네덜란드 열도,2021-02
2021-02-28,103740,66084,37656,보츠와나,2021-02
2021-02-28,99400,0,99400,세인트 빈센트 그레나딘,2021-02
2021-02-28,86191,561,85630,안티가 바부다,2021-02
2021-02-28,72588,0,72588,카보 베르데,2021-02
2021-02-28,69796,4651478,-4581682,나미비아,2021-02
2021-02-28,65130,0,65130,티모르,2021-02
2021-02-28,64323,24864,39459,스와질랜드,2021-02
2021-02-28,61841,0,61841,에리트리아,2021-02
2021-02-28,59339,0,59339,세인트 마틴,2021-02
2021-02-28,57870,298,57572,챠드,2021-02
2021-02-28,57093,0,57093,불령 가이아나,2021-02
2021-02-28,54268,7771,46497,레소토,2021-02
2021-02-28,51100,45747,5353,모나코,2021-02
2021-02-28,40349,51,40298,중앙아프리카공화국,2021-02
2021-02-28,35636,16352,19284,적도 기니,2021-02
2021-02-28,35129,0,35129,부룬디,2021-02
2021-02-28,24896,0,24896,메요트,2021-02
2021-02-28,13674,32,13642,지브랄타,2021-02
2021-02-28,6534,0,6534,상토메 프린스페,2021-02
2021-02-28,6340,429,5911,앙귈라,2021-02
2021-02-28,4245,131,4114,세인트 키츠 네비스,2021-02
2021-02-28,2806,183570,-180764,몬트세라트,2021-02
2021-02-28,1181,16385,-15204,안도라,2021-02
2021-02-28,339,0,339,그린랜드,2021-02
2021-02-28,322,0,322,남수단,2021-02
2021-02-28,291,17875,-17584,통가,2021-02
2021-02-28,223,18,205,쿡 아일랜드,2021-02
2021-02-28,140,10475,-10335,미령 버진군도,2021-02
2021-02-28,0,103,-103,보빗군도,2021-02
2021-02-28,0,55205,-55205,파로에 군도,2021-02
2021-02-28,0,348,-348,투르크 & 카이코스 군도,2021-02
2021-02-28,0,14708,-14708,건지,2021-02
2021-02-28,0,233,-233,불령 남부지역,2021-02
2021-02-28,0,218,-218,세인트 바르탤르미,2021-02
2021-02-28,0,154,-154,마이너 아우틀링 합중국 군도,2021-02
2021-02-28,0,30597,-30597,코모로스,2021-02
2021-02-28,0,104690,-104690,토켈라우,2021-02
2021-02-28,0,4552,-4552,안타티카,2021-02
2021-02-28,0,500,-500,맨섬,2021-02
2021-02-28,0,615,-615,니우에,2021-02
2021-02-28,0,337,-337,코스 군도,2021-02
2021-02-28,0,2815353,-2815353,나우루,2021-02
2021-02-28,0,413610,-413610,산마리노,2021-02
2021-03-31,13408119054,10884574875,2523544179,중국,2021-03
2021-03-31,7970755898,6221032807,1749723091,미국,2021-03
2021-03-31,4207078759,2107989120,2099089639,베트남,2021-03
2021-03-31,3402418498,185057333,3217361165,홍콩,2021-03
2021-03-31,2415077031,4834351877,-2419274846,일본,2021-03
2021-03-31,1901695515,1970970372,-69274857,대만,2021-03
2021-03-31,1335901292,633630171,702271121,인도,2021-03
2021-03-31,1165307045,1929761971,-764454926,독일,2021-03
2021-03-31,1111516759,1018695058,92821701,싱가포르,2021-03
2021-03-31,923558295,702852719,220705576,멕시코,2021-03
2021-03-31,851091108,601983983,249107125,태국,2021-03
2021-03-31,793110695,1125761350,-332650655,러시아 연방,2021-03
2021-03-31,729309055,837988031,-108678976,말레이시아,2021-03
2021-03-31,725610248,2693117670,-1967507422,호주,2021-03
2021-03-31,695531335,764719426,-69188091,인도네시아,2021-03
2021-03-31,670630752,132993752,537637000,튀르키예,2021-03
2021-03-31,654349934,311912480,342437454,필리핀,2021-03
2021-03-31,647168961,86750454,560418507,폴란드,2021-03
2021-03-31,634644462,529600223,105044239,캐나다,2021-03
2021-03-31,564474073,433946315,130527758,영국,2021-03
2021-03-31,476174890,1081051489,-604876599,네덜란드,2021-03
2021-03-31,465628594,587405790,-121777196,프랑스,2021-03
2021-03-31,443796521,476313312,-32516791,브라질,2021-03
2021-03-31,426579654,784346706,-357767052,이탈리아,2021-03
2021-03-31,407974616,35914148,372060468,몰타,2021-03
2021-03-31,383130672,167906468,215224204,벨기에,2021-03
2021-03-31,361024841,57797472,303227369,헝가리,2021-03
2021-03-31,347021772,31227,346990545,마샬군도,2021-03
2021-03-31,343487135,75541694,267945441,슬로바키아,2021-03
2021-03-31,297008008,635202225,-338194217,아랍에미리트 연합,2021-03
2021-03-31,285465974,233375746,52090228,스페인,2021-03
2021-03-31,284722057,99561813,185160244,체코공화국,2021-03
2021-03-31,250560056,106298637,144261419,덴마크,2021-03
2021-03-31,224789654,1493344184,-1268554530,사우디아라비아,2021-03
2021-03-31,181827924,129588389,52239535,그리스,2021-03
2021-03-31,156501210,240948670,-84447460,노르웨이,2021-03
2021-03-31,156500781,172649091,-16148310,스웨덴,2021-03
2021-03-31,155683826,145456108,10227718,이스라엘,2021-03
2021-03-31,148926856,62336182,86590674,방글라데시,2021-03
2021-03-31,145510388,2034631,143475757,우즈베키스탄,2021-03
2021-03-31,145041356,44314695,100726661,이집트,2021-03
2021-03-31,143851193,19043559,124807634,파키스탄,2021-03
2021-03-31,134096263,338607483,-204511220,칠레,2021-03
2021-03-31,123808472,156326842,-32518370,오스트리아,2021-03
2021-03-31,121491973,100242802,21249171,뉴질랜드,2021-03
2021-03-31,106131430,16341480,89789950,슬로베니아,2021-03
2021-03-31,84796014,257779077,-172983063,이라크,2021-03
2021-03-31,84711685,39216824,45494861,콜롬비아,2021-03
2021-03-31,82025296,144541720,-62516424,나이지리아,2021-03
2021-03-31,80838216,209031221,-128193005,남아프리카공화국,2021-03
2021-03-31,76312373,321593807,-245281434,페루,2021-03
2021-03-31,74610817,810808,73800009,파나마,2021-03
2021-03-31,72880223,303190932,-230310709,스위스,2021-03
2021-03-31,69892766,10955236,58937530,에쿠아도르,2021-03
2021-03-31,66096582,119541073,-53444491,카자흐스탄,2021-03
2021-03-31,61154490,45325895,15828595,포루투갈,2021-03
2021-03-31,59866105,11650990,48215115,튀니지,2021-03
2021-03-31,56418683,116135154,-59716471,아일랜드,2021-03
2021-03-31,53058558,34388167,18670391,캄보디아,2021-03
2021-03-31,51138722,8779693,42359029,요르단,2021-03
2021-03-31,47394336,51297820,-3903484,루마니아,2021-03
2021-03-31,45180291,1620719,43559572,리비아,2021-03
2021-03-31,40435159,12884619,27550540,우크라이나,2021-03
2021-03-31,37087035,53451609,-16364574,아르헨티나,2021-03
2021-03-31,36405307,6350411,30054896,라이베리아,2021-03
2021-03-31,34403750,678441023,-644037273,카타르,2021-03
2021-03-31,33294650,658835131,-625540481,쿠웨이트,2021-03
2021-03-31,33270925,27076250,6194675,세르비아,2021-03
2021-03-31,33098698,2104281,30994417,탄자니아,2021-03
2021-03-31,32870744,26358362,6512382,푸에르토리코,2021-03
2021-03-31,31979160,412345,31566815,몽골,2021-03
2021-03-31,31641847,18897760,12744087,모로코,2021-03
2021-03-31,30533508,71848827,-41315319,핀란드,2021-03
2021-03-31,27128063,12247496,14880567,스리랑카,2021-03
2021-03-31,26862748,29305053,-2442305,엘살바도르,2021-03
2021-03-31,25980474,3892280,22088194,가나,2021-03
2021-03-31,24136907,4646556,19490351,케냐,2021-03
2021-03-31,23360821,280533,23080288,피지,2021-03
2021-03-31,22986807,10176087,12810720,리투아니아,2021-03
2021-03-31,21778696,6837605,14941091,도미니카 공화국,2021-03
2021-03-31,21399175,184381785,-162982610,오만,2021-03
2021-03-31,20776322,27379173,-6602851,과테말라,2021-03
2021-03-31,19362411,191609203,-172246792,알제리,2021-03
2021-03-31,19126326,221919,18904407,이란,2021-03
2021-03-31,16026819,5466426,10560393,온두라스,2021-03
2021-03-31,15341917,28652401,-13310484,바레인,2021-03
2021-03-31,15209694,24179461,-8969767,불가리아,2021-03
2021-03-31,15207168,3861513,11345655,에티오피아,2021-03
2021-03-31,14901114,40129156,-25228042,미얀마,2021-03
2021-03-31,14749024,5174895,9574129,파라과이,2021-03
2021-03-31,14198095,1261829,12936266,수단,2021-03
2021-03-31,13880818,1399088,12481730,코트디봐르,2021-03
2021-03-31,12580670,584119,11996551,괌,2021-03
2021-03-31,12307067,28474319,-16167252,앙골라,2021-03
2021-03-31,12097034,5249506,6847528,우루과이,2021-03
2021-03-31,11516443,2634574,8881869,레바논,2021-03
2021-03-31,11107917,13913020,-2805103,코스타리카,2021-03
2021-03-31,10505532,3380970,7124562,크로아티아,2021-03
2021-03-31,10201812,3032981,7168831,예맨,2021-03
2021-03-31,10044355,26242,10018113,키르기스스탄,2021-03
2021-03-31,9367150,215582,9151568,아제르바이잔,2021-03
2021-03-31,8850756,1016545,7834211,투발루,2021-03
2021-03-31,8569229,2917393,5651836,세네갈,2021-03
2021-03-31,8126337,44616,8081721,모잠비크,2021-03
2021-03-31,8079989,8294404,-214415,에스토니아,2021-03
2021-03-31,8068378,112440,7955938,카메룬,2021-03
2021-03-31,8053114,211971,7841143,아이티,2021-03
2021-03-31,7722954,44212119,-36489165,파푸아 뉴기니,2021-03
2021-03-31,7398726,611535,6787191,조지아,2021-03
2021-03-31,7396728,8536236,-1139508,라트비아,2021-03
2021-03-31,7237338,222375648,-215138310,기타국,2021-03
2021-03-31,7030066,7822,7022244,불령 리유니온 코모도 제도,2021-03
2021-03-31,6733912,21824358,-15090446,트리니다드 토바고,2021-03
2021-03-31,5840836,18633536,-12792700,브루나이,2021-03
2021-03-31,5760555,11685022,-5924467,기니,2021-03
2021-03-31,5738777,5429799,308978,라오스,2021-03
2021-03-31,5401917,0,5401917,팔레스타인 해방기구,2021-03
2021-03-31,5393971,1368168,4025803,니카라과,2021-03
2021-03-31,5314909,6151962,-837053,잠비아,2021-03
2021-03-31,5209716,515986,4693730,지부티,2021-03
2021-03-31,5132601,5251705,-119104,벨라루스,2021-03
2021-03-31,5008978,1305146,3703832,마다카스카르,2021-03
2021-03-31,4894732,86720803,-81826071,콩고민주공화국,2021-03
2021-03-31,4658108,50006,4608102,사모아,2021-03
2021-03-31,4049861,504742,3545119,아이슬란드,2021-03
2021-03-31,3786344,247836,3538508,콩고,2021-03
2021-03-31,3587394,3351,3584043,타지크,2021-03
2021-03-31,3346423,38,3346385,가이아나,2021-03
2021-03-31,3209934,294010,2915924,우간다,2021-03
2021-03-31,3208113,401079,2807034,네팔,2021-03
2021-03-31,3160821,3973699,-812878,알바니아,2021-03
2021-03-31,3111095,19091,3092004,팔라우,2021-03
2021-03-31,2974678,37683,2936995,마카오,2021-03
2021-03-31,2920031,1674368,1245663,베네주엘라,2021-03
2021-03-31,2869896,20012580,-17142684,볼리비아,2021-03
2021-03-31,2866003,2153550,712453,짐바브웨,2021-03
2021-03-31,2851094,117841,2733253,불령 폴리네시아,2021-03
2021-03-31,2844221,175279,2668942,르완다,2021-03
2021-03-31,2831195,129207,2701988,아프카니스탄,2021-03
2021-03-31,2750426,44,2750382,부르키나 파소,2021-03
2021-03-31,2613004,3377,2609627,시리아,2021-03
2021-03-31,2517818,376268,2141550,사이프러스,2021-03
2021-03-31,2249444,30762261,-28512817,뉴 칼레도니아,2021-03
2021-03-31,2022588,518013,1504575,모리셔스,2021-03
2021-03-31,1954430,199721,1754709,자마이카,2021-03
2021-03-31,1951107,2340573,-389466,아르메니아,2021-03
2021-03-31,1850515,1166457,684058,리히텐슈타인,2021-03
2021-03-31,1838538,234897,1603641,말라위,2021-03
2021-03-31,1666432,3958596,-2292164,토고,2021-03
2021-03-31,1662996,6629872,-4966876,룩셈부르그,2021-03
2021-03-31,1465558,0,1465558,메요트,2021-03
2021-03-31,1458250,3173605,-1715355,보스니아-헤르체고비나,2021-03
2021-03-31,1428679,1821,1426858,키리바티,2021-03
2021-03-31,1338824,25,1338799,부탄,2021-03
2021-03-31,1294022,0,1294022,소말리아,2021-03
2021-03-31,1164548,2331,1162217,투르크멘,2021-03
2021-03-31,1096913,126539,970374,마세도니아,2021-03
2021-03-31,1081366,16,1081350,베닝,2021-03
2021-03-31,1047182,61143,986039,북마리아나 군도,2021-03
2021-03-31,995950,0,995950,마티니크,2021-03
2021-03-31,980823,3886686,-2905863,가봉,2021-03
2021-03-31,947218,374,946844,아루바,2021-03
2021-03-31,881090,127908,753182,니제르,2021-03
2021-03-31,879001,2541407,-1662406,몰도바,2021-03
2021-03-31,789541,498836,290705,수리남,2021-03
2021-03-31,777098,0,777098,불령 가이아나,2021-03
2021-03-31,729350,359674,369676,솔로몬 군도,2021-03
2021-03-31,718979,705,718274,버뮤다,2021-03
2021-03-31,691038,68,690970,말리,2021-03
2021-03-31,659917,73825,586092,아메리칸 사모아,2021-03
2021-03-31,651994,32433,619561,마이크로네시아,2021-03
2021-03-31,634770,8884,625886,바하마,2021-03
2021-03-31,621852,1903793,-1281941,모리타니,2021-03
2021-03-31,608935,35348,573587,도미니카,2021-03
2021-03-31,542790,1100,541690,영령 캐이맨 군도,2021-03
2021-03-31,528097,894703,-366606,세이쉘,2021-03
2021-03-31,515269,36745,478524,몰디브,2021-03
2021-03-31,491936,1821166,-1329230,시에라 리온,2021-03
2021-03-31,475598,184016,291582,감비아,2021-03
2021-03-31,430875,143,430732,과델로프,2021-03
2021-03-31,418464,728780,-310316,바누아투,2021-03
2021-03-31,385554,42364,343190,바베이도스,2021-03
2021-03-31,345939,63176,282763,쿠바,2021-03
2021-03-31,322783,0,322783,남수단,2021-03
2021-03-31,303789,6412,297377,세인트 키츠 네비스,2021-03
2021-03-31,278491,0,278491,세인트 마틴,2021-03
2021-03-31,268358,1450,266908,나우루,2021-03
2021-03-31,253317,0,253317,그레나다,2021-03
2021-03-31,234134,7585,226549,몬테네그로,2021-03
2021-03-31,230207,133919,96288,중앙아프리카공화국,2021-03
2021-03-31,222386,33763,188623,나미비아,2021-03
2021-03-31,219774,46680,173094,큐라소,2021-03
2021-03-31,215853,42,215811,벨리제,2021-03
2021-03-31,191343,2255,189088,안티가 바부다,2021-03
2021-03-31,167727,899,166828,네덜란드 열도,2021-03
2021-03-31,133827,5964,127863,토켈라우,2021-03
2021-03-31,119110,29001,90109,카보 베르데,2021-03
2021-03-31,93789,46956,46833,스와질랜드,2021-03
2021-03-31,92127,6821,85306,보츠와나,2021-03
2021-03-31,68389,0,68389,세인트 루시아,2021-03
2021-03-31,66143,0,66143,영령 버진군도,2021-03
2021-03-31,62920,1372,61548,남조지아 & 남샌드위치 군도,2021-03
2021-03-31,57830,15048,42782,레소토,2021-03
2021-03-31,50865,0,50865,세인트 빈센트 그레나딘,2021-03
2021-03-31,39000,0,39000,티모르,2021-03
2021-03-31,36128,1760,34368,챠드,2021-03
2021-03-31,29123,2970,26153,통가,2021-03
2021-03-31,27241,47794719,-47767478,적도 기니,2021-03
2021-03-31,20511,71,20440,상토메 프린스페,2021-03
2021-03-31,18808,0,18808,왈라스 & 퓨투나 군도,2021-03
2021-03-31,16326,3876,12450,코모로스,2021-03
2021-03-31,16007,53473,-37466,부룬디,2021-03
2021-03-31,11469,17034,-5565,안도라,2021-03
2021-03-31,7261,0,7261,세인트 바르탤르미,2021-03
2021-03-31,6844,1966,4878,미령 버진군도,2021-03
2021-03-31,6542,455564,-449022,모나코,2021-03
2021-03-31,5469,539,4930,지브랄타,2021-03
2021-03-31,1615,2001,-386,건지,2021-03
2021-03-31,1080,18,1062,파로에 군도,2021-03
2021-03-31,965,613,352,앙귈라,2021-03
2021-03-31,78,287,-209,그린랜드,2021-03
2021-03-31,40,0,40,세인트마틴(생마르탱),2021-03
2021-03-31,0,22569,-22569,니우에,2021-03
2021-03-31,0,325142,-325142,기네비소,2021-03
2021-03-31,0,19672,-19672,맨섬,2021-03
2021-03-31,0,1152,-1152,마이너 아우틀링 합중국 군도,2021-03
2021-03-31,0,10451068,-10451068,에리트리아,2021-03
2021-03-31,0,8842,-8842,쿡 아일랜드,2021-03
2021-03-31,0,7590,-7590,코스 군도,2021-03
2021-03-31,0,2105588,-2105588,안타티카,2021-03
2021-03-31,0,136,-136,투르크 & 카이코스 군도,2021-03
2021-03-31,0,18,-18,저어지,2021-03
2021-03-31,0,75160,-75160,몬트세라트,2021-03
2021-03-31,0,240713,-240713,산마리노,2021-03
2021-03-31,0,534,-534,불령 남부지역,2021-03
2021-04-30,13401058327,11517639417,1883418910,중국,2021-04
2021-04-30,7557229358,6440356900,1116872458,미국,2021-04
2021-04-30,4334987144,2138287601,2196699543,베트남,2021-04
2021-04-30,2985366252,164570676,2820795576,홍콩,2021-04
2021-04-30,2489524820,4845078772,-2355553952,일본,2021-04
2021-04-30,1770534845,1852259291,-81724446,대만,2021-04
2021-04-30,1351273036,734173196,617099840,인도,2021-04
2021-04-30,981880940,2061881281,-1080000341,독일,2021-04
2021-04-30,884062846,1119938448,-235875602,싱가포르,2021-04
2021-04-30,877857322,635938594,241918728,멕시코,2021-04
2021-04-30,836356215,1560840135,-724483920,러시아 연방,2021-04
2021-04-30,799769254,776237490,23531764,말레이시아,2021-04
2021-04-30,767341008,2406133166,-1638792158,호주,2021-04
2021-04-30,761699948,582373204,179326744,태국,2021-04
2021-04-30,666339498,829826616,-163487118,인도네시아,2021-04
2021-04-30,617628253,297946537,319681716,필리핀,2021-04
2021-04-30,593433937,100136876,493297061,폴란드,2021-04
2021-04-30,587960344,123730974,464229370,튀르키예,2021-04
2021-04-30,576082235,593816366,-17734131,캐나다,2021-04
2021-04-30,462349777,818930389,-356580612,네덜란드,2021-04
2021-04-30,462082324,554367213,-92284889,영국,2021-04
2021-04-30,407931945,448989181,-41057236,브라질,2021-04
2021-04-30,374847610,682320929,-307473319,이탈리아,2021-04
2021-04-30,370924071,6251617,364672454,몰타,2021-04
2021-04-30,355880978,431436704,-75555726,아랍에미리트 연합,2021-04
2021-04-30,341456341,553361978,-211905637,프랑스,2021-04
2021-04-30,303252598,219911122,83341476,벨기에,2021-04
2021-04-30,286909385,351540,286557845,라이베리아,2021-04
2021-04-30,285990748,53826950,232163798,헝가리,2021-04
2021-04-30,254872612,63870307,191002305,슬로바키아,2021-04
2021-04-30,251021495,93257964,157763531,체코공화국,2021-04
2021-04-30,241192938,188358493,52834445,스페인,2021-04
2021-04-30,239162460,56350,239106110,마샬군도,2021-04
2021-04-30,207463855,1686215584,-1478751729,사우디아라비아,2021-04
2021-04-30,171518500,55041624,116476876,방글라데시,2021-04
2021-04-30,155960485,2428431,153532054,우즈베키스탄,2021-04
2021-04-30,155593762,156977127,-1383365,이스라엘,2021-04
2021-04-30,146872845,39680816,107192029,파키스탄,2021-04
2021-04-30,138841073,21979830,116861243,이집트,2021-04
2021-04-30,127224213,458812898,-331588685,칠레,2021-04
2021-04-30,121811588,163020486,-41208898,오스트리아,2021-04
2021-04-30,120947451,208434805,-87487354,스웨덴,2021-04
2021-04-30,113043923,579811583,-466767660,이라크,2021-04
2021-04-30,108061895,161691705,-53629810,뉴질랜드,2021-04
2021-04-30,101364856,9568866,91795990,에쿠아도르,2021-04
2021-04-30,89693360,73033938,16659422,그리스,2021-04
2021-04-30,88056505,28448926,59607579,콜롬비아,2021-04
2021-04-30,81890889,13663476,68227413,슬로베니아,2021-04
2021-04-30,78406966,81909860,-3502894,남아프리카공화국,2021-04
2021-04-30,69169838,247018740,-177848902,페루,2021-04
2021-04-30,67085095,36802893,30282202,나이지리아,2021-04
2021-04-30,64676323,117724343,-53048020,노르웨이,2021-04
2021-04-30,64289141,285336893,-221047752,카자흐스탄,2021-04
2021-04-30,58151302,45162906,12988396,루마니아,2021-04
2021-04-30,55882283,36193881,19688402,포루투갈,2021-04
2021-04-30,55409183,230334574,-174925391,오만,2021-04
2021-04-30,52027346,25074433,26952913,파나마,2021-04
2021-04-30,51079021,266753427,-215674406,스위스,2021-04
2021-04-30,49131309,13229370,35901939,과테말라,2021-04
2021-04-30,47716906,25356101,22360805,캄보디아,2021-04
2021-04-30,45152846,6575652,38577194,요르단,2021-04
2021-04-30,41185242,31477580,9707662,푸에르토리코,2021-04
2021-04-30,40968474,95552646,-54584172,아일랜드,2021-04
2021-04-30,40724744,13163899,27560845,우크라이나,2021-04
2021-04-30,38736321,1466687,37269634,리비아,2021-04
2021-04-30,35667334,86476728,-50809394,덴마크,2021-04
2021-04-30,35171436,319325,34852111,몽골,2021-04
2021-04-30,32912521,768721091,-735808570,카타르,2021-04
2021-04-30,31799604,54997890,-23198286,핀란드,2021-04
2021-04-30,28409095,51174315,-22765220,아르헨티나,2021-04
2021-04-30,28335588,675821773,-647486185,쿠웨이트,2021-04
2021-04-30,27898437,3592579,24305858,케냐,2021-04
2021-04-30,27221533,17703469,9518064,모로코,2021-04
2021-04-30,27042895,2321479,24721416,가나,2021-04
2021-04-30,25576308,8198120,17378188,도미니카 공화국,2021-04
2021-04-30,24979240,292606,24686634,피지,2021-04
2021-04-30,23714571,22811212,903359,세르비아,2021-04
2021-04-30,20386234,13602960,6783274,스리랑카,2021-04
2021-04-30,18276692,1629322,16647370,코트디봐르,2021-04
2021-04-30,18060109,112586756,-94526647,알제리,2021-04
2021-04-30,17211463,1720619,15490844,수단,2021-04
2021-04-30,16535238,5269376,11265862,예맨,2021-04
2021-04-30,16466834,266701,16200133,네팔,2021-04
2021-04-30,15912340,45315642,-29403302,코스타리카,2021-04
2021-04-30,15885765,30173055,-14287290,미얀마,2021-04
2021-04-30,15655977,7651335,8004642,리투아니아,2021-04
2021-04-30,14884005,14247365,636640,엘살바도르,2021-04
2021-04-30,14379420,12404470,1974950,불가리아,2021-04
2021-04-30,14283675,35457227,-21173552,적도 기니,2021-04
2021-04-30,12962418,1977972,10984446,탄자니아,2021-04
2021-04-30,12094129,10155796,1938333,우루과이,2021-04
2021-04-30,11733584,666307,11067277,이란,2021-04
2021-04-30,11598569,2091,11596478,앙골라,2021-04
2021-04-30,10368342,6255603,4112739,튀니지,2021-04
2021-04-30,10306070,483265,9822805,우간다,2021-04
2021-04-30,10263513,3154302,7109211,조지아,2021-04
2021-04-30,10030309,23630473,-13600164,온두라스,2021-04
2021-04-30,9566781,1529733,8037048,크로아티아,2021-04
2021-04-30,9261946,17490,9244456,키르기스스탄,2021-04
2021-04-30,7899526,8866032,-966506,파라과이,2021-04
2021-04-30,7895468,21269192,-13373724,모잠비크,2021-04
2021-04-30,7882568,27744446,-19861878,바레인,2021-04
2021-04-30,7858018,3804317,4053701,레바논,2021-04
2021-04-30,7751851,8322000,-570149,라트비아,2021-04
2021-04-30,7729117,4886902,2842215,에스토니아,2021-04
2021-04-30,7555102,61905,7493197,아제르바이잔,2021-04
2021-04-30,7276711,6229774,1046937,에티오피아,2021-04
2021-04-30,7100987,21116614,-14015627,니카라과,2021-04
2021-04-30,7049570,0,7049570,팔레스타인 해방기구,2021-04
2021-04-30,6863157,3031390,3831767,세네갈,2021-04
2021-04-30,6782783,278060,6504723,아이티,2021-04
2021-04-30,5800950,5643474,157476,벨라루스,2021-04
2021-04-30,5432547,4151748,1280799,라오스,2021-04
2021-04-30,5378471,49459,5329012,보츠와나,2021-04
2021-04-30,5284788,7459947,-2175159,룩셈부르그,2021-04
2021-04-30,5130721,164300,4966421,괌,2021-04
2021-04-30,4640933,1235,4639698,불령 리유니온 코모도 제도,2021-04
2021-04-30,4611906,218792,4393114,말리,2021-04
2021-04-30,4566571,432607,4133964,지부티,2021-04
2021-04-30,4349034,1411338,2937696,파푸아 뉴기니,2021-04
2021-04-30,4247664,476739,3770925,카메룬,2021-04
2021-04-30,3583095,102145877,-98562782,콩고민주공화국,2021-04
2021-04-30,3450014,60934,3389080,아프카니스탄,2021-04
2021-04-30,3387443,343557,3043886,아이슬란드,2021-04
2021-04-30,3275592,74062,3201530,부르키나 파소,2021-04
2021-04-30,3235021,517499,2717522,사이프러스,2021-04
2021-04-30,3228457,23973606,-20745149,트리니다드 토바고,2021-04
2021-04-30,3154769,16855,3137914,타지크,2021-04
2021-04-30,3102472,4803,3097669,시리아,2021-04
2021-04-30,3007735,192307,2815428,사모아,2021-04
2021-04-30,2940880,819813,2121067,마다카스카르,2021-04
2021-04-30,2925023,90105552,-87180529,볼리비아,2021-04
2021-04-30,2775744,0,2775744,마티니크,2021-04
2021-04-30,2722263,233893845,-231171582,기타국,2021-04
2021-04-30,2642967,1395892,1247075,베네주엘라,2021-04
2021-04-30,2603912,3871298,-1267386,토고,2021-04
2021-04-30,2533534,534,2533000,가이아나,2021-04
2021-04-30,2480183,838843,1641340,알바니아,2021-04
2021-04-30,2361744,0,2361744,과델로프,2021-04
2021-04-30,2315060,118480,2196580,자마이카,2021-04
2021-04-30,2230798,62262182,-60031384,콩고,2021-04
2021-04-30,2151052,806452,1344600,아르메니아,2021-04
2021-04-30,2106872,248,2106624,베닝,2021-04
2021-04-30,2060329,284100,1776229,모리셔스,2021-04
2021-04-30,2013754,17853896,-15840142,브루나이,2021-04
2021-04-30,1954713,5422115,-3467402,기니,2021-04
2021-04-30,1923132,27534,1895598,르완다,2021-04
2021-04-30,1750094,12400180,-10650086,뉴 칼레도니아,2021-04
2021-04-30,1652015,33911,1618104,마카오,2021-04
2021-04-30,1518080,942293,575787,리히텐슈타인,2021-04
2021-04-30,1450893,66243,1384650,마이크로네시아,2021-04
2021-04-30,1428257,196522,1231735,불령 폴리네시아,2021-04
2021-04-30,1403147,1685612,-282465,몰도바,2021-04
2021-04-30,1278901,0,1278901,부탄,2021-04
2021-04-30,1270285,1618,1268667,바하마,2021-04
2021-04-30,1265972,36678,1229294,아메리칸 사모아,2021-04
2021-04-30,1246495,381,1246114,불령 가이아나,2021-04
2021-04-30,1198160,1354410,-156250,짐바브웨,2021-04
2021-04-30,1133616,1596454,-462838,보스니아-헤르체고비나,2021-04
2021-04-30,1082274,252208,830066,가봉,2021-04
2021-04-30,1023121,281664,741457,세이쉘,2021-04
2021-04-30,961184,59233,901951,소말리아,2021-04
2021-04-30,874731,222,874509,몰디브,2021-04
2021-04-30,870647,2519483,-1648836,솔로몬 군도,2021-04
2021-04-30,780134,153588,626546,말라위,2021-04
2021-04-30,774911,59,774852,카보 베르데,2021-04
2021-04-30,760209,39589,720620,북마리아나 군도,2021-04
2021-04-30,734037,44715936,-43981899,니제르,2021-04
2021-04-30,643781,1029098,-385317,키리바티,2021-04
2021-04-30,634901,1390362,-755461,시에라 리온,2021-04
2021-04-30,574371,8690906,-8116535,잠비아,2021-04
2021-04-30,536635,0,536635,영령 캐이맨 군도,2021-04
2021-04-30,512115,0,512115,아루바,2021-04
2021-04-30,502004,1071377,-569373,바누아투,2021-04
2021-04-30,473013,30633,442380,중앙아프리카공화국,2021-04
2021-04-30,469693,0,469693,버뮤다,2021-04
2021-04-30,456638,205644,250994,감비아,2021-04
2021-04-30,455383,2023503,-1568120,마세도니아,2021-04
2021-04-30,437997,45115,392882,바베이도스,2021-04
2021-04-30,424964,1574,423390,투르크멘,2021-04
2021-04-30,393639,1723931,-1330292,모리타니,2021-04
2021-04-30,347526,532369,-184843,수리남,2021-04
2021-04-30,340044,0,340044,큐라소,2021-04
2021-04-30,337541,25,337516,티모르,2021-04
2021-04-30,324895,0,324895,세인트 마틴,2021-04
2021-04-30,289298,0,289298,세인트 루시아,2021-04
2021-04-30,252590,0,252590,팔라우,2021-04
2021-04-30,235596,0,235596,챠드,2021-04
2021-04-30,213791,0,213791,메요트,2021-04
2021-04-30,209652,1241,208411,안티가 바부다,2021-04
2021-04-30,207924,221,207703,몬테네그로,2021-04
2021-04-30,196856,9063,187793,영령 버진군도,2021-04
2021-04-30,181541,9033,172508,나미비아,2021-04
2021-04-30,157797,91667,66130,그레나다,2021-04
2021-04-30,144151,0,144151,투발루,2021-04
2021-04-30,137280,15064,122216,도미니카,2021-04
2021-04-30,135879,0,135879,지브랄타,2021-04
2021-04-30,134892,58,134834,세인트 키츠 네비스,2021-04
2021-04-30,111515,5615,105900,벨리제,2021-04
2021-04-30,77887,0,77887,세인트 빈센트 그레나딘,2021-04
2021-04-30,66627,270334,-203707,쿠바,2021-04
2021-04-30,53461,0,53461,에리트리아,2021-04
2021-04-30,49414,1258,48156,네덜란드 열도,2021-04
2021-04-30,42944,215,42729,남수단,2021-04
2021-04-30,33825,11719,22106,레소토,2021-04
2021-04-30,32995,10089,22906,부룬디,2021-04
2021-04-30,29878,0,29878,나우루,2021-04
2021-04-30,29442,87589,-58147,스와질랜드,2021-04
2021-04-30,28895,59940,-31045,상토메 프린스페,2021-04
2021-04-30,28076,15432,12644,안도라,2021-04
2021-04-30,23453,95,23358,보네르 신트외스타티위스,2021-04
2021-04-30,19810,1238641,-1218831,산마리노,2021-04
2021-04-30,16024,17865,-1841,통가,2021-04
2021-04-30,9452,0,9452,투르크 & 카이코스 군도,2021-04
2021-04-30,5560,809,4751,저어지,2021-04
2021-04-30,3565,47016,-43451,포클랜드 군도,2021-04
2021-04-30,1200,17523,-16323,건지,2021-04
2021-04-30,835,221069,-220234,기네비소,2021-04
2021-04-30,538,1774,-1236,앙귈라,2021-04
2021-04-30,507,0,507,남조지아 & 남샌드위치 군도,2021-04
2021-04-30,314,496,-182,미령 버진군도,2021-04
2021-04-30,100,71371,-71271,모나코,2021-04
2021-04-30,63,0,63,몬트세라트,2021-04
2021-04-30,52,0,52,세인트마틴(생마르탱),2021-04
2021-04-30,35,12,23,쿡 아일랜드,2021-04
2021-04-30,0,4154,-4154,자이르,2021-04
2021-04-30,0,5727,-5727,안타티카,2021-04
2021-04-30,0,16341,-16341,니우에,2021-04
2021-04-30,0,100,-100,맨섬,2021-04
2021-04-30,0,92,-92,그린랜드,2021-04
2021-04-30,0,18238,-18238,토켈라우,2021-04
2021-04-30,0,52038,-52038,코스 군도,2021-04
2021-04-30,0,680,-680,불령 남부지역,2021-04
2021-04-30,0,62233,-62233,코모로스,2021-04
2021-04-30,0,348,-348,마이너 아우틀링 합중국 군도,2021-04
2021-04-30,0,26369,-26369,세인트 헬레나,2021-04
2021-04-30,0,286,-286,영령 인도양,2021-04
2021-05-31,13246809078,10874644107,2372164971,중국,2021-05
2021-05-31,7448015955,6436130294,1011885661,미국,2021-05
2021-05-31,4167818891,1845274994,2322543897,베트남,2021-05
2021-05-31,3093419795,118045029,2975374766,홍콩,2021-05
2021-05-31,2361626618,3967898497,-1606271879,일본,2021-05
2021-05-31,1950811653,1908779417,42032236,대만,2021-05
2021-05-31,1381625105,809804541,571820564,싱가포르,2021-05
2021-05-31,993776435,583047040,410729395,인도,2021-05
2021-05-31,949239871,2023577776,-1074337905,독일,2021-05
2021-05-31,935342636,923160789,12181847,말레이시아,2021-05
2021-05-31,897618984,508953790,388665194,멕시코,2021-05
2021-05-31,772786668,1294681571,-521894903,러시아 연방,2021-05
2021-05-31,724331458,598400850,125930608,태국,2021-05
2021-05-31,687663946,710014821,-22350875,인도네시아,2021-05
2021-05-31,682264131,2075597466,-1393333335,호주,2021-05
2021-05-31,671001215,267901368,403099847,필리핀,2021-05
2021-05-31,622307401,87213760,535093641,튀르키예,2021-05
2021-05-31,566851388,120842153,446009235,폴란드,2021-05
2021-05-31,549505732,68981,549436751,마샬군도,2021-05
2021-05-31,526431561,584689678,-58258117,영국,2021-05
2021-05-31,508387340,650683915,-142296575,캐나다,2021-05
2021-05-31,429354671,674480078,-245125407,네덜란드,2021-05
2021-05-31,401070063,717599371,-316529308,이탈리아,2021-05
2021-05-31,372923725,73712804,299210921,헝가리,2021-05
2021-05-31,333899673,511990605,-178090932,브라질,2021-05
2021-05-31,323186256,189556436,133629820,벨기에,2021-05
2021-05-31,309545231,551811993,-242266762,프랑스,2021-05
2021-05-31,233804493,99139703,134664790,체코공화국,2021-05
2021-05-31,220486558,202262817,18223741,스페인,2021-05
2021-05-31,220014992,647970449,-427955457,아랍에미리트 연합,2021-05
2021-05-31,213794495,51372223,162422272,슬로바키아,2021-05
2021-05-31,196757791,1821417363,-1624659572,사우디아라비아,2021-05
2021-05-31,190716532,5332397,185384135,몰타,2021-05
2021-05-31,186053838,137877725,48176113,뉴질랜드,2021-05
2021-05-31,154491572,404656247,-250164675,칠레,2021-05
2021-05-31,148562146,1571478,146990668,우즈베키스탄,2021-05
2021-05-31,139266510,51438090,87828420,이집트,2021-05
2021-05-31,124841139,143456593,-18615454,스웨덴,2021-05
2021-05-31,124508882,156229220,-31720338,이스라엘,2021-05
2021-05-31,118737880,32072290,86665590,방글라데시,2021-05
2021-05-31,109150747,10801802,98348945,슬로베니아,2021-05
2021-05-31,108778491,2817961,105960530,파나마,2021-05
2021-05-31,106414681,167217001,-60802320,오스트리아,2021-05
2021-05-31,102445213,18936742,83508471,파키스탄,2021-05
2021-05-31,101927661,269740584,-167812923,페루,2021-05
2021-05-31,91054226,79950641,11103585,콜롬비아,2021-05
2021-05-31,80284945,152454389,-72169444,카자흐스탄,2021-05
2021-05-31,72011768,200552225,-128540457,남아프리카공화국,2021-05
2021-05-31,69244515,104049521,-34805006,아일랜드,2021-05
2021-05-31,65406031,4995,65401036,바하마,2021-05
2021-05-31,65390418,144381924,-78991506,나이지리아,2021-05
2021-05-31,60833636,406719763,-345886127,이라크,2021-05
2021-05-31,55608090,4795315,50812775,토고,2021-05
2021-05-31,54590956,7015970,47574986,요르단,2021-05
2021-05-31,51050656,41196824,9853832,포루투갈,2021-05
2021-05-31,49738948,15440930,34298018,에쿠아도르,2021-05
2021-05-31,49445619,117757089,-68311470,덴마크,2021-05
2021-05-31,48635837,36537767,12098070,루마니아,2021-05
2021-05-31,48096819,21262588,26834231,우크라이나,2021-05
2021-05-31,47340002,268806876,-221466874,스위스,2021-05
2021-05-31,42882688,754190,42128498,리비아,2021-05
2021-05-31,42733974,15023420,27710554,캄보디아,2021-05
2021-05-31,38444565,71928107,-33483542,핀란드,2021-05
2021-05-31,37349507,38895356,-1545849,푸에르토리코,2021-05
2021-05-31,36036412,2198942,33837470,몽골,2021-05
2021-05-31,35677819,7522687,28155132,튀니지,2021-05
2021-05-31,35523486,36080620,-557134,아르헨티나,2021-05
2021-05-31,34317850,106706818,-72388968,그리스,2021-05
2021-05-31,33177693,120966794,-87789101,노르웨이,2021-05
2021-05-31,31919501,777480650,-745561149,카타르,2021-05
2021-05-31,30145208,10965975,19179233,스리랑카,2021-05
2021-05-31,27518298,17905176,9613122,모로코,2021-05
2021-05-31,24763615,18297361,6466254,미얀마,2021-05
2021-05-31,24181557,4639515,19542042,가나,2021-05
2021-05-31,23968047,9861908,14106139,과테말라,2021-05
2021-05-31,23892389,24663052,-770663,엘살바도르,2021-05
2021-05-31,23380138,10688282,12691856,코스타리카,2021-05
2021-05-31,21749146,2042767,19706379,탄자니아,2021-05
2021-05-31,21425303,7098714,14326589,도미니카 공화국,2021-05
2021-05-31,20206590,19623406,583184,세르비아,2021-05
2021-05-31,18558117,147169764,-128611647,오만,2021-05
2021-05-31,18118389,70288809,-52170420,콩고민주공화국,2021-05
2021-05-31,17267462,2352734,14914728,케냐,2021-05
2021-05-31,16106215,1629679,14476536,코트디봐르,2021-05
2021-05-31,15821158,4065411,11755747,예맨,2021-05
2021-05-31,15804558,3328644,12475914,세네갈,2021-05
2021-05-31,15262256,177932154,-162669898,알제리,2021-05
2021-05-31,14899184,554589239,-539690055,쿠웨이트,2021-05
2021-05-31,14799074,12156594,2642480,우루과이,2021-05
2021-05-31,14365206,869294,13495912,수단,2021-05
2021-05-31,13967461,9824609,4142852,리투아니아,2021-05
2021-05-31,13917309,14163160,-245851,불가리아,2021-05
2021-05-31,12414817,5170719,7244098,온두라스,2021-05
2021-05-31,12333755,787014,11546741,이란,2021-05
2021-05-31,11312490,6148266,5164224,에티오피아,2021-05
2021-05-31,11287686,6577761,4709925,에스토니아,2021-05
2021-05-31,10534370,1871,10532499,앙골라,2021-05
2021-05-31,10178499,11992292,-1813793,라트비아,2021-05
2021-05-31,9745399,162884,9582515,네팔,2021-05
2021-05-31,9718544,17649345,-7930801,바레인,2021-05
2021-05-31,8637757,2892180,5745577,레바논,2021-05
2021-05-31,8420353,63904,8356449,조지아,2021-05
2021-05-31,8275746,10072935,-1797189,파라과이,2021-05
2021-05-31,8193520,600868,7592652,모잠비크,2021-05
2021-05-31,8093417,25241,8068176,아제르바이잔,2021-05
2021-05-31,8070286,12251,8058035,키르기스스탄,2021-05
2021-05-31,7935305,208332,7726973,아이티,2021-05
2021-05-31,7142760,649725,6493035,아이슬란드,2021-05
2021-05-31,6476875,151026,6325849,괌,2021-05
2021-05-31,6335024,1192590,5142434,크로아티아,2021-05
2021-05-31,6277520,3683233,2594287,라오스,2021-05
2021-05-31,5908050,358607,5549443,니카라과,2021-05
2021-05-31,5084653,246430078,-241345425,기타국,2021-05
2021-05-31,5075243,52479955,-47404712,브루나이,2021-05
2021-05-31,5042094,6983,5035111,불령 리유니온 코모도 제도,2021-05
2021-05-31,4746893,4115845,631048,벨라루스,2021-05
2021-05-31,4628894,188,4628706,타지크,2021-05
2021-05-31,4415199,299594,4115605,카메룬,2021-05
2021-05-31,4190298,10934137,-6743839,트리니다드 토바고,2021-05
2021-05-31,4142565,57593776,-53451211,파푸아 뉴기니,2021-05
2021-05-31,3633083,10529917,-6896834,룩셈부르그,2021-05
2021-05-31,3281706,4381,3277325,시리아,2021-05
2021-05-31,3202613,172178,3030435,라이베리아,2021-05
2021-05-31,3130973,0,3130973,가이아나,2021-05
2021-05-31,3118945,207803,2911142,사모아,2021-05
2021-05-31,2660569,23,2660546,부르키나 파소,2021-05
2021-05-31,2649580,927656,1721924,사이프러스,2021-05
2021-05-31,2632891,290,2632601,팔레스타인 해방기구,2021-05
2021-05-31,2601120,856510,1744610,베네주엘라,2021-05
2021-05-31,2552318,314514,2237804,피지,2021-05
2021-05-31,2547753,1065404,1482349,시에라 리온,2021-05
2021-05-31,2543061,5041861,-2498800,기니,2021-05
2021-05-31,2456695,29360,2427335,마카오,2021-05
2021-05-31,2396876,539578,1857298,우간다,2021-05
2021-05-31,2387295,12519818,-10132523,볼리비아,2021-05
2021-05-31,2242637,27347697,-25105060,뉴 칼레도니아,2021-05
2021-05-31,2190740,661341,1529399,모리셔스,2021-05
2021-05-31,2120372,2379971,-259599,아르메니아,2021-05
2021-05-31,2114649,445437,1669212,알바니아,2021-05
2021-05-31,1995964,4757870,-2761906,잠비아,2021-05
2021-05-31,1871984,128423930,-126551946,콩고,2021-05
2021-05-31,1831174,462227,1368947,자마이카,2021-05
2021-05-31,1818887,4653,1814234,아프카니스탄,2021-05
2021-05-31,1774163,371,1773792,투르크멘,2021-05
2021-05-31,1735253,784334,950919,마다카스카르,2021-05
2021-05-31,1732648,1264149,468499,리히텐슈타인,2021-05
2021-05-31,1698603,193633,1504970,짐바브웨,2021-05
2021-05-31,1674204,688,1673516,바베이도스,2021-05
2021-05-31,1596859,273606,1323253,세이쉘,2021-05
2021-05-31,1480332,509,1479823,베닝,2021-05
2021-05-31,1456953,385342,1071611,말라위,2021-05
2021-05-31,1413260,1545629,-132369,몰도바,2021-05
2021-05-31,1289943,455238,834705,지부티,2021-05
2021-05-31,1266598,55952,1210646,북마리아나 군도,2021-05
2021-05-31,1258399,0,1258399,부탄,2021-05
2021-05-31,1163697,186621,977076,르완다,2021-05
2021-05-31,1084779,692,1084087,나미비아,2021-05
2021-05-31,975514,215,975299,소말리아,2021-05
2021-05-31,923434,172744,750690,불령 폴리네시아,2021-05
2021-05-31,811495,18446,793049,세인트 루시아,2021-05
2021-05-31,809563,4375,805188,과델로프,2021-05
2021-05-31,765160,413496,351664,솔로몬 군도,2021-05
2021-05-31,741048,0,741048,세인트 마틴,2021-05
2021-05-31,676003,279744,396259,아메리칸 사모아,2021-05
2021-05-31,622389,135700,486689,마세도니아,2021-05
2021-05-31,613906,2381571,-1767665,보스니아-헤르체고비나,2021-05
2021-05-31,598472,3866785,-3268313,몬테네그로,2021-05
2021-05-31,580271,102098,478173,수리남,2021-05
2021-05-31,558102,208,557894,몰디브,2021-05
2021-05-31,551651,112052,439599,마이크로네시아,2021-05
2021-05-31,474019,0,474019,키리바티,2021-05
2021-05-31,447633,0,447633,아루바,2021-05
2021-05-31,445722,0,445722,마티니크,2021-05
2021-05-31,439647,769,438878,벨리제,2021-05
2021-05-31,417015,1286462,-869447,감비아,2021-05
2021-05-31,379876,16246,363630,도미니카,2021-05
2021-05-31,348238,12,348226,카보 베르데,2021-05
2021-05-31,303860,3458249,-3154389,모리타니,2021-05
2021-05-31,303657,2614,301043,안티가 바부다,2021-05
2021-05-31,288090,47,288043,그레나다,2021-05
2021-05-31,285316,338179,-52863,쿠바,2021-05
2021-05-31,281476,711,280765,버뮤다,2021-05
2021-05-31,281249,354530,-73281,가봉,2021-05
2021-05-31,280348,4300,276048,투발루,2021-05
2021-05-31,273483,3666148,-3392665,바누아투,2021-05
2021-05-31,264195,18451,245744,팔라우,2021-05
2021-05-31,196296,0,196296,큐라소,2021-05
2021-05-31,192890,0,192890,불령 가이아나,2021-05
2021-05-31,186242,12148,174094,보츠와나,2021-05
2021-05-31,160438,598810,-438372,말리,2021-05
2021-05-31,141863,0,141863,영령 캐이맨 군도,2021-05
2021-05-31,132935,0,132935,티모르,2021-05
2021-05-31,97954,0,97954,중앙아프리카공화국,2021-05
2021-05-31,93544,10769,82775,부룬디,2021-05
2021-05-31,91852,1075,90777,코모로스,2021-05
2021-05-31,90270,321936,-231666,기네비소,2021-05
2021-05-31,77862,105163,-27301,스와질랜드,2021-05
2021-05-31,71402,909,70493,상토메 프린스페,2021-05
2021-05-31,62640,11916,50724,레소토,2021-05
2021-05-31,58368,5942,52426,세인트 키츠 네비스,2021-05
2021-05-31,54499,30602,23897,네덜란드 열도,2021-05
2021-05-31,49105,1176,47929,지브랄타,2021-05
2021-05-31,41657,1441,40216,세인트 빈센트 그레나딘,2021-05
2021-05-31,33491,1010325,-976834,니제르,2021-05
2021-05-31,23581,1213532,-1189951,산마리노,2021-05
2021-05-31,17295,0,17295,메요트,2021-05
2021-05-31,12532,0,12532,세인트 바르탤르미,2021-05
2021-05-31,6954,0,6954,챠드,2021-05
2021-05-31,5168,632,4536,영령 버진군도,2021-05
2021-05-31,3278,17160,-13882,안도라,2021-05
2021-05-31,3089,993,2096,미령 버진군도,2021-05
2021-05-31,2202,62015,-59813,모나코,2021-05
2021-05-31,1675,0,1675,적도 기니,2021-05
2021-05-31,1387,2006,-619,앙귈라,2021-05
2021-05-31,1250,0,1250,세인트마틴(생마르탱),2021-05
2021-05-31,675,0,675,쿡 아일랜드,2021-05
2021-05-31,277,686,-409,저어지,2021-05
2021-05-31,236,154,82,그린랜드,2021-05
2021-05-31,154,0,154,남수단,2021-05
2021-05-31,25,28367,-28342,통가,2021-05
2021-05-31,0,201,-201,안타티카,2021-05
2021-05-31,0,9648944,-9648944,에리트리아,2021-05
2021-05-31,0,201,-201,불령 남부지역,2021-05
2021-05-31,0,92621,-92621,니우에,2021-05
2021-05-31,0,1849,-1849,건지,2021-05
2021-05-31,0,12486,-12486,맨섬,2021-05
2021-05-31,0,2816036,-2816036,나우루,2021-05
2021-05-31,0,510,-510,영령 인도양,2021-05
2021-05-31,0,1394,-1394,코스 군도,2021-05
2021-05-31,0,35995,-35995,파로에 군도,2021-05
2021-05-31,0,225214,-225214,토켈라우,2021-05
2021-06-30,13070490087,11423625298,1646864789,중국,2021-06
2021-06-30,8717226261,6489351064,2227875197,미국,2021-06
2021-06-30,4581970971,1783297364,2798673607,베트남,2021-06
2021-06-30,3471242070,160787802,3310454268,홍콩,2021-06
2021-06-30,2597105443,4599343067,-2002237624,일본,2021-06
2021-06-30,2062478197,1818776846,243701351,대만,2021-06
2021-06-30,1181818729,982946425,198872304,싱가포르,2021-06
2021-06-30,1166422432,586353878,580068554,인도,2021-06
2021-06-30,1019440456,1850097770,-830657314,독일,2021-06
2021-06-30,987867718,581671027,406196691,멕시코,2021-06
2021-06-30,961016755,1310181028,-349164273,러시아 연방,2021-06
2021-06-30,847889465,2276419402,-1428529937,호주,2021-06
2021-06-30,772821083,902933368,-130112285,말레이시아,2021-06
2021-06-30,770670651,285862232,484808419,필리핀,2021-06
2021-06-30,699459586,750259971,-50800385,인도네시아,2021-06
2021-06-30,680937894,651293839,29644055,태국,2021-06
2021-06-30,607967967,120452197,487515770,폴란드,2021-06
2021-06-30,585635676,625301738,-39666062,캐나다,2021-06
2021-06-30,562838304,504089450,58748854,영국,2021-06
2021-06-30,542797950,107408290,435389660,튀르키예,2021-06
2021-06-30,514040781,718431698,-204390917,네덜란드,2021-06
2021-06-30,423260010,15930,423244080,라이베리아,2021-06
2021-06-30,406244513,746177795,-339933282,브라질,2021-06
2021-06-30,399508679,566904495,-167395816,프랑스,2021-06
2021-06-30,389021559,745647398,-356625839,이탈리아,2021-06
2021-06-30,387585004,246684523,140900481,벨기에,2021-06
2021-06-30,359132136,65947304,293184832,마샬군도,2021-06
2021-06-30,352357400,558599301,-206241901,아랍에미리트 연합,2021-06
2021-06-30,326191757,82995398,243196359,헝가리,2021-06
2021-06-30,267149693,92833803,174315890,체코공화국,2021-06
2021-06-30,252604209,1925312052,-1672707843,사우디아라비아,2021-06
2021-06-30,230005998,57603289,172402709,슬로바키아,2021-06
2021-06-30,215329943,2041322,213288621,우즈베키스탄,2021-06
2021-06-30,211020315,236254924,-25234609,스페인,2021-06
2021-06-30,209711722,55476481,154235241,파나마,2021-06
2021-06-30,190698767,1869,190696898,버뮤다,2021-06
2021-06-30,157207015,46184374,111022641,이집트,2021-06
2021-06-30,155608938,418411016,-262802078,칠레,2021-06
2021-06-30,153816052,129467805,24348247,이스라엘,2021-06
2021-06-30,148455480,1692,148453788,바하마,2021-06
2021-06-30,141245942,133284516,7961426,뉴질랜드,2021-06
2021-06-30,136305944,23656737,112649207,파키스탄,2021-06
2021-06-30,133764041,23386443,110377598,방글라데시,2021-06
2021-06-30,124085172,12227635,111857537,나이지리아,2021-06
2021-06-30,116510621,162084827,-45574206,스웨덴,2021-06
2021-06-30,114038261,77961982,36076279,아일랜드,2021-06
2021-06-30,106320255,6044140,100276115,몰타,2021-06
2021-06-30,99860028,13355949,86504079,슬로베니아,2021-06
2021-06-30,97286410,239592498,-142306088,남아프리카공화국,2021-06
2021-06-30,89192886,196185573,-106992687,오스트리아,2021-06
2021-06-30,72592543,317418150,-244825607,이라크,2021-06
2021-06-30,70052388,153803115,-83750727,페루,2021-06
2021-06-30,68605931,262021031,-193415100,스위스,2021-06
2021-06-30,67970552,41521012,26449540,포루투갈,2021-06
2021-06-30,60658951,329885593,-269226642,카자흐스탄,2021-06
2021-06-30,60001532,3207959,56793573,토고,2021-06
2021-06-30,58948402,9351985,49596417,에쿠아도르,2021-06
2021-06-30,57556779,121279503,-63722724,콜롬비아,2021-06
2021-06-30,55882309,9176933,46705376,우크라이나,2021-06
2021-06-30,54962442,42952252,12010190,루마니아,2021-06
2021-06-30,54932646,19937284,34995362,캄보디아,2021-06
2021-06-30,54273920,81323215,-27049295,핀란드,2021-06
2021-06-30,53611035,34544324,19066711,카메룬,2021-06
2021-06-30,47933854,25136412,22797442,푸에르토리코,2021-06
2021-06-30,47141563,278117032,-230975469,노르웨이,2021-06
2021-06-30,44566172,285150,44281022,리비아,2021-06
2021-06-30,41113877,6895280,34218597,요르단,2021-06
2021-06-30,40900532,85522022,-44621490,그리스,2021-06
2021-06-30,40549107,2955259,37593848,몽골,2021-06
2021-06-30,40439393,89801974,-49362581,덴마크,2021-06
2021-06-30,40114040,626882965,-586768925,쿠웨이트,2021-06
2021-06-30,38510928,332063767,-293552839,오만,2021-06
2021-06-30,35482513,17312251,18170262,미얀마,2021-06
2021-06-30,33674687,8066525,25608162,도미니카 공화국,2021-06
2021-06-30,32001599,108978804,-76977205,아르헨티나,2021-06
2021-06-30,30347371,25422103,4925268,모로코,2021-06
2021-06-30,29738937,1909259,27829678,가나,2021-06
2021-06-30,29031798,7702613,21329185,과테말라,2021-06
2021-06-30,27229525,710967124,-683737599,카타르,2021-06
2021-06-30,25450234,35841113,-10390879,바레인,2021-06
2021-06-30,24698225,15396284,9301941,스리랑카,2021-06
2021-06-30,23875143,8977439,14897704,리투아니아,2021-06
2021-06-30,22462877,585194,21877683,괌,2021-06
2021-06-30,20612961,25581062,-4968101,세르비아,2021-06
2021-06-30,18134136,3292996,14841140,엘살바도르,2021-06
2021-06-30,17449965,302868,17147097,이란,2021-06
2021-06-30,17049144,30045047,-12995903,코스타리카,2021-06
2021-06-30,16636891,16335969,300922,불가리아,2021-06
2021-06-30,15994229,326738,15667491,네팔,2021-06
2021-06-30,15659577,1017660,14641917,수단,2021-06
2021-06-30,15591631,8456489,7135142,튀니지,2021-06
2021-06-30,15435524,148109128,-132673604,알제리,2021-06
2021-06-30,14517361,1085291,13432070,탄자니아,2021-06
2021-06-30,12786590,6742807,6043783,케냐,2021-06
2021-06-30,12500858,23567265,-11066407,온두라스,2021-06
2021-06-30,11432193,749903,10682290,코트디봐르,2021-06
2021-06-30,10455988,1189,10454799,앙골라,2021-06
2021-06-30,9987955,861210,9126745,파라과이,2021-06
2021-06-30,9573249,8466909,1106340,우루과이,2021-06
2021-06-30,9418641,10279774,-861133,에티오피아,2021-06
2021-06-30,9356858,482570,8874288,아이티,2021-06
2021-06-30,9303792,8582318,721474,에스토니아,2021-06
2021-06-30,9296312,588255,8708057,아제르바이잔,2021-06
2021-06-30,9237764,9812051,-574287,벨라루스,2021-06
2021-06-30,9198654,20611,9178043,키르기스스탄,2021-06
2021-06-30,8976353,1200241,7776112,크로아티아,2021-06
2021-06-30,8625183,345461178,-336835995,기타국,2021-06
2021-06-30,8169208,4645325,3523883,레바논,2021-06
2021-06-30,7998164,10424551,-2426387,니카라과,2021-06
2021-06-30,6848342,9484052,-2635710,라트비아,2021-06
2021-06-30,6757751,3456572,3301179,세네갈,2021-06
2021-06-30,6665185,1283857,5381328,조지아,2021-06
2021-06-30,6185792,21003866,-14818074,모잠비크,2021-06
2021-06-30,6060655,273662,5786993,팔레스타인 해방기구,2021-06
2021-06-30,6052796,103392,5949404,부르키나 파소,2021-06
2021-06-30,5664779,3198303,2466476,기니,2021-06
2021-06-30,5465740,204297,5261443,피지,2021-06
2021-06-30,5321927,21386040,-16064113,잠비아,2021-06
2021-06-30,5271309,0,5271309,타지크,2021-06
2021-06-30,5026092,7181994,-2155902,예맨,2021-06
2021-06-30,4069751,4512928,-443177,라오스,2021-06
2021-06-30,3856475,18263403,-14406928,볼리비아,2021-06
2021-06-30,3750768,87891464,-84140696,콩고민주공화국,2021-06
2021-06-30,3726876,495521,3231355,브루나이,2021-06
2021-06-30,3651912,8328,3643584,불령 리유니온 코모도 제도,2021-06
2021-06-30,3575864,11118997,-7543133,아르메니아,2021-06
2021-06-30,3435302,74237,3361065,자마이카,2021-06
2021-06-30,3015526,15204,3000322,시리아,2021-06
2021-06-30,2943866,69759,2874107,마카오,2021-06
2021-06-30,2906556,38765248,-35858692,파푸아 뉴기니,2021-06
2021-06-30,2846103,4678987,-1832884,아이슬란드,2021-06
2021-06-30,2817681,286509,2531172,사이프러스,2021-06
2021-06-30,2517441,1589801,927640,마다카스카르,2021-06
2021-06-30,2473575,44829,2428746,르완다,2021-06
2021-06-30,2374547,0,2374547,키리바티,2021-06
2021-06-30,2344682,13799920,-11455238,룩셈부르그,2021-06
2021-06-30,2327878,19886629,-17558751,트리니다드 토바고,2021-06
2021-06-30,2262532,121917,2140615,불령 폴리네시아,2021-06
2021-06-30,2232633,901079,1331554,알바니아,2021-06
2021-06-30,2178203,215595,1962608,모리셔스,2021-06
2021-06-30,2169732,892,2168840,부탄,2021-06
2021-06-30,2107382,362987,1744395,지부티,2021-06
2021-06-30,2058734,515253,1543481,우간다,2021-06
2021-06-30,1956011,58,1955953,베닝,2021-06
2021-06-30,1921640,472058,1449582,짐바브웨,2021-06
2021-06-30,1888551,104555,1783996,아메리칸 사모아,2021-06
2021-06-30,1884249,27156241,-25271992,뉴 칼레도니아,2021-06
2021-06-30,1751395,291482,1459913,사모아,2021-06
2021-06-30,1697248,1672300,24948,시에라 리온,2021-06
2021-06-30,1657295,125899,1531396,가이아나,2021-06
2021-06-30,1653374,1109615,543759,리히텐슈타인,2021-06
2021-06-30,1582300,1652628,-70328,몰도바,2021-06
2021-06-30,1548750,0,1548750,세인트 마틴,2021-06
2021-06-30,1535891,159047,1376844,아프카니스탄,2021-06
2021-06-30,1525339,62,1525277,마티니크,2021-06
2021-06-30,1427952,2196026,-768074,콩고,2021-06
2021-06-30,1420578,437914,982664,베네주엘라,2021-06
2021-06-30,1213531,108506,1105025,북마리아나 군도,2021-06
2021-06-30,1099968,494634,605334,나미비아,2021-06
2021-06-30,1057604,1222272,-164668,말리,2021-06
2021-06-30,918081,483940,434141,세이쉘,2021-06
2021-06-30,902976,71687,831289,마이크로네시아,2021-06
2021-06-30,892668,12244,880424,바베이도스,2021-06
2021-06-30,754602,2013734,-1259132,보스니아-헤르체고비나,2021-06
2021-06-30,740025,146,739879,카보 베르데,2021-06
2021-06-30,733964,198,733766,아루바,2021-06
2021-06-30,711310,1409891,-698581,모리타니,2021-06
2021-06-30,702579,2520240,-1817661,솔로몬 군도,2021-06
2021-06-30,688600,164722,523878,소말리아,2021-06
2021-06-30,569967,0,569967,큐라소,2021-06
2021-06-30,560168,55,560113,불령 가이아나,2021-06
2021-06-30,527144,310632,216512,쿠바,2021-06
2021-06-30,498439,0,498439,영령 캐이맨 군도,2021-06
2021-06-30,477791,60,477731,과델로프,2021-06
2021-06-30,443900,38370,405530,스와질랜드,2021-06
2021-06-30,433908,294614,139294,수리남,2021-06
2021-06-30,362903,659,362244,몰디브,2021-06
2021-06-30,342630,20104,322526,투르크멘,2021-06
2021-06-30,307010,0,307010,그레나다,2021-06
2021-06-30,298963,732580,-433617,마세도니아,2021-06
2021-06-30,296321,302947,-6626,바누아투,2021-06
2021-06-30,289754,0,289754,메요트,2021-06
2021-06-30,273534,123936287,-123662753,가봉,2021-06
2021-06-30,271136,3528370,-3257234,몬테네그로,2021-06
2021-06-30,268693,0,268693,영령 버진군도,2021-06
2021-06-30,265666,2591,263075,안티가 바부다,2021-06
2021-06-30,251170,1431850,-1180680,벨리제,2021-06
2021-06-30,250949,38481,212468,보츠와나,2021-06
2021-06-30,236887,0,236887,세인트 바르탤르미,2021-06
2021-06-30,231122,21277,209845,팔라우,2021-06
2021-06-30,215806,0,215806,상토메 프린스페,2021-06
2021-06-30,209209,174852,34357,기네비소,2021-06
2021-06-30,192146,251520,-59374,도미니카,2021-06
2021-06-30,184074,28174,155900,세인트 루시아,2021-06
2021-06-30,174392,32069,142323,남수단,2021-06
2021-06-30,141450,138,141312,세인트 빈센트 그레나딘,2021-06
2021-06-30,140252,2488733,-2348481,니제르,2021-06
2021-06-30,138518,50,138468,감비아,2021-06
2021-06-30,136181,9780,126401,마이너 아우틀링 합중국 군도,2021-06
2021-06-30,114505,228,114277,티모르,2021-06
2021-06-30,111995,519,111476,네덜란드 열도,2021-06
2021-06-30,111628,0,111628,투발루,2021-06
2021-06-30,45925,1135,44790,지브랄타,2021-06
2021-06-30,45216,368,44848,중앙아프리카공화국,2021-06
2021-06-30,40124,21,40103,세인트 키츠 네비스,2021-06
2021-06-30,40005,38994,1011,통가,2021-06
2021-06-30,39761,1039,38722,나우루,2021-06
2021-06-30,36400,2282074,-2245674,산마리노,2021-06
2021-06-30,34811,486,34325,챠드,2021-06
2021-06-30,22165,334,21831,투르크 & 카이코스 군도,2021-06
2021-06-30,21060,30596,-9536,코모로스,2021-06
2021-06-30,19124,19339,-215,안도라,2021-06
2021-06-30,7400,23674,-16274,모나코,2021-06
2021-06-30,6212,30806,-24594,부룬디,2021-06
2021-06-30,5178,544,4634,남조지아 & 남샌드위치 군도,2021-06
2021-06-30,3255,32751,-29496,미령 버진군도,2021-06
2021-06-30,2302,1181,1121,앙귈라,2021-06
2021-06-30,2186,135572,-133386,말라위,2021-06
2021-06-30,2185,76373241,-76371056,적도 기니,2021-06
2021-06-30,1100,87620,-86520,토켈라우,2021-06
2021-06-30,1050,26290142,-26289092,에리트리아,2021-06
2021-06-30,795,0,795,세인트마틴(생마르탱),2021-06
2021-06-30,687,457,230,그린랜드,2021-06
2021-06-30,375,1397,-1022,저어지,2021-06
2021-06-30,342,0,342,피트카이른,2021-06
2021-06-30,0,25345,-25345,니우에,2021-06
2021-06-30,0,3542,-3542,안타티카,2021-06
2021-06-30,0,133,-133,몬트세라트,2021-06
2021-06-30,0,162,-162,보빗군도,2021-06
2021-06-30,0,59,-59,포클랜드 군도,2021-06
2021-06-30,0,156,-156,크리스마스 아일랜드,2021-06
2021-06-30,0,763,-763,서사하라,2021-06
2021-06-30,0,11744,-11744,코스 군도,2021-06
2021-06-30,0,155,-155,불령 남부지역,2021-06
2021-06-30,0,1936,-1936,파로에 군도,2021-06
2021-06-30,0,295,-295,왈라스 & 퓨투나 군도,2021-06
2021-06-30,0,5051,-5051,레소토,2021-06
2021-07-31,13586374429,11524029841,2062344588,중국,2021-07
2021-07-31,8724015829,6339476701,2384539128,미국,2021-07
2021-07-31,4934034094,1989460723,2944573371,베트남,2021-07
2021-07-31,2872361283,267292784,2605068499,홍콩,2021-07
2021-07-31,2565013671,4536865223,-1971851552,일본,2021-07
2021-07-31,2022049659,2049201529,-27151870,대만,2021-07
2021-07-31,1582734677,831688468,751046209,싱가포르,2021-07
2021-07-31,1229935201,711401684,518533517,인도,2021-07
2021-07-31,1129022868,780730613,348292255,멕시코,2021-07
2021-07-31,899640559,3184507243,-2284866684,호주,2021-07
2021-07-31,806026129,1183476522,-377450393,러시아 연방,2021-07
2021-07-31,786896449,352739349,434157100,필리핀,2021-07
2021-07-31,777134953,624971462,152163491,태국,2021-07
2021-07-31,771280468,1908267396,-1136986928,독일,2021-07
2021-07-31,745959010,890220459,-144261449,말레이시아,2021-07
2021-07-31,691665557,1076989434,-385323877,인도네시아,2021-07
2021-07-31,668500048,68105224,600394824,마샬군도,2021-07
2021-07-31,584110997,96949210,487161787,폴란드,2021-07
2021-07-31,578480387,406352668,172127719,캐나다,2021-07
2021-07-31,565577878,475487795,90090083,영국,2021-07
2021-07-31,517861434,1225848254,-707986820,네덜란드,2021-07
2021-07-31,513924087,75353642,438570445,튀르키예,2021-07
2021-07-31,396462892,761559749,-365096857,이탈리아,2021-07
2021-07-31,389986804,62176038,327810766,헝가리,2021-07
2021-07-31,382307610,6223138,376084472,몰타,2021-07
2021-07-31,376549206,777555360,-401006154,브라질,2021-07
2021-07-31,359935344,554274791,-194339447,아랍에미리트 연합,2021-07
2021-07-31,356389216,309143148,47246068,벨기에,2021-07
2021-07-31,313800479,1839191483,-1525391004,사우디아라비아,2021-07
2021-07-31,311444339,562885348,-251441009,프랑스,2021-07
2021-07-31,311359364,123138748,188220616,그리스,2021-07
2021-07-31,234084451,93653847,140430604,체코공화국,2021-07
2021-07-31,214470209,276185728,-61715519,스페인,2021-07
2021-07-31,211449375,152911716,58537659,뉴질랜드,2021-07
2021-07-31,204332795,47404041,156928754,슬로바키아,2021-07
2021-07-31,186336186,34706790,151629396,방글라데시,2021-07
2021-07-31,176009448,2389910,173619538,우즈베키스탄,2021-07
2021-07-31,174899318,100133619,74765699,파나마,2021-07
2021-07-31,158297621,454780605,-296482984,칠레,2021-07
2021-07-31,148961851,106507417,42454434,이스라엘,2021-07
2021-07-31,148752955,351513,148401442,라이베리아,2021-07
2021-07-31,137294564,51455056,85839508,이집트,2021-07
2021-07-31,127710549,16829795,110880754,파키스탄,2021-07
2021-07-31,118496322,11180152,107316170,슬로베니아,2021-07
2021-07-31,111496795,7635515,103861280,에쿠아도르,2021-07
2021-07-31,106746131,1014562,105731569,토고,2021-07
2021-07-31,102933135,176111047,-73177912,오스트리아,2021-07
2021-07-31,94821567,307996359,-213174792,스위스,2021-07
2021-07-31,93273282,195616132,-102342850,남아프리카공화국,2021-07
2021-07-31,93116671,180143497,-87026826,스웨덴,2021-07
2021-07-31,82174539,52536140,29638399,콜롬비아,2021-07
2021-07-31,81785477,535760116,-453974639,이라크,2021-07
2021-07-31,81383494,462966435,-381582941,페루,2021-07
2021-07-31,81051002,36540638,44510364,포루투갈,2021-07
2021-07-31,80566386,39745900,40820486,나이지리아,2021-07
2021-07-31,70292947,28823033,41469914,캄보디아,2021-07
2021-07-31,70243696,8458435,61785261,요르단,2021-07
2021-07-31,56450347,110466385,-54016038,아일랜드,2021-07
2021-07-31,54230055,261220791,-206990736,카자흐스탄,2021-07
2021-07-31,53680920,64019536,-10338616,루마니아,2021-07
2021-07-31,52539140,353554682,-301015542,노르웨이,2021-07
2021-07-31,49759289,26930262,22829027,우크라이나,2021-07
2021-07-31,49665881,84872616,-35206735,덴마크,2021-07
2021-07-31,40924859,23165271,17759588,푸에르토리코,2021-07
2021-07-31,38864710,2435111,36429599,몽골,2021-07
2021-07-31,37142784,26935280,10207504,미얀마,2021-07
2021-07-31,31759447,93016046,-61256599,핀란드,2021-07
2021-07-31,30546863,9900392,20646471,스리랑카,2021-07
2021-07-31,30357622,930567,29427055,리비아,2021-07
2021-07-31,29629397,17405453,12223944,모로코,2021-07
2021-07-31,28995272,7603634,21391638,과테말라,2021-07
2021-07-31,28313676,1967095,26346581,엘살바도르,2021-07
2021-07-31,28056855,126799795,-98742940,아르헨티나,2021-07
2021-07-31,27866052,883460015,-855593963,카타르,2021-07
2021-07-31,25765850,9990421,15775429,도미니카 공화국,2021-07
2021-07-31,25650080,220264,25429816,피지,2021-07
2021-07-31,24831445,390793579,-365962134,오만,2021-07
2021-07-31,22875043,3224444,19650599,세르비아,2021-07
2021-07-31,22865238,4090224,18775014,가나,2021-07
2021-07-31,21711475,810658571,-788947096,쿠웨이트,2021-07
2021-07-31,19929822,8645417,11284405,에티오피아,2021-07
2021-07-31,19394692,12188268,7206424,리투아니아,2021-07
2021-07-31,17254354,149178276,-131923922,코스타리카,2021-07
2021-07-31,17209857,403694,16806163,탄자니아,2021-07
2021-07-31,17043732,615301,16428431,괌,2021-07
2021-07-31,15562329,4586159,10976170,케냐,2021-07
2021-07-31,15268078,440558,14827520,코트디봐르,2021-07
2021-07-31,13995264,121728631,-107733367,알제리,2021-07
2021-07-31,13541480,151285,13390195,수단,2021-07
2021-07-31,13172618,4529037,8643581,온두라스,2021-07
2021-07-31,13058246,14398717,-1340471,불가리아,2021-07
2021-07-31,12899034,115156925,-102257891,바레인,2021-07
2021-07-31,12811184,3184045,9627139,예맨,2021-07
2021-07-31,11377797,1369255,10008542,파라과이,2021-07
2021-07-31,10871119,269751,10601368,이란,2021-07
2021-07-31,10374766,12199777,-1825011,우루과이,2021-07
2021-07-31,10138876,14731946,-4593070,벨라루스,2021-07
2021-07-31,10009578,2968,10006610,키르기스스탄,2021-07
2021-07-31,9564989,11370334,-1805345,튀니지,2021-07
2021-07-31,8433080,3539288,4893792,에스토니아,2021-07
2021-07-31,8210069,8682906,-472837,세네갈,2021-07
2021-07-31,8122082,3943695,4178387,크로아티아,2021-07
2021-07-31,7483473,11393128,-3909655,라트비아,2021-07
2021-07-31,7387645,1398,7386247,앙골라,2021-07
2021-07-31,6891101,155228,6735873,아이티,2021-07
2021-07-31,6720969,394853,6326116,말리,2021-07
2021-07-31,6651807,37635138,-30983331,카메룬,2021-07
2021-07-31,6501109,1104832,5396277,조지아,2021-07
2021-07-31,6428907,199677,6229230,팔레스타인 해방기구,2021-07
2021-07-31,6426272,3428034,2998238,라오스,2021-07
2021-07-31,6337218,357551,5979667,아제르바이잔,2021-07
2021-07-31,6149418,443013,5706405,모잠비크,2021-07
2021-07-31,5925033,12927587,-7002554,룩셈부르그,2021-07
2021-07-31,5761105,2744930,3016175,레바논,2021-07
2021-07-31,5718179,751470,4966709,니카라과,2021-07
2021-07-31,5633037,1714,5631323,불령 리유니온 코모도 제도,2021-07
2021-07-31,5563087,13734,5549353,불령 폴리네시아,2021-07
2021-07-31,5439582,37244868,-31805286,파푸아 뉴기니,2021-07
2021-07-31,5416315,2263455,3152860,아이슬란드,2021-07
2021-07-31,5215033,323,5214710,마티니크,2021-07
2021-07-31,4835920,337479,4498441,자마이카,2021-07
2021-07-31,4610256,1616413,2993843,베네주엘라,2021-07
2021-07-31,4355900,161474,4194426,브루나이,2021-07
2021-07-31,4127733,4738842,-611109,기니,2021-07
2021-07-31,4067061,379445383,-375378322,기타국,2021-07
2021-07-31,3960750,647242,3313508,사이프러스,2021-07
2021-07-31,3836427,2140,3834287,타지크,2021-07
2021-07-31,3513891,225662,3288229,네팔,2021-07
2021-07-31,3453434,443201,3010233,모리셔스,2021-07
2021-07-31,3313654,37218,3276436,부르키나 파소,2021-07
2021-07-31,3174512,1054536,2119976,알바니아,2021-07
2021-07-31,3127550,14647,3112903,팔라우,2021-07
2021-07-31,2942769,9665394,-6722625,잠비아,2021-07
2021-07-31,2877300,825008,2052292,마다카스카르,2021-07
2021-07-31,2793293,89346,2703947,사모아,2021-07
2021-07-31,2431291,5260,2426031,시리아,2021-07
2021-07-31,2201057,1742809,458248,아르메니아,2021-07
2021-07-31,2063351,28556552,-26493201,트리니다드 토바고,2021-07
2021-07-31,2038479,57234347,-55195868,볼리비아,2021-07
2021-07-31,2024920,110395,1914525,가이아나,2021-07
2021-07-31,1972681,39864,1932817,아프카니스탄,2021-07
2021-07-31,1819044,524447,1294597,우간다,2021-07
2021-07-31,1782647,209156,1573491,지부티,2021-07
2021-07-31,1772293,3123109,-1350816,몰도바,2021-07
2021-07-31,1706635,50643,1655992,마카오,2021-07
2021-07-31,1689075,31229324,-29540249,뉴 칼레도니아,2021-07
2021-07-31,1434685,905237,529448,리히텐슈타인,2021-07
2021-07-31,1353458,623,1352835,바하마,2021-07
2021-07-31,1325813,8002990,-6677177,나미비아,2021-07
2021-07-31,1316180,0,1316180,베닝,2021-07
2021-07-31,1303173,683566,619607,세이쉘,2021-07
2021-07-31,1278205,68440757,-67162552,콩고,2021-07
2021-07-31,1225092,134808,1090284,르완다,2021-07
2021-07-31,1215575,304903,910672,짐바브웨,2021-07
2021-07-31,1087554,199542,888012,말라위,2021-07
2021-07-31,1084714,3088382,-2003668,모리타니,2021-07
2021-07-31,1039327,0,1039327,소말리아,2021-07
2021-07-31,1029028,73288369,-72259341,콩고민주공화국,2021-07
2021-07-31,778703,258,778445,부탄,2021-07
2021-07-31,776149,67983,708166,북마리아나 군도,2021-07
2021-07-31,749164,0,749164,세인트 마틴,2021-07
2021-07-31,701737,90,701647,불령 가이아나,2021-07
2021-07-31,696375,520169,176206,솔로몬 군도,2021-07
2021-07-31,680037,58944,621093,쿠바,2021-07
2021-07-31,664869,145570,519299,마이크로네시아,2021-07
2021-07-31,633553,36559,596994,아루바,2021-07
2021-07-31,631327,361,630966,투르크멘,2021-07
2021-07-31,584947,100381,484566,수리남,2021-07
2021-07-31,582145,0,582145,과델로프,2021-07
2021-07-31,579398,0,579398,키리바티,2021-07
2021-07-31,571008,4052340,-3481332,보스니아-헤르체고비나,2021-07
2021-07-31,563234,124383,438851,아메리칸 사모아,2021-07
2021-07-31,522137,5710,516427,몰디브,2021-07
2021-07-31,518696,205145,313551,마세도니아,2021-07
2021-07-31,464274,48903,415371,가봉,2021-07
2021-07-31,394815,0,394815,영령 캐이맨 군도,2021-07
2021-07-31,389835,397884,-8049,감비아,2021-07
2021-07-31,339227,1309,337918,카보 베르데,2021-07
2021-07-31,332562,714229,-381667,시에라 리온,2021-07
2021-07-31,328710,72,328638,부룬디,2021-07
2021-07-31,302063,48770,253293,버뮤다,2021-07
2021-07-31,289582,1149386,-859804,바누아투,2021-07
2021-07-31,281173,4345,276828,벨리제,2021-07
2021-07-31,276238,17910,258328,도미니카,2021-07
2021-07-31,272108,0,272108,세인트 루시아,2021-07
2021-07-31,268349,0,268349,큐라소,2021-07
2021-07-31,253614,2294098,-2040484,몬테네그로,2021-07
2021-07-31,221917,41257,180660,바베이도스,2021-07
2021-07-31,181002,0,181002,세인트 빈센트 그레나딘,2021-07
2021-07-31,167873,5,167868,투발루,2021-07
2021-07-31,162069,0,162069,남수단,2021-07
2021-07-31,115058,59882,55176,보츠와나,2021-07
2021-07-31,110180,100,110080,영령 버진군도,2021-07
2021-07-31,100711,645,100066,나우루,2021-07
2021-07-31,99700,71569,28131,안티가 바부다,2021-07
2021-07-31,73643,289202,-215559,니제르,2021-07
2021-07-31,71775,92092,-20317,스와질랜드,2021-07
2021-07-31,70226,0,70226,투르크 & 카이코스 군도,2021-07
2021-07-31,56288,13167,43121,앙귈라,2021-07
2021-07-31,52946,0,52946,그레나다,2021-07
2021-07-31,50865,71026271,-70975406,적도 기니,2021-07
2021-07-31,41210,678820,-637610,산마리노,2021-07
2021-07-31,38266,745,37521,네덜란드 열도,2021-07
2021-07-31,32245,0,32245,지브랄타,2021-07
2021-07-31,19593,211,19382,상토메 프린스페,2021-07
2021-07-31,14642,62990,-48348,레소토,2021-07
2021-07-31,11069,0,11069,티모르,2021-07
2021-07-31,6286,30649,-24363,코모로스,2021-07
2021-07-31,4781,294960,-290179,모나코,2021-07
2021-07-31,3883,12293,-8410,안도라,2021-07
2021-07-31,3434,0,3434,왈라스 & 퓨투나 군도,2021-07
2021-07-31,3005,300,2705,남조지아 & 남샌드위치 군도,2021-07
2021-07-31,2357,79473,-77116,중앙아프리카공화국,2021-07
2021-07-31,1476,2793,-1317,쿡 아일랜드,2021-07
2021-07-31,208,11581,-11373,그린랜드,2021-07
2021-07-31,184,8252,-8068,미령 버진군도,2021-07
2021-07-31,178,513,-335,저어지,2021-07
2021-07-31,10,0,10,파로에 군도,2021-07
2021-07-31,0,50,-50,코스 군도,2021-07
2021-07-31,0,14769,-14769,니우에,2021-07
2021-07-31,0,154,-154,토켈라우,2021-07
2021-07-31,0,8190,-8190,몬트세라트,2021-07
2021-07-31,0,117,-117,불령 남부지역,2021-07
2021-07-31,0,850,-850,통가,2021-07
2021-07-31,0,219,-219,크리스마스 아일랜드,2021-07
2021-07-31,0,1033,-1033,마이너 아우틀링 합중국 군도,2021-07
2021-07-31,0,22834529,-22834529,에리트리아,2021-07
2021-07-31,0,4367,-4367,세인트 키츠 네비스,2021-07
2021-07-31,0,250,-250,자이르,2021-07
2021-08-31,13881327880,11731429287,2149898593,중국,2021-08
2021-08-31,7704223847,6210231515,1493992332,미국,2021-08
2021-08-31,4850337611,2123504026,2726833585,베트남,2021-08
2021-08-31,3415828590,154167061,3261661529,홍콩,2021-08
2021-08-31,2522980082,4454302301,-1931322219,일본,2021-08
2021-08-31,2138340073,2026277873,112062200,대만,2021-08
2021-08-31,1285755417,737522587,548232830,인도,2021-08
2021-08-31,1116603698,745968425,370635273,싱가포르,2021-08
2021-08-31,1023432987,726516881,296916106,멕시코,2021-08
2021-08-31,819656788,361877718,457779070,필리핀,2021-08
2021-08-31,786967899,1709551134,-922583235,독일,2021-08
2021-08-31,714211129,710922606,3288523,말레이시아,2021-08
2021-08-31,692950837,601298441,91652396,태국,2021-08
2021-08-31,675742044,2761561458,-2085819414,호주,2021-08
2021-08-31,674274193,1537346421,-863072228,러시아 연방,2021-08
2021-08-31,642310442,1028246351,-385935909,인도네시아,2021-08
2021-08-31,633965860,81144362,552821498,튀르키예,2021-08
2021-08-31,551474063,91896489,459577574,폴란드,2021-08
2021-08-31,506810758,4739050,502071708,몰타,2021-08
2021-08-31,476617046,346709305,129907741,영국,2021-08
2021-08-31,432764579,495560400,-62795821,캐나다,2021-08
2021-08-31,428744086,564690982,-135946896,네덜란드,2021-08
2021-08-31,372396263,604836223,-232439960,아랍에미리트 연합,2021-08
2021-08-31,361186333,331981575,29204758,벨기에,2021-08
2021-08-31,338870109,642550363,-303680254,이탈리아,2021-08
2021-08-31,322910173,61362057,261548116,헝가리,2021-08
2021-08-31,322290388,429070764,-106780376,브라질,2021-08
2021-08-31,266815444,220666,266594778,라이베리아,2021-08
2021-08-31,264390721,28018431,236372290,파나마,2021-08
2021-08-31,251590824,566476767,-314885943,프랑스,2021-08
2021-08-31,234013530,84817415,149196115,체코공화국,2021-08
2021-08-31,213614821,141953263,71661558,그리스,2021-08
2021-08-31,211723382,208676055,3047327,스페인,2021-08
2021-08-31,195226204,2200440667,-2005214463,사우디아라비아,2021-08
2021-08-31,192910693,48912599,143998094,슬로바키아,2021-08
2021-08-31,189804712,602,189804110,버뮤다,2021-08
2021-08-31,153785203,2331792,151453411,토고,2021-08
2021-08-31,149760025,78581013,71179012,이집트,2021-08
2021-08-31,139420008,1202185,138217823,우즈베키스탄,2021-08
2021-08-31,137752906,92455421,45297485,이스라엘,2021-08
2021-08-31,137424717,305180998,-167756281,칠레,2021-08
2021-08-31,134258792,157791941,-23533149,뉴질랜드,2021-08
2021-08-31,116777962,11289933,105488029,파키스탄,2021-08
2021-08-31,110783688,461833745,-351050057,이라크,2021-08
2021-08-31,110690712,151292678,-40601966,스웨덴,2021-08
2021-08-31,109462237,57590651,51871586,나이지리아,2021-08
2021-08-31,104911619,11048945,93862674,슬로베니아,2021-08
2021-08-31,104780342,78492645,26287697,아일랜드,2021-08
2021-08-31,97268870,46755169,50513701,방글라데시,2021-08
2021-08-31,96410782,104273603,-7862821,마샬군도,2021-08
2021-08-31,95533703,167408590,-71874887,오스트리아,2021-08
2021-08-31,75192027,259141035,-183949008,스위스,2021-08
2021-08-31,68783085,224113333,-155330248,남아프리카공화국,2021-08
2021-08-31,64483247,52831133,11652114,콜롬비아,2021-08
2021-08-31,61067392,254482641,-193415249,기타국,2021-08
2021-08-31,60853215,40810435,20042780,포루투갈,2021-08
2021-08-31,60694332,6718329,53976003,요르단,2021-08
2021-08-31,57778389,243193005,-185414616,페루,2021-08
2021-08-31,56945915,303463998,-246518083,카자흐스탄,2021-08
2021-08-31,55334521,297035351,-241700830,노르웨이,2021-08
2021-08-31,52905284,7646132,45259152,에쿠아도르,2021-08
2021-08-31,49739516,11891940,37847576,우크라이나,2021-08
2021-08-31,44855043,37881861,6973182,캄보디아,2021-08
2021-08-31,42839582,59956635,-17117053,루마니아,2021-08
2021-08-31,37396124,1084681276,-1047285152,카타르,2021-08
2021-08-31,35065222,92528611,-57463389,덴마크,2021-08
2021-08-31,32602444,3068174,29534270,몽골,2021-08
2021-08-31,31632260,2038169,29594091,리비아,2021-08
2021-08-31,27677354,47767855,-20090501,미얀마,2021-08
2021-08-31,27269392,7298218,19971174,도미니카 공화국,2021-08
2021-08-31,26241712,21636242,4605470,모로코,2021-08
2021-08-31,26050328,27323104,-1272776,푸에르토리코,2021-08
2021-08-31,25875443,11471465,14403978,과테말라,2021-08
2021-08-31,25447305,596411361,-570964056,쿠웨이트,2021-08
2021-08-31,25112703,215558,24897145,피지,2021-08
2021-08-31,23712078,169510643,-145798565,아르헨티나,2021-08
2021-08-31,23218715,14985245,8233470,세르비아,2021-08
2021-08-31,20452443,3664443,16788000,가나,2021-08
2021-08-31,19737113,80023397,-60286284,핀란드,2021-08
2021-08-31,19631802,9563272,10068530,리투아니아,2021-08
2021-08-31,19011779,8675651,10336128,스리랑카,2021-08
2021-08-31,18261434,2843371,15418063,엘살바도르,2021-08
2021-08-31,17880934,34744666,-16863732,바레인,2021-08
2021-08-31,17573613,573287,17000326,탄자니아,2021-08
2021-08-31,16689716,3841696,12848020,케냐,2021-08
2021-08-31,15224857,303792268,-288567411,알제리,2021-08
2021-08-31,14557229,14922154,-364925,우루과이,2021-08
2021-08-31,14111003,33933151,-19822148,불가리아,2021-08
2021-08-31,13273102,1821127,11451975,수단,2021-08
2021-08-31,12791017,64329232,-51538215,코스타리카,2021-08
2021-08-31,12515253,18877819,-6362566,모잠비크,2021-08
2021-08-31,11340370,1800585,9539785,코트디봐르,2021-08
2021-08-31,10754628,2982716,7771912,온두라스,2021-08
2021-08-31,10565616,397964,10167652,이란,2021-08
2021-08-31,10330527,10131323,199204,파라과이,2021-08
2021-08-31,10081256,62870,10018386,아제르바이잔,2021-08
2021-08-31,9997583,307049371,-297051788,오만,2021-08
2021-08-31,9091725,1683269,7408456,크로아티아,2021-08
2021-08-31,9079353,91926,8987427,키르기스스탄,2021-08
2021-08-31,8882246,87228,8795018,조지아,2021-08
2021-08-31,8722267,8549269,172998,에티오피아,2021-08
2021-08-31,7174047,38510,7135537,아이티,2021-08
2021-08-31,6963648,13688207,-6724559,라트비아,2021-08
2021-08-31,6630385,1181607,5448778,니카라과,2021-08
2021-08-31,6355309,59377939,-53022630,콩고민주공화국,2021-08
2021-08-31,6293477,4667891,1625586,세네갈,2021-08
2021-08-31,6283129,6179316,103813,에스토니아,2021-08
2021-08-31,6209834,10583037,-4373203,튀니지,2021-08
2021-08-31,6116020,2209253,3906767,벨라루스,2021-08
2021-08-31,5724869,2364879,3359990,레바논,2021-08
2021-08-31,5710688,230287,5480401,브루나이,2021-08
2021-08-31,5571551,1043399,4528152,괌,2021-08
2021-08-31,5309120,3890,5305230,앙골라,2021-08
2021-08-31,5122697,2543358,2579339,예맨,2021-08
2021-08-31,5006716,448912,4557804,쿠바,2021-08
2021-08-31,4384229,167356,4216873,팔레스타인 해방기구,2021-08
2021-08-31,4299143,48941,4250202,마카오,2021-08
2021-08-31,4211223,34677516,-30466293,파푸아 뉴기니,2021-08
2021-08-31,3892792,3899464,-6672,라오스,2021-08
2021-08-31,3808499,309258,3499241,나미비아,2021-08
2021-08-31,3739286,15779,3723507,팔라우,2021-08
2021-08-31,3315399,636,3314763,타지크,2021-08
2021-08-31,3247477,215582,3031895,지부티,2021-08
2021-08-31,3169482,51318839,-48149357,트리니다드 토바고,2021-08
2021-08-31,3123538,235074,2888464,자마이카,2021-08
2021-08-31,3091124,659140,2431984,베네주엘라,2021-08
2021-08-31,2958193,2497457,460736,마다카스카르,2021-08
2021-08-31,2949887,393504,2556383,말리,2021-08
2021-08-31,2909357,1887119,1022238,아이슬란드,2021-08
2021-08-31,2883616,10296,2873320,시리아,2021-08
2021-08-31,2730711,4247363,-1516652,보스니아-헤르체고비나,2021-08
2021-08-31,2708770,447723,2261047,콩고,2021-08
2021-08-31,2614159,33147,2581012,부르키나 파소,2021-08
2021-08-31,2573679,225896,2347783,사이프러스,2021-08
2021-08-31,2422731,4540,2418191,불령 리유니온 코모도 제도,2021-08
2021-08-31,2393069,220671,2172398,카메룬,2021-08
2021-08-31,2332113,1667799,664314,알바니아,2021-08
2021-08-31,2214238,468014,1746224,모리셔스,2021-08
2021-08-31,1949745,150799,1798946,사모아,2021-08
2021-08-31,1944829,38388485,-36443656,뉴 칼레도니아,2021-08
2021-08-31,1941487,34119648,-32178161,볼리비아,2021-08
2021-08-31,1841692,3194730,-1353038,아르메니아,2021-08
2021-08-31,1830158,0,1830158,마티니크,2021-08
2021-08-31,1735265,3560813,-1825548,기니,2021-08
2021-08-31,1696473,52270,1644203,북마리아나 군도,2021-08
2021-08-31,1659676,39125,1620551,베닝,2021-08
2021-08-31,1616914,6074313,-4457399,룩셈부르그,2021-08
2021-08-31,1488361,0,1488361,과델로프,2021-08
2021-08-31,1448193,416623,1031570,세이쉘,2021-08
2021-08-31,1423726,650,1423076,바하마,2021-08
2021-08-31,1407571,0,1407571,소말리아,2021-08
2021-08-31,1382892,134197,1248695,짐바브웨,2021-08
2021-08-31,1240145,43242,1196903,가이아나,2021-08
2021-08-31,1227736,2660720,-1432984,몰도바,2021-08
2021-08-31,1184835,465,1184370,아루바,2021-08
2021-08-31,1163037,11712065,-10549028,잠비아,2021-08
2021-08-31,1123745,154197,969548,불령 폴리네시아,2021-08
2021-08-31,1051578,307861,743717,네팔,2021-08
2021-08-31,901474,663261,238213,바누아투,2021-08
2021-08-31,900279,538270,362009,우간다,2021-08
2021-08-31,861551,53815,807736,르완다,2021-08
2021-08-31,813420,156950,656470,솔로몬 군도,2021-08
2021-08-31,774241,9884,764357,몰디브,2021-08
2021-08-31,772367,74747,697620,말라위,2021-08
2021-08-31,744293,17787,726506,벨리제,2021-08
2021-08-31,700456,11685,688771,마이크로네시아,2021-08
2021-08-31,700189,6744,693445,세인트 빈센트 그레나딘,2021-08
2021-08-31,685568,37144,648424,바베이도스,2021-08
2021-08-31,674993,154037,520956,아프카니스탄,2021-08
2021-08-31,595145,215818,379327,수리남,2021-08
2021-08-31,582672,1248191,-665519,리히텐슈타인,2021-08
2021-08-31,565580,174261,391319,아메리칸 사모아,2021-08
2021-08-31,557111,493,556618,카보 베르데,2021-08
2021-08-31,549105,797501,-248396,키리바티,2021-08
2021-08-31,408942,64928,344014,마세도니아,2021-08
2021-08-31,400140,0,400140,세인트 마틴,2021-08
2021-08-31,390112,876484,-486372,안티가 바부다,2021-08
2021-08-31,367939,32,367907,부탄,2021-08
2021-08-31,326246,146534913,-146208667,가봉,2021-08
2021-08-31,310794,1255581,-944787,시에라 리온,2021-08
2021-08-31,302094,60014,242080,도미니카,2021-08
2021-08-31,262816,387164,-124348,감비아,2021-08
2021-08-31,235466,0,235466,영령 캐이맨 군도,2021-08
2021-08-31,207208,0,207208,세인트 루시아,2021-08
2021-08-31,203251,713,202538,투르크멘,2021-08
2021-08-31,193643,27404644,-27211001,미령 버진군도,2021-08
2021-08-31,180000,187,179813,코모로스,2021-08
2021-08-31,172540,0,172540,불령 가이아나,2021-08
2021-08-31,166774,0,166774,큐라소,2021-08
2021-08-31,165027,0,165027,투발루,2021-08
2021-08-31,157754,41918,115836,스와질랜드,2021-08
2021-08-31,157383,1138,156245,앙귈라,2021-08
2021-08-31,140667,0,140667,그레나다,2021-08
2021-08-31,131582,2372,129210,네덜란드 열도,2021-08
2021-08-31,110871,2648984,-2538113,몬테네그로,2021-08
2021-08-31,92590,39945,52645,중앙아프리카공화국,2021-08
2021-08-31,54376,21870,32506,통가,2021-08
2021-08-31,50443,0,50443,지브랄타,2021-08
2021-08-31,47923,1646449,-1598526,모리타니,2021-08
2021-08-31,43464,2206,41258,부룬디,2021-08
2021-08-31,43430,24536,18894,보츠와나,2021-08
2021-08-31,29878,9691,20187,나우루,2021-08
2021-08-31,26705,0,26705,왈라스 & 퓨투나 군도,2021-08
2021-08-31,22696,0,22696,챠드,2021-08
2021-08-31,21299,254,21045,니제르,2021-08
2021-08-31,17188,100,17088,영령 버진군도,2021-08
2021-08-31,15696,11,15685,티모르,2021-08
2021-08-31,13709,261616,-247907,기네비소,2021-08
2021-08-31,8500,0,8500,적도 기니,2021-08
2021-08-31,6011,4806,1205,세인트 키츠 네비스,2021-08
2021-08-31,5864,200,5664,남수단,2021-08
2021-08-31,5530,0,5530,상토메 프린스페,2021-08
2021-08-31,4679,18076,-13397,모나코,2021-08
2021-08-31,4441,41434,-36993,안도라,2021-08
2021-08-31,2091,183997,-181906,파로에 군도,2021-08
2021-08-31,731,0,731,그린랜드,2021-08
2021-08-31,20,495,-475,저어지,2021-08
2021-08-31,0,1144,-1144,투르크 & 카이코스 군도,2021-08
2021-08-31,0,1189,-1189,남조지아 & 남샌드위치 군도,2021-08
2021-08-31,0,407,-407,레소토,2021-08
2021-08-31,0,29397,-29397,세인트 헬레나,2021-08
2021-08-31,0,19,-19,쿡 아일랜드,2021-08
2021-08-31,0,700,-700,보빗군도,2021-08
2021-08-31,0,382653,-382653,산마리노,2021-08
2021-08-31,0,295,-295,코스 군도,2021-08
2021-08-31,0,6270,-6270,토켈라우,2021-08
2021-08-31,0,32914,-32914,니우에,2021-08
2021-08-31,0,262,-262,영령 인도양,2021-08
2021-08-31,0,10865317,-10865317,에리트리아,2021-08
2021-09-30,14291980345,11409467110,2882513235,중국,2021-09
2021-09-30,7983934107,5959730391,2024203716,미국,2021-09
2021-09-30,5101701490,1976767390,3124934100,베트남,2021-09
2021-09-30,3852088155,208245270,3643842885,홍콩,2021-09
2021-09-30,2541017857,4649135416,-2108117559,일본,2021-09
2021-09-30,2206938060,1939972975,266965085,대만,2021-09
2021-09-30,1493610973,765523706,728087267,인도,2021-09
2021-09-30,1332201589,854246488,477955101,싱가포르,2021-09
2021-09-30,1083205552,1602907011,-519701459,러시아 연방,2021-09
2021-09-30,987889775,579617197,408272578,멕시코,2021-09
2021-09-30,928033888,368925149,559108739,필리핀,2021-09
2021-09-30,842731791,924906133,-82174342,말레이시아,2021-09
2021-09-30,830673351,1877835869,-1047162518,독일,2021-09
2021-09-30,804980247,3287104535,-2482124288,호주,2021-09
2021-09-30,666604354,945702267,-279097913,인도네시아,2021-09
2021-09-30,643973726,597923067,46050659,태국,2021-09
2021-09-30,627543652,86625037,540918615,튀르키예,2021-09
2021-09-30,618507383,572055632,46451751,네덜란드,2021-09
2021-09-30,578634251,516520603,62113648,프랑스,2021-09
2021-09-30,560567343,88814981,471752362,폴란드,2021-09
2021-09-30,498026792,552248529,-54221737,캐나다,2021-09
2021-09-30,470042734,349447302,120595432,영국,2021-09
2021-09-30,382121209,378983256,3137953,브라질,2021-09
2021-09-30,378171566,584464749,-206293183,이탈리아,2021-09
2021-09-30,350116425,684946413,-334829988,아랍에미리트 연합,2021-09
2021-09-30,341196197,95658626,245537571,헝가리,2021-09
2021-09-30,339345634,381989572,-42643938,벨기에,2021-09
2021-09-30,277894378,2085923731,-1808029353,사우디아라비아,2021-09
2021-09-30,252660781,54031594,198629187,슬로바키아,2021-09
2021-09-30,236864616,97502343,139362273,체코공화국,2021-09
2021-09-30,215549562,179384272,36165290,스페인,2021-09
2021-09-30,207202961,113373202,93829759,그리스,2021-09
2021-09-30,189903415,63044,189840371,라이베리아,2021-09
2021-09-30,158253775,102724088,55529687,뉴질랜드,2021-09
2021-09-30,157738220,97403165,60335055,이스라엘,2021-09
2021-09-30,152184082,1882152,150301930,우즈베키스탄,2021-09
2021-09-30,143299389,55670468,87628921,방글라데시,2021-09
2021-09-30,142824128,152187325,-9363197,스웨덴,2021-09
2021-09-30,131044861,128168353,2876508,오스트리아,2021-09
2021-09-30,129086771,273534188,-144447417,스위스,2021-09
2021-09-30,127398418,44092914,83305504,이집트,2021-09
2021-09-30,124339999,9891277,114448722,슬로베니아,2021-09
2021-09-30,120023553,47132754,72890799,파키스탄,2021-09
2021-09-30,107265686,405295675,-298029989,칠레,2021-09
2021-09-30,94996387,414799126,-319802739,노르웨이,2021-09
2021-09-30,93565014,70030190,23534824,핀란드,2021-09
2021-09-30,91021098,282417142,-191396044,남아프리카공화국,2021-09
2021-09-30,87443356,11358312,76085044,에쿠아도르,2021-09
2021-09-30,77443935,44481982,32961953,포루투갈,2021-09
2021-09-30,76319040,4781551,71537489,몰타,2021-09
2021-09-30,73996848,63876928,10119920,콜롬비아,2021-09
2021-09-30,73325176,94109979,-20784803,아일랜드,2021-09
2021-09-30,73122847,387015402,-313892555,이라크,2021-09
2021-09-30,65488711,100709382,-35220671,카자흐스탄,2021-09
2021-09-30,62189437,2607569,59581868,토고,2021-09
2021-09-30,61536113,9843571,51692542,요르단,2021-09
2021-09-30,60177187,6409756,53767431,나이지리아,2021-09
2021-09-30,55358304,236030578,-180672274,페루,2021-09
2021-09-30,55111439,83259164,-28147725,덴마크,2021-09
2021-09-30,53140707,7655957,45484750,과테말라,2021-09
2021-09-30,51953254,32903612,19049642,캄보디아,2021-09
2021-09-30,51106815,28431884,22674931,파나마,2021-09
2021-09-30,46059046,60457915,-14398869,루마니아,2021-09
2021-09-30,43384099,18011482,25372617,우크라이나,2021-09
2021-09-30,39088916,272848207,-233759291,아르헨티나,2021-09
2021-09-30,38033717,4386929,33646788,몽골,2021-09
2021-09-30,35675787,20780261,14895526,푸에르토리코,2021-09
2021-09-30,32213502,965574385,-933360883,카타르,2021-09
2021-09-30,30239442,57699071,-27459629,미얀마,2021-09
2021-09-30,30132794,9586825,20545969,도미니카 공화국,2021-09
2021-09-30,29734302,152762712,-123028410,오만,2021-09
2021-09-30,29663660,766923625,-737259965,쿠웨이트,2021-09
2021-09-30,29326832,1140218,28186614,리비아,2021-09
2021-09-30,29041670,47276554,-18234884,코스타리카,2021-09
2021-09-30,28354766,2993141,25361625,엘살바도르,2021-09
2021-09-30,28309357,27287702,1021655,세르비아,2021-09
2021-09-30,27609040,17822503,9786537,스리랑카,2021-09
2021-09-30,23209287,4451719,18757568,가나,2021-09
2021-09-30,22986258,4745552,18240706,에스토니아,2021-09
2021-09-30,21967250,2767803,19199447,케냐,2021-09
2021-09-30,21694384,245532,21448852,이란,2021-09
2021-09-30,20737819,9805043,10932776,튀니지,2021-09
2021-09-30,19448698,6856265,12592433,에티오피아,2021-09
2021-09-30,19411759,2081483,17330276,코트디봐르,2021-09
2021-09-30,19112416,15847292,3265124,모로코,2021-09
2021-09-30,17819953,1272262,16547691,탄자니아,2021-09
2021-09-30,17541495,1844457,15697038,크로아티아,2021-09
2021-09-30,17346770,12508367,4838403,리투아니아,2021-09
2021-09-30,14507385,194245546,-179738161,알제리,2021-09
2021-09-30,12787256,63583189,-50795933,불가리아,2021-09
2021-09-30,12398071,3020991,9377080,온두라스,2021-09
2021-09-30,12059594,1507477,10552117,수단,2021-09
2021-09-30,11214314,5831022,5383292,우루과이,2021-09
2021-09-30,10952355,14292,10938063,아제르바이잔,2021-09
2021-09-30,10216388,1078143,9138245,파라과이,2021-09
2021-09-30,10114341,83359,10030982,조지아,2021-09
2021-09-30,8589298,6612,8582686,키르기스스탄,2021-09
2021-09-30,8499093,3143689,5355404,예맨,2021-09
2021-09-30,8394098,1087114,7306984,니카라과,2021-09
2021-09-30,8367593,752833,7614760,아이티,2021-09
2021-09-30,7770999,7643477,127522,세네갈,2021-09
2021-09-30,7487716,2829291,4658425,기니,2021-09
2021-09-30,7211249,1574228,5637021,레바논,2021-09
2021-09-30,7183542,3043149,4140393,라오스,2021-09
2021-09-30,6972221,397779233,-390807012,기타국,2021-09
2021-09-30,6461472,1362,6460110,앙골라,2021-09
2021-09-30,6376427,515050,5861377,괌,2021-09
2021-09-30,6022596,18199455,-12176859,바레인,2021-09
2021-09-30,5828946,1840335,3988611,벨라루스,2021-09
2021-09-30,5076082,678936,4397146,쿠바,2021-09
2021-09-30,4866350,11271900,-6405550,라트비아,2021-09
2021-09-30,4826131,4039366,786765,브루나이,2021-09
2021-09-30,4738002,60004924,-55266922,콩고민주공화국,2021-09
2021-09-30,4489355,1941755,2547600,마다카스카르,2021-09
2021-09-30,4482095,30661999,-26179904,모잠비크,2021-09
2021-09-30,4133985,41437825,-37303840,트리니다드 토바고,2021-09
2021-09-30,3871333,53421,3817912,마카오,2021-09
2021-09-30,3817219,7894,3809325,타지크,2021-09
2021-09-30,3489898,58502900,-55013002,파푸아 뉴기니,2021-09
2021-09-30,3456013,38328,3417685,팔레스타인 해방기구,2021-09
2021-09-30,3438287,5310636,-1872349,잠비아,2021-09
2021-09-30,3388342,0,3388342,지부티,2021-09
2021-09-30,3358454,751870,2606584,모리셔스,2021-09
2021-09-30,3300081,32911,3267170,부르키나 파소,2021-09
2021-09-30,3062614,1347468,1715146,아이슬란드,2021-09
2021-09-30,3002498,155184,2847314,자마이카,2021-09
2021-09-30,2879713,2384645,495068,알바니아,2021-09
2021-09-30,2822389,42185579,-39363190,뉴 칼레도니아,2021-09
2021-09-30,2717323,626760,2090563,네팔,2021-09
2021-09-30,2692542,377124,2315418,피지,2021-09
2021-09-30,2654537,80177,2574360,사모아,2021-09
2021-09-30,2506217,666813,1839404,사이프러스,2021-09
2021-09-30,2488517,1388779,1099738,베네주엘라,2021-09
2021-09-30,2453828,288442,2165386,우간다,2021-09
2021-09-30,2402033,8013527,-5611494,볼리비아,2021-09
2021-09-30,2400696,64128,2336568,카메룬,2021-09
2021-09-30,2366183,7253647,-4887464,룩셈부르그,2021-09
2021-09-30,2081149,980413,1100736,바누아투,2021-09
2021-09-30,1991926,249116,1742810,르완다,2021-09
2021-09-30,1886254,171660,1714594,가이아나,2021-09
2021-09-30,1824471,0,1824471,불령 리유니온 코모도 제도,2021-09
2021-09-30,1696131,5898,1690233,시리아,2021-09
2021-09-30,1601567,1150623,450944,모리타니,2021-09
2021-09-30,1428194,70649194,-69221000,콩고,2021-09
2021-09-30,1424069,43458,1380611,소말리아,2021-09
2021-09-30,1345991,90726,1255265,불령 폴리네시아,2021-09
2021-09-30,1277731,3657792,-2380061,아르메니아,2021-09
2021-09-30,1225413,27,1225386,베닝,2021-09
2021-09-30,1197705,4699691,-3501986,몰도바,2021-09
2021-09-30,1119940,194185,925755,북마리아나 군도,2021-09
2021-09-30,1108530,67786,1040744,아루바,2021-09
2021-09-30,1064556,225971,838585,짐바브웨,2021-09
2021-09-30,1044376,1496,1042880,바하마,2021-09
2021-09-30,990549,63,990486,부룬디,2021-09
2021-09-30,908085,31356,876729,바베이도스,2021-09
2021-09-30,870064,17,870047,부탄,2021-09
2021-09-30,859422,0,859422,과델로프,2021-09
2021-09-30,833529,157196,676333,세이쉘,2021-09
2021-09-30,790039,1304199,-514160,리히텐슈타인,2021-09
2021-09-30,738299,3096,735203,안도라,2021-09
2021-09-30,723893,178291,545602,말리,2021-09
2021-09-30,709609,665,708944,투발루,2021-09
2021-09-30,705754,93480,612274,아프카니스탄,2021-09
2021-09-30,628350,175,628175,세인트 빈센트 그레나딘,2021-09
2021-09-30,586023,1152996,-566973,마세도니아,2021-09
2021-09-30,568498,34164,534334,스와질랜드,2021-09
2021-09-30,560450,143367,417083,키리바티,2021-09
2021-09-30,549199,67877,481322,마이크로네시아,2021-09
2021-09-30,521578,243554,278024,수리남,2021-09
2021-09-30,501525,0,501525,세인트 마틴,2021-09
2021-09-30,489829,44542,445287,마샬군도,2021-09
2021-09-30,460723,2845,457878,몰디브,2021-09
2021-09-30,454593,16446,438147,솔로몬 군도,2021-09
2021-09-30,439619,207380,232239,가봉,2021-09
2021-09-30,436517,200,436317,버뮤다,2021-09
2021-09-30,414356,4176742,-3762386,보스니아-헤르체고비나,2021-09
2021-09-30,405892,9795,396097,보츠와나,2021-09
2021-09-30,400859,1385167,-984308,시에라 리온,2021-09
2021-09-30,397305,1235363,-838058,벨리제,2021-09
2021-09-30,396262,147334,248928,나미비아,2021-09
2021-09-30,365371,49936,315435,세인트 루시아,2021-09
2021-09-30,352036,0,352036,메요트,2021-09
2021-09-30,326693,252243,74450,말라위,2021-09
2021-09-30,322049,71,321978,티모르,2021-09
2021-09-30,319381,0,319381,불령 가이아나,2021-09
2021-09-30,301701,23051,278650,아메리칸 사모아,2021-09
2021-09-30,270771,0,270771,큐라소,2021-09
2021-09-30,237651,0,237651,세인트 바르탤르미,2021-09
2021-09-30,207163,96149492,-95942329,적도 기니,2021-09
2021-09-30,186212,37,186175,영령 캐이맨 군도,2021-09
2021-09-30,176230,0,176230,카보 베르데,2021-09
2021-09-30,170559,34,170525,챠드,2021-09
2021-09-30,168883,8691,160192,레소토,2021-09
2021-09-30,161552,406,161146,도미니카,2021-09
2021-09-30,145258,1483,143775,안티가 바부다,2021-09
2021-09-30,135930,1488329,-1352399,몬테네그로,2021-09
2021-09-30,123043,333,122710,마티니크,2021-09
2021-09-30,115431,150036,-34605,감비아,2021-09
2021-09-30,102252,21,102231,세인트 키츠 네비스,2021-09
2021-09-30,97829,24225,73604,팔라우,2021-09
2021-09-30,83134,0,83134,에리트리아,2021-09
2021-09-30,77625,330,77295,투르크 & 카이코스 군도,2021-09
2021-09-30,69802,21127,48675,코모로스,2021-09
2021-09-30,48878,56,48822,영령 버진군도,2021-09
2021-09-30,43257,0,43257,나우루,2021-09
2021-09-30,43150,484,42666,네덜란드 열도,2021-09
2021-09-30,26086,6525,19561,그레나다,2021-09
2021-09-30,25360,289288,-263928,산마리노,2021-09
2021-09-30,20632,199293,-178661,니제르,2021-09
2021-09-30,16600,19362,-2762,통가,2021-09
2021-09-30,11719,0,11719,남수단,2021-09
2021-09-30,11534,1795,9739,투르크멘,2021-09
2021-09-30,9075,15982,-6907,모나코,2021-09
2021-09-30,8986,186,8800,세인트 헬레나,2021-09
2021-09-30,6000,5252,748,상토메 프린스페,2021-09
2021-09-30,2961,200,2761,지브랄타,2021-09
2021-09-30,1238,22675,-21437,저어지,2021-09
2021-09-30,1043,35550,-34507,미령 버진군도,2021-09
2021-09-30,851,96333,-95482,토켈라우,2021-09
2021-09-30,830,39616,-38786,기네비소,2021-09
2021-09-30,627,103,524,앙귈라,2021-09
2021-09-30,230,0,230,건지,2021-09
2021-09-30,219,503786,-503567,파로에 군도,2021-09
2021-09-30,131,1707,-1576,중앙아프리카공화국,2021-09
2021-09-30,84,0,84,세인트마틴(생마르탱),2021-09
2021-09-30,65,7182,-7117,그린랜드,2021-09
2021-09-30,40,0,40,쿡 아일랜드,2021-09
2021-09-30,0,6901,-6901,코스 군도,2021-09
2021-09-30,0,26,-26,몬트세라트,2021-09
2021-09-30,0,32,-32,교황청,2021-09
2021-09-30,0,92,-92,영령 인도양,2021-09
2021-09-30,0,39,-39,마이너 아우틀링 합중국 군도,2021-09
2021-09-30,0,75,-75,크리스마스 아일랜드,2021-09
2021-09-30,0,14674,-14674,니우에,2021-09
2021-09-30,0,8238,-8238,안타티카,2021-09
2021-10-31,14415867215,11984638723,2431228492,중국,2021-10
2021-10-31,8066782602,5995841131,2070941471,미국,2021-10
2021-10-31,4904971459,1975876184,2929095275,베트남,2021-10
2021-10-31,2739662629,194870678,2544791951,홍콩,2021-10
2021-10-31,2614683864,4696430129,-2081746265,일본,2021-10
2021-10-31,2226232273,1987232103,239000170,대만,2021-10
2021-10-31,1401204630,741357156,659847474,인도,2021-10
2021-10-31,1353717532,874566039,479151493,싱가포르,2021-10
2021-10-31,1025859718,999565125,26294593,말레이시아,2021-10
2021-10-31,1021644332,2878302391,-1856658059,호주,2021-10
2021-10-31,984263365,363493844,620769521,필리핀,2021-10
2021-10-31,975661417,736638638,239022779,멕시코,2021-10
2021-10-31,805867769,1524646165,-718778396,러시아 연방,2021-10
2021-10-31,792840246,1840410653,-1047570407,독일,2021-10
2021-10-31,741270211,926588268,-185318057,인도네시아,2021-10
2021-10-31,715653718,122370771,593282947,튀르키예,2021-10
2021-10-31,677840561,580766004,97074557,태국,2021-10
2021-10-31,577150300,636706796,-59556496,캐나다,2021-10
2021-10-31,506253199,648746575,-142493376,프랑스,2021-10
2021-10-31,499294283,454455215,44839068,네덜란드,2021-10
2021-10-31,485133464,85546121,399587343,폴란드,2021-10
2021-10-31,478171248,581079892,-102908644,영국,2021-10
2021-10-31,415495379,2434351195,-2018855816,사우디아라비아,2021-10
2021-10-31,400668673,416302274,-15633601,벨기에,2021-10
2021-10-31,352452838,619939488,-267486650,이탈리아,2021-10
2021-10-31,344891643,642143488,-297251845,브라질,2021-10
2021-10-31,324808046,64600461,260207585,파나마,2021-10
2021-10-31,321314735,655218087,-333903352,아랍에미리트 연합,2021-10
2021-10-31,238919306,54576676,184342630,슬로바키아,2021-10
2021-10-31,236680179,100904245,135775934,체코공화국,2021-10
2021-10-31,235848445,52257751,183590694,헝가리,2021-10
2021-10-31,219867307,164199592,55667715,스페인,2021-10
2021-10-31,209032415,136490022,72542393,그리스,2021-10
2021-10-31,202742985,46028576,156714409,마샬군도,2021-10
2021-10-31,184801876,3479,184798397,바하마,2021-10
2021-10-31,180078971,57079829,122999142,방글라데시,2021-10
2021-10-31,179608700,109949037,69659663,이스라엘,2021-10
2021-10-31,177109481,126911605,50197876,뉴질랜드,2021-10
2021-10-31,160266684,136497878,23768806,스웨덴,2021-10
2021-10-31,155983132,2554378,153428754,우즈베키스탄,2021-10
2021-10-31,153424349,5654299,147770050,몰타,2021-10
2021-10-31,142724437,7586756,135137681,슬로베니아,2021-10
2021-10-31,142521632,440027848,-297506216,칠레,2021-10
2021-10-31,140854433,110402919,30451514,이집트,2021-10
2021-10-31,130234492,161454657,-31220165,나이지리아,2021-10
2021-10-31,126206537,14984649,111221888,파키스탄,2021-10
2021-10-31,114968386,139845264,-24876878,오스트리아,2021-10
2021-10-31,104462881,67930763,36532118,콜롬비아,2021-10
2021-10-31,94878277,273962697,-179084420,이라크,2021-10
2021-10-31,82980868,256303123,-173322255,스위스,2021-10
2021-10-31,80894018,105484069,-24590051,아일랜드,2021-10
2021-10-31,77901488,11321569,66579919,요르단,2021-10
2021-10-31,73878301,303734410,-229856109,카자흐스탄,2021-10
2021-10-31,72323854,259977531,-187653677,노르웨이,2021-10
2021-10-31,71205339,225965327,-154759988,남아프리카공화국,2021-10
2021-10-31,68271236,29309667,38961569,포루투갈,2021-10
2021-10-31,63980117,366696445,-302716328,페루,2021-10
2021-10-31,59460224,12096708,47363516,에쿠아도르,2021-10
2021-10-31,58281743,317901757,-259620014,오만,2021-10
2021-10-31,55908540,11275984,44632556,과테말라,2021-10
2021-10-31,51445513,33566700,17878813,우크라이나,2021-10
2021-10-31,48848960,23637992,25210968,캄보디아,2021-10
2021-10-31,47607310,84677455,-37070145,루마니아,2021-10
2021-10-31,47172634,81710426,-34537792,덴마크,2021-10
2021-10-31,45066144,1278978115,-1233911971,카타르,2021-10
2021-10-31,41565040,27445032,14120008,푸에르토리코,2021-10
2021-10-31,36920149,217254106,-180333957,아르헨티나,2021-10
2021-10-31,34628471,1335364,33293107,리비아,2021-10
2021-10-31,33802757,94996402,-61193645,핀란드,2021-10
2021-10-31,32497267,4269049,28228218,케냐,2021-10
2021-10-31,30458866,65045093,-34586227,미얀마,2021-10
2021-10-31,29183898,3341984,25841914,가나,2021-10
2021-10-31,29116828,8429215,20687613,도미니카 공화국,2021-10
2021-10-31,27506196,713136468,-685630272,쿠웨이트,2021-10
2021-10-31,27440596,2972013,24468583,몽골,2021-10
2021-10-31,27385452,64850,27320602,피지,2021-10
2021-10-31,26553804,3172055,23381749,엘살바도르,2021-10
2021-10-31,21458416,7851448,13606968,스리랑카,2021-10
2021-10-31,21411560,12515288,8896272,모로코,2021-10
2021-10-31,18220999,11501506,6719493,리투아니아,2021-10
2021-10-31,18130753,1438962,16691791,코트디봐르,2021-10
2021-10-31,17618647,6880153,10738494,튀니지,2021-10
2021-10-31,17334292,198895,17135397,이란,2021-10
2021-10-31,17332252,13092151,4240101,코스타리카,2021-10
2021-10-31,16534552,3426244,13108308,라오스,2021-10
2021-10-31,16460776,657849,15802927,탄자니아,2021-10
2021-10-31,16413249,13615091,2798158,세르비아,2021-10
2021-10-31,13545314,2567872,10977442,크로아티아,2021-10
2021-10-31,12515285,199133388,-186618103,알제리,2021-10
2021-10-31,12254607,179150,12075457,모잠비크,2021-10
2021-10-31,12111199,556240,11554959,파라과이,2021-10
2021-10-31,11889622,505482,11384140,네팔,2021-10
2021-10-31,11817687,72388457,-60570770,불가리아,2021-10
2021-10-31,11759280,41118,11718162,아제르바이잔,2021-10
2021-10-31,11236701,8346485,2890216,에티오피아,2021-10
2021-10-31,10267790,2148702,8119088,수단,2021-10
2021-10-31,10087117,2564746,7522371,조지아,2021-10
2021-10-31,9821709,0,9821709,몰디브,2021-10
2021-10-31,9605988,114409,9491579,키르기스스탄,2021-10
2021-10-31,9441359,14953936,-5512577,우루과이,2021-10
2021-10-31,9407026,315762424,-306355398,기타국,2021-10
2021-10-31,9298366,4494007,4804359,온두라스,2021-10
2021-10-31,9118182,1526051,7592131,아이슬란드,2021-10
2021-10-31,9059720,4900753,4158967,에스토니아,2021-10
2021-10-31,8809041,43673437,-34864396,바레인,2021-10
2021-10-31,8720786,5913581,2807205,예맨,2021-10
2021-10-31,7272336,1012334,6260002,니카라과,2021-10
2021-10-31,6873491,5183930,1689561,레바논,2021-10
2021-10-31,6761599,376128,6385471,괌,2021-10
2021-10-31,6736524,4358575,2377949,세네갈,2021-10
2021-10-31,6687137,44910,6642227,아메리칸 사모아,2021-10
2021-10-31,6013878,304900,5708978,앙골라,2021-10
2021-10-31,5842363,1221838,4620525,마다카스카르,2021-10
2021-10-31,5801256,0,5801256,팔레스타인 해방기구,2021-10
2021-10-31,4815198,30483919,-25668721,트리니다드 토바고,2021-10
2021-10-31,4696737,17016,4679721,아이티,2021-10
2021-10-31,4609646,1044186,3565460,알바니아,2021-10
2021-10-31,4604233,430679,4173554,쿠바,2021-10
2021-10-31,4527300,658218,3869082,아프카니스탄,2021-10
2021-10-31,4480509,11950192,-7469683,라트비아,2021-10
2021-10-31,4383304,120,4383184,타지크,2021-10
2021-10-31,4289596,40018,4249578,마카오,2021-10
2021-10-31,4199475,76817089,-72617614,콩고민주공화국,2021-10
2021-10-31,3944187,174905,3769282,카메룬,2021-10
2021-10-31,3622852,247363,3375489,르완다,2021-10
2021-10-31,3583124,49,3583075,지부티,2021-10
2021-10-31,3580699,10128956,-6548257,벨라루스,2021-10
2021-10-31,3520190,8845950,-5325760,룩셈부르그,2021-10
2021-10-31,3334968,175660900,-172325932,파푸아 뉴기니,2021-10
2021-10-31,3330648,3421116,-90468,몰도바,2021-10
2021-10-31,3167939,232361,2935578,사모아,2021-10
2021-10-31,2988102,1609510,1378592,토고,2021-10
2021-10-31,2816363,343826,2472537,우간다,2021-10
2021-10-31,2766324,69430,2696894,자마이카,2021-10
2021-10-31,2736030,0,2736030,중앙아프리카공화국,2021-10
2021-10-31,2494271,613359,1880912,베네주엘라,2021-10
2021-10-31,2366059,290075,2075984,모리셔스,2021-10
2021-10-31,2331763,900735,1431028,콩고,2021-10
2021-10-31,2249394,2275925,-26531,보스니아-헤르체고비나,2021-10
2021-10-31,2210556,2166177,44379,브루나이,2021-10
2021-10-31,2168561,800561,1368000,니제르,2021-10
2021-10-31,2068233,298796,1769437,사이프러스,2021-10
2021-10-31,2064241,8139470,-6075229,아르메니아,2021-10
2021-10-31,2033295,165662,1867633,북마리아나 군도,2021-10
2021-10-31,2012333,64,2012269,과델로프,2021-10
2021-10-31,1971332,0,1971332,마티니크,2021-10
2021-10-31,1899604,29142830,-27243226,뉴 칼레도니아,2021-10
2021-10-31,1879990,1990898,-110908,기니,2021-10
2021-10-31,1710053,1664,1708389,가이아나,2021-10
2021-10-31,1610836,70207,1540629,불령 폴리네시아,2021-10
2021-10-31,1533586,60499,1473087,부르키나 파소,2021-10
2021-10-31,1526458,8669578,-7143120,잠비아,2021-10
2021-10-31,1490402,12687,1477715,불령 리유니온 코모도 제도,2021-10
2021-10-31,1287189,2956910,-1669721,모리타니,2021-10
2021-10-31,1272597,239441,1033156,짐바브웨,2021-10
2021-10-31,1267596,46240914,-44973318,볼리비아,2021-10
2021-10-31,1190584,88031,1102553,소말리아,2021-10
2021-10-31,1166294,0,1166294,세인트 마틴,2021-10
2021-10-31,1142988,509926,633062,세이쉘,2021-10
2021-10-31,1092127,9698,1082429,시리아,2021-10
2021-10-31,1026869,84553,942316,아루바,2021-10
2021-10-31,1008909,156968,851941,키리바티,2021-10
2021-10-31,1005168,57636,947532,스와질랜드,2021-10
2021-10-31,955009,0,955009,남수단,2021-10
2021-10-31,953000,54,952946,베닝,2021-10
2021-10-31,818117,7083,811034,큐라소,2021-10
2021-10-31,784365,50,784315,영령 캐이맨 군도,2021-10
2021-10-31,783433,33871,749562,팔라우,2021-10
2021-10-31,737053,4453,732600,부탄,2021-10
2021-10-31,725680,1059874,-334194,마세도니아,2021-10
2021-10-31,696894,410283,286611,수리남,2021-10
2021-10-31,695422,0,695422,메요트,2021-10
2021-10-31,642098,30082,612016,마이크로네시아,2021-10
2021-10-31,641421,1314246,-672825,리히텐슈타인,2021-10
2021-10-31,598833,160918072,-160319239,가봉,2021-10
2021-10-31,572234,0,572234,세인트 루시아,2021-10
2021-10-31,530332,242409,287923,라이베리아,2021-10
2021-10-31,530310,64456,465854,보츠와나,2021-10
2021-10-31,435918,1983694,-1547776,솔로몬 군도,2021-10
2021-10-31,385280,449680,-64400,감비아,2021-10
2021-10-31,373628,4098,369530,부룬디,2021-10
2021-10-31,323461,513137,-189676,시에라 리온,2021-10
2021-10-31,305199,73426,231773,벨리제,2021-10
2021-10-31,286101,1599,284502,코모로스,2021-10
2021-10-31,285727,227,285500,불령 가이아나,2021-10
2021-10-31,275781,175011,100770,말리,2021-10
2021-10-31,269575,0,269575,버뮤다,2021-10
2021-10-31,255067,0,255067,세인트 바르탤르미,2021-10
2021-10-31,248692,0,248692,그레나다,2021-10
2021-10-31,199932,661724,-461792,바누아투,2021-10
2021-10-31,186992,2784506,-2597514,말라위,2021-10
2021-10-31,184027,0,184027,투르크멘,2021-10
2021-10-31,180244,0,180244,영령 버진군도,2021-10
2021-10-31,176731,4198,172533,투발루,2021-10
2021-10-31,174707,10372751,-10198044,에리트리아,2021-10
2021-10-31,174591,181897,-7306,나미비아,2021-10
2021-10-31,170314,39894,130420,바베이도스,2021-10
2021-10-31,118864,0,118864,챠드,2021-10
2021-10-31,117501,111325,6176,네덜란드 열도,2021-10
2021-10-31,92175,3576470,-3484295,나우루,2021-10
2021-10-31,71162,69042,2120,안티가 바부다,2021-10
2021-10-31,59393,73300,-13907,티모르,2021-10
2021-10-31,55785,14672046,-14616261,몬테네그로,2021-10
2021-10-31,46993,1059,45934,앙귈라,2021-10
2021-10-31,40686,38761004,-38720318,적도 기니,2021-10
2021-10-31,39504,0,39504,카보 베르데,2021-10
2021-10-31,39084,0,39084,세인트마틴(생마르탱),2021-10
2021-10-31,34612,2136,32476,투르크 & 카이코스 군도,2021-10
2021-10-31,30285,6757,23528,안도라,2021-10
2021-10-31,28720,558265,-529545,산마리노,2021-10
2021-10-31,21015,14248,6767,도미니카,2021-10
2021-10-31,20496,4500,15996,지브랄타,2021-10
2021-10-31,19155,68,19087,세인트 빈센트 그레나딘,2021-10
2021-10-31,18710,310,18400,토켈라우,2021-10
2021-10-31,17309,267855,-250546,기네비소,2021-10
2021-10-31,13000,662,12338,왈라스 & 퓨투나 군도,2021-10
2021-10-31,12061,21870,-9809,통가,2021-10
2021-10-31,5069,37353,-32284,세인트 키츠 네비스,2021-10
2021-10-31,4000,26829,-22829,모나코,2021-10
2021-10-31,1510,24601,-23091,미령 버진군도,2021-10
2021-10-31,1500,0,1500,마이너 아우틀링 합중국 군도,2021-10
2021-10-31,200,581,-381,저어지,2021-10
2021-10-31,196,0,196,그린랜드,2021-10
2021-10-31,46,314205,-314159,파로에 군도,2021-10
2021-10-31,0,579,-579,건지,2021-10
2021-10-31,0,6980,-6980,영령 인도양,2021-10
2021-10-31,0,420,-420,크리스마스 아일랜드,2021-10
2021-10-31,0,26931,-26931,니우에,2021-10
2021-10-31,0,6408,-6408,레소토,2021-10
2021-10-31,0,541,-541,몬트세라트,2021-10
2021-10-31,0,3056,-3056,코스 군도,2021-10
2021-10-31,0,3191,-3191,맨섬,2021-10
2021-10-31,0,94,-94,쿡 아일랜드,2021-10
2021-10-31,0,237660,-237660,허드 앤 맥도날드 군도,2021-10
2021-10-31,0,8448,-8448,보빗군도,2021-10
2021-11-30,15272549044,13663761395,1608787649,중국,2021-11
2021-11-30,8133640339,6640496024,1493144315,미국,2021-11
2021-11-30,5478296945,2117855372,3360441573,베트남,2021-11
2021-11-30,3232583381,127360847,3105222534,홍콩,2021-11
2021-11-30,2813250497,4863815885,-2050565388,일본,2021-11
2021-11-30,2508842848,31711006,2477131842,모잠비크,2021-11
2021-11-30,2398738581,2193904810,204833771,대만,2021-11
2021-11-30,1473320133,791820668,681499465,인도,2021-11
2021-11-30,1463579344,764866619,698712725,싱가포르,2021-11
2021-11-30,959547344,428681558,530865786,필리핀,2021-11
2021-11-30,954468391,845604101,108864290,말레이시아,2021-11
2021-11-30,947691148,3478891979,-2531200831,호주,2021-11
2021-11-30,882933963,925631871,-42697908,인도네시아,2021-11
2021-11-30,874747174,674912058,199835116,멕시코,2021-11
2021-11-30,857755599,2312060567,-1454304968,러시아 연방,2021-11
2021-11-30,820883309,1624658716,-803775407,독일,2021-11
2021-11-30,706257568,595870616,110386952,태국,2021-11
2021-11-30,663066589,640138731,22927858,캐나다,2021-11
2021-11-30,563474436,114511132,448963304,튀르키예,2021-11
2021-11-30,518337986,564887570,-46549584,프랑스,2021-11
2021-11-30,516548720,552992638,-36443918,네덜란드,2021-11
2021-11-30,494306635,383221942,111084693,영국,2021-11
2021-11-30,431726127,684821912,-253095785,이탈리아,2021-11
2021-11-30,395397022,70518419,324878603,폴란드,2021-11
2021-11-30,395034111,265346955,129687156,벨기에,2021-11
2021-11-30,382723803,565226482,-182502679,브라질,2021-11
2021-11-30,380215605,703248508,-323032903,아랍에미리트 연합,2021-11
2021-11-30,359596895,59774138,299822757,헝가리,2021-11
2021-11-30,297145852,2565113038,-2267967186,사우디아라비아,2021-11
2021-11-30,273711168,78839486,194871682,체코공화국,2021-11
2021-11-30,246573082,2201,246570881,바하마,2021-11
2021-11-30,238830309,36332823,202497486,슬로바키아,2021-11
2021-11-30,234898512,195315769,39582743,스페인,2021-11
2021-11-30,215717242,101146968,114570274,그리스,2021-11
2021-11-30,213777441,51802825,161974616,파나마,2021-11
2021-11-30,182690112,140727744,41962368,뉴질랜드,2021-11
2021-11-30,180809948,2688308,178121640,우즈베키스탄,2021-11
2021-11-30,179091437,135518902,43572535,이스라엘,2021-11
2021-11-30,172394824,102753817,69641007,이집트,2021-11
2021-11-30,151160179,8993242,142166937,슬로베니아,2021-11
2021-11-30,142126878,49389885,92736993,방글라데시,2021-11
2021-11-30,142111631,111066692,31044939,아일랜드,2021-11
2021-11-30,133086565,195191957,-62105392,스웨덴,2021-11
2021-11-30,123373559,387922126,-264548567,칠레,2021-11
2021-11-30,119969678,177463107,-57493429,오스트리아,2021-11
2021-11-30,116864486,32404134,84460352,파키스탄,2021-11
2021-11-30,102148158,54200454,47947704,핀란드,2021-11
2021-11-30,85850004,375831638,-289981634,남아프리카공화국,2021-11
2021-11-30,81001383,115057125,-34055742,카자흐스탄,2021-11
2021-11-30,75974493,121197921,-45223428,콜롬비아,2021-11
2021-11-30,74073219,12871,74060348,라이베리아,2021-11
2021-11-30,66498565,10092141,56406424,요르단,2021-11
2021-11-30,65780958,263422448,-197641490,스위스,2021-11
2021-11-30,63392703,761201934,-697809231,이라크,2021-11
2021-11-30,62306502,118760945,-56454443,나이지리아,2021-11
2021-11-30,61125417,32989430,28135987,포루투갈,2021-11
2021-11-30,60767218,48908996,11858222,우크라이나,2021-11
2021-11-30,52709054,223547413,-170838359,페루,2021-11
2021-11-30,52345985,26077175,26268810,캄보디아,2021-11
2021-11-30,50060476,244339133,-194278657,노르웨이,2021-11
2021-11-30,49814744,58821192,-9006448,루마니아,2021-11
2021-11-30,47865542,77087568,-29222026,덴마크,2021-11
2021-11-30,47342295,9915156,37427139,에쿠아도르,2021-11
2021-11-30,43573422,206036345,-162462923,오만,2021-11
2021-11-30,40388828,824869,39563959,리비아,2021-11
2021-11-30,37787087,34933127,2853960,미얀마,2021-11
2021-11-30,36966818,157414341,-120447523,바레인,2021-11
2021-11-30,33780362,9107563,24672799,과테말라,2021-11
2021-11-30,31966085,1703386,30262699,몽골,2021-11
2021-11-30,30698126,342793157,-312095031,아르헨티나,2021-11
2021-11-30,30575616,6982416,23593200,크로아티아,2021-11
2021-11-30,28315629,45127497,-16811868,푸에르토리코,2021-11
2021-11-30,28072388,1099750251,-1071677863,카타르,2021-11
2021-11-30,27927661,2820960,25106701,가나,2021-11
2021-11-30,27125007,8637939,18487068,세르비아,2021-11
2021-11-30,26525227,6127550,20397677,도미니카 공화국,2021-11
2021-11-30,26345333,23415854,2929479,모로코,2021-11
2021-11-30,26252218,791693393,-765441175,쿠웨이트,2021-11
2021-11-30,23199860,10971920,12227940,스리랑카,2021-11
2021-11-30,18093380,10669922,7423458,리투아니아,2021-11
2021-11-30,18041210,2961354,15079856,케냐,2021-11
2021-11-30,17276707,796616,16480091,코트디봐르,2021-11
2021-11-30,17207183,320869,16886314,탄자니아,2021-11
2021-11-30,16760178,4415653,12344525,엘살바도르,2021-11
2021-11-30,16527647,878878,15648769,이란,2021-11
2021-11-30,14841700,51950380,-37108680,알제리,2021-11
2021-11-30,14233719,45781,14187938,키르기스스탄,2021-11
2021-11-30,14186495,59749321,-45562826,불가리아,2021-11
2021-11-30,13755173,7181945,6573228,에티오피아,2021-11
2021-11-30,13249222,12166980,1082242,코스타리카,2021-11
2021-11-30,13179467,14106984,-927517,우루과이,2021-11
2021-11-30,10951453,10539644,411809,튀니지,2021-11
2021-11-30,10512925,69743859,-59230934,콩고민주공화국,2021-11
2021-11-30,10152964,87867,10065097,아제르바이잔,2021-11
2021-11-30,9924018,4210279,5713739,온두라스,2021-11
2021-11-30,9880433,4953138,4927295,에스토니아,2021-11
2021-11-30,9610861,216563,9394298,르완다,2021-11
2021-11-30,9342951,192615,9150336,조지아,2021-11
2021-11-30,9198675,1147956,8050719,파라과이,2021-11
2021-11-30,8842728,164705,8678023,앙골라,2021-11
2021-11-30,8373095,213132694,-204759599,기타국,2021-11
2021-11-30,8146609,12942447,-4795838,벨라루스,2021-11
2021-11-30,7950981,3903955,4047026,세네갈,2021-11
2021-11-30,7731574,547081,7184493,아이티,2021-11
2021-11-30,7642871,2944728,4698143,예맨,2021-11
2021-11-30,7569309,5173027,2396282,몰타,2021-11
2021-11-30,7499918,1047559,6452359,니카라과,2021-11
2021-11-30,6599521,181925,6417596,팔레스타인 해방기구,2021-11
2021-11-30,6303067,458041,5845026,괌,2021-11
2021-11-30,6277342,0,6277342,수단,2021-11
2021-11-30,6027423,1939725,4087698,레바논,2021-11
2021-11-30,5721468,181,5721287,타지크,2021-11
2021-11-30,5378376,10682286,-5303910,라트비아,2021-11
2021-11-30,4534517,897757,3636760,마다카스카르,2021-11
2021-11-30,4504507,0,4504507,지부티,2021-11
2021-11-30,4277598,10579006,-6301408,피지,2021-11
2021-11-30,4161434,3625522,535912,라오스,2021-11
2021-11-30,3847178,3768,3843410,불령 리유니온 코모도 제도,2021-11
2021-11-30,3784698,302212,3482486,카메룬,2021-11
2021-11-30,3748181,305548,3442633,네팔,2021-11
2021-11-30,3483478,3368824,114654,알바니아,2021-11
2021-11-30,3305227,33644,3271583,부르키나 파소,2021-11
2021-11-30,3205872,314582,2891290,사이프러스,2021-11
2021-11-30,3015672,1734978,1280694,아이슬란드,2021-11
2021-11-30,2873208,228570,2644638,모리셔스,2021-11
2021-11-30,2854938,26748969,-23894031,트리니다드 토바고,2021-11
2021-11-30,2842428,11127809,-8285381,룩셈부르그,2021-11
2021-11-30,2725610,156666179,-153940569,파푸아 뉴기니,2021-11
2021-11-30,2696871,2674349,22522,베네주엘라,2021-11
2021-11-30,2576708,25758,2550950,보츠와나,2021-11
2021-11-30,2537973,43663630,-41125657,뉴 칼레도니아,2021-11
2021-11-30,2528211,9883314,-7355103,토고,2021-11
2021-11-30,2329314,65762235,-63432921,볼리비아,2021-11
2021-11-30,2214766,488822,1725944,자마이카,2021-11
2021-11-30,2205907,122154,2083753,북마리아나 군도,2021-11
2021-11-30,1969873,3535069,-1565196,잠비아,2021-11
2021-11-30,1884834,314580,1570254,우간다,2021-11
2021-11-30,1868616,151723,1716893,가이아나,2021-11
2021-11-30,1856264,2529634,-673370,기니,2021-11
2021-11-30,1776385,4039816,-2263431,몰도바,2021-11
2021-11-30,1707665,142318,1565347,소말리아,2021-11
2021-11-30,1679583,0,1679583,불령 폴리네시아,2021-11
2021-11-30,1619532,432,1619100,아루바,2021-11
2021-11-30,1467137,8061094,-6593957,마샬군도,2021-11
2021-11-30,1428297,517306,910991,콩고,2021-11
2021-11-30,1390937,3644,1387293,투르크멘,2021-11
2021-11-30,1340442,8009615,-6669173,아르메니아,2021-11
2021-11-30,1307113,365200,941913,사모아,2021-11
2021-11-30,1304395,1779,1302616,말리,2021-11
2021-11-30,1298264,80556,1217708,마카오,2021-11
2021-11-30,1251017,14595,1236422,시리아,2021-11
2021-11-30,1167224,430885,736339,짐바브웨,2021-11
2021-11-30,1007781,2336454,-1328673,브루나이,2021-11
2021-11-30,982109,4025,978084,니제르,2021-11
2021-11-30,942907,198169,744738,베닝,2021-11
2021-11-30,928183,1441943,-513760,리히텐슈타인,2021-11
2021-11-30,916085,10715,905370,시에라 리온,2021-11
2021-11-30,897891,265,897626,과델로프,2021-11
2021-11-30,896700,2572842,-1676142,보스니아-헤르체고비나,2021-11
2021-11-30,896065,217711,678354,아메리칸 사모아,2021-11
2021-11-30,855159,2583622,-1728463,솔로몬 군도,2021-11
2021-11-30,833624,0,833624,세인트 마틴,2021-11
2021-11-30,827494,548139,279355,키리바티,2021-11
2021-11-30,811511,220628,590883,쿠바,2021-11
2021-11-30,805603,1178642,-373039,세이쉘,2021-11
2021-11-30,716474,458802,257672,아프카니스탄,2021-11
2021-11-30,658657,3222347,-2563690,바누아투,2021-11
2021-11-30,610317,5280581,-4670264,모리타니,2021-11
2021-11-30,605096,16770,588326,마티니크,2021-11
2021-11-30,564060,0,564060,영령 캐이맨 군도,2021-11
2021-11-30,549208,2200,547008,몰디브,2021-11
2021-11-30,541424,0,541424,벨리제,2021-11
2021-11-30,530390,0,530390,남수단,2021-11
2021-11-30,513779,19,513760,팔라우,2021-11
2021-11-30,458403,17274,441129,세인트 루시아,2021-11
2021-11-30,437396,64267,373129,마이크로네시아,2021-11
2021-11-30,437087,82121911,-81684824,가봉,2021-11
2021-11-30,426057,11,426046,부탄,2021-11
2021-11-30,383385,0,383385,큐라소,2021-11
2021-11-30,356890,734,356156,지브랄타,2021-11
2021-11-30,353138,112471,240667,스와질랜드,2021-11
2021-11-30,347031,0,347031,버뮤다,2021-11
2021-11-30,341620,131846,209774,티모르,2021-11
2021-11-30,324693,112008,212685,안티가 바부다,2021-11
2021-11-30,318391,1074173,-755782,마세도니아,2021-11
2021-11-30,281571,338499,-56928,수리남,2021-11
2021-11-30,277724,11374051,-11096327,에리트리아,2021-11
2021-11-30,267977,1432429,-1164452,나미비아,2021-11
2021-11-30,232634,1126,231508,부룬디,2021-11
2021-11-30,229489,36258,193231,감비아,2021-11
2021-11-30,215822,0,215822,불령 가이아나,2021-11
2021-11-30,215589,38793,176796,바베이도스,2021-11
2021-11-30,198886,0,198886,도미니카,2021-11
2021-11-30,183062,0,183062,그레나다,2021-11
2021-11-30,167900,310218,-142318,말라위,2021-11
2021-11-30,167145,50,167095,영령 버진군도,2021-11
2021-11-30,121771,807,120964,카보 베르데,2021-11
2021-11-30,102144,0,102144,메요트,2021-11
2021-11-30,94247,0,94247,적도 기니,2021-11
2021-11-30,89861,78204,11657,안도라,2021-11
2021-11-30,89633,31,89602,세인트 빈센트 그레나딘,2021-11
2021-11-30,86926,0,86926,네덜란드 열도,2021-11
2021-11-30,80933,48982,31951,중앙아프리카공화국,2021-11
2021-11-30,75200,0,75200,보빗군도,2021-11
2021-11-30,74075,286,73789,챠드,2021-11
2021-11-30,34010,4190398,-4156388,나우루,2021-11
2021-11-30,31321,8966,22355,세인트 키츠 네비스,2021-11
2021-11-30,31320,650,30670,왈라스 & 퓨투나 군도,2021-11
2021-11-30,24382,0,24382,투발루,2021-11
2021-11-30,21725,652455,-630730,통가,2021-11
2021-11-30,15452,0,15452,투르크 & 카이코스 군도,2021-11
2021-11-30,13940,119923,-105983,산마리노,2021-11
2021-11-30,13333,0,13333,코모로스,2021-11
2021-11-30,12574,8944940,-8932366,몬테네그로,2021-11
2021-11-30,11772,1070,10702,상토메 프린스페,2021-11
2021-11-30,10361,38559,-28198,모나코,2021-11
2021-11-30,9800,430,9370,남조지아 & 남샌드위치 군도,2021-11
2021-11-30,9090,9861,-771,레소토,2021-11
2021-11-30,4031,1454,2577,앙귈라,2021-11
2021-11-30,2180,0,2180,세인트 바르탤르미,2021-11
2021-11-30,2058,28914,-26856,미령 버진군도,2021-11
2021-11-30,810,162649,-161839,기네비소,2021-11
2021-11-30,647,0,647,세인트마틴(생마르탱),2021-11
2021-11-30,504,2719,-2215,저어지,2021-11
2021-11-30,290,0,290,쿡 아일랜드,2021-11
2021-11-30,122,449021,-448899,그린랜드,2021-11
2021-11-30,4,18841,-18837,파로에 군도,2021-11
2021-11-30,0,948,-948,세인트 피레 미켈론,2021-11
2021-11-30,0,3,-3,안타티카,2021-11
2021-11-30,0,17520,-17520,건지,2021-11
2021-11-30,0,10534,-10534,맨섬,2021-11
2021-11-30,0,20593,-20593,니우에,2021-11
2021-12-31,15342562681,13829108559,1513454122,중국,2021-12
2021-12-31,8787542044,5701577478,3085964566,미국,2021-12
2021-12-31,5617022808,2179673669,3437349139,베트남,2021-12
2021-12-31,3444272573,269921164,3174351409,홍콩,2021-12
2021-12-31,2712571429,5130741601,-2418170172,일본,2021-12
2021-12-31,2333287536,2187757047,145530489,대만,2021-12
2021-12-31,1411021119,902243411,508777708,싱가포르,2021-12
2021-12-31,1314389970,743735513,570654457,인도,2021-12
2021-12-31,1226626989,1144029331,82597658,말레이시아,2021-12
2021-12-31,1161608572,326642240,834966332,필리핀,2021-12
2021-12-31,1130830496,3831861873,-2701031377,호주,2021-12
2021-12-31,1057350946,2023921508,-966570562,러시아 연방,2021-12
2021-12-31,1020957764,828862152,192095612,멕시코,2021-12
2021-12-31,1003991467,1295684450,-291692983,인도네시아,2021-12
2021-12-31,914588490,2156955445,-1242366955,독일,2021-12
2021-12-31,714432766,628271176,86161590,태국,2021-12
2021-12-31,576581623,130436606,446145017,튀르키예,2021-12
2021-12-31,573075345,438224289,134851056,캐나다,2021-12
2021-12-31,566836664,1099112867,-532276203,네덜란드,2021-12
2021-12-31,538352681,640073032,-101720351,영국,2021-12
2021-12-31,524848019,88682783,436165236,폴란드,2021-12
2021-12-31,505958036,59887233,446070803,헝가리,2021-12
2021-12-31,480400812,624276603,-143875791,이탈리아,2021-12
2021-12-31,477017491,3326878235,-2849860744,사우디아라비아,2021-12
2021-12-31,437444048,622373530,-184929482,브라질,2021-12
2021-12-31,432048730,723200249,-291151519,아랍에미리트 연합,2021-12
2021-12-31,398645264,612238083,-213592819,벨기에,2021-12
2021-12-31,395146772,133918808,261227964,그리스,2021-12
2021-12-31,353094675,607263670,-254168995,프랑스,2021-12
2021-12-31,341941576,212769141,129172435,스페인,2021-12
2021-12-31,268412860,99856350,168556510,체코공화국,2021-12
2021-12-31,252590220,48997756,203592464,슬로바키아,2021-12
2021-12-31,251768956,7005673,244763283,몰타,2021-12
2021-12-31,197126654,131666609,65460045,뉴질랜드,2021-12
2021-12-31,185415944,629705,184786239,우즈베키스탄,2021-12
2021-12-31,185020677,0,185020677,버뮤다,2021-12
2021-12-31,183016385,142500340,40516045,이스라엘,2021-12
2021-12-31,175648522,93988,175554534,마샬군도,2021-12
2021-12-31,151098818,11819989,139278829,이집트,2021-12
2021-12-31,144835157,73522590,71312567,파키스탄,2021-12
2021-12-31,144469096,428214313,-283745217,칠레,2021-12
2021-12-31,126732473,128589550,-1857077,아일랜드,2021-12
2021-12-31,122037818,53246032,68791786,방글라데시,2021-12
2021-12-31,115483711,176355,115307356,라이베리아,2021-12
2021-12-31,111118488,12074274,99044214,슬로베니아,2021-12
2021-12-31,103390453,208666193,-105275740,스웨덴,2021-12
2021-12-31,101337613,181946333,-80608720,오스트리아,2021-12
2021-12-31,84109707,112984601,-28874894,카자흐스탄,2021-12
2021-12-31,82435179,617221896,-534786717,이라크,2021-12
2021-12-31,82232471,227081391,-144848920,남아프리카공화국,2021-12
2021-12-31,66869573,362153048,-295283475,스위스,2021-12
2021-12-31,66499627,38266504,28233123,콜롬비아,2021-12
2021-12-31,64395289,42320200,22075089,나이지리아,2021-12
2021-12-31,64143741,249193469,-185049728,노르웨이,2021-12
2021-12-31,63910228,80732442,-16822214,우크라이나,2021-12
2021-12-31,63212967,32439491,30773476,캄보디아,2021-12
2021-12-31,59358797,37284454,22074343,포루투갈,2021-12
2021-12-31,59219735,107723166,-48503431,덴마크,2021-12
2021-12-31,56470925,330535627,-274064702,페루,2021-12
2021-12-31,52767093,1410116758,-1357349665,카타르,2021-12
2021-12-31,51523382,61266340,-9742958,루마니아,2021-12
2021-12-31,50377416,14435806,35941610,요르단,2021-12
2021-12-31,48920810,97720151,-48799341,에쿠아도르,2021-12
2021-12-31,45163106,305618081,-260454975,아르헨티나,2021-12
2021-12-31,40682123,93021367,-52339244,핀란드,2021-12
2021-12-31,38078972,1461657,36617315,리비아,2021-12
2021-12-31,37109995,36837060,272935,미얀마,2021-12
2021-12-31,36416207,346607718,-310191511,오만,2021-12
2021-12-31,35679473,5595895,30083578,케냐,2021-12
2021-12-31,35557729,71218103,-35660374,푸에르토리코,2021-12
2021-12-31,32729960,1939731,30790229,몽골,2021-12
2021-12-31,32606498,25200625,7405873,모로코,2021-12
2021-12-31,30945929,8168585,22777344,피지,2021-12
2021-12-31,30475720,4627059,25848661,파푸아 뉴기니,2021-12
2021-12-31,30392286,162067919,-131675633,알제리,2021-12
2021-12-31,29561838,1025761127,-996199289,쿠웨이트,2021-12
2021-12-31,28306807,7712973,20593834,도미니카 공화국,2021-12
2021-12-31,27904418,10861859,17042559,스리랑카,2021-12
2021-12-31,27871465,8939978,18931487,과테말라,2021-12
2021-12-31,25794236,48484854,-22690618,파나마,2021-12
2021-12-31,24965749,4465836,20499913,엘살바도르,2021-12
2021-12-31,23777760,3139999,20637761,가나,2021-12
2021-12-31,21450925,435491,21015434,이란,2021-12
2021-12-31,19364271,11057721,8306550,리투아니아,2021-12
2021-12-31,18073407,2625426,15447981,코트디봐르,2021-12
2021-12-31,16645948,12602368,4043580,세르비아,2021-12
2021-12-31,15100808,14359448,741360,코스타리카,2021-12
2021-12-31,13984515,1855511,12129004,탄자니아,2021-12
2021-12-31,13976420,1175943,12800477,파라과이,2021-12
2021-12-31,13297592,69749068,-56451476,불가리아,2021-12
2021-12-31,11860933,36894,11824039,수단,2021-12
2021-12-31,11856879,7200796,4656083,크로아티아,2021-12
2021-12-31,11853739,61013,11792726,아제르바이잔,2021-12
2021-12-31,11472739,633806,10838933,온두라스,2021-12
2021-12-31,11397832,10186284,1211548,튀니지,2021-12
2021-12-31,11019358,49397,10969961,키르기스스탄,2021-12
2021-12-31,10911732,19437439,-8525707,우루과이,2021-12
2021-12-31,9857205,105037727,-95180522,바레인,2021-12
2021-12-31,9422953,236719,9186234,조지아,2021-12
2021-12-31,9091030,82401173,-73310143,모잠비크,2021-12
2021-12-31,8828166,3503574,5324592,세네갈,2021-12
2021-12-31,8717525,6369816,2347709,예맨,2021-12
2021-12-31,8629273,32689,8596584,부르키나 파소,2021-12
2021-12-31,8275067,8107198,167869,에스토니아,2021-12
2021-12-31,7895146,55170177,-47275031,트리니다드 토바고,2021-12
2021-12-31,7714628,1176968,6537660,레바논,2021-12
2021-12-31,7349456,614440,6735016,앙골라,2021-12
2021-12-31,7087300,400151000,-393063700,기타국,2021-12
2021-12-31,7063559,1074634,5988925,아이슬란드,2021-12
2021-12-31,6715183,11896,6703287,팔레스타인 해방기구,2021-12
2021-12-31,6579041,5736,6573305,말리,2021-12
2021-12-31,6020032,0,6020032,타지크,2021-12
2021-12-31,6000739,7949542,-1948803,에티오피아,2021-12
2021-12-31,5997680,50971754,-44974074,콩고민주공화국,2021-12
2021-12-31,5709383,1195779,4513604,니카라과,2021-12
2021-12-31,5594664,11199683,-5605019,라트비아,2021-12
2021-12-31,5476424,501029,4975395,아이티,2021-12
2021-12-31,4929346,1373325,3556021,괌,2021-12
2021-12-31,4727249,40182356,-35455107,볼리비아,2021-12
2021-12-31,4227916,266364,3961552,말라위,2021-12
2021-12-31,4068502,611678,3456824,모리셔스,2021-12
2021-12-31,3962811,10362252,-6399441,룩셈부르그,2021-12
2021-12-31,3888586,545246,3343340,쿠바,2021-12
2021-12-31,3786781,1854903,1931878,벨라루스,2021-12
2021-12-31,3691939,5328740,-1636801,라오스,2021-12
2021-12-31,3643148,420,3642728,불령 리유니온 코모도 제도,2021-12
2021-12-31,3610115,1762112,1848003,알바니아,2021-12
2021-12-31,3592868,2463199,1129669,마다카스카르,2021-12
2021-12-31,3516594,634328,2882266,베네주엘라,2021-12
2021-12-31,3359325,2444508,914817,몰도바,2021-12
2021-12-31,3357513,403252,2954261,짐바브웨,2021-12
2021-12-31,3202260,681530,2520730,우간다,2021-12
2021-12-31,3081224,354708,2726516,네팔,2021-12
2021-12-31,2976593,4697887,-1721294,토고,2021-12
2021-12-31,2970625,0,2970625,지부티,2021-12
2021-12-31,2867327,27721,2839606,아메리칸 사모아,2021-12
2021-12-31,2553916,444932,2108984,카메룬,2021-12
2021-12-31,2507101,292503,2214598,사이프러스,2021-12
2021-12-31,2389376,401275,1988101,르완다,2021-12
2021-12-31,2279220,2265672,13548,아르메니아,2021-12
2021-12-31,2279069,289514,1989555,세이쉘,2021-12
2021-12-31,2200360,44063847,-41863487,뉴 칼레도니아,2021-12
2021-12-31,2131008,979116,1151892,콩고,2021-12
2021-12-31,1919448,0,1919448,과델로프,2021-12
2021-12-31,1853736,4135847,-2282111,기니,2021-12
2021-12-31,1807196,240849,1566347,아프카니스탄,2021-12
2021-12-31,1798500,38379,1760121,마티니크,2021-12
2021-12-31,1773043,12227,1760816,시리아,2021-12
2021-12-31,1703235,199196,1504039,북마리아나 군도,2021-12
2021-12-31,1693336,229180,1464156,가이아나,2021-12
2021-12-31,1637083,27562,1609521,마카오,2021-12
2021-12-31,1525644,0,1525644,소말리아,2021-12
2021-12-31,1506993,8529296,-7022303,잠비아,2021-12
2021-12-31,1451724,0,1451724,불령 폴리네시아,2021-12
2021-12-31,1428339,1643814,-215475,브루나이,2021-12
2021-12-31,1274988,80554368,-79279380,가봉,2021-12
2021-12-31,1238796,219958,1018838,사모아,2021-12
2021-12-31,1232934,218722,1014212,자마이카,2021-12
2021-12-31,1226356,6517,1219839,바하마,2021-12
2021-12-31,1200999,1864581,-663582,리히텐슈타인,2021-12
2021-12-31,1174951,0,1174951,아루바,2021-12
2021-12-31,1076994,41869,1035125,베닝,2021-12
2021-12-31,994827,10,994817,니제르,2021-12
2021-12-31,825658,4711,820947,투발루,2021-12
2021-12-31,730321,35114,695207,도미니카,2021-12
2021-12-31,696368,0,696368,큐라소,2021-12
2021-12-31,689621,0,689621,불령 가이아나,2021-12
2021-12-31,625177,1,625176,영령 캐이맨 군도,2021-12
2021-12-31,619935,0,619935,벨리제,2021-12
2021-12-31,560355,213591,346764,수리남,2021-12
2021-12-31,495008,467443,27565,마세도니아,2021-12
2021-12-31,493711,70052,423659,보츠와나,2021-12
2021-12-31,480333,0,480333,남수단,2021-12
2021-12-31,465592,0,465592,세인트 마틴,2021-12
2021-12-31,457459,143,457316,메요트,2021-12
2021-12-31,457272,2841881,-2384609,모리타니,2021-12
2021-12-31,430183,227302,202881,키리바티,2021-12
2021-12-31,418279,0,418279,솔로몬 군도,2021-12
2021-12-31,406912,0,406912,몰디브,2021-12
2021-12-31,391273,2636,388637,카보 베르데,2021-12
2021-12-31,377699,2702069,-2324370,보스니아-헤르체고비나,2021-12
2021-12-31,318696,2282012,-1963316,바누아투,2021-12
2021-12-31,303147,0,303147,투르크멘,2021-12
2021-12-31,300421,67667,232754,안티가 바부다,2021-12
2021-12-31,299775,2432099,-2132324,시에라 리온,2021-12
2021-12-31,296602,485295,-188693,감비아,2021-12
2021-12-31,296005,69,295936,부탄,2021-12
2021-12-31,285493,0,285493,그레나다,2021-12
2021-12-31,252952,8436,244516,마이크로네시아,2021-12
2021-12-31,229623,53402,176221,티모르,2021-12
2021-12-31,170905,7366,163539,세인트 빈센트 그레나딘,2021-12
2021-12-31,168564,78193,90371,스와질랜드,2021-12
2021-12-31,151770,2192,149578,안도라,2021-12
2021-12-31,150121,81324,68797,바베이도스,2021-12
2021-12-31,145644,26,145618,영령 버진군도,2021-12
2021-12-31,116063,0,116063,챠드,2021-12
2021-12-31,106726,96743,9983,팔라우,2021-12
2021-12-31,97578,0,97578,세인트 루시아,2021-12
2021-12-31,88776,4350660,-4261884,나우루,2021-12
2021-12-31,84812,394531,-309719,나미비아,2021-12
2021-12-31,82622,122407,-39785,세인트 키츠 네비스,2021-12
2021-12-31,76815,0,76815,지브랄타,2021-12
2021-12-31,70592,28828,41764,코모로스,2021-12
2021-12-31,66242,9748328,-9682086,몬테네그로,2021-12
2021-12-31,61048,123,60925,부룬디,2021-12
2021-12-31,45113,790186,-745073,통가,2021-12
2021-12-31,40265,7796,32469,에리트리아,2021-12
2021-12-31,39099,2820,36279,네덜란드 열도,2021-12
2021-12-31,33608,0,33608,적도 기니,2021-12
2021-12-31,19921,0,19921,남조지아 & 남샌드위치 군도,2021-12
2021-12-31,17928,373165,-355237,산마리노,2021-12
2021-12-31,16540,17544,-1004,미령 버진군도,2021-12
2021-12-31,9026,0,9026,투르크 & 카이코스 군도,2021-12
2021-12-31,5409,12,5397,상토메 프린스페,2021-12
2021-12-31,4331,67426,-63095,파로에 군도,2021-12
2021-12-31,4019,3817,202,코스 군도,2021-12
2021-12-31,2052,0,2052,앙귈라,2021-12
2021-12-31,1788,468824,-467036,모나코,2021-12
2021-12-31,1590,0,1590,세인트마틴(생마르탱),2021-12
2021-12-31,920,168478,-167558,기네비소,2021-12
2021-12-31,462,147,315,건지,2021-12
2021-12-31,263,0,263,세인트 바르탤르미,2021-12
2021-12-31,220,5835,-5615,그린랜드,2021-12
2021-12-31,80,747,-667,저어지,2021-12
2021-12-31,0,3127,-3127,마이너 아우틀링 합중국 군도,2021-12
2021-12-31,0,53166,-53166,중앙아프리카공화국,2021-12
2021-12-31,0,10413,-10413,레소토,2021-12
2021-12-31,0,8664,-8664,세인트 헬레나,2021-12
2021-12-31,0,25,-25,몬트세라트,2021-12
2021-12-31,0,9080,-9080,니우에,2021-12
2021-12-31,0,489,-489,피트카이른,2021-12
2021-12-31,0,14160,-14160,불령 남부지역,2021-12
2021-12-31,0,452248,-452248,맨섬,2021-12
2021-12-31,0,570,-570,왈라스 & 퓨투나 군도,2021-12
2021-12-31,0,10,-10,보네르 신트외스타티위스,2021-12
2021-12-31,0,316,-316,보빗군도,2021-12
2021-12-31,0,832,-832,쿡 아일랜드,2021-12
2021-12-31,0,560,-560,크리스마스 아일랜드,2021-12
2021-12-31,0,102,-102,영령 인도양,2021-12
2022-01-31,13369828912,13178863723,190965189,중국,2022-01
2022-01-31,8569920487,7105625425,1464295062,미국,2022-01
2022-01-31,5305470700,2311736438,2993734262,베트남,2022-01
2022-01-31,2617191374,4457191797,-1840000423,일본,2022-01
2022-01-31,2497240094,154528613,2342711481,홍콩,2022-01
2022-01-31,1888768591,2120716716,-231948125,대만,2022-01
2022-01-31,1465042670,695029987,770012683,인도,2022-01
2022-01-31,1375444529,915495310,459949219,싱가포르,2022-01
2022-01-31,1197523005,661365927,536157078,멕시코,2022-01
2022-01-31,1061362231,3955418472,-2894056241,호주,2022-01
2022-01-31,979063453,400282680,578780773,필리핀,2022-01
2022-01-31,898239152,1377843966,-479604814,인도네시아,2022-01
2022-01-31,852347824,1563302185,-710954361,말레이시아,2022-01
2022-01-31,807989937,2016618584,-1208628647,러시아 연방,2022-01
2022-01-31,807233291,1642450943,-835217652,독일,2022-01
2022-01-31,770245631,555686219,214559412,태국,2022-01
2022-01-31,682874521,579713104,103161417,캐나다,2022-01
2022-01-31,658764740,98074218,560690522,튀르키예,2022-01
2022-01-31,593278906,84385295,508893611,폴란드,2022-01
2022-01-31,543310356,533368307,9942049,네덜란드,2022-01
2022-01-31,502473241,378949516,123523725,영국,2022-01
2022-01-31,497274265,644733451,-147459186,이탈리아,2022-01
2022-01-31,489156210,552365971,-63209761,프랑스,2022-01
2022-01-31,440881850,634770576,-193888726,브라질,2022-01
2022-01-31,416051784,213016384,203035400,벨기에,2022-01
2022-01-31,400875476,51354529,349520947,헝가리,2022-01
2022-01-31,372045579,12225544,359820035,마샬군도,2022-01
2022-01-31,356345287,803309357,-446964070,아랍에미리트 연합,2022-01
2022-01-31,308503447,225455702,83047745,스페인,2022-01
2022-01-31,280058164,3291497586,-3011439422,사우디아라비아,2022-01
2022-01-31,262772496,67723623,195048873,체코공화국,2022-01
2022-01-31,258142466,76792256,181350210,슬로바키아,2022-01
2022-01-31,194250700,163561880,30688820,이스라엘,2022-01
2022-01-31,190356376,54824791,135531585,방글라데시,2022-01
2022-01-31,183582590,2309255,181273335,우즈베키스탄,2022-01
2022-01-31,174020154,6683991,167336163,토고,2022-01
2022-01-31,168105794,7777878,160327916,슬로베니아,2022-01
2022-01-31,151116810,36532385,114584425,이집트,2022-01
2022-01-31,132350746,659888740,-527537994,칠레,2022-01
2022-01-31,129131613,124868932,4262681,뉴질랜드,2022-01
2022-01-31,124775067,153688978,-28913911,스웨덴,2022-01
2022-01-31,117961966,425328983,-307367017,이라크,2022-01
2022-01-31,115953353,52392780,63560573,콜롬비아,2022-01
2022-01-31,99100563,144863775,-45763212,그리스,2022-01
2022-01-31,98376329,66686518,31689811,파키스탄,2022-01
2022-01-31,94333639,133722760,-39389121,오스트리아,2022-01
2022-01-31,94057782,243522691,-149464909,남아프리카공화국,2022-01
2022-01-31,78765393,32978958,45786435,캄보디아,2022-01
2022-01-31,74338874,56350437,17988437,포루투갈,2022-01
2022-01-31,73131694,333563364,-260431670,페루,2022-01
2022-01-31,67987610,293951176,-225963566,스위스,2022-01
2022-01-31,59834635,53627374,6207261,루마니아,2022-01
2022-01-31,58505491,119940764,-61435273,나이지리아,2022-01
2022-01-31,55126139,110545829,-55419690,아일랜드,2022-01
2022-01-31,54916509,224370367,-169453858,아르헨티나,2022-01
2022-01-31,54395116,215545100,-161149984,노르웨이,2022-01
2022-01-31,53109244,103247293,-50138049,카자흐스탄,2022-01
2022-01-31,47792911,77150847,-29357936,덴마크,2022-01
2022-01-31,45845035,8156379,37688656,요르단,2022-01
2022-01-31,42659183,11220455,31438728,리투아니아,2022-01
2022-01-31,40342809,11350022,28992787,에쿠아도르,2022-01
2022-01-31,40249935,40232448,17487,미얀마,2022-01
2022-01-31,40140257,1267775400,-1227635143,카타르,2022-01
2022-01-31,37918172,2057140,35861032,리비아,2022-01
2022-01-31,36753083,94515883,-57762800,우크라이나,2022-01
2022-01-31,35699536,264492,35435044,피지,2022-01
2022-01-31,34241382,1758656,32482726,몽골,2022-01
2022-01-31,34199581,183130358,-148930777,파푸아 뉴기니,2022-01
2022-01-31,33349688,16950487,16399201,모로코,2022-01
2022-01-31,31766284,3139271,28627013,엘살바도르,2022-01
2022-01-31,30357180,1584234,28772946,가나,2022-01
2022-01-31,28041148,11052697,16988451,도미니카 공화국,2022-01
2022-01-31,26833032,6302757,20530275,과테말라,2022-01
2022-01-31,26747801,6112127,20635674,케냐,2022-01
2022-01-31,26311511,1084781526,-1058470015,쿠웨이트,2022-01
2022-01-31,24799463,10503574,14295889,스리랑카,2022-01
2022-01-31,24584900,62206854,-37621954,모잠비크,2022-01
2022-01-31,22554771,68555766,-46000995,푸에르토리코,2022-01
2022-01-31,22509835,95677262,-73167427,핀란드,2022-01
2022-01-31,22282286,729297131,-707014845,오만,2022-01
2022-01-31,20655537,17881356,2774181,세르비아,2022-01
2022-01-31,20404866,70323703,-49918837,바레인,2022-01
2022-01-31,20272820,30526329,-10253509,파나마,2022-01
2022-01-31,18917621,1513062,17404559,이란,2022-01
2022-01-31,18145113,10783675,7361438,코스타리카,2022-01
2022-01-31,17211295,213568283,-196356988,알제리,2022-01
2022-01-31,17112494,37928717,-20816223,불가리아,2022-01
2022-01-31,14639006,3712591,10926415,탄자니아,2022-01
2022-01-31,13139646,844099,12295547,수단,2022-01
2022-01-31,12333043,518144,11814899,코트디봐르,2022-01
2022-01-31,12315108,889903,11425205,온두라스,2022-01
2022-01-31,10757110,5914,10751196,키르기스스탄,2022-01
2022-01-31,10504357,3836396,6667961,예맨,2022-01
2022-01-31,9822463,17750698,-7928235,우루과이,2022-01
2022-01-31,9313056,11581089,-2268033,크로아티아,2022-01
2022-01-31,8362649,6394,8356255,아제르바이잔,2022-01
2022-01-31,7884038,1905000,5979038,니카라과,2022-01
2022-01-31,7869287,875,7868412,앙골라,2022-01
2022-01-31,7751540,560005,7191535,괌,2022-01
2022-01-31,7394322,14086790,-6692468,튀니지,2022-01
2022-01-31,7197744,82103473,-74905729,콩고민주공화국,2022-01
2022-01-31,7048732,11025888,-3977156,에스토니아,2022-01
2022-01-31,6953415,1877088,5076327,파라과이,2022-01
2022-01-31,6847291,5705538,1141753,레바논,2022-01
2022-01-31,6512154,759841,5752313,조지아,2022-01
2022-01-31,6339915,364953,5974962,아이티,2022-01
2022-01-31,5897654,163500373,-157602719,카메룬,2022-01
2022-01-31,5897276,959,5896317,지부티,2022-01
2022-01-31,5802889,14780911,-8978022,트리니다드 토바고,2022-01
2022-01-31,5679896,557439819,-551759923,기타국,2022-01
2022-01-31,5648013,5438860,209153,라오스,2022-01
2022-01-31,5624845,7976165,-2351320,몰타,2022-01
2022-01-31,5550471,4027277,1523194,세네갈,2022-01
2022-01-31,5433441,0,5433441,팔레스타인 해방기구,2022-01
2022-01-31,5394145,11855297,-6461152,라트비아,2022-01
2022-01-31,5369279,7917260,-2547981,에티오피아,2022-01
2022-01-31,4754521,1556714,3197807,아이슬란드,2022-01
2022-01-31,4715152,17807,4697345,팔라우,2022-01
2022-01-31,4302015,340,4301675,불령 리유니온 코모도 제도,2022-01
2022-01-31,3839549,600,3838949,타지크,2022-01
2022-01-31,3822090,2322313,1499777,몰도바,2022-01
2022-01-31,3637341,626601,3010740,쿠바,2022-01
2022-01-31,3454634,3015999,438635,마다카스카르,2022-01
2022-01-31,3187239,18716106,-15528867,볼리비아,2022-01
2022-01-31,3124566,154256,2970310,사모아,2022-01
2022-01-31,3021316,1025521,1995795,사이프러스,2022-01
2022-01-31,2954574,526715,2427859,자마이카,2022-01
2022-01-31,2899892,688341,2211551,베네주엘라,2022-01
2022-01-31,2775434,947552,1827882,벨라루스,2022-01
2022-01-31,2668279,64286,2603993,부르키나 파소,2022-01
2022-01-31,2638813,236057,2402756,모리셔스,2022-01
2022-01-31,2620377,267885,2352492,네팔,2022-01
2022-01-31,2619107,5675817,-3056710,룩셈부르그,2022-01
2022-01-31,2377714,21211679,-18833965,뉴 칼레도니아,2022-01
2022-01-31,2269587,1028138,1241449,아르메니아,2022-01
2022-01-31,2064517,0,2064517,과델로프,2022-01
2022-01-31,2010789,277735,1733054,세이쉘,2022-01
2022-01-31,1971042,4738523,-2767481,기니,2022-01
2022-01-31,1964145,1218648,745497,알바니아,2022-01
2022-01-31,1861011,1269,1859742,바하마,2022-01
2022-01-31,1758244,1173497,584747,콩고,2022-01
2022-01-31,1728521,632,1727889,가이아나,2022-01
2022-01-31,1700391,92016,1608375,북마리아나 군도,2022-01
2022-01-31,1585715,195,1585520,아루바,2022-01
2022-01-31,1557597,76,1557521,시리아,2022-01
2022-01-31,1527475,0,1527475,부탄,2022-01
2022-01-31,1393266,122177,1271089,아프카니스탄,2022-01
2022-01-31,1368052,182388,1185664,불령 폴리네시아,2022-01
2022-01-31,1293536,99070,1194466,마세도니아,2022-01
2022-01-31,1292766,454753,838013,짐바브웨,2022-01
2022-01-31,1288976,17283,1271693,니제르,2022-01
2022-01-31,1276990,64472,1212518,르완다,2022-01
2022-01-31,1265497,10932,1254565,아메리칸 사모아,2022-01
2022-01-31,1231710,43,1231667,베닝,2022-01
2022-01-31,1219615,483382,736233,브루나이,2022-01
2022-01-31,1077746,1132451,-54705,리히텐슈타인,2022-01
2022-01-31,1040469,164264,876205,소말리아,2022-01
2022-01-31,1038659,20337,1018322,바베이도스,2022-01
2022-01-31,1028967,113836,915131,마카오,2022-01
2022-01-31,1009237,4216,1005021,몰디브,2022-01
2022-01-31,924582,124,924458,마이크로네시아,2022-01
2022-01-31,896158,7807650,-6911492,잠비아,2022-01
2022-01-31,818082,3261888,-2443806,보스니아-헤르체고비나,2022-01
2022-01-31,778874,0,778874,마티니크,2022-01
2022-01-31,776404,2192514,-1416110,모리타니,2022-01
2022-01-31,675905,539536,136369,수리남,2022-01
2022-01-31,622995,610,622385,말리,2022-01
2022-01-31,622820,19844,602976,벨리제,2022-01
2022-01-31,581562,412669,168893,라이베리아,2022-01
2022-01-31,534075,0,534075,감비아,2022-01
2022-01-31,526275,6677,519598,보츠와나,2022-01
2022-01-31,494015,21265,472750,세인트 빈센트 그레나딘,2022-01
2022-01-31,462834,74710855,-74248021,가봉,2022-01
2022-01-31,448916,0,448916,투르크멘,2022-01
2022-01-31,446887,337,446550,부룬디,2022-01
2022-01-31,443719,371034,72685,우간다,2022-01
2022-01-31,428462,30390,398072,세인트 루시아,2022-01
2022-01-31,416917,239609,177308,바누아투,2022-01
2022-01-31,408023,38512,369511,티모르,2022-01
2022-01-31,393238,1049570,-656332,시에라 리온,2022-01
2022-01-31,370742,0,370742,세인트 마틴,2022-01
2022-01-31,365854,61049846,-60683992,몬테네그로,2022-01
2022-01-31,348148,43754,304394,불령 가이아나,2022-01
2022-01-31,344217,1712981,-1368764,키리바티,2022-01
2022-01-31,261245,2965,258280,그레나다,2022-01
2022-01-31,241861,37929672,-37687811,지브랄타,2022-01
2022-01-31,228051,37112,190939,도미니카,2022-01
2022-01-31,204934,0,204934,영령 캐이맨 군도,2022-01
2022-01-31,200533,38058648,-37858115,적도 기니,2022-01
2022-01-31,195150,73722,121428,안티가 바부다,2022-01
2022-01-31,162051,6338,155713,카보 베르데,2022-01
2022-01-31,156903,0,156903,메요트,2022-01
2022-01-31,151792,6,151786,솔로몬 군도,2022-01
2022-01-31,133512,479,133033,버뮤다,2022-01
2022-01-31,131910,0,131910,큐라소,2022-01
2022-01-31,100655,9,100646,네덜란드 열도,2022-01
2022-01-31,68299,4605218,-4536919,말라위,2022-01
2022-01-31,65071,42,65029,세인트 키츠 네비스,2022-01
2022-01-31,64764,0,64764,기네비소,2022-01
2022-01-31,60480,168471,-107991,나미비아,2022-01
2022-01-31,59316,0,59316,투발루,2022-01
2022-01-31,56968,108434,-51466,스와질랜드,2022-01
2022-01-31,39098,0,39098,남수단,2022-01
2022-01-31,32817,47301,-14484,안도라,2022-01
2022-01-31,26462,0,26462,투르크 & 카이코스 군도,2022-01
2022-01-31,24055,371044,-346989,산마리노,2022-01
2022-01-31,13231,0,13231,왈라스 & 퓨투나 군도,2022-01
2022-01-31,9815,45,9770,통가,2022-01
2022-01-31,6914,0,6914,세인트 바르탤르미,2022-01
2022-01-31,6300,0,6300,영령 버진군도,2022-01
2022-01-31,5071,0,5071,중앙아프리카공화국,2022-01
2022-01-31,3927,0,3927,세인트마틴(생마르탱),2022-01
2022-01-31,3382,357,3025,코모로스,2022-01
2022-01-31,3300,641,2659,몬트세라트,2022-01
2022-01-31,1670,420,1250,앙귈라,2022-01
2022-01-31,530,334,196,건지,2022-01
2022-01-31,501,35,466,코스 군도,2022-01
2022-01-31,496,0,496,상토메 프린스페,2022-01
2022-01-31,391,19010,-18619,미령 버진군도,2022-01
2022-01-31,261,5824,-5563,그린랜드,2022-01
2022-01-31,161,1286,-1125,저어지,2022-01
2022-01-31,39,5539,-5500,파로에 군도,2022-01
2022-01-31,0,166,-166,맨섬,2022-01
2022-01-31,0,98,-98,영령 인도양,2022-01
2022-01-31,0,148,-148,레소토,2022-01
2022-01-31,0,55882,-55882,모나코,2022-01
2022-01-31,0,1457,-1457,챠드,2022-01
2022-01-31,0,16,-16,세인트 헬레나,2022-01
2022-01-31,0,27,-27,안타티카,2022-01
2022-01-31,0,15788832,-15788832,에리트리아,2022-01
2022-01-31,0,10936,-10936,니우에,2022-01
2022-01-31,0,15656,-15656,토켈라우,2022-01
2022-02-28,13042436185,10410116237,2632319948,중국,2022-02
2022-02-28,7740904909,5965124609,1775780300,미국,2022-02
2022-02-28,5236006920,2073063545,3162943375,베트남,2022-02
2022-02-28,2480974250,4713195373,-2232221123,일본,2022-02
2022-02-28,2413334765,133709025,2279625740,홍콩,2022-02
2022-02-28,2243277299,1982898709,260378590,대만,2022-02
2022-02-28,1426093052,758086893,668006159,싱가포르,2022-02
2022-02-28,1351392450,732729700,618662750,인도,2022-02
2022-02-28,1090495732,3319970322,-2229474590,호주,2022-02
2022-02-28,996592203,391550022,605042181,필리핀,2022-02
2022-02-28,947515796,517757888,429757908,멕시코,2022-02
2022-02-28,931564993,1708454445,-776889452,러시아 연방,2022-02
2022-02-28,905118510,1208933096,-303814586,말레이시아,2022-02
2022-02-28,748971683,1058059733,-309088050,인도네시아,2022-02
2022-02-28,743495218,1823430766,-1079935548,독일,2022-02
2022-02-28,688207127,71254986,616952141,튀르키예,2022-02
2022-02-28,684582352,671319898,13262454,태국,2022-02
2022-02-28,591992796,580338342,11654454,캐나다,2022-02
2022-02-28,568527632,619854397,-51326765,네덜란드,2022-02
2022-02-28,544877693,80200007,464677686,폴란드,2022-02
2022-02-28,528817933,645043889,-116225956,브라질,2022-02
2022-02-28,510617946,542223870,-31605924,영국,2022-02
2022-02-28,500915451,595408812,-94493361,프랑스,2022-02
2022-02-28,443662959,632365685,-188702726,이탈리아,2022-02
2022-02-28,423989359,209078718,214910641,벨기에,2022-02
2022-02-28,400711959,6872561,393839398,몰타,2022-02
2022-02-28,390644858,71639374,319005484,헝가리,2022-02
2022-02-28,382793743,497593219,-114799476,아랍에미리트 연합,2022-02
2022-02-28,312898937,78145,312820792,마샬군도,2022-02
2022-02-28,303310028,2713941260,-2410631232,사우디아라비아,2022-02
2022-02-28,258093667,218081346,40012321,스페인,2022-02
2022-02-28,232868983,79775584,153093399,체코공화국,2022-02
2022-02-28,216724534,1211,216723323,바하마,2022-02
2022-02-28,216150514,69116903,147033611,슬로바키아,2022-02
2022-02-28,206991534,143066167,63925367,뉴질랜드,2022-02
2022-02-28,206938662,128883146,78055516,이스라엘,2022-02
2022-02-28,194800219,48295,194751924,라이베리아,2022-02
2022-02-28,150465148,138289648,12175500,이집트,2022-02
2022-02-28,143855885,2077123,141778762,우즈베키스탄,2022-02
2022-02-28,140106722,133850213,6256509,스웨덴,2022-02
2022-02-28,136481064,9355509,127125555,나이지리아,2022-02
2022-02-28,118637230,6029572,112607658,슬로베니아,2022-02
2022-02-28,116561942,53998487,62563455,파나마,2022-02
2022-02-28,111739594,60118300,51621294,방글라데시,2022-02
2022-02-28,111311768,75587081,35724687,파키스탄,2022-02
2022-02-28,111041150,472275786,-361234636,칠레,2022-02
2022-02-28,99328961,137505767,-38176806,오스트리아,2022-02
2022-02-28,82212469,132184454,-49971985,아일랜드,2022-02
2022-02-28,78576204,293691004,-215114800,카자흐스탄,2022-02
2022-02-28,76558839,194101217,-117542378,남아프리카공화국,2022-02
2022-02-28,76274218,236441199,-160166981,스위스,2022-02
2022-02-28,70750741,35540557,35210184,콜롬비아,2022-02
2022-02-28,68578003,39370274,29207729,포루투갈,2022-02
2022-02-28,62020513,19790860,42229653,요르단,2022-02
2022-02-28,59188145,225005702,-165817557,페루,2022-02
2022-02-28,58810838,74214422,-15403584,루마니아,2022-02
2022-02-28,58061469,150524310,-92462841,노르웨이,2022-02
2022-02-28,51383655,31524957,19858698,캄보디아,2022-02
2022-02-28,50187234,13266805,36920429,그리스,2022-02
2022-02-28,49147686,651446685,-602298999,이라크,2022-02
2022-02-28,39163520,2328779,36834741,리비아,2022-02
2022-02-28,38143911,157334180,-119190269,아르헨티나,2022-02
2022-02-28,36545171,87327780,-50782609,덴마크,2022-02
2022-02-28,33071285,2970551,30100734,몽골,2022-02
2022-02-28,30687662,56442043,-25754381,미얀마,2022-02
2022-02-28,29397702,15994551,13403151,모로코,2022-02
2022-02-28,28601151,11921153,16679998,리투아니아,2022-02
2022-02-28,27558782,48913022,-21354240,푸에르토리코,2022-02
2022-02-28,26083708,7743355,18340353,세르비아,2022-02
2022-02-28,25404566,8548140,16856426,에쿠아도르,2022-02
2022-02-28,23379140,65242223,-41863083,핀란드,2022-02
2022-02-28,23131147,6818951,16312196,도미니카 공화국,2022-02
2022-02-28,22932638,63672949,-40740311,우크라이나,2022-02
2022-02-28,22675813,332137196,-309461383,오만,2022-02
2022-02-28,21324684,3078567,18246117,가나,2022-02
2022-02-28,20525494,1259885730,-1239360236,카타르,2022-02
2022-02-28,19309405,5005336,14304069,과테말라,2022-02
2022-02-28,17859933,12547711,5312222,스리랑카,2022-02
2022-02-28,17421734,96600684,-79178950,바레인,2022-02
2022-02-28,17352483,1872662,15479821,엘살바도르,2022-02
2022-02-28,16300481,1172649667,-1156349186,쿠웨이트,2022-02
2022-02-28,16247229,12244653,4002576,튀니지,2022-02
2022-02-28,16223753,6984076,9239677,케냐,2022-02
2022-02-28,16157906,22827781,-6669875,불가리아,2022-02
2022-02-28,15175936,15256460,-80524,코스타리카,2022-02
2022-02-28,14436063,1124808,13311255,수단,2022-02
2022-02-28,14195418,20049589,-5854171,우루과이,2022-02
2022-02-28,13365915,2024308,11341607,탄자니아,2022-02
2022-02-28,12982124,1010917,11971207,코트디봐르,2022-02
2022-02-28,12979623,15241755,-2262132,크로아티아,2022-02
2022-02-28,12659570,2214000,10445570,이란,2022-02
2022-02-28,12479405,264447318,-251967913,알제리,2022-02
2022-02-28,11985102,380501,11604601,모잠비크,2022-02
2022-02-28,10337842,5289,10332553,키르기스스탄,2022-02
2022-02-28,10162540,20742294,-10579754,온두라스,2022-02
2022-02-28,10137331,551203,9586128,조지아,2022-02
2022-02-28,9635652,42141,9593511,아제르바이잔,2022-02
2022-02-28,9146269,918271,8227998,파라과이,2022-02
2022-02-28,8439628,46525,8393103,카메룬,2022-02
2022-02-28,7010800,3615231,3395569,세네갈,2022-02
2022-02-28,6662743,1691908,4970835,레바논,2022-02
2022-02-28,6415872,5798907,616965,에스토니아,2022-02
2022-02-28,5952745,146188,5806557,앙골라,2022-02
2022-02-28,5887706,4403616,1484090,에티오피아,2022-02
2022-02-28,5741613,6456997,-715384,룩셈부르그,2022-02
2022-02-28,5657885,8657527,-2999642,예맨,2022-02
2022-02-28,5554660,556105,4998555,사이프러스,2022-02
2022-02-28,5509998,4681591,828407,라오스,2022-02
2022-02-28,5360708,257739,5102969,아이티,2022-02
2022-02-28,5341921,468800,4873121,괌,2022-02
2022-02-28,5273870,424389,4849481,니카라과,2022-02
2022-02-28,4565177,14022,4551155,니제르,2022-02
2022-02-28,4258713,643388,3615325,모리셔스,2022-02
2022-02-28,4228603,1461,4227142,부르키나 파소,2022-02
2022-02-28,4105083,102112977,-98007894,파푸아 뉴기니,2022-02
2022-02-28,4038678,81415,3957263,팔레스타인 해방기구,2022-02
2022-02-28,3867097,89142156,-85275059,콩고민주공화국,2022-02
2022-02-28,3798824,6455,3792369,불령 리유니온 코모도 제도,2022-02
2022-02-28,3794872,7497982,-3703110,라트비아,2022-02
2022-02-28,3789993,1379667,2410326,벨라루스,2022-02
2022-02-28,3617688,394708275,-391090587,기타국,2022-02
2022-02-28,3504439,30342739,-26838300,트리니다드 토바고,2022-02
2022-02-28,3406936,568048,2838888,아이슬란드,2022-02
2022-02-28,3383275,28,3383247,타지크,2022-02
2022-02-28,3197136,256852,2940284,자마이카,2022-02
2022-02-28,3043996,0,3043996,지부티,2022-02
2022-02-28,3015589,124286,2891303,사모아,2022-02
2022-02-28,2961416,1863835,1097581,말라위,2022-02
2022-02-28,2767344,2705108,62236,솔로몬 군도,2022-02
2022-02-28,2752211,350764,2401447,베네주엘라,2022-02
2022-02-28,2668290,517893,2150397,피지,2022-02
2022-02-28,2565366,3050805,-485439,몰도바,2022-02
2022-02-28,2534763,266621,2268142,네팔,2022-02
2022-02-28,2482450,2341250,141200,알바니아,2022-02
2022-02-28,2446678,1520243,926435,짐바브웨,2022-02
2022-02-28,2440994,131486552,-129045558,볼리비아,2022-02
2022-02-28,2423297,54795660,-52372363,브루나이,2022-02
2022-02-28,2410819,3452233,-1041414,아르메니아,2022-02
2022-02-28,2377017,6830586,-4453569,마다카스카르,2022-02
2022-02-28,2276188,15715553,-13439365,뉴 칼레도니아,2022-02
2022-02-28,2228941,8297754,-6068813,기니,2022-02
2022-02-28,1890460,145906,1744554,르완다,2022-02
2022-02-28,1707376,11,1707365,베닝,2022-02
2022-02-28,1707274,6526955,-4819681,토고,2022-02
2022-02-28,1626284,15405540,-13779256,잠비아,2022-02
2022-02-28,1531027,625067,905960,마세도니아,2022-02
2022-02-28,1455413,313206,1142207,가이아나,2022-02
2022-02-28,1361436,601331,760105,콩고,2022-02
2022-02-28,1245529,66357,1179172,마카오,2022-02
2022-02-28,1233495,225,1233270,시리아,2022-02
2022-02-28,1212741,306111,906630,북마리아나 군도,2022-02
2022-02-28,1165921,0,1165921,투발루,2022-02
2022-02-28,1132881,559434,573447,우간다,2022-02
2022-02-28,1119479,1037456,82023,모리타니,2022-02
2022-02-28,908779,310867,597912,소말리아,2022-02
2022-02-28,882720,1754525,-871805,리히텐슈타인,2022-02
2022-02-28,784266,466464,317802,세이쉘,2022-02
2022-02-28,755024,5559,749465,아프카니스탄,2022-02
2022-02-28,731962,20098,711864,과델로프,2022-02
2022-02-28,725233,2502,722731,몰디브,2022-02
2022-02-28,720354,517469,202885,쿠바,2022-02
2022-02-28,713176,0,713176,영령 캐이맨 군도,2022-02
2022-02-28,658784,18239,640545,바베이도스,2022-02
2022-02-28,652693,291125,361568,수리남,2022-02
2022-02-28,597030,3706797,-3109767,보스니아-헤르체고비나,2022-02
2022-02-28,589604,0,589604,세인트 빈센트 그레나딘,2022-02
2022-02-28,583239,0,583239,세인트 마틴,2022-02
2022-02-28,508814,0,508814,아루바,2022-02
2022-02-28,487223,0,487223,세인트 루시아,2022-02
2022-02-28,472643,129943,342700,키리바티,2022-02
2022-02-28,470879,0,470879,버뮤다,2022-02
2022-02-28,464792,60,464732,부탄,2022-02
2022-02-28,462297,252,462045,마이크로네시아,2022-02
2022-02-28,460561,119,460442,불령 가이아나,2022-02
2022-02-28,426992,98735639,-98308647,가봉,2022-02
2022-02-28,402188,0,402188,남수단,2022-02
2022-02-28,394116,236755,157361,아메리칸 사모아,2022-02
2022-02-28,378573,131668,246905,안티가 바부다,2022-02
2022-02-28,355336,130325,225011,나미비아,2022-02
2022-02-28,351967,135031,216936,스와질랜드,2022-02
2022-02-28,347276,38472,308804,코모로스,2022-02
2022-02-28,339193,305,338888,벨리제,2022-02
2022-02-28,334735,473,334262,마티니크,2022-02
2022-02-28,327004,1751018,-1424014,바누아투,2022-02
2022-02-28,293281,0,293281,말리,2022-02
2022-02-28,288420,0,288420,큐라소,2022-02
2022-02-28,258317,517124,-258807,감비아,2022-02
2022-02-28,256724,1421279,-1164555,시에라 리온,2022-02
2022-02-28,254921,383,254538,투르크멘,2022-02
2022-02-28,253431,0,253431,메요트,2022-02
2022-02-28,249999,1310,248689,카보 베르데,2022-02
2022-02-28,245933,48343,197590,보츠와나,2022-02
2022-02-28,199078,503,198575,그레나다,2022-02
2022-02-28,173381,63957,109424,불령 폴리네시아,2022-02
2022-02-28,161793,17337034,-17175241,몬테네그로,2022-02
2022-02-28,159873,10475,149398,부룬디,2022-02
2022-02-28,130547,3878,126669,도미니카,2022-02
2022-02-28,105958,0,105958,안타티카,2022-02
2022-02-28,85752,0,85752,팔라우,2022-02
2022-02-28,75160,0,75160,나우루,2022-02
2022-02-28,73714,66351429,-66277715,티모르,2022-02
2022-02-28,62629,200,62429,영령 버진군도,2022-02
2022-02-28,56715,928,55787,중앙아프리카공화국,2022-02
2022-02-28,51356,44443,6913,적도 기니,2022-02
2022-02-28,43421,768,42653,지브랄타,2022-02
2022-02-28,37258,0,37258,네덜란드 열도,2022-02
2022-02-28,24575,132870,-108295,산마리노,2022-02
2022-02-28,19763,7781,11982,레소토,2022-02
2022-02-28,17507,1102,16405,앙귈라,2022-02
2022-02-28,16291,6476,9815,안도라,2022-02
2022-02-28,11137,0,11137,챠드,2022-02
2022-02-28,10500,0,10500,투르크 & 카이코스 군도,2022-02
2022-02-28,7108,0,7108,에리트리아,2022-02
2022-02-28,6138,3547,2591,세인트 키츠 네비스,2022-02
2022-02-28,4996,0,4996,상토메 프린스페,2022-02
2022-02-28,3638,0,3638,세인트 바르탤르미,2022-02
2022-02-28,2860,32438,-29578,모나코,2022-02
2022-02-28,1980,0,1980,쿡 아일랜드,2022-02
2022-02-28,762,13738,-12976,미령 버진군도,2022-02
2022-02-28,550,226773,-226223,기네비소,2022-02
2022-02-28,455,569,-114,저어지,2022-02
2022-02-28,45,0,45,그린랜드,2022-02
2022-02-28,0,474,-474,세인트 헬레나,2022-02
2022-02-28,0,2628,-2628,피트카이른,2022-02
2022-02-28,0,76,-76,통가,2022-02
2022-02-28,0,10075,-10075,니우에,2022-02
2022-02-28,0,2,-2,왈라스 & 퓨투나 군도,2022-02
2022-02-28,0,4600,-4600,토켈라우,2022-02
2022-02-28,0,316,-316,남조지아 & 남샌드위치 군도,2022-02
2022-03-31,15642332161,12626983606,3015348555,중국,2022-03
2022-03-31,9638756584,6996572373,2642184211,미국,2022-03
2022-03-31,6136685640,2632676194,3504009446,베트남,2022-03
2022-03-31,2845962553,190360954,2655601599,홍콩,2022-03
2022-03-31,2775632071,5335419814,-2559787743,일본,2022-03
2022-03-31,2621276216,2419487661,201788555,대만,2022-03
2022-03-31,2118976161,753832423,1365143738,싱가포르,2022-03
2022-03-31,1669483445,4394022074,-2724538629,호주,2022-03
2022-03-31,1508012658,983453261,524559397,인도,2022-03
2022-03-31,1357920954,561383892,796537062,멕시코,2022-03
2022-03-31,1160444297,446631034,713813263,필리핀,2022-03
2022-03-31,982353951,1325683171,-343329220,말레이시아,2022-03
2022-03-31,957360868,2235517625,-1278156757,독일,2022-03
2022-03-31,875279349,1530250655,-654971306,인도네시아,2022-03
2022-03-31,786643998,761290777,25353221,태국,2022-03
2022-03-31,759678560,877069993,-117391433,캐나다,2022-03
2022-03-31,733591555,119305579,614285976,튀르키예,2022-03
2022-03-31,728605927,424082499,304523428,영국,2022-03
2022-03-31,652044304,74191415,577852889,폴란드,2022-03
2022-03-31,626539819,633743675,-7203856,네덜란드,2022-03
2022-03-31,521264996,730132142,-208867146,이탈리아,2022-03
2022-03-31,479412623,750789915,-271377292,브라질,2022-03
2022-03-31,442393437,57003565,385389872,헝가리,2022-03
2022-03-31,411812663,196802741,215009922,벨기에,2022-03
2022-03-31,408194874,662187765,-253992891,프랑스,2022-03
2022-03-31,395284614,3468900647,-3073616033,사우디아라비아,2022-03
2022-03-31,349729293,1656502713,-1306773420,러시아 연방,2022-03
2022-03-31,344067194,151535335,192531859,뉴질랜드,2022-03
2022-03-31,336401894,15017534,321384360,그리스,2022-03
2022-03-31,326893799,256694297,70199502,스페인,2022-03
2022-03-31,326320745,807265169,-480944424,아랍에미리트 연합,2022-03
2022-03-31,293802745,62079538,231723207,슬로바키아,2022-03
2022-03-31,288757044,106469396,182287648,체코공화국,2022-03
2022-03-31,227613858,570680,227043178,라이베리아,2022-03
2022-03-31,224415314,43430,224371884,마샬군도,2022-03
2022-03-31,194567457,4510147,190057310,우즈베키스탄,2022-03
2022-03-31,179187785,156408246,22779539,이스라엘,2022-03
2022-03-31,163854354,168428137,-4573783,오스트리아,2022-03
2022-03-31,162137810,197502983,-35365173,이집트,2022-03
2022-03-31,154642756,11322785,143319971,몰타,2022-03
2022-03-31,147411731,37793115,109618616,파키스탄,2022-03
2022-03-31,144673896,164982756,-20308860,스웨덴,2022-03
2022-03-31,139213681,303176094,-163962413,남아프리카공화국,2022-03
2022-03-31,130645816,629370565,-498724749,칠레,2022-03
2022-03-31,120476239,82384540,38091699,방글라데시,2022-03
2022-03-31,118972666,6999,118965667,바하마,2022-03
2022-03-31,87103178,10131260,76971918,슬로베니아,2022-03
2022-03-31,83972745,1169607,82803138,사이프러스,2022-03
2022-03-31,83731512,16651733,67079779,요르단,2022-03
2022-03-31,80465274,622835268,-542369994,카자흐스탄,2022-03
2022-03-31,76896913,77317365,-420452,콜롬비아,2022-03
2022-03-31,72864268,667337366,-594473098,이라크,2022-03
2022-03-31,67411563,47425494,19986069,캄보디아,2022-03
2022-03-31,66706545,281885831,-215179286,나이지리아,2022-03
2022-03-31,64596385,40453081,24143304,포루투갈,2022-03
2022-03-31,58625575,379130996,-320505421,페루,2022-03
2022-03-31,58397240,289568815,-231171575,스위스,2022-03
2022-03-31,56673638,129349183,-72675545,노르웨이,2022-03
2022-03-31,55729799,106552647,-50822848,아일랜드,2022-03
2022-03-31,53574225,61263384,-7689159,루마니아,2022-03
2022-03-31,46904269,1107773392,-1060869123,카타르,2022-03
2022-03-31,44509620,706175,43803445,리비아,2022-03
2022-03-31,42818775,11560083,31258692,에쿠아도르,2022-03
2022-03-31,41193243,216731,40976512,피지,2022-03
2022-03-31,40658295,17646259,23012036,리투아니아,2022-03
2022-03-31,39953171,2291473,37661698,몽골,2022-03
2022-03-31,37764685,27671532,10093153,푸에르토리코,2022-03
2022-03-31,37764287,83277028,-45512741,덴마크,2022-03
2022-03-31,36779025,433295,36345730,괌,2022-03
2022-03-31,35607997,182267066,-146659069,아르헨티나,2022-03
2022-03-31,34470256,69869261,-35399005,미얀마,2022-03
2022-03-31,34004307,1407600972,-1373596665,쿠웨이트,2022-03
2022-03-31,33629817,18754364,14875453,모로코,2022-03
2022-03-31,30482715,452391427,-421908712,오만,2022-03
2022-03-31,27236728,9812436,17424292,도미니카 공화국,2022-03
2022-03-31,26239054,6384993,19854061,케냐,2022-03
2022-03-31,24070213,36330545,-12260332,파나마,2022-03
2022-03-31,23492444,10948870,12543574,과테말라,2022-03
2022-03-31,23065013,8218184,14846829,세르비아,2022-03
2022-03-31,22639445,14657340,7982105,스리랑카,2022-03
2022-03-31,22450793,3037315,19413478,가나,2022-03
2022-03-31,21686345,108356694,-86670349,핀란드,2022-03
2022-03-31,20388157,468052,19920105,이란,2022-03
2022-03-31,19743792,13779337,5964455,코스타리카,2022-03
2022-03-31,19402094,183694929,-164292835,알제리,2022-03
2022-03-31,16872491,3836850,13035641,탄자니아,2022-03
2022-03-31,16698544,15478940,1219604,튀니지,2022-03
2022-03-31,16673705,1687233,14986472,코트디봐르,2022-03
2022-03-31,16512608,3786058,12726550,크로아티아,2022-03
2022-03-31,16503523,19562841,-3059318,우루과이,2022-03
2022-03-31,14149049,16938,14132111,키르기스스탄,2022-03
2022-03-31,13130456,3972416,9158040,엘살바도르,2022-03
2022-03-31,13085538,27587064,-14501526,불가리아,2022-03
2022-03-31,11028511,1732690,9295821,조지아,2022-03
2022-03-31,10586442,187266,10399176,수단,2022-03
2022-03-31,10490165,55520986,-45030821,모잠비크,2022-03
2022-03-31,10330100,1221081,9109019,레바논,2022-03
2022-03-31,10039033,29828384,-19789351,바레인,2022-03
2022-03-31,9830544,357728,9472816,팔레스타인 해방기구,2022-03
2022-03-31,9807693,932049,8875644,파라과이,2022-03
2022-03-31,9774491,182473,9592018,아제르바이잔,2022-03
2022-03-31,9439521,6824319,2615202,온두라스,2022-03
2022-03-31,8782359,3195,8779164,앙골라,2022-03
2022-03-31,8093641,59886,8033755,아이티,2022-03
2022-03-31,7901624,3693336,4208288,세네갈,2022-03
2022-03-31,6985671,5718493,1267178,라오스,2022-03
2022-03-31,6777871,433808598,-427030727,기타국,2022-03
2022-03-31,6731617,8643163,-1911546,니카라과,2022-03
2022-03-31,6021604,7989878,-1968274,뉴 칼레도니아,2022-03
2022-03-31,5944151,109359754,-103415603,파푸아 뉴기니,2022-03
2022-03-31,5735154,6009405,-274251,에스토니아,2022-03
2022-03-31,5139192,849540,4289652,베네주엘라,2022-03
2022-03-31,5085023,7896030,-2811007,예맨,2022-03
2022-03-31,4442399,11992,4430407,불령 리유니온 코모도 제도,2022-03
2022-03-31,4296051,994912,3301139,말라위,2022-03
2022-03-31,4233506,27017140,-22783634,트리니다드 토바고,2022-03
2022-03-31,4174711,8034180,-3859469,라트비아,2022-03
2022-03-31,3987820,167072,3820748,불령 폴리네시아,2022-03
2022-03-31,3724824,2100,3722724,지부티,2022-03
2022-03-31,3674526,8384247,-4709721,에티오피아,2022-03
2022-03-31,3604234,32437,3571797,부르키나 파소,2022-03
2022-03-31,3530324,983227,2547097,콩고,2022-03
2022-03-31,3317842,6357941,-3040099,토고,2022-03
2022-03-31,3284956,147843738,-144558782,콩고민주공화국,2022-03
2022-03-31,3258527,169232,3089295,사모아,2022-03
2022-03-31,3226891,185,3226706,타지크,2022-03
2022-03-31,3207040,1785702,1421338,말리,2022-03
2022-03-31,3136131,1119006,2017125,키리바티,2022-03
2022-03-31,2936150,386237,2549913,자마이카,2022-03
2022-03-31,2907182,684185,2222997,브루나이,2022-03
2022-03-31,2884297,2674974,209323,몰도바,2022-03
2022-03-31,2881954,32243,2849711,카메룬,2022-03
2022-03-31,2848160,7349200,-4501040,기니,2022-03
2022-03-31,2830767,1785346,1045421,아이슬란드,2022-03
2022-03-31,2624768,37,2624731,베닝,2022-03
2022-03-31,2441963,2411280,30683,아르메니아,2022-03
2022-03-31,2438451,9438716,-7000265,마다카스카르,2022-03
2022-03-31,2384759,11675151,-9290392,룩셈부르그,2022-03
2022-03-31,2286552,23905,2262647,가이아나,2022-03
2022-03-31,2223095,337224,1885871,네팔,2022-03
2022-03-31,2222798,492101,1730697,모리셔스,2022-03
2022-03-31,2092385,25983535,-23891150,볼리비아,2022-03
2022-03-31,2073305,359155,1714150,마세도니아,2022-03
2022-03-31,1995635,35983889,-33988254,알바니아,2022-03
2022-03-31,1927080,1715,1925365,아루바,2022-03
2022-03-31,1755808,808159,947649,벨라루스,2022-03
2022-03-31,1747463,537498,1209965,세이쉘,2022-03
2022-03-31,1649325,4704,1644621,시리아,2022-03
2022-03-31,1627857,6529,1621328,아프카니스탄,2022-03
2022-03-31,1594313,59964376,-58370063,우크라이나,2022-03
2022-03-31,1577692,350537,1227155,기네비소,2022-03
2022-03-31,1463701,430814,1032887,수리남,2022-03
2022-03-31,1356921,55078,1301843,북마리아나 군도,2022-03
2022-03-31,1193692,338030,855662,소말리아,2022-03
2022-03-31,1175153,0,1175153,마티니크,2022-03
2022-03-31,1156281,0,1156281,부탄,2022-03
2022-03-31,1103113,1952087,-848974,리히텐슈타인,2022-03
2022-03-31,1006774,2921331,-1914557,시에라 리온,2022-03
2022-03-31,942017,1572562,-630545,우간다,2022-03
2022-03-31,914901,5640738,-4725837,잠비아,2022-03
2022-03-31,909110,0,909110,투르크멘,2022-03
2022-03-31,907749,41083,866666,마카오,2022-03
2022-03-31,897278,102283,794995,바누아투,2022-03
2022-03-31,832558,7296,825262,벨리제,2022-03
2022-03-31,819982,195388,624594,르완다,2022-03
2022-03-31,816752,0,816752,투발루,2022-03
2022-03-31,811195,2186938,-1375743,모리타니,2022-03
2022-03-31,794762,49457,745305,아메리칸 사모아,2022-03
2022-03-31,761997,324580,437417,짐바브웨,2022-03
2022-03-31,748340,213,748127,과델로프,2022-03
2022-03-31,703760,6396,697364,니제르,2022-03
2022-03-31,693595,5875955,-5182360,보스니아-헤르체고비나,2022-03
2022-03-31,653488,155047,498441,마이크로네시아,2022-03
2022-03-31,616163,0,616163,큐라소,2022-03
2022-03-31,592485,1322,591163,몰디브,2022-03
2022-03-31,575119,0,575119,솔로몬 군도,2022-03
2022-03-31,540124,322,539802,도미니카,2022-03
2022-03-31,488914,0,488914,세인트 마틴,2022-03
2022-03-31,479742,62444,417298,바베이도스,2022-03
2022-03-31,426410,0,426410,세인트 루시아,2022-03
2022-03-31,336680,985443,-648763,감비아,2022-03
2022-03-31,334384,97082261,-96747877,가봉,2022-03
2022-03-31,299107,23301,275806,안도라,2022-03
2022-03-31,272572,0,272572,세인트 빈센트 그레나딘,2022-03
2022-03-31,256312,59,256253,버뮤다,2022-03
2022-03-31,254346,168,254178,부룬디,2022-03
2022-03-31,246597,0,246597,불령 가이아나,2022-03
2022-03-31,221293,74279,147014,팔라우,2022-03
2022-03-31,192400,416183,-223783,쿠바,2022-03
2022-03-31,170859,0,170859,그레나다,2022-03
2022-03-31,160760,1439525,-1278765,산마리노,2022-03
2022-03-31,153141,303,152838,카보 베르데,2022-03
2022-03-31,124275,0,124275,티모르,2022-03
2022-03-31,117200,9057,108143,네덜란드 열도,2022-03
2022-03-31,103488,25293,78195,보츠와나,2022-03
2022-03-31,68281,73516,-5235,스와질랜드,2022-03
2022-03-31,66984,4277036,-4210052,나우루,2022-03
2022-03-31,65163,445339,-380176,나미비아,2022-03
2022-03-31,50082,19968,30114,통가,2022-03
2022-03-31,47042,1488,45554,안티가 바부다,2022-03
2022-03-31,39548,99,39449,지브랄타,2022-03
2022-03-31,36842,10817678,-10780836,에리트리아,2022-03
2022-03-31,27338,6755,20583,미령 버진군도,2022-03
2022-03-31,24217,8834,15383,세인트 키츠 네비스,2022-03
2022-03-31,21659,24179727,-24158068,몬테네그로,2022-03
2022-03-31,19043,25,19018,영령 캐이맨 군도,2022-03
2022-03-31,18030,236,17794,앙귈라,2022-03
2022-03-31,15730,221,15509,챠드,2022-03
2022-03-31,15560,18739944,-18724384,적도 기니,2022-03
2022-03-31,11895,0,11895,왈라스 & 퓨투나 군도,2022-03
2022-03-31,10292,0,10292,세인트 바르탤르미,2022-03
2022-03-31,7509,0,7509,코모로스,2022-03
2022-03-31,5297,232,5065,영령 버진군도,2022-03
2022-03-31,5138,379794,-374656,모나코,2022-03
2022-03-31,4200,0,4200,안타티카,2022-03
2022-03-31,3465,0,3465,중앙아프리카공화국,2022-03
2022-03-31,2659,3784,-1125,레소토,2022-03
2022-03-31,2260,610,1650,포클랜드 군도,2022-03
2022-03-31,2160,0,2160,세인트마틴(생마르탱),2022-03
2022-03-31,981,8,973,남수단,2022-03
2022-03-31,957,22249,-21292,세인트 헬레나,2022-03
2022-03-31,679,2265,-1586,저어지,2022-03
2022-03-31,349,1643,-1294,건지,2022-03
2022-03-31,162,1567,-1405,파로에 군도,2022-03
2022-03-31,161,0,161,그린랜드,2022-03
2022-03-31,0,1259,-1259,쿡 아일랜드,2022-03
2022-03-31,0,4706,-4706,허드 앤 맥도날드 군도,2022-03
2022-03-31,0,21576,-21576,토켈라우,2022-03
2022-03-31,0,1404,-1404,마이너 아우틀링 합중국 군도,2022-03
2022-03-31,0,86995,-86995,맨섬,2022-03
2022-03-31,0,25374,-25374,니우에,2022-03
2022-03-31,0,172,-172,영령 인도양,2022-03
2022-03-31,0,2084,-2084,스발비드 군도,2022-03
2022-03-31,0,242,-242,몬트세라트,2022-03
2022-04-30,12949233745,12332267535,616966210,중국,2022-04
2022-04-30,9605726016,6606658188,2999067828,미국,2022-04
2022-04-30,5405344624,2338354185,3066990439,베트남,2022-04
2022-04-30,2624893550,4879907653,-2255014103,일본,2022-04
2022-04-30,2309273173,2398831259,-89558086,대만,2022-04
2022-04-30,2299944294,163119261,2136825033,홍콩,2022-04
2022-04-30,1857721458,842717227,1015004231,싱가포르,2022-04
2022-04-30,1575453749,2936619053,-1361165304,호주,2022-04
2022-04-30,1540594906,891258443,649336463,인도,2022-04
2022-04-30,1234243001,349916918,884326083,필리핀,2022-04
2022-04-30,1168987268,581529653,587457615,멕시코,2022-04
2022-04-30,1012967137,1168138253,-155171116,말레이시아,2022-04
2022-04-30,897848582,2271245141,-1373396559,독일,2022-04
2022-04-30,861040156,1250955989,-389915833,인도네시아,2022-04
2022-04-30,792990642,114000014,678990628,튀르키예,2022-04
2022-04-30,777160214,723399549,53760665,태국,2022-04
2022-04-30,734222098,729333113,4888985,캐나다,2022-04
2022-04-30,560179166,641781058,-81601892,영국,2022-04
2022-04-30,537901133,678747163,-140846030,이탈리아,2022-04
2022-04-30,509110504,86850393,422260111,폴란드,2022-04
2022-04-30,496202417,428680989,67521428,네덜란드,2022-04
2022-04-30,439888120,59090247,380797873,헝가리,2022-04
2022-04-30,422018250,591812815,-169794565,프랑스,2022-04
2022-04-30,416321354,232127039,184194315,벨기에,2022-04
2022-04-30,396405128,537975082,-141569954,브라질,2022-04
2022-04-30,342503664,3530835000,-3188331336,사우디아라비아,2022-04
2022-04-30,328831217,220475786,108355431,스페인,2022-04
2022-04-30,313756659,597823,313158836,라이베리아,2022-04
2022-04-30,282768740,1093858897,-811090157,아랍에미리트 연합,2022-04
2022-04-30,244836633,1682871606,-1438034973,러시아 연방,2022-04
2022-04-30,225891737,81339925,144551812,체코공화국,2022-04
2022-04-30,214350962,5709663,208641299,토고,2022-04
2022-04-30,212080816,174102184,37978632,뉴질랜드,2022-04
2022-04-30,211009799,6336393,204673406,몰타,2022-04
2022-04-30,208152741,55492644,152660097,슬로바키아,2022-04
2022-04-30,194144971,65933786,128211185,방글라데시,2022-04
2022-04-30,182777109,1645322,181131787,우즈베키스탄,2022-04
2022-04-30,165789879,185421900,-19632021,오스트리아,2022-04
2022-04-30,162386904,655764780,-493377876,칠레,2022-04
2022-04-30,146976570,121189754,25786816,이스라엘,2022-04
2022-04-30,141618405,132785166,8833239,스웨덴,2022-04
2022-04-30,135847454,9994798,125852656,슬로베니아,2022-04
2022-04-30,131293899,23476762,107817137,파키스탄,2022-04
2022-04-30,124273989,532153169,-407879180,카자흐스탄,2022-04
2022-04-30,118857833,7267277,111590556,케냐,2022-04
2022-04-30,115335785,164676206,-49340421,이집트,2022-04
2022-04-30,102426611,323928774,-221502163,남아프리카공화국,2022-04
2022-04-30,90958885,42233981,48724904,콜롬비아,2022-04
2022-04-30,88368753,8126590,80242163,에쿠아도르,2022-04
2022-04-30,86931046,143489360,-56558314,노르웨이,2022-04
2022-04-30,76543456,318360893,-241817437,페루,2022-04
2022-04-30,74816183,754430133,-679613950,이라크,2022-04
2022-04-30,73793626,12290863,61502763,그리스,2022-04
2022-04-30,67073531,259328699,-192255168,스위스,2022-04
2022-04-30,66967358,136039372,-69072014,아일랜드,2022-04
2022-04-30,66693257,32931352,33761905,포루투갈,2022-04
2022-04-30,66665731,69425516,-2759785,나이지리아,2022-04
2022-04-30,62405978,10438715,51967263,요르단,2022-04
2022-04-30,57812885,28924490,28888395,캄보디아,2022-04
2022-04-30,54083283,200173,53883110,괌,2022-04
2022-04-30,42836558,46567308,-3730750,루마니아,2022-04
2022-04-30,42517775,44340177,-1822402,미얀마,2022-04
2022-04-30,41497390,3025362,38472028,몽골,2022-04
2022-04-30,40498734,21108786,19389948,푸에르토리코,2022-04
2022-04-30,38137898,80302951,-42165053,덴마크,2022-04
2022-04-30,37677881,737840,36940041,리비아,2022-04
2022-04-30,37032072,10971764,26060308,리투아니아,2022-04
2022-04-30,35398325,116926080,-81527755,아르헨티나,2022-04
2022-04-30,35035072,18850,35016222,마샬군도,2022-04
2022-04-30,33986274,485105831,-451119557,오만,2022-04
2022-04-30,33930915,9333797,24597118,도미니카 공화국,2022-04
2022-04-30,33362044,72605471,-39243427,모로코,2022-04
2022-04-30,32664962,87458338,-54793376,파나마,2022-04
2022-04-30,28099726,31801489,-3701763,세르비아,2022-04
2022-04-30,25319360,1407839755,-1382520395,카타르,2022-04
2022-04-30,25097578,13405022,11692556,과테말라,2022-04
2022-04-30,24932137,104968528,-80036391,핀란드,2022-04
2022-04-30,22874674,1315261175,-1292386501,쿠웨이트,2022-04
2022-04-30,21371869,11250015,10121854,코스타리카,2022-04
2022-04-30,20539136,10354743,10184393,크로아티아,2022-04
2022-04-30,19714034,13660728,6053306,엘살바도르,2022-04
2022-04-30,19560120,1664734,17895386,코트디봐르,2022-04
2022-04-30,19371870,13534491,5837379,스리랑카,2022-04
2022-04-30,19239131,6714381,12524750,온두라스,2022-04
2022-04-30,18781922,2636910,16145012,가나,2022-04
2022-04-30,18463452,598,18462854,앙골라,2022-04
2022-04-30,15668932,23482298,-7813366,불가리아,2022-04
2022-04-30,15624047,1383932,14240115,이란,2022-04
2022-04-30,15609654,241730607,-226120953,알제리,2022-04
2022-04-30,13705225,102409,13602816,키르기스스탄,2022-04
2022-04-30,13105329,8450820,4654509,탄자니아,2022-04
2022-04-30,11885905,189668,11696237,수단,2022-04
2022-04-30,11852068,34528,11817540,아제르바이잔,2022-04
2022-04-30,11542483,82143570,-70601087,모잠비크,2022-04
2022-04-30,11271756,1681465,9590291,파라과이,2022-04
2022-04-30,10922610,10495275,427335,튀니지,2022-04
2022-04-30,10463209,3362876,7100333,세네갈,2022-04
2022-04-30,9389939,50565717,-41175778,우루과이,2022-04
2022-04-30,8588081,145654125,-137066044,바레인,2022-04
2022-04-30,8013241,546197,7467044,조지아,2022-04
2022-04-30,7924731,23272327,-15347596,라오스,2022-04
2022-04-30,7802245,1847618,5954627,레바논,2022-04
2022-04-30,7234773,4917222,2317551,에스토니아,2022-04
2022-04-30,6892825,10209440,-3316615,니카라과,2022-04
2022-04-30,6495270,8416918,-1921648,니제르,2022-04
2022-04-30,6451303,2011965,4439338,우간다,2022-04
2022-04-30,6429430,97288502,-90859072,콩고민주공화국,2022-04
2022-04-30,6341776,86946,6254830,팔레스타인 해방기구,2022-04
2022-04-30,5996514,5254446,742068,룩셈부르그,2022-04
2022-04-30,5873245,140914224,-135040979,우크라이나,2022-04
2022-04-30,5763078,156360,5606718,자마이카,2022-04
2022-04-30,5657440,185455,5471985,아이티,2022-04
2022-04-30,5620428,104114,5516314,피지,2022-04
2022-04-30,5521165,300905960,-295384795,기타국,2022-04
2022-04-30,5338413,18844241,-13505828,트리니다드 토바고,2022-04
2022-04-30,5122166,24856,5097310,카메룬,2022-04
2022-04-30,5087222,2184,5085038,타지크,2022-04
2022-04-30,4930329,3764827,1165502,브루나이,2022-04
2022-04-30,4812861,917506,3895355,아이슬란드,2022-04
2022-04-30,4468507,6031252,-1562745,예맨,2022-04
2022-04-30,4403412,56952687,-52549275,볼리비아,2022-04
2022-04-30,3893149,1292345,2600804,베네주엘라,2022-04
2022-04-30,3880054,6254714,-2374660,에티오피아,2022-04
2022-04-30,3774179,80,3774099,지부티,2022-04
2022-04-30,3745465,2383023,1362442,몰도바,2022-04
2022-04-30,3404470,1011226,2393244,부르키나 파소,2022-04
2022-04-30,3385626,1013146,2372480,모리셔스,2022-04
2022-04-30,3385112,100797,3284315,사모아,2022-04
2022-04-30,3375335,663965,2711370,사이프러스,2022-04
2022-04-30,3207925,5458733,-2250808,기니,2022-04
2022-04-30,3147097,6067455,-2920358,라트비아,2022-04
2022-04-30,3073806,1995380,1078426,알바니아,2022-04
2022-04-30,2982313,2597,2979716,불령 리유니온 코모도 제도,2022-04
2022-04-30,2862948,4119959,-1257011,마다카스카르,2022-04
2022-04-30,2788017,523471,2264546,말리,2022-04
2022-04-30,2784505,3063422,-278917,보스니아-헤르체고비나,2022-04
2022-04-30,2664052,1582736,1081316,아르메니아,2022-04
2022-04-30,2641136,226182,2414954,네팔,2022-04
2022-04-30,2637900,198,2637702,가이아나,2022-04
2022-04-30,2489726,1346210,1143516,벨라루스,2022-04
2022-04-30,2389820,29620072,-27230252,뉴 칼레도니아,2022-04
2022-04-30,2305396,573,2304823,아루바,2022-04
2022-04-30,2287369,3033529,-746160,말라위,2022-04
2022-04-30,2229523,0,2229523,큐라소,2022-04
2022-04-30,2074282,12047675,-9973393,파푸아 뉴기니,2022-04
2022-04-30,2032617,2402658,-370041,모리타니,2022-04
2022-04-30,1906395,287849,1618546,콩고,2022-04
2022-04-30,1899971,72617,1827354,불령 폴리네시아,2022-04
2022-04-30,1781093,20947,1760146,시리아,2022-04
2022-04-30,1746323,265527,1480796,나미비아,2022-04
2022-04-30,1701711,344153,1357558,수리남,2022-04
2022-04-30,1700915,2027150,-326235,짐바브웨,2022-04
2022-04-30,1680085,0,1680085,베닝,2022-04
2022-04-30,1553476,0,1553476,세인트 마틴,2022-04
2022-04-30,1541777,239799,1301978,마세도니아,2022-04
2022-04-30,1466026,75518,1390508,마카오,2022-04
2022-04-30,1444314,18216,1426098,마티니크,2022-04
2022-04-30,1399515,4757710,-3358195,잠비아,2022-04
2022-04-30,1335493,1907552,-572059,리히텐슈타인,2022-04
2022-04-30,1307561,163399,1144162,북마리아나 군도,2022-04
2022-04-30,1223918,33759,1190159,마이크로네시아,2022-04
2022-04-30,1204370,72728,1131642,보츠와나,2022-04
2022-04-30,1197190,0,1197190,영령 캐이맨 군도,2022-04
2022-04-30,1177396,4855,1172541,아프카니스탄,2022-04
2022-04-30,1143550,500,1143050,투르크멘,2022-04
2022-04-30,1127088,7109,1119979,아메리칸 사모아,2022-04
2022-04-30,969768,115199646,-114229878,가봉,2022-04
2022-04-30,956503,704678,251825,세이쉘,2022-04
2022-04-30,892217,151750,740467,소말리아,2022-04
2022-04-30,860166,20846,839320,바하마,2022-04
2022-04-30,814290,0,814290,몰디브,2022-04
2022-04-30,799543,0,799543,과델로프,2022-04
2022-04-30,727442,4637615,-3910173,나우루,2022-04
2022-04-30,674786,0,674786,불령 가이아나,2022-04
2022-04-30,518596,1054576,-535980,쿠바,2022-04
2022-04-30,487056,1445770,-958714,솔로몬 군도,2022-04
2022-04-30,466862,0,466862,벨리제,2022-04
2022-04-30,456479,155,456324,세인트 루시아,2022-04
2022-04-30,455344,385,454959,영령 버진군도,2022-04
2022-04-30,442957,12666,430291,스와질랜드,2022-04
2022-04-30,440521,143176,297345,르완다,2022-04
2022-04-30,435186,410,434776,버뮤다,2022-04
2022-04-30,419247,966890,-547643,바누아투,2022-04
2022-04-30,403159,730,402429,부탄,2022-04
2022-04-30,386314,800742,-414428,시에라 리온,2022-04
2022-04-30,365211,638445,-273234,감비아,2022-04
2022-04-30,335710,63712,271998,안티가 바부다,2022-04
2022-04-30,304089,4171,299918,도미니카,2022-04
2022-04-30,301254,63580,237674,중앙아프리카공화국,2022-04
2022-04-30,282089,486,281603,세인트 빈센트 그레나딘,2022-04
2022-04-30,266478,0,266478,그레나다,2022-04
2022-04-30,233589,68195,165394,바베이도스,2022-04
2022-04-30,233207,23578,209629,카보 베르데,2022-04
2022-04-30,230837,194333,36504,티모르,2022-04
2022-04-30,215129,343334,-128205,키리바티,2022-04
2022-04-30,205347,63031892,-62826545,적도 기니,2022-04
2022-04-30,168325,1,168324,남수단,2022-04
2022-04-30,91557,4721,86836,미령 버진군도,2022-04
2022-04-30,83605,12,83593,챠드,2022-04
2022-04-30,78302,4404,73898,세인트 키츠 네비스,2022-04
2022-04-30,76781,312,76469,네덜란드 열도,2022-04
2022-04-30,67566,42050,25516,팔라우,2022-04
2022-04-30,57313,931939,-874626,산마리노,2022-04
2022-04-30,43352,1158,42194,부룬디,2022-04
2022-04-30,31145,578,30567,지브랄타,2022-04
2022-04-30,23773,485,23288,앙귈라,2022-04
2022-04-30,16535,78108,-61573,파로에 군도,2022-04
2022-04-30,16321,23038989,-23022668,몬테네그로,2022-04
2022-04-30,15612,0,15612,왈라스 & 퓨투나 군도,2022-04
2022-04-30,13696,8124,5572,투발루,2022-04
2022-04-30,7700,31715,-24015,기네비소,2022-04
2022-04-30,4499,5556,-1057,세인트 바르탤르미,2022-04
2022-04-30,2940,5004,-2064,레소토,2022-04
2022-04-30,2704,3616,-912,안도라,2022-04
2022-04-30,2584,82735,-80151,모나코,2022-04
2022-04-30,1681,0,1681,세인트 헬레나,2022-04
2022-04-30,1345,0,1345,세인트마틴(생마르탱),2022-04
2022-04-30,1300,639,661,투르크 & 카이코스 군도,2022-04
2022-04-30,396,1734,-1338,저어지,2022-04
2022-04-30,393,26583,-26190,그린랜드,2022-04
2022-04-30,29,1815,-1786,쿡 아일랜드,2022-04
2022-04-30,4,13879752,-13879748,에리트리아,2022-04
2022-04-30,0,4757,-4757,마이너 아우틀링 합중국 군도,2022-04
2022-04-30,0,209,-209,영령 인도양,2022-04
2022-04-30,0,1768,-1768,코스 군도,2022-04
2022-04-30,0,1291,-1291,포클랜드 군도,2022-04
2022-04-30,0,3681,-3681,토켈라우,2022-04
2022-04-30,0,2965,-2965,코모로스,2022-04
2022-04-30,0,402,-402,통가,2022-04
2022-04-30,0,3,-3,메요트,2022-04
2022-04-30,0,16241,-16241,몬트세라트,2022-04
2022-04-30,0,727,-727,스발비드 군도,2022-04
2022-04-30,0,136,-136,니우에,2022-04
2022-05-31,13419778702,14515940795,-1096162093,중국,2022-05
2022-05-31,9620648743,7196285707,2424363036,미국,2022-05
2022-05-31,4951818601,2175085049,2776733552,베트남,2022-05
2022-05-31,2949302352,2427228874,522073478,대만,2022-05
2022-05-31,2830499956,4259691820,-1429191864,일본,2022-05
2022-05-31,2637335125,134978212,2502356913,홍콩,2022-05
2022-05-31,1970569751,3832748298,-1862178547,호주,2022-05
2022-05-31,1700822646,1078170417,622652229,인도,2022-05
2022-05-31,1652990834,857067285,795923549,싱가포르,2022-05
2022-05-31,1264886831,423785434,841101397,필리핀,2022-05
2022-05-31,1136932828,776414157,360518671,멕시코,2022-05
2022-05-31,1024150117,1319683201,-295533084,인도네시아,2022-05
2022-05-31,897014119,997825373,-100811254,말레이시아,2022-05
2022-05-31,893903806,2031531897,-1137628091,독일,2022-05
2022-05-31,850699999,829229244,21470755,네덜란드,2022-05
2022-05-31,792675165,683647705,109027460,태국,2022-05
2022-05-31,705792266,145006342,560785924,튀르키예,2022-05
2022-05-31,685235732,797877072,-112641340,캐나다,2022-05
2022-05-31,639423868,117604957,521818911,폴란드,2022-05
2022-05-31,576355915,772217,575583698,라이베리아,2022-05
2022-05-31,543452349,57811028,485641321,헝가리,2022-05
2022-05-31,532114919,6379634,525735285,토고,2022-05
2022-05-31,516382039,752177860,-235795821,영국,2022-05
2022-05-31,463290728,1013240397,-549949669,아랍에미리트 연합,2022-05
2022-05-31,462472527,489648785,-27176258,브라질,2022-05
2022-05-31,445471468,727013302,-281541834,이탈리아,2022-05
2022-05-31,421496361,3730847234,-3309350873,사우디아라비아,2022-05
2022-05-31,414135461,331848615,82286846,벨기에,2022-05
2022-05-31,370861799,676970675,-306108876,프랑스,2022-05
2022-05-31,313499223,1068994152,-755494929,러시아 연방,2022-05
2022-05-31,303476337,43022268,260454069,방글라데시,2022-05
2022-05-31,292986706,213251383,79735323,스페인,2022-05
2022-05-31,279650135,83030367,196619768,체코공화국,2022-05
2022-05-31,263709725,439647,263270078,마샬군도,2022-05
2022-05-31,225687289,48985565,176701724,슬로바키아,2022-05
2022-05-31,202737308,209391480,-6654172,뉴질랜드,2022-05
2022-05-31,187983534,416,187983118,바하마,2022-05
2022-05-31,169696703,8808655,160888048,에쿠아도르,2022-05
2022-05-31,166649284,3611242,163038042,우즈베키스탄,2022-05
2022-05-31,161120174,21768319,139351855,그리스,2022-05
2022-05-31,151368934,140952831,10416103,이스라엘,2022-05
2022-05-31,143789983,10345680,133444303,몰타,2022-05
2022-05-31,140861137,741698735,-600837598,칠레,2022-05
2022-05-31,132342867,42813262,89529605,파키스탄,2022-05
2022-05-31,131547888,357779089,-226231201,카자흐스탄,2022-05
2022-05-31,128959614,120057260,8902354,이집트,2022-05
2022-05-31,122602538,171809298,-49206760,오스트리아,2022-05
2022-05-31,120450899,9449795,111001104,슬로베니아,2022-05
2022-05-31,111409802,199935493,-88525691,스웨덴,2022-05
2022-05-31,110111889,0,110111889,서사하라,2022-05
2022-05-31,93378234,300349818,-206971584,남아프리카공화국,2022-05
2022-05-31,86442964,117628491,-31185527,아일랜드,2022-05
2022-05-31,84911098,762521962,-677610864,이라크,2022-05
2022-05-31,84393050,981354,83411696,사이프러스,2022-05
2022-05-31,83061127,42920420,40140707,콜롬비아,2022-05
2022-05-31,82353310,146523297,-64169987,아르헨티나,2022-05
2022-05-31,82101893,175434107,-93332214,노르웨이,2022-05
2022-05-31,81844323,4531991,77312332,파나마,2022-05
2022-05-31,75094835,274927072,-199832237,페루,2022-05
2022-05-31,72300071,150681211,-78381140,나이지리아,2022-05
2022-05-31,70671894,48755248,21916646,포루투갈,2022-05
2022-05-31,62978119,9453309,53524810,요르단,2022-05
2022-05-31,61497098,366372,61130726,괌,2022-05
2022-05-31,56121016,0,56121016,버뮤다,2022-05
2022-05-31,56007064,272030157,-216023093,스위스,2022-05
2022-05-31,54289267,27326889,26962378,캄보디아,2022-05
2022-05-31,49786541,1057010,48729531,피지,2022-05
2022-05-31,44074550,28287,44046263,중앙아프리카공화국,2022-05
2022-05-31,40616802,10611376,30005426,리투아니아,2022-05
2022-05-31,40131454,30934821,9196633,미얀마,2022-05
2022-05-31,39247747,1352377340,-1313129593,카타르,2022-05
2022-05-31,38679218,5732269,32946949,몽골,2022-05
2022-05-31,38484171,96163969,-57679798,루마니아,2022-05
2022-05-31,37277293,19109659,18167634,리비아,2022-05
2022-05-31,36624645,89872062,-53247417,덴마크,2022-05
2022-05-31,36098252,11077868,25020384,도미니카 공화국,2022-05
2022-05-31,32409035,14950118,17458917,모로코,2022-05
2022-05-31,31165393,23903931,7261462,푸에르토리코,2022-05
2022-05-31,28567698,1020013305,-991445607,쿠웨이트,2022-05
2022-05-31,27489019,10567359,16921660,과테말라,2022-05
2022-05-31,27259751,28762109,-1502358,코스타리카,2022-05
2022-05-31,25808512,9153631,16654881,케냐,2022-05
2022-05-31,25746064,97542297,-71796233,핀란드,2022-05
2022-05-31,20802356,284999077,-264196721,오만,2022-05
2022-05-31,19695987,326153363,-306457376,알제리,2022-05
2022-05-31,19414050,3353850,16060200,가나,2022-05
2022-05-31,19178827,8951634,10227193,세르비아,2022-05
2022-05-31,18900015,871238,18028777,코트디봐르,2022-05
2022-05-31,18040746,328349,17712397,이란,2022-05
2022-05-31,16760284,83725,16676559,파라과이,2022-05
2022-05-31,16502565,16983958,-481393,엘살바도르,2022-05
2022-05-31,16013038,9863,16003175,아제르바이잔,2022-05
2022-05-31,15849545,29459247,-13609702,불가리아,2022-05
2022-05-31,15418735,11632788,3785947,스리랑카,2022-05
2022-05-31,14320303,118,14320185,키르기스스탄,2022-05
2022-05-31,13593293,9172257,4421036,탄자니아,2022-05
2022-05-31,12656281,12622329,33952,크로아티아,2022-05
2022-05-31,11945384,21265765,-9320381,온두라스,2022-05
2022-05-31,11753478,230552,11522926,조지아,2022-05
2022-05-31,11257302,33885109,-22627807,우루과이,2022-05
2022-05-31,10976991,1036256,9940735,수단,2022-05
2022-05-31,10558717,20391,10538326,카메룬,2022-05
2022-05-31,10345464,140959800,-130614336,바레인,2022-05
2022-05-31,10333714,11989499,-1655785,튀니지,2022-05
2022-05-31,9976569,8407202,1569367,예맨,2022-05
2022-05-31,9585730,33358159,-23772429,모잠비크,2022-05
2022-05-31,9186938,32427862,-23240924,우크라이나,2022-05
2022-05-31,8970698,9348742,-378044,니카라과,2022-05
2022-05-31,8887231,4999705,3887526,라오스,2022-05
2022-05-31,8610715,3717647,4893068,세네갈,2022-05
2022-05-31,8254348,341833,7912515,앙골라,2022-05
2022-05-31,8000814,7779856,220958,에티오피아,2022-05
2022-05-31,7553742,129,7553613,팔레스타인 해방기구,2022-05
2022-05-31,7454588,2797811,4656777,레바논,2022-05
2022-05-31,7443101,3979341,3463760,파푸아 뉴기니,2022-05
2022-05-31,7396404,5512953,1883451,에스토니아,2022-05
2022-05-31,7286345,66099,7220246,팔라우,2022-05
2022-05-31,5922897,274096,5648801,아이티,2022-05
2022-05-31,5633586,5344858,288728,기니,2022-05
2022-05-31,5475217,349840503,-344365286,기타국,2022-05
2022-05-31,5407721,70306688,-64898967,콩고민주공화국,2022-05
2022-05-31,5377841,290403,5087438,네팔,2022-05
2022-05-31,5224589,575230,4649359,자마이카,2022-05
2022-05-31,4751332,43329752,-38578420,트리니다드 토바고,2022-05
2022-05-31,4570534,57047906,-52477372,뉴 칼레도니아,2022-05
2022-05-31,4484362,10423559,-5939197,라트비아,2022-05
2022-05-31,4450580,73101915,-68651335,볼리비아,2022-05
2022-05-31,4304759,6896,4297863,타지크,2022-05
2022-05-31,4009963,1537,4008426,가이아나,2022-05
2022-05-31,3960316,1682151,2278165,아이슬란드,2022-05
2022-05-31,3448923,258960,3189963,사모아,2022-05
2022-05-31,3350821,1593059,1757762,아르메니아,2022-05
2022-05-31,3209447,1890168,1319279,우간다,2022-05
2022-05-31,3162516,1841902,1320614,베네주엘라,2022-05
2022-05-31,3077707,25056110,-21978403,마다카스카르,2022-05
2022-05-31,2859442,5568176,-2708734,몰도바,2022-05
2022-05-31,2807388,299506,2507882,모리셔스,2022-05
2022-05-31,2724100,0,2724100,지부티,2022-05
2022-05-31,2552739,8561426,-6008687,룩셈부르그,2022-05
2022-05-31,2528282,143212,2385070,북마리아나 군도,2022-05
2022-05-31,2312875,1436776,876099,보스니아-헤르체고비나,2022-05
2022-05-31,2229286,1140745,1088541,콩고,2022-05
2022-05-31,2214538,14171,2200367,베닝,2022-05
2022-05-31,2165710,652321,1513389,알바니아,2022-05
2022-05-31,2110564,78301641,-76191077,브루나이,2022-05
2022-05-31,2002869,1619366,383503,벨라루스,2022-05
2022-05-31,1854210,614,1853596,아루바,2022-05
2022-05-31,1851078,111547,1739531,불령 폴리네시아,2022-05
2022-05-31,1834993,32726,1802267,부르키나 파소,2022-05
2022-05-31,1674224,85002,1589222,소말리아,2022-05
2022-05-31,1617966,0,1617966,큐라소,2022-05
2022-05-31,1581122,18535,1562587,니제르,2022-05
2022-05-31,1552999,193693,1359306,마카오,2022-05
2022-05-31,1549233,513409,1035824,아메리칸 사모아,2022-05
2022-05-31,1489033,0,1489033,세인트 마틴,2022-05
2022-05-31,1427842,1962481,-534639,짐바브웨,2022-05
2022-05-31,1325066,805,1324261,불령 리유니온 코모도 제도,2022-05
2022-05-31,1310270,0,1310270,과델로프,2022-05
2022-05-31,1160759,66966,1093793,나미비아,2022-05
2022-05-31,1131098,8298,1122800,아프카니스탄,2022-05
2022-05-31,1129071,1749695,-620624,리히텐슈타인,2022-05
2022-05-31,1093119,43254,1049865,마티니크,2022-05
2022-05-31,1062318,78837,983481,시리아,2022-05
2022-05-31,941062,785915,155147,수리남,2022-05
2022-05-31,935613,5962,929651,도미니카,2022-05
2022-05-31,824311,346382,477929,세이쉘,2022-05
2022-05-31,811464,5083022,-4271558,잠비아,2022-05
2022-05-31,800856,1544870,-744014,마세도니아,2022-05
2022-05-31,790582,83,790499,불령 가이아나,2022-05
2022-05-31,786809,2989,783820,몰디브,2022-05
2022-05-31,763731,326734,436997,말리,2022-05
2022-05-31,761283,0,761283,보츠와나,2022-05
2022-05-31,715192,5497,709695,세인트 빈센트 그레나딘,2022-05
2022-05-31,683825,2791316,-2107491,모리타니,2022-05
2022-05-31,682348,4996,677352,마이크로네시아,2022-05
2022-05-31,644297,6115,638182,스와질랜드,2022-05
2022-05-31,628395,0,628395,카보 베르데,2022-05
2022-05-31,611566,66487,545079,세인트 루시아,2022-05
2022-05-31,606125,864010,-257885,부탄,2022-05
2022-05-31,570095,33021,537074,바베이도스,2022-05
2022-05-31,551188,21318,529870,르완다,2022-05
2022-05-31,544063,5251,538812,벨리제,2022-05
2022-05-31,526594,752830,-226236,솔로몬 군도,2022-05
2022-05-31,438904,1321713,-882809,바누아투,2022-05
2022-05-31,418575,540562,-121987,쿠바,2022-05
2022-05-31,399053,5304277,-4905224,영령 캐이맨 군도,2022-05
2022-05-31,321242,10,321232,투르크멘,2022-05
2022-05-31,308885,37622,271263,세인트 키츠 네비스,2022-05
2022-05-31,296053,266594,29459,감비아,2022-05
2022-05-31,271561,212239121,-211967560,가봉,2022-05
2022-05-31,266066,595538,-329472,말라위,2022-05
2022-05-31,265364,1469875,-1204511,시에라 리온,2022-05
2022-05-31,232364,0,232364,남수단,2022-05
2022-05-31,228498,0,228498,키리바티,2022-05
2022-05-31,211346,68503,142843,그린랜드,2022-05
2022-05-31,199996,51693587,-51493591,몬테네그로,2022-05
2022-05-31,178262,0,178262,투르크 & 카이코스 군도,2022-05
2022-05-31,156146,35,156111,영령 버진군도,2022-05
2022-05-31,152144,3035,149109,레소토,2022-05
2022-05-31,115469,2094041,-1978572,나우루,2022-05
2022-05-31,90959,687,90272,투발루,2022-05
2022-05-31,88161,0,88161,지브랄타,2022-05
2022-05-31,87015,6870,80145,안도라,2022-05
2022-05-31,75371,728,74643,그레나다,2022-05
2022-05-31,73842,1871729,-1797887,산마리노,2022-05
2022-05-31,59713,72030,-12317,안티가 바부다,2022-05
2022-05-31,41179,46850997,-46809818,적도 기니,2022-05
2022-05-31,40758,7612,33146,미령 버진군도,2022-05
2022-05-31,38240,202,38038,네덜란드 열도,2022-05
2022-05-31,32795,0,32795,티모르,2022-05
2022-05-31,19620,15663,3957,통가,2022-05
2022-05-31,18788,583,18205,챠드,2022-05
2022-05-31,17671,507,17164,부룬디,2022-05
2022-05-31,14001,16688246,-16674245,에리트리아,2022-05
2022-05-31,9787,438,9349,앙귈라,2022-05
2022-05-31,4545,0,4545,보네르 신트외스타티위스,2022-05
2022-05-31,2237,123,2114,쿡 아일랜드,2022-05
2022-05-31,1262,0,1262,세인트 헬레나,2022-05
2022-05-31,797,588,209,토켈라우,2022-05
2022-05-31,740,260,480,코모로스,2022-05
2022-05-31,570,17608,-17038,파로에 군도,2022-05
2022-05-31,562,441,121,크리스마스 아일랜드,2022-05
2022-05-31,324,17988,-17664,모나코,2022-05
2022-05-31,63,0,63,세인트마틴(생마르탱),2022-05
2022-05-31,0,249,-249,교황청,2022-05
2022-05-31,0,467,-467,상토메 프린스페,2022-05
2022-05-31,0,124151,-124151,맨섬,2022-05
2022-05-31,0,1509,-1509,영령 인도양,2022-05
2022-05-31,0,3196,-3196,포클랜드 군도,2022-05
2022-05-31,0,1306,-1306,저어지,2022-05
2022-05-31,0,312,-312,세인트 바르탤르미,2022-05
2022-05-31,0,3251899,-3251899,안타티카,2022-05
2022-05-31,0,633,-633,보빗군도,2022-05
2022-05-31,0,187,-187,마이너 아우틀링 합중국 군도,2022-05
2022-05-31,0,115,-115,남조지아 & 남샌드위치 군도,2022-05
2022-05-31,0,201,-201,니우에,2022-05
2022-06-30,12960972678,14158523851,-1197551173,중국,2022-06
2022-06-30,9768741294,6769779446,2998961848,미국,2022-06
2022-06-30,4846172580,1983011256,2863161324,베트남,2022-06
2022-06-30,2819013637,165398361,2653615276,홍콩,2022-06
2022-06-30,2651096368,4530262007,-1879165639,일본,2022-06
2022-06-30,2415617832,2538659185,-123041353,대만,2022-06
2022-06-30,1578812623,3736347807,-2157535184,호주,2022-06
2022-06-30,1532102037,875565478,656536559,싱가포르,2022-06
2022-06-30,1428531881,855861917,572669964,인도,2022-06
2022-06-30,1232977945,403204238,829773707,필리핀,2022-06
2022-06-30,1014011709,935871032,78140677,멕시코,2022-06
2022-06-30,1007056613,966203885,40852728,말레이시아,2022-06
2022-06-30,864251687,1816312863,-952061176,독일,2022-06
2022-06-30,845198066,1064062373,-218864307,인도네시아,2022-06
2022-06-30,772552634,983611334,-211058700,네덜란드,2022-06
2022-06-30,729571002,720283135,9287867,태국,2022-06
2022-06-30,658856246,733175800,-74319554,캐나다,2022-06
2022-06-30,587271072,80968764,506302308,폴란드,2022-06
2022-06-30,554250686,198615649,355635037,튀르키예,2022-06
2022-06-30,529686281,480204434,49481847,영국,2022-06
2022-06-30,435628995,67313015,368315980,헝가리,2022-06
2022-06-30,428161597,3199895357,-2771733760,사우디아라비아,2022-06
2022-06-30,417438986,150340872,267098114,벨기에,2022-06
2022-06-30,383561717,625414757,-241853040,브라질,2022-06
2022-06-30,368110679,686473939,-318363260,이탈리아,2022-06
2022-06-30,346440330,187005464,159434866,뉴질랜드,2022-06
2022-06-30,337362556,802197182,-464834626,러시아 연방,2022-06
2022-06-30,311891147,8794082,303097065,토고,2022-06
2022-06-30,303211272,16294253,286917019,마샬군도,2022-06
2022-06-30,295183312,632875990,-337692678,프랑스,2022-06
2022-06-30,274361204,1330965088,-1056603884,아랍에미리트 연합,2022-06
2022-06-30,264625480,55741,264569739,라이베리아,2022-06
2022-06-30,264167471,96830642,167336829,체코공화국,2022-06
2022-06-30,240546925,2360,240544565,버뮤다,2022-06
2022-06-30,231880580,215815579,16065001,스페인,2022-06
2022-06-30,211485422,37737834,173747588,슬로바키아,2022-06
2022-06-30,181495728,35889379,145606349,방글라데시,2022-06
2022-06-30,173294751,1783234,171511517,우즈베키스탄,2022-06
2022-06-30,163547376,734655021,-571107645,카자흐스탄,2022-06
2022-06-30,157696578,171028125,-13331547,이스라엘,2022-06
2022-06-30,146011736,133585497,12426239,오스트리아,2022-06
2022-06-30,134790895,887074831,-752283936,이라크,2022-06
2022-06-30,132273775,40069360,92204415,이집트,2022-06
2022-06-30,124471279,7360112,117111167,에쿠아도르,2022-06
2022-06-30,124081256,10401547,113679709,그리스,2022-06
2022-06-30,122007765,401142444,-279134679,칠레,2022-06
2022-06-30,114875004,3565119,111309885,케냐,2022-06
2022-06-30,108018337,10592833,97425504,슬로베니아,2022-06
2022-06-30,104467175,16050439,88416736,파키스탄,2022-06
2022-06-30,102719907,187151630,-84431723,스웨덴,2022-06
2022-06-30,94962390,975500,93986890,카메룬,2022-06
2022-06-30,84208762,256164562,-171955800,스위스,2022-06
2022-06-30,77725250,66423967,11301283,콜롬비아,2022-06
2022-06-30,77674797,307081106,-229406309,남아프리카공화국,2022-06
2022-06-30,76119914,502489,75617425,괌,2022-06
2022-06-30,71200075,12654824,58545251,요르단,2022-06
2022-06-30,66273078,126288796,-60015718,페루,2022-06
2022-06-30,59855008,130559968,-70704960,아일랜드,2022-06
2022-06-30,53610562,107857795,-54247233,나이지리아,2022-06
2022-06-30,51862037,25216183,26645854,캄보디아,2022-06
2022-06-30,51638694,41297160,10341534,포루투갈,2022-06
2022-06-30,47459703,42856973,4602730,파나마,2022-06
2022-06-30,46986020,2167279,44818741,몽골,2022-06
2022-06-30,43845655,124237839,-80392184,아르헨티나,2022-06
2022-06-30,41404163,1123201286,-1081797123,카타르,2022-06
2022-06-30,40037839,11878118,28159721,리투아니아,2022-06
2022-06-30,39819516,56450417,-16630901,루마니아,2022-06
2022-06-30,38936043,92787889,-53851846,덴마크,2022-06
2022-06-30,31017958,127328224,-96310266,노르웨이,2022-06
2022-06-30,30007727,934022749,-904015022,쿠웨이트,2022-06
2022-06-30,29673380,18472946,11200434,푸에르토리코,2022-06
2022-06-30,29485339,30490116,-1004777,미얀마,2022-06
2022-06-30,25980228,8885568,17094660,과테말라,2022-06
2022-06-30,23806805,9052687,14754118,도미니카 공화국,2022-06
2022-06-30,22796790,485860,22310930,이란,2022-06
2022-06-30,22026908,14363770,7663138,모로코,2022-06
2022-06-30,21680918,138036234,-116355316,핀란드,2022-06
2022-06-30,20400058,37168694,-16768636,리비아,2022-06
2022-06-30,20046091,235742353,-215696262,오만,2022-06
2022-06-30,18920046,3560766,15359280,엘살바도르,2022-06
2022-06-30,18286585,54311,18232274,키르기스스탄,2022-06
2022-06-30,17953369,11416893,6536476,코스타리카,2022-06
2022-06-30,17489021,526879,16962142,탄자니아,2022-06
2022-06-30,17260238,115657,17144581,앙골라,2022-06
2022-06-30,16633931,25551144,-8917213,세르비아,2022-06
2022-06-30,15812912,434766,15378146,파라과이,2022-06
2022-06-30,15785544,10221874,5563670,스리랑카,2022-06
2022-06-30,15527080,10786183,4740897,몰타,2022-06
2022-06-30,15219649,301069943,-285850294,알제리,2022-06
2022-06-30,15211678,14521898,689780,우크라이나,2022-06
2022-06-30,14742582,2808771,11933811,가나,2022-06
2022-06-30,14234288,82467788,-68233500,바레인,2022-06
2022-06-30,14130453,1072034,13058419,수단,2022-06
2022-06-30,13316568,426392,12890176,코트디봐르,2022-06
2022-06-30,12182215,5204699,6977516,온두라스,2022-06
2022-06-30,11244915,17035712,-5790797,불가리아,2022-06
2022-06-30,11242858,203547,11039311,팔레스타인 해방기구,2022-06
2022-06-30,11125647,35996613,-24870966,모잠비크,2022-06
2022-06-30,10854813,12073425,-1218612,튀니지,2022-06
2022-06-30,10565202,1925183,8640019,크로아티아,2022-06
2022-06-30,9973937,21471273,-11497336,우루과이,2022-06
2022-06-30,8399415,1996675,6402740,조지아,2022-06
2022-06-30,8094895,1914920,6179975,레바논,2022-06
2022-06-30,7757449,51173,7706276,아제르바이잔,2022-06
2022-06-30,7260909,11131554,-3870645,니카라과,2022-06
2022-06-30,6692627,3715274,2977353,에스토니아,2022-06
2022-06-30,6255254,395659,5859595,브루나이,2022-06
2022-06-30,6165985,5724295,441690,라오스,2022-06
2022-06-30,5944962,1308114,4636848,베네주엘라,2022-06
2022-06-30,5858121,2551947,3306174,세네갈,2022-06
2022-06-30,5758772,3475096,2283676,몰도바,2022-06
2022-06-30,5757481,668293,5089188,쿠바,2022-06
2022-06-30,5657641,391999578,-386341937,기타국,2022-06
2022-06-30,5495617,54947596,-49451979,콩고민주공화국,2022-06
2022-06-30,5453278,72987,5380291,아이티,2022-06
2022-06-30,5429269,11960402,-6531133,트리니다드 토바고,2022-06
2022-06-30,5102554,224613,4877941,자마이카,2022-06
2022-06-30,4733694,9504,4724190,불령 리유니온 코모도 제도,2022-06
2022-06-30,4267968,7290381,-3022413,예맨,2022-06
2022-06-30,4155252,6312,4148940,타지크,2022-06
2022-06-30,3928035,290966,3637069,말라위,2022-06
2022-06-30,3883067,5799499,-1916432,라트비아,2022-06
2022-06-30,3854329,5559335,-1705006,기니,2022-06
2022-06-30,3804019,15708333,-11904314,파푸아 뉴기니,2022-06
2022-06-30,3753982,172220,3581762,사모아,2022-06
2022-06-30,3744028,159051,3584977,사이프러스,2022-06
2022-06-30,3733743,7984567,-4250824,에티오피아,2022-06
2022-06-30,3640122,0,3640122,지부티,2022-06
2022-06-30,3159058,1862036,1297022,아이슬란드,2022-06
2022-06-30,3027668,56885770,-53858102,볼리비아,2022-06
2022-06-30,2938676,10527120,-7588444,룩셈부르그,2022-06
2022-06-30,2877259,439427,2437832,모리셔스,2022-06
2022-06-30,2841635,30993,2810642,부르키나 파소,2022-06
2022-06-30,2629085,21628784,-18999699,마다카스카르,2022-06
2022-06-30,2599372,425090,2174282,알바니아,2022-06
2022-06-30,2570429,1597321,973108,아르메니아,2022-06
2022-06-30,2538209,60637581,-58099372,뉴 칼레도니아,2022-06
2022-06-30,2474037,214734,2259303,불령 폴리네시아,2022-06
2022-06-30,2300186,773391,1526795,짐바브웨,2022-06
2022-06-30,2296038,2404684,-108646,벨라루스,2022-06
2022-06-30,2251195,3277819,-1026624,모리타니,2022-06
2022-06-30,2214909,83405,2131504,시리아,2022-06
2022-06-30,2114851,222664,1892187,북마리아나 군도,2022-06
2022-06-30,1998472,12162,1986310,아루바,2022-06
2022-06-30,1837344,189802,1647542,가이아나,2022-06
2022-06-30,1633067,679,1632388,몰디브,2022-06
2022-06-30,1523241,1048787,474454,우간다,2022-06
2022-06-30,1495335,385483,1109852,네팔,2022-06
2022-06-30,1402609,23,1402586,베닝,2022-06
2022-06-30,1394638,645662,748976,콩고,2022-06
2022-06-30,1272195,3519,1268676,바하마,2022-06
2022-06-30,1239153,196505,1042648,피지,2022-06
2022-06-30,1208689,4930418,-3721729,보스니아-헤르체고비나,2022-06
2022-06-30,1144741,1136974,7767,니제르,2022-06
2022-06-30,1123767,1085700,38067,세이쉘,2022-06
2022-06-30,980087,223362,756725,마세도니아,2022-06
2022-06-30,962889,121398,841491,아프카니스탄,2022-06
2022-06-30,956294,83605,872689,마카오,2022-06
2022-06-30,928466,861018,67448,시에라 리온,2022-06
2022-06-30,925993,31318,894675,가봉,2022-06
2022-06-30,903916,0,903916,큐라소,2022-06
2022-06-30,812811,42089,770722,르완다,2022-06
2022-06-30,781650,1325,780325,마티니크,2022-06
2022-06-30,739549,1343508,-603959,리히텐슈타인,2022-06
2022-06-30,698416,0,698416,세인트 바르탤르미,2022-06
2022-06-30,698088,0,698088,소말리아,2022-06
2022-06-30,665114,761,664353,바베이도스,2022-06
2022-06-30,638442,0,638442,세인트 마틴,2022-06
2022-06-30,614677,497246,117431,수리남,2022-06
2022-06-30,608084,7167,600917,투르크멘,2022-06
2022-06-30,584236,5209,579027,마이크로네시아,2022-06
2022-06-30,566239,435125,131114,키리바티,2022-06
2022-06-30,550858,897,549961,과델로프,2022-06
2022-06-30,525679,272705,252974,말리,2022-06
2022-06-30,452368,9548409,-9096041,잠비아,2022-06
2022-06-30,402683,11,402672,챠드,2022-06
2022-06-30,348379,122,348257,세인트 빈센트 그레나딘,2022-06
2022-06-30,333905,92,333813,솔로몬 군도,2022-06
2022-06-30,321110,3486819,-3165709,바누아투,2022-06
2022-06-30,310058,34,310024,불령 가이아나,2022-06
2022-06-30,303727,0,303727,영령 캐이맨 군도,2022-06
2022-06-30,288852,361836,-72984,나미비아,2022-06
2022-06-30,287307,388800,-101493,부탄,2022-06
2022-06-30,272093,0,272093,남수단,2022-06
2022-06-30,251408,0,251408,팔라우,2022-06
2022-06-30,238979,43718,195261,안티가 바부다,2022-06
2022-06-30,238547,935332,-696785,감비아,2022-06
2022-06-30,226648,0,226648,메요트,2022-06
2022-06-30,205768,1358505,-1152737,투발루,2022-06
2022-06-30,195810,9884,185926,안도라,2022-06
2022-06-30,188630,85841,102789,벨리제,2022-06
2022-06-30,162755,0,162755,세인트 루시아,2022-06
2022-06-30,135541,16060,119481,세인트 키츠 네비스,2022-06
2022-06-30,127168,692056,-564888,스와질랜드,2022-06
2022-06-30,119860,522101,-402241,아메리칸 사모아,2022-06
2022-06-30,95666,4946,90720,상토메 프린스페,2022-06
2022-06-30,93464,0,93464,나우루,2022-06
2022-06-30,89744,68614659,-68524915,몬테네그로,2022-06
2022-06-30,86240,3973,82267,그레나다,2022-06
2022-06-30,75793,16672,59121,모나코,2022-06
2022-06-30,68401,160,68241,네덜란드 열도,2022-06
2022-06-30,54534,18747,35787,부룬디,2022-06
2022-06-30,49095,28,49067,카보 베르데,2022-06
2022-06-30,47840,17587,30253,도미니카,2022-06
2022-06-30,47087,24775,22312,적도 기니,2022-06
2022-06-30,42471,705,41766,지브랄타,2022-06
2022-06-30,38333,578138,-539805,산마리노,2022-06
2022-06-30,27099,19690,7409,보츠와나,2022-06
2022-06-30,21719,104,21615,영령 버진군도,2022-06
2022-06-30,12560,14,12546,티모르,2022-06
2022-06-30,10836,322,10514,통가,2022-06
2022-06-30,10057,72676,-62619,기네비소,2022-06
2022-06-30,4900,0,4900,세인트마틴(생마르탱),2022-06
2022-06-30,4215,7344,-3129,미령 버진군도,2022-06
2022-06-30,2184,17413459,-17411275,에리트리아,2022-06
2022-06-30,400,17,383,앙귈라,2022-06
2022-06-30,322,0,322,쿡 아일랜드,2022-06
2022-06-30,289,0,289,그린랜드,2022-06
2022-06-30,219,0,219,투르크 & 카이코스 군도,2022-06
2022-06-30,10,10,0,파로에 군도,2022-06
2022-06-30,0,33910,-33910,니우에,2022-06
2022-06-30,0,1009,-1009,저어지,2022-06
2022-06-30,0,115,-115,보네르 신트외스타티위스,2022-06
2022-06-30,0,25557,-25557,코모로스,2022-06
2022-06-30,0,550,-550,스발비드 군도,2022-06
2022-06-30,0,62,-62,크리스마스 아일랜드,2022-06
2022-06-30,0,9250,-9250,세인트 헬레나,2022-06
2022-06-30,0,8154,-8154,몬트세라트,2022-06
2022-06-30,0,1,-1,토켈라우,2022-06
2022-06-30,0,4173,-4173,레소토,2022-06
2022-06-30,0,6263,-6263,허드 앤 맥도날드 군도,2022-06
2022-07-31,13214288402,13823354140,-609065738,중국,2022-07
2022-07-31,10104092349,6690429091,3413663258,미국,2022-07
2022-07-31,5223836823,2228047182,2995789641,베트남,2022-07
2022-07-31,2494966315,4543697058,-2048730743,일본,2022-07
2022-07-31,2361418364,844864877,1516553487,인도,2022-07
2022-07-31,2031222636,2680135945,-648913309,대만,2022-07
2022-07-31,1964553742,4225125436,-2260571694,호주,2022-07
2022-07-31,1923475783,889624290,1033851493,싱가포르,2022-07
2022-07-31,1683134507,192916544,1490217963,홍콩,2022-07
2022-07-31,1335639433,1220666356,114973077,말레이시아,2022-07
2022-07-31,1209541949,440027163,769514786,필리핀,2022-07
2022-07-31,1077984324,890933249,187051075,멕시코,2022-07
2022-07-31,893010233,1425191986,-532181753,인도네시아,2022-07
2022-07-31,886187816,1836462712,-950274896,독일,2022-07
2022-07-31,809740979,608100900,201640079,네덜란드,2022-07
2022-07-31,749239952,739350340,9889612,태국,2022-07
2022-07-31,690365956,109490281,580875675,폴란드,2022-07
2022-07-31,665649364,751069472,-85420108,캐나다,2022-07
2022-07-31,645756474,101330354,544426120,튀르키예,2022-07
2022-07-31,571175845,58517950,512657895,헝가리,2022-07
2022-07-31,568346350,345428279,222918071,영국,2022-07
2022-07-31,502217714,653338868,-151121154,프랑스,2022-07
2022-07-31,462933826,852330600,-389396774,러시아 연방,2022-07
2022-07-31,452845526,3921856975,-3469011449,사우디아라비아,2022-07
2022-07-31,441230033,724277129,-283047096,이탈리아,2022-07
2022-07-31,431348074,170642887,260705187,뉴질랜드,2022-07
2022-07-31,418371719,244275017,174096702,벨기에,2022-07
2022-07-31,416897194,824072274,-407175080,브라질,2022-07
2022-07-31,307495116,2395972652,-2088477536,아랍에미리트 연합,2022-07
2022-07-31,281333002,83185739,198147263,체코공화국,2022-07
2022-07-31,278237299,235876115,42361184,스페인,2022-07
2022-07-31,276916149,49887522,227028627,방글라데시,2022-07
2022-07-31,246481642,226513,246255129,라이베리아,2022-07
2022-07-31,234594465,2269034,232325431,우즈베키스탄,2022-07
2022-07-31,226211496,77145174,149066322,슬로바키아,2022-07
2022-07-31,216022105,16165159,199856946,몰타,2022-07
2022-07-31,206617977,3972362,202645615,토고,2022-07
2022-07-31,197525156,3220,197521936,마샬군도,2022-07
2022-07-31,197088659,344067591,-146978932,노르웨이,2022-07
2022-07-31,173762260,373401563,-199639303,카자흐스탄,2022-07
2022-07-31,160856675,113656797,47199878,이스라엘,2022-07
2022-07-31,155340223,1135924301,-980584078,이라크,2022-07
2022-07-31,135772805,10257103,125515702,슬로베니아,2022-07
2022-07-31,122601734,110829231,11772503,그리스,2022-07
2022-07-31,121809464,68677395,53132069,이집트,2022-07
2022-07-31,121008712,554852868,-433844156,칠레,2022-07
2022-07-31,115454262,161810456,-46356194,스웨덴,2022-07
2022-07-31,114120406,387075728,-272955322,남아프리카공화국,2022-07
2022-07-31,113885391,134293328,-20407937,오스트리아,2022-07
2022-07-31,98441708,55912749,42528959,파키스탄,2022-07
2022-07-31,80292836,34756669,45536167,콜롬비아,2022-07
2022-07-31,70631059,113057676,-42426617,아일랜드,2022-07
2022-07-31,67501614,498387090,-430885476,페루,2022-07
2022-07-31,67005842,289126873,-222121031,스위스,2022-07
2022-07-31,66585997,35938616,30647381,포루투갈,2022-07
2022-07-31,65271969,107009765,-41737796,나이지리아,2022-07
2022-07-31,64172685,6007749,58164936,에쿠아도르,2022-07
2022-07-31,62394973,14127213,48267760,요르단,2022-07
2022-07-31,58813431,60135502,-1322071,파푸아 뉴기니,2022-07
2022-07-31,58002598,76309381,-18306783,덴마크,2022-07
2022-07-31,57588216,1342120358,-1284532142,카타르,2022-07
2022-07-31,50148610,791888,49356722,피지,2022-07
2022-07-31,49807873,37480445,12327428,캄보디아,2022-07
2022-07-31,49140904,85578828,-36437924,루마니아,2022-07
2022-07-31,48282009,193550220,-145268211,아르헨티나,2022-07
2022-07-31,45150302,30082097,15068205,푸에르토리코,2022-07
2022-07-31,38783327,69954,38713373,아제르바이잔,2022-07
2022-07-31,37400171,11192962,26207209,리투아니아,2022-07
2022-07-31,36207396,2166913,34040483,몽골,2022-07
2022-07-31,34231875,1270676304,-1236444429,쿠웨이트,2022-07
2022-07-31,30999785,10198246,20801539,도미니카 공화국,2022-07
2022-07-31,30746749,20212250,10534499,과테말라,2022-07
2022-07-31,30655255,730525312,-699870057,오만,2022-07
2022-07-31,29706978,14867,29692111,키르기스스탄,2022-07
2022-07-31,28754024,43409367,-14655343,미얀마,2022-07
2022-07-31,28469659,103803680,-75334021,핀란드,2022-07
2022-07-31,27455011,14722920,12732091,모로코,2022-07
2022-07-31,25722572,101478448,-75755876,파나마,2022-07
2022-07-31,23841512,7716996,16124516,리비아,2022-07
2022-07-31,21550851,6062497,15488354,케냐,2022-07
2022-07-31,20009974,2473123,17536851,이란,2022-07
2022-07-31,15841011,2832516,13008495,가나,2022-07
2022-07-31,15738433,11637346,4101087,스리랑카,2022-07
2022-07-31,15398699,392331,15006368,코트디봐르,2022-07
2022-07-31,14855853,24214719,-9358866,세르비아,2022-07
2022-07-31,14806243,8518684,6287559,튀니지,2022-07
2022-07-31,14562453,380426409,-365863956,알제리,2022-07
2022-07-31,14551140,6693341,7857799,온두라스,2022-07
2022-07-31,14353107,29407958,-15054851,우루과이,2022-07
2022-07-31,14083811,24075866,-9992055,우크라이나,2022-07
2022-07-31,13740913,15360111,-1619198,코스타리카,2022-07
2022-07-31,13501951,617463,12884488,파라과이,2022-07
2022-07-31,13485365,450507488,-437022123,기타국,2022-07
2022-07-31,13032165,4447725,8584440,엘살바도르,2022-07
2022-07-31,12292022,26816981,-14524959,불가리아,2022-07
2022-07-31,11593669,1018145,10575524,탄자니아,2022-07
2022-07-31,11464553,1208,11463345,앙골라,2022-07
2022-07-31,10186773,74469678,-64282905,바레인,2022-07
2022-07-31,10178705,80838597,-70659892,모잠비크,2022-07
2022-07-31,9241042,828739,8412303,수단,2022-07
2022-07-31,8792784,6575,8786209,타지크,2022-07
2022-07-31,8381958,311170,8070788,조지아,2022-07
2022-07-31,7316274,78725,7237549,아이티,2022-07
2022-07-31,7070993,2714450,4356543,레바논,2022-07
2022-07-31,6981755,12324963,-5343208,트리니다드 토바고,2022-07
2022-07-31,6789992,11081665,-4291673,라오스,2022-07
2022-07-31,6708024,388326,6319698,괌,2022-07
2022-07-31,6626020,755273,5870747,모리셔스,2022-07
2022-07-31,6470300,150790,6319510,팔레스타인 해방기구,2022-07
2022-07-31,6454659,4357231,2097428,예맨,2022-07
2022-07-31,6438219,4265077,2173142,에스토니아,2022-07
2022-07-31,6278029,5076290,1201739,세네갈,2022-07
2022-07-31,6073569,323811,5749758,카메룬,2022-07
2022-07-31,5903272,203943,5699329,사모아,2022-07
2022-07-31,5738095,13828786,-8090691,니카라과,2022-07
2022-07-31,5600018,12447625,-6847607,크로아티아,2022-07
2022-07-31,5466681,1439396,4027285,아이슬란드,2022-07
2022-07-31,5440363,3243185,2197178,브루나이,2022-07
2022-07-31,5431686,18484021,-13052335,에티오피아,2022-07
2022-07-31,5216190,94780641,-89564451,콩고민주공화국,2022-07
2022-07-31,5079468,7482985,-2403517,라트비아,2022-07
2022-07-31,4544862,0,4544862,불령 폴리네시아,2022-07
2022-07-31,4165506,54751562,-50586056,뉴 칼레도니아,2022-07
2022-07-31,4054960,299152,3755808,자마이카,2022-07
2022-07-31,4003838,5034678,-1030840,기니,2022-07
2022-07-31,3868651,7154589,-3285938,보스니아-헤르체고비나,2022-07
2022-07-31,3835022,1215586,2619436,베네주엘라,2022-07
2022-07-31,3669653,11473997,-7804344,룩셈부르그,2022-07
2022-07-31,3565576,2198715,1366861,벨라루스,2022-07
2022-07-31,3530560,0,3530560,아루바,2022-07
2022-07-31,3484340,0,3484340,가이아나,2022-07
2022-07-31,3445828,839283,2606545,아르메니아,2022-07
2022-07-31,3323219,13112485,-9789266,마다카스카르,2022-07
2022-07-31,3308158,440,3307718,부르키나 파소,2022-07
2022-07-31,3211248,1020,3210228,불령 리유니온 코모도 제도,2022-07
2022-07-31,3199724,506326,2693398,사이프러스,2022-07
2022-07-31,3155311,0,3155311,지부티,2022-07
2022-07-31,3069158,2803399,265759,몰도바,2022-07
2022-07-31,2691580,73641018,-70949438,볼리비아,2022-07
2022-07-31,2571552,78943,2492609,북마리아나 군도,2022-07
2022-07-31,2515033,382046,2132987,알바니아,2022-07
2022-07-31,2510829,140260,2370569,르완다,2022-07
2022-07-31,2130123,681650,1448473,네팔,2022-07
2022-07-31,2047369,5962,2041407,시리아,2022-07
2022-07-31,1894783,795966,1098817,콩고,2022-07
2022-07-31,1776476,4103022,-2326546,잠비아,2022-07
2022-07-31,1528857,11,1528846,베닝,2022-07
2022-07-31,1522697,902002,620695,시에라 리온,2022-07
2022-07-31,1519990,3748,1516242,아프카니스탄,2022-07
2022-07-31,1410338,615384,794954,세이쉘,2022-07
2022-07-31,1330621,118969844,-117639223,가봉,2022-07
2022-07-31,1263045,1953,1261092,말리,2022-07
2022-07-31,1231787,0,1231787,버뮤다,2022-07
2022-07-31,1195376,2075345,-879969,리히텐슈타인,2022-07
2022-07-31,1186207,9708,1176499,과델로프,2022-07
2022-07-31,1159724,0,1159724,마티니크,2022-07
2022-07-31,1158329,527188,631141,우간다,2022-07
2022-07-31,1106003,411366,694637,마세도니아,2022-07
2022-07-31,1080409,124903,955506,짐바브웨,2022-07
2022-07-31,1061894,0,1061894,소말리아,2022-07
2022-07-31,1043474,0,1043474,큐라소,2022-07
2022-07-31,1008383,2095555,-1087172,모리타니,2022-07
2022-07-31,1001994,5906,996088,세인트 빈센트 그레나딘,2022-07
2022-07-31,1000366,56336,944030,마카오,2022-07
2022-07-31,954628,0,954628,영령 캐이맨 군도,2022-07
2022-07-31,935293,2812836,-1877543,솔로몬 군도,2022-07
2022-07-31,885169,652463,232706,쿠바,2022-07
2022-07-31,692010,19377,672633,바베이도스,2022-07
2022-07-31,675468,9181,666287,바하마,2022-07
2022-07-31,674100,7111,666989,세인트 바르탤르미,2022-07
2022-07-31,671608,0,671608,메요트,2022-07
2022-07-31,616227,472164,144063,수리남,2022-07
2022-07-31,601287,2072,599215,몰디브,2022-07
2022-07-31,595136,27,595109,카보 베르데,2022-07
2022-07-31,588775,149435,439340,키리바티,2022-07
2022-07-31,586510,25992,560518,투르크멘,2022-07
2022-07-31,554406,0,554406,세인트 루시아,2022-07
2022-07-31,527264,0,527264,불령 가이아나,2022-07
2022-07-31,517550,2333856,-1816306,바누아투,2022-07
2022-07-31,495236,11063,484173,보츠와나,2022-07
2022-07-31,453204,504166,-50962,아메리칸 사모아,2022-07
2022-07-31,442655,2511,440144,그레나다,2022-07
2022-07-31,434590,453,434137,벨리제,2022-07
2022-07-31,402795,46753,356042,마이크로네시아,2022-07
2022-07-31,400677,475830,-75153,부탄,2022-07
2022-07-31,380685,417285,-36600,니제르,2022-07
2022-07-31,333197,47773,285424,안티가 바부다,2022-07
2022-07-31,331403,265011,66392,감비아,2022-07
2022-07-31,314873,0,314873,영령 버진군도,2022-07
2022-07-31,300989,7187556,-6886567,몬테네그로,2022-07
2022-07-31,234192,857713,-623521,산마리노,2022-07
2022-07-31,203058,52972,150086,팔라우,2022-07
2022-07-31,193374,14417,178957,세인트 키츠 네비스,2022-07
2022-07-31,179658,0,179658,세인트 마틴,2022-07
2022-07-31,174243,249,173994,지브랄타,2022-07
2022-07-31,173880,117,173763,도미니카,2022-07
2022-07-31,150358,242090,-91732,나미비아,2022-07
2022-07-31,136393,7571,128822,미령 버진군도,2022-07
2022-07-31,132408,1439,130969,몬트세라트,2022-07
2022-07-31,123406,61,123345,부룬디,2022-07
2022-07-31,109420,168310,-58890,투발루,2022-07
2022-07-31,106043,10,106033,티모르,2022-07
2022-07-31,80887,1632,79255,레소토,2022-07
2022-07-31,77946,97128,-19182,스와질랜드,2022-07
2022-07-31,58960,0,58960,적도 기니,2022-07
2022-07-31,54323,1675,52648,네덜란드 열도,2022-07
2022-07-31,50350,147,50203,쿡 아일랜드,2022-07
2022-07-31,39379,8487,30892,중앙아프리카공화국,2022-07
2022-07-31,37397,224,37173,나우루,2022-07
2022-07-31,35657,277879,-242222,말라위,2022-07
2022-07-31,30562,0,30562,왈라스 & 퓨투나 군도,2022-07
2022-07-31,20153,0,20153,세인트마틴(생마르탱),2022-07
2022-07-31,19991,0,19991,투르크 & 카이코스 군도,2022-07
2022-07-31,17677,18805,-1128,통가,2022-07
2022-07-31,16400,169,16231,챠드,2022-07
2022-07-31,11124,208160,-197036,기네비소,2022-07
2022-07-31,5417,403,5014,코모로스,2022-07
2022-07-31,3211,0,3211,남수단,2022-07
2022-07-31,2588,1641,947,안도라,2022-07
2022-07-31,2563,0,2563,상토메 프린스페,2022-07
2022-07-31,2091,341515,-339424,모나코,2022-07
2022-07-31,1048,866,182,앙귈라,2022-07
2022-07-31,281,5066,-4785,니우에,2022-07
2022-07-31,215,505,-290,저어지,2022-07
2022-07-31,58,0,58,파로에 군도,2022-07
2022-07-31,54,8960,-8906,그린랜드,2022-07
2022-07-31,0,627,-627,마이너 아우틀링 합중국 군도,2022-07
2022-07-31,0,1264,-1264,건지,2022-07
2022-07-31,0,460,-460,안타티카,2022-07
2022-07-31,0,551,-551,코스 군도,2022-07
2022-08-31,13116160377,13501247802,-385087425,중국,2022-08
2022-08-31,8751247017,7779216057,972030960,미국,2022-08
2022-08-31,4733042197,2774919723,1958122474,베트남,2022-08
2022-08-31,2546588066,4462975343,-1916387277,일본,2022-08
2022-08-31,2219440066,2660236656,-440796590,대만,2022-08
2022-08-31,2213095409,1029959807,1183135602,싱가포르,2022-08
2022-08-31,1949320258,175987311,1773332947,홍콩,2022-08
2022-08-31,1767022544,4006709127,-2239686583,호주,2022-08
2022-08-31,1630462417,681161970,949300447,인도,2022-08
2022-08-31,1213956154,1255579264,-41623110,말레이시아,2022-08
2022-08-31,1103737914,705765462,397972452,멕시코,2022-08
2022-08-31,998706857,459645844,539061013,필리핀,2022-08
2022-08-31,892844110,1436156360,-543312250,인도네시아,2022-08
2022-08-31,837423448,610817546,226605902,네덜란드,2022-08
2022-08-31,803646697,2066845744,-1263199047,독일,2022-08
2022-08-31,693406160,708581352,-15175192,태국,2022-08
2022-08-31,666113309,918424535,-252311226,캐나다,2022-08
2022-08-31,624411139,85772259,538638880,튀르키예,2022-08
2022-08-31,616415733,98680149,517735584,폴란드,2022-08
2022-08-31,547313318,627574936,-80261618,프랑스,2022-08
2022-08-31,538007008,62158690,475848318,헝가리,2022-08
2022-08-31,485022146,468218566,16803580,영국,2022-08
2022-08-31,438302882,923884965,-485582083,러시아 연방,2022-08
2022-08-31,419341921,616647784,-197305863,브라질,2022-08
2022-08-31,397306141,235986728,161319413,벨기에,2022-08
2022-08-31,383744610,4649286742,-4265542132,사우디아라비아,2022-08
2022-08-31,366154386,709784002,-343629616,이탈리아,2022-08
2022-08-31,288546697,1511496881,-1222950184,아랍에미리트 연합,2022-08
2022-08-31,282577655,167634361,114943294,뉴질랜드,2022-08
2022-08-31,260751146,65193539,195557607,방글라데시,2022-08
2022-08-31,259335672,500739,258834933,라이베리아,2022-08
2022-08-31,235346419,2480848,232865571,토고,2022-08
2022-08-31,231980737,85451458,146529279,체코공화국,2022-08
2022-08-31,204543436,221592986,-17049550,스페인,2022-08
2022-08-31,199157059,62362531,136794528,슬로바키아,2022-08
2022-08-31,183165640,1448103,181717537,우즈베키스탄,2022-08
2022-08-31,177501714,104142889,73358825,노르웨이,2022-08
2022-08-31,146986894,225036089,-78049195,나이지리아,2022-08
2022-08-31,145621146,150678135,-5056989,이스라엘,2022-08
2022-08-31,138573162,463002046,-324428884,카자흐스탄,2022-08
2022-08-31,129777856,67060,129710796,마샬군도,2022-08
2022-08-31,126955331,46762731,80192600,파나마,2022-08
2022-08-31,119873744,145080660,-25206916,스웨덴,2022-08
2022-08-31,119292885,627170528,-507877643,칠레,2022-08
2022-08-31,110689422,298124960,-187435538,이집트,2022-08
2022-08-31,106007077,7542191,98464886,몰타,2022-08
2022-08-31,100208984,516942769,-416733785,남아프리카공화국,2022-08
2022-08-31,96804519,20338407,76466112,파키스탄,2022-08
2022-08-31,93641272,10270359,83370913,슬로베니아,2022-08
2022-08-31,90903805,248502228,-157598423,오스트리아,2022-08
2022-08-31,89620636,270540533,-180919897,스위스,2022-08
2022-08-31,78139323,14815972,63323351,요르단,2022-08
2022-08-31,75534262,29997,75504265,카메룬,2022-08
2022-08-31,75119922,85271677,-10151755,콜롬비아,2022-08
2022-08-31,66877490,147643411,-80765921,페루,2022-08
2022-08-31,65502476,726843438,-661340962,이라크,2022-08
2022-08-31,60469765,15614940,44854825,과테말라,2022-08
2022-08-31,51188933,654480932,-603291999,오만,2022-08
2022-08-31,50024247,332604353,-282580106,아르헨티나,2022-08
2022-08-31,45413649,856246648,-810832999,쿠웨이트,2022-08
2022-08-31,41200487,369778,40830709,피지,2022-08
2022-08-31,41034391,37251205,3783186,캄보디아,2022-08
2022-08-31,40172767,0,40172767,서사하라,2022-08
2022-08-31,39255124,105565970,-66310846,아일랜드,2022-08
2022-08-31,38867628,1819474159,-1780606531,카타르,2022-08
2022-08-31,38086295,287611,37798684,괌,2022-08
2022-08-31,38020108,46668822,-8648714,포루투갈,2022-08
2022-08-31,35910072,4873700,31036372,몽골,2022-08
2022-08-31,35168319,73152065,-37983746,루마니아,2022-08
2022-08-31,34814830,81206,34733624,키르기스스탄,2022-08
2022-08-31,33131800,94441144,-61309344,덴마크,2022-08
2022-08-31,30280672,8498734,21781938,도미니카 공화국,2022-08
2022-08-31,29398922,4228372,25170550,케냐,2022-08
2022-08-31,28865801,10869441,17996360,리투아니아,2022-08
2022-08-31,27300583,122490053,-95189470,에쿠아도르,2022-08
2022-08-31,25058625,65048785,-39990160,미얀마,2022-08
2022-08-31,23575966,16388445,7187521,모로코,2022-08
2022-08-31,22904786,19120520,3784266,리비아,2022-08
2022-08-31,22736595,21566864,1169731,푸에르토리코,2022-08
2022-08-31,22407088,29339872,-6932784,우크라이나,2022-08
2022-08-31,19729270,3798022,15931248,탄자니아,2022-08
2022-08-31,19595828,115932409,-96336581,바레인,2022-08
2022-08-31,18274606,160784407,-142509801,그리스,2022-08
2022-08-31,18169301,14551106,3618195,우루과이,2022-08
2022-08-31,16394239,16700777,-306538,코스타리카,2022-08
2022-08-31,16282656,3824491,12458165,엘살바도르,2022-08
2022-08-31,15622230,22161906,-6539676,세르비아,2022-08
2022-08-31,15025620,3259003,11766617,가나,2022-08
2022-08-31,14062175,99550380,-85488205,핀란드,2022-08
2022-08-31,13690420,21266788,-7576368,크로아티아,2022-08
2022-08-31,13689854,382286583,-368596729,알제리,2022-08
2022-08-31,13322971,13947620,-624649,스리랑카,2022-08
2022-08-31,12618238,159177,12459061,아제르바이잔,2022-08
2022-08-31,11663342,3877,11659465,타지크,2022-08
2022-08-31,11528260,36173089,-24644829,불가리아,2022-08
2022-08-31,11402050,309675,11092375,이란,2022-08
2022-08-31,11155274,5007356,6147918,온두라스,2022-08
2022-08-31,9948934,8539450,1409484,코트디봐르,2022-08
2022-08-31,8914177,11931637,-3017460,튀니지,2022-08
2022-08-31,8884867,1005608,7879259,파라과이,2022-08
2022-08-31,8443717,2086135,6357582,니카라과,2022-08
2022-08-31,8169930,345214,7824716,조지아,2022-08
2022-08-31,8112701,63770,8048931,앙골라,2022-08
2022-08-31,7332545,2667241,4665304,예맨,2022-08
2022-08-31,7121362,629503,6491859,아메리칸 사모아,2022-08
2022-08-31,6812256,4979518,1832738,브루나이,2022-08
2022-08-31,6757953,477282,6280671,수단,2022-08
2022-08-31,6591411,1191708,5399703,레바논,2022-08
2022-08-31,6202040,9488708,-3286668,세네갈,2022-08
2022-08-31,6103231,202438,5900793,아이티,2022-08
2022-08-31,5618162,63127784,-57509622,모잠비크,2022-08
2022-08-31,5589881,15966,5573915,세인트 키츠 네비스,2022-08
2022-08-31,5449552,14034777,-8585225,에티오피아,2022-08
2022-08-31,4913323,6152084,-1238761,에스토니아,2022-08
2022-08-31,4611260,11155225,-6543965,트리니다드 토바고,2022-08
2022-08-31,4602553,485047,4117506,팔레스타인 해방기구,2022-08
2022-08-31,4473709,50307175,-45833466,파푸아 뉴기니,2022-08
2022-08-31,4091290,2773858,1317432,볼리비아,2022-08
2022-08-31,3919519,964000,2955519,모리셔스,2022-08
2022-08-31,3538235,336069874,-332531639,기타국,2022-08
2022-08-31,3382697,4510425,-1127728,라오스,2022-08
2022-08-31,3247005,7818067,-4571062,라트비아,2022-08
2022-08-31,3111728,317237,2794491,자마이카,2022-08
2022-08-31,3057696,6264076,-3206380,룩셈부르그,2022-08
2022-08-31,3002902,1171665,1831237,벨라루스,2022-08
2022-08-31,2979383,830375,2149008,베네주엘라,2022-08
2022-08-31,2940514,370322,2570192,네팔,2022-08
2022-08-31,2860182,80666948,-77806766,콩고민주공화국,2022-08
2022-08-31,2770062,1787987,982075,아르메니아,2022-08
2022-08-31,2765011,743161,2021850,사이프러스,2022-08
2022-08-31,2692143,0,2692143,지부티,2022-08
2022-08-31,2600830,0,2600830,가이아나,2022-08
2022-08-31,2539532,13919,2525613,불령 리유니온 코모도 제도,2022-08
2022-08-31,2457483,400249,2057234,마세도니아,2022-08
2022-08-31,2379321,674198,1705123,알바니아,2022-08
2022-08-31,2337331,13642093,-11304762,마다카스카르,2022-08
2022-08-31,2300030,0,2300030,아루바,2022-08
2022-08-31,2165302,3308,2161994,과델로프,2022-08
2022-08-31,2070405,31309,2039096,부르키나 파소,2022-08
2022-08-31,1867164,1879180,-12016,세이쉘,2022-08
2022-08-31,1761444,156320,1605124,마카오,2022-08
2022-08-31,1691585,45220537,-43528952,뉴 칼레도니아,2022-08
2022-08-31,1653618,1186605,467013,우간다,2022-08
2022-08-31,1606696,441637,1165059,콩고,2022-08
2022-08-31,1574014,46105,1527909,북마리아나 군도,2022-08
2022-08-31,1572794,158704,1414090,소말리아,2022-08
2022-08-31,1420228,122553,1297675,사모아,2022-08
2022-08-31,1401694,247243,1154451,불령 폴리네시아,2022-08
2022-08-31,1396871,6009761,-4612890,보스니아-헤르체고비나,2022-08
2022-08-31,1278734,155405,1123329,르완다,2022-08
2022-08-31,1275788,16,1275772,영령 캐이맨 군도,2022-08
2022-08-31,1236930,0,1236930,큐라소,2022-08
2022-08-31,1191463,19,1191444,시리아,2022-08
2022-08-31,1169528,2374128,-1204600,아이슬란드,2022-08
2022-08-31,1164737,7833353,-6668616,잠비아,2022-08
2022-08-31,1065350,769915,295435,시에라 리온,2022-08
2022-08-31,1060358,3546623,-2486265,몰도바,2022-08
2022-08-31,1042523,0,1042523,베닝,2022-08
2022-08-31,1030222,0,1030222,마티니크,2022-08
2022-08-31,1010327,0,1010327,부탄,2022-08
2022-08-31,999955,23,999932,투르크멘,2022-08
2022-08-31,975009,5702313,-4727304,기니,2022-08
2022-08-31,958423,92351,866072,아프카니스탄,2022-08
2022-08-31,913354,592458,320896,쿠바,2022-08
2022-08-31,904849,792210,112639,짐바브웨,2022-08
2022-08-31,900080,0,900080,세인트 마틴,2022-08
2022-08-31,869566,741,868825,마이크로네시아,2022-08
2022-08-31,854094,100,853994,버뮤다,2022-08
2022-08-31,834801,120023,714778,가봉,2022-08
2022-08-31,761380,2635,758745,바하마,2022-08
2022-08-31,723924,42633,681291,세인트 루시아,2022-08
2022-08-31,714992,2357035,-1642043,리히텐슈타인,2022-08
2022-08-31,665066,226748,438318,키리바티,2022-08
2022-08-31,648186,6761,641425,투발루,2022-08
2022-08-31,615185,84705,530480,벨리제,2022-08
2022-08-31,556220,23423,532797,바베이도스,2022-08
2022-08-31,540541,710,539831,몰디브,2022-08
2022-08-31,483186,6284,476902,안티가 바부다,2022-08
2022-08-31,464980,3001504,-2536524,모리타니,2022-08
2022-08-31,447474,0,447474,남수단,2022-08
2022-08-31,437074,1119925,-682851,바누아투,2022-08
2022-08-31,432261,545931,-113670,감비아,2022-08
2022-08-31,383060,0,383060,에리트리아,2022-08
2022-08-31,374955,0,374955,메요트,2022-08
2022-08-31,374471,196510,177961,말리,2022-08
2022-08-31,352805,211,352594,그레나다,2022-08
2022-08-31,338773,509589,-170816,세인트 빈센트 그레나딘,2022-08
2022-08-31,338083,0,338083,불령 가이아나,2022-08
2022-08-31,320526,0,320526,솔로몬 군도,2022-08
2022-08-31,317207,16468838,-16151631,몬테네그로,2022-08
2022-08-31,262193,1000602,-738409,수리남,2022-08
2022-08-31,245114,15344,229770,네덜란드 열도,2022-08
2022-08-31,205206,593,204613,투르크 & 카이코스 군도,2022-08
2022-08-31,164097,0,164097,영령 버진군도,2022-08
2022-08-31,151901,237066,-85165,산마리노,2022-08
2022-08-31,139676,130953,8723,티모르,2022-08
2022-08-31,122910,78352,44558,스와질랜드,2022-08
2022-08-31,101235,28991,72244,팔라우,2022-08
2022-08-31,93183,0,93183,도미니카,2022-08
2022-08-31,86553,8483,78070,지브랄타,2022-08
2022-08-31,85520,3253198,-3167678,나우루,2022-08
2022-08-31,84810,1068,83742,중앙아프리카공화국,2022-08
2022-08-31,83706,156,83550,부룬디,2022-08
2022-08-31,81074,4582,76492,보츠와나,2022-08
2022-08-31,66006,1015,64991,카보 베르데,2022-08
2022-08-31,59274,0,59274,상토메 프린스페,2022-08
2022-08-31,56583,0,56583,세인트 바르탤르미,2022-08
2022-08-31,54205,0,54205,세인트마틴(생마르탱),2022-08
2022-08-31,50799,1022,49777,챠드,2022-08
2022-08-31,36401,722483,-686082,말라위,2022-08
2022-08-31,28550,93812206,-93783656,적도 기니,2022-08
2022-08-31,21638,321762,-300124,나미비아,2022-08
2022-08-31,13200,46905,-33705,모나코,2022-08
2022-08-31,11919,20166,-8247,미령 버진군도,2022-08
2022-08-31,8198,39569,-31371,그린랜드,2022-08
2022-08-31,5898,2520,3378,니제르,2022-08
2022-08-31,5440,19518,-14078,통가,2022-08
2022-08-31,3446,97238,-93792,기네비소,2022-08
2022-08-31,2900,0,2900,앙귈라,2022-08
2022-08-31,1320,46724,-45404,안도라,2022-08
2022-08-31,35,966,-931,건지,2022-08
2022-08-31,30,0,30,쿡 아일랜드,2022-08
2022-08-31,0,82,-82,마이너 아우틀링 합중국 군도,2022-08
2022-08-31,0,11503,-11503,토켈라우,2022-08
2022-08-31,0,9754,-9754,포클랜드 군도,2022-08
2022-08-31,0,13,-13,크리스마스 아일랜드,2022-08
2022-08-31,0,42,-42,보네르 신트외스타티위스,2022-08
2022-08-31,0,2573,-2573,레소토,2022-08
2022-08-31,0,1263,-1263,저어지,2022-08
2022-08-31,0,1273,-1273,남조지아 & 남샌드위치 군도,2022-08
2022-08-31,0,6654,-6654,세인트 헬레나,2022-08
2022-08-31,0,526,-526,코스 군도,2022-08
2022-08-31,0,3417,-3417,니우에,2022-08
2022-08-31,0,201929,-201929,맨섬,2022-08
2022-08-31,0,24873,-24873,코모로스,2022-08
2022-08-31,0,265,-265,영령 인도양,2022-08
2022-08-31,0,23802,-23802,몬트세라트,2022-08
2022-09-30,13342692411,12677996005,664696406,중국,2022-09
2022-09-30,9248928412,6657837343,2591091069,미국,2022-09
2022-09-30,4761383871,2281160708,2480223163,베트남,2022-09
2022-09-30,2873738775,86844022,2786894753,홍콩,2022-09
2022-09-30,2581742556,4435941785,-1854199229,일본,2022-09
2022-09-30,1985916279,2652550202,-666633923,대만,2022-09
2022-09-30,1939090457,839911231,1099179226,싱가포르,2022-09
2022-09-30,1615030189,577671372,1037358817,인도,2022-09
2022-09-30,1567683476,3765504266,-2197820790,호주,2022-09
2022-09-30,991529189,672529564,318999625,멕시코,2022-09
2022-09-30,942249091,1630480617,-688231526,독일,2022-09
2022-09-30,935405732,458818970,476586762,필리핀,2022-09
2022-09-30,919007334,1764246616,-845239282,말레이시아,2022-09
2022-09-30,876418037,1412309027,-535890990,인도네시아,2022-09
2022-09-30,710467638,656757886,53709752,네덜란드,2022-09
2022-09-30,703125724,611543280,91582444,태국,2022-09
2022-09-30,620736262,863079281,-242343019,캐나다,2022-09
2022-09-30,602369187,81024987,521344200,폴란드,2022-09
2022-09-30,593984085,580088814,13895271,영국,2022-09
2022-09-30,531599214,130746621,400852593,튀르키예,2022-09
2022-09-30,502047427,946435769,-444388342,러시아 연방,2022-09
2022-09-30,487344381,71927503,415416878,헝가리,2022-09
2022-09-30,448273246,778015461,-329742215,브라질,2022-09
2022-09-30,444657161,182263710,262393451,벨기에,2022-09
2022-09-30,434377326,3486157955,-3051780629,사우디아라비아,2022-09
2022-09-30,379483076,146353361,233129715,뉴질랜드,2022-09
2022-09-30,375418952,10033664,365385288,라이베리아,2022-09
2022-09-30,355142399,779566763,-424424364,이탈리아,2022-09
2022-09-30,333217834,26483,333191351,마샬군도,2022-09
2022-09-30,328475860,733175377,-404699517,프랑스,2022-09
2022-09-30,296132349,1479329451,-1183197102,아랍에미리트 연합,2022-09
2022-09-30,283923247,75252773,208670474,체코공화국,2022-09
2022-09-30,282145680,197228414,84917266,스페인,2022-09
2022-09-30,275508611,78060564,197448047,슬로바키아,2022-09
2022-09-30,253052043,72677773,180374270,방글라데시,2022-09
2022-09-30,178093230,2214517,175878713,우즈베키스탄,2022-09
2022-09-30,175649972,3562993,172086979,토고,2022-09
2022-09-30,157613307,119708638,37904669,카자흐스탄,2022-09
2022-09-30,155702817,113919787,41783030,이스라엘,2022-09
2022-09-30,138139753,7345285,130794468,슬로베니아,2022-09
2022-09-30,118255986,35585502,82670484,파나마,2022-09
2022-09-30,116126681,152685533,-36558852,오스트리아,2022-09
2022-09-30,110170232,529049843,-418879611,칠레,2022-09
2022-09-30,104561782,1123110385,-1018548603,이라크,2022-09
2022-09-30,102081431,247628751,-145547320,스위스,2022-09
2022-09-30,93567592,220989394,-127421802,이집트,2022-09
2022-09-30,90911144,174812931,-83901787,스웨덴,2022-09
2022-09-30,74509994,367759038,-293249044,남아프리카공화국,2022-09
2022-09-30,73671353,14608979,59062374,요르단,2022-09
2022-09-30,71906589,108424164,-36517575,아일랜드,2022-09
2022-09-30,66190958,76365977,-10175019,콜롬비아,2022-09
2022-09-30,64752731,16791452,47961279,파키스탄,2022-09
2022-09-30,63301290,170385276,-107083986,페루,2022-09
2022-09-30,55227283,42023894,13203389,캄보디아,2022-09
2022-09-30,54771041,113142016,-58370975,노르웨이,2022-09
2022-09-30,51998032,333575214,-281577182,나이지리아,2022-09
2022-09-30,51985177,28417115,23568062,포루투갈,2022-09
2022-09-30,50619404,90673772,-40054368,덴마크,2022-09
2022-09-30,50442092,41295,50400797,키르기스스탄,2022-09
2022-09-30,49195679,947880440,-898684761,쿠웨이트,2022-09
2022-09-30,47858954,445368,47413586,괌,2022-09
2022-09-30,39862686,9749174,30113512,모로코,2022-09
2022-09-30,38784265,6077088,32707177,에쿠아도르,2022-09
2022-09-30,36422129,57297797,-20875668,루마니아,2022-09
2022-09-30,31995648,2696405,29299243,몽골,2022-09
2022-09-30,29191996,90665450,-61473454,미얀마,2022-09
2022-09-30,29038640,1363568270,-1334529630,카타르,2022-09
2022-09-30,27677319,312118436,-284441117,아르헨티나,2022-09
2022-09-30,27208474,22312624,4895850,푸에르토리코,2022-09
2022-09-30,27027075,289711231,-262684156,알제리,2022-09
2022-09-30,26994602,30475797,-3481195,그리스,2022-09
2022-09-30,26092793,5185498,20907295,도미니카 공화국,2022-09
2022-09-30,25930128,65244632,-39314504,핀란드,2022-09
2022-09-30,25210033,304503073,-279293040,오만,2022-09
2022-09-30,24802725,10433561,14369164,리투아니아,2022-09
2022-09-30,24458420,6462616,17995804,케냐,2022-09
2022-09-30,24379553,59155608,-34776055,우크라이나,2022-09
2022-09-30,20914422,12749001,8165421,과테말라,2022-09
2022-09-30,20711634,360204,20351430,리비아,2022-09
2022-09-30,19047185,7017957,12029228,몰타,2022-09
2022-09-30,18102455,4297357,13805098,탄자니아,2022-09
2022-09-30,16327530,13357670,2969860,코스타리카,2022-09
2022-09-30,16125841,7610748,8515093,세르비아,2022-09
2022-09-30,14997676,4107,14993569,아제르바이잔,2022-09
2022-09-30,14602827,1322003,13280824,이란,2022-09
2022-09-30,13730024,10398649,3331375,스리랑카,2022-09
2022-09-30,13666938,6353803,7313135,룩셈부르그,2022-09
2022-09-30,12452375,1969895,10482480,가나,2022-09
2022-09-30,12432326,8345119,4087207,튀니지,2022-09
2022-09-30,11631545,3439414,8192131,엘살바도르,2022-09
2022-09-30,11309583,27638307,-16328724,우루과이,2022-09
2022-09-30,10616265,28676433,-18060168,바레인,2022-09
2022-09-30,10334247,198073,10136174,코트디봐르,2022-09
2022-09-30,9939638,38315008,-28375370,불가리아,2022-09
2022-09-30,9872802,3439919,6432883,온두라스,2022-09
2022-09-30,9610437,409897,9200540,조지아,2022-09
2022-09-30,9465614,77732,9387882,수단,2022-09
2022-09-30,9021740,51919062,-42897322,모잠비크,2022-09
2022-09-30,8140171,5230194,2909977,세네갈,2022-09
2022-09-30,7564261,925,7563336,앙골라,2022-09
2022-09-30,7448238,64078,7384160,타지크,2022-09
2022-09-30,6887208,1283741,5603467,파라과이,2022-09
2022-09-30,6506048,7321717,-815669,크로아티아,2022-09
2022-09-30,6483637,6069903,413734,에스토니아,2022-09
2022-09-30,5644475,15458869,-9814394,에티오피아,2022-09
2022-09-30,5643289,1520715,4122574,니카라과,2022-09
2022-09-30,5433138,1054405,4378733,아이슬란드,2022-09
2022-09-30,5341186,604080,4737106,레바논,2022-09
2022-09-30,5301775,79967339,-74665564,볼리비아,2022-09
2022-09-30,5267603,179635,5087968,피지,2022-09
2022-09-30,5048995,462348100,-457299105,기타국,2022-09
2022-09-30,4942207,56951371,-52009164,콩고민주공화국,2022-09
2022-09-30,4910723,5755480,-844757,라트비아,2022-09
2022-09-30,4649033,2334587,2314446,예맨,2022-09
2022-09-30,4599707,628649,3971058,모리셔스,2022-09
2022-09-30,4515658,0,4515658,팔레스타인 해방기구,2022-09
2022-09-30,4438482,57232608,-52794126,브루나이,2022-09
2022-09-30,4352425,850586,3501839,아이티,2022-09
2022-09-30,4345652,33406830,-29061178,트리니다드 토바고,2022-09
2022-09-30,4316540,1739943,2576597,알바니아,2022-09
2022-09-30,4220605,3592063,628542,몰도바,2022-09
2022-09-30,4123328,1967504,2155824,베네주엘라,2022-09
2022-09-30,3942080,296645148,-292703068,파푸아 뉴기니,2022-09
2022-09-30,3724719,566121,3158598,벨라루스,2022-09
2022-09-30,3529776,346007,3183769,마카오,2022-09
2022-09-30,3486570,28913,3457657,아메리칸 사모아,2022-09
2022-09-30,3461784,101383,3360401,말라위,2022-09
2022-09-30,3416088,616917,2799171,네팔,2022-09
2022-09-30,3226537,0,3226537,부르키나 파소,2022-09
2022-09-30,3171854,10682772,-7510918,마다카스카르,2022-09
2022-09-30,3121593,123687,2997906,사모아,2022-09
2022-09-30,3111324,4448947,-1337623,아르메니아,2022-09
2022-09-30,3079209,52884,3026325,자마이카,2022-09
2022-09-30,2885837,21170,2864667,지부티,2022-09
2022-09-30,2719272,102433887,-99714615,적도 기니,2022-09
2022-09-30,2707241,2688,2704553,카메룬,2022-09
2022-09-30,2576354,94971,2481383,불령 리유니온 코모도 제도,2022-09
2022-09-30,2531581,2242395,289186,우간다,2022-09
2022-09-30,2436536,379522,2057014,사이프러스,2022-09
2022-09-30,2339401,4363774,-2024373,라오스,2022-09
2022-09-30,2324532,272278,2052254,르완다,2022-09
2022-09-30,2020272,130,2020142,베닝,2022-09
2022-09-30,1953665,1636379,317286,기니,2022-09
2022-09-30,1939272,18795,1920477,키리바티,2022-09
2022-09-30,1845445,0,1845445,시리아,2022-09
2022-09-30,1810757,711134,1099623,콩고,2022-09
2022-09-30,1772004,253940,1518064,세이쉘,2022-09
2022-09-30,1690585,286,1690299,불령 폴리네시아,2022-09
2022-09-30,1508414,202,1508212,과델로프,2022-09
2022-09-30,1490914,92340,1398574,아프카니스탄,2022-09
2022-09-30,1427327,253162,1174165,마세도니아,2022-09
2022-09-30,1403020,1261391,141629,시에라 리온,2022-09
2022-09-30,1363788,0,1363788,몬트세라트,2022-09
2022-09-30,1306045,1565,1304480,바하마,2022-09
2022-09-30,1255292,24003744,-22748452,뉴 칼레도니아,2022-09
2022-09-30,1250573,360750,889823,부탄,2022-09
2022-09-30,1194384,5605897,-4411513,잠비아,2022-09
2022-09-30,1072090,3864252,-2792162,보스니아-헤르체고비나,2022-09
2022-09-30,1070496,65389,1005107,북마리아나 군도,2022-09
2022-09-30,1059750,0,1059750,큐라소,2022-09
2022-09-30,1011366,83503,927863,소말리아,2022-09
2022-09-30,996582,245336,751246,가봉,2022-09
2022-09-30,899567,2067594,-1168027,리히텐슈타인,2022-09
2022-09-30,896090,0,896090,가이아나,2022-09
2022-09-30,871869,102,871767,마티니크,2022-09
2022-09-30,870215,0,870215,아루바,2022-09
2022-09-30,840535,194722,645813,말리,2022-09
2022-09-30,823140,387553,435587,수리남,2022-09
2022-09-30,820904,813810,7094,모리타니,2022-09
2022-09-30,807842,295124,512718,짐바브웨,2022-09
2022-09-30,726534,0,726534,카보 베르데,2022-09
2022-09-30,704953,574816,130137,바누아투,2022-09
2022-09-30,701909,17718,684191,벨리제,2022-09
2022-09-30,701561,2756084,-2054523,솔로몬 군도,2022-09
2022-09-30,631240,0,631240,영령 캐이맨 군도,2022-09
2022-09-30,588126,624340,-36214,세인트 빈센트 그레나딘,2022-09
2022-09-30,564923,0,564923,마이크로네시아,2022-09
2022-09-30,542659,1384,541275,몰디브,2022-09
2022-09-30,471916,50628,421288,세인트 루시아,2022-09
2022-09-30,467779,0,467779,영령 버진군도,2022-09
2022-09-30,455387,0,455387,투르크멘,2022-09
2022-09-30,454223,0,454223,세인트 마틴,2022-09
2022-09-30,421601,7104,414497,그레나다,2022-09
2022-09-30,386333,131,386202,바베이도스,2022-09
2022-09-30,375049,0,375049,티모르,2022-09
2022-09-30,307839,0,307839,중앙아프리카공화국,2022-09
2022-09-30,255525,0,255525,버뮤다,2022-09
2022-09-30,248989,100,248889,팔라우,2022-09
2022-09-30,242827,538235,-295408,쿠바,2022-09
2022-09-30,237500,673421,-435921,나미비아,2022-09
2022-09-30,234636,0,234636,안티가 바부다,2022-09
2022-09-30,201025,8776,192249,보츠와나,2022-09
2022-09-30,190424,12832,177592,스와질랜드,2022-09
2022-09-30,163348,155058,8290,감비아,2022-09
2022-09-30,158155,34994,123161,도미니카,2022-09
2022-09-30,154244,1349514,-1195270,산마리노,2022-09
2022-09-30,152560,417,152143,지브랄타,2022-09
2022-09-30,152153,1840,150313,세인트 키츠 네비스,2022-09
2022-09-30,105630,93,105537,상토메 프린스페,2022-09
2022-09-30,92861,56,92805,네덜란드 열도,2022-09
2022-09-30,83944,276,83668,앙귈라,2022-09
2022-09-30,68679,15949890,-15881211,몬테네그로,2022-09
2022-09-30,60350,0,60350,투발루,2022-09
2022-09-30,38354,11016,27338,부룬디,2022-09
2022-09-30,35254,183,35071,챠드,2022-09
2022-09-30,31000,62564,-31564,모나코,2022-09
2022-09-30,15027,2608,12419,코모로스,2022-09
2022-09-30,14115,0,14115,세인트 헬레나,2022-09
2022-09-30,13330,0,13330,메요트,2022-09
2022-09-30,11000,68413,-57413,기네비소,2022-09
2022-09-30,10542,441,10101,건지,2022-09
2022-09-30,9380,0,9380,세인트 바르탤르미,2022-09
2022-09-30,9300,0,9300,니제르,2022-09
2022-09-30,8536,4360,4176,안도라,2022-09
2022-09-30,8185,0,8185,투르크 & 카이코스 군도,2022-09
2022-09-30,3715,0,3715,남수단,2022-09
2022-09-30,3712,0,3712,불령 가이아나,2022-09
2022-09-30,1481,0,1481,세인트마틴(생마르탱),2022-09
2022-09-30,1012,15429,-14417,미령 버진군도,2022-09
2022-09-30,315,624,-309,저어지,2022-09
2022-09-30,208,211124,-210916,그린랜드,2022-09
2022-09-30,128,5570,-5442,레소토,2022-09
2022-09-30,0,274,-274,피트카이른,2022-09
2022-09-30,0,1050,-1050,니우에,2022-09
2022-09-30,0,198746,-198746,맨섬,2022-09
2022-09-30,0,3377,-3377,파로에 군도,2022-09
2022-09-30,0,67,-67,영령 인도양,2022-09
2022-09-30,0,15,-15,스발비드 군도,2022-09
2022-09-30,0,15321,-15321,통가,2022-09
2022-09-30,0,16399,-16399,허드 앤 맥도날드 군도,2022-09
2022-09-30,0,679,-679,크리스마스 아일랜드,2022-09
2022-09-30,0,3789,-3789,토켈라우,2022-09
2022-09-30,0,660,-660,포클랜드 군도,2022-09
2022-09-30,0,10,-10,마이너 아우틀링 합중국 군도,2022-09
2022-10-31,12155840722,13411940587,-1256099865,중국,2022-10
2022-10-31,8591667627,6692906203,1898761424,미국,2022-10
2022-10-31,4959096294,2111583147,2847513147,베트남,2022-10
2022-10-31,2272321310,4300343099,-2028021789,일본,2022-10
2022-10-31,2006519987,191741968,1814778019,홍콩,2022-10
2022-10-31,1794125998,2239636431,-445510433,대만,2022-10
2022-10-31,1403230320,521848164,881382156,인도,2022-10
2022-10-31,1372837028,3233994344,-1861157316,호주,2022-10
2022-10-31,1323398475,795402920,527995555,싱가포르,2022-10
2022-10-31,936576119,83312217,853263902,폴란드,2022-10
2022-10-31,874789140,730604417,144184723,멕시코,2022-10
2022-10-31,788646700,1192522528,-403875828,인도네시아,2022-10
2022-10-31,781807475,524624356,257183119,필리핀,2022-10
2022-10-31,723291868,2113308459,-1390016591,독일,2022-10
2022-10-31,717097154,1320383428,-603286274,말레이시아,2022-10
2022-10-31,646430843,981854288,-335423445,러시아 연방,2022-10
2022-10-31,613348936,514561382,98787554,캐나다,2022-10
2022-10-31,601289963,99259567,502030396,튀르키예,2022-10
2022-10-31,576914990,430153830,146761160,네덜란드,2022-10
2022-10-31,576577013,592897796,-16320783,태국,2022-10
2022-10-31,481810145,16161,481793984,라이베리아,2022-10
2022-10-31,464670426,384878770,79791656,영국,2022-10
2022-10-31,433789034,78757022,355032012,헝가리,2022-10
2022-10-31,399390344,596404283,-197013939,프랑스,2022-10
2022-10-31,393641755,125056593,268585162,뉴질랜드,2022-10
2022-10-31,381564087,608760266,-227196179,이탈리아,2022-10
2022-10-31,367873736,353131458,14742278,벨기에,2022-10
2022-10-31,365944259,1538936052,-1172991793,아랍에미리트 연합,2022-10
2022-10-31,356193798,3217906151,-2861712353,사우디아라비아,2022-10
2022-10-31,332054449,6556819,325497630,몰타,2022-10
2022-10-31,318542290,715126214,-396583924,브라질,2022-10
2022-10-31,233266538,84314422,148952116,체코공화국,2022-10
2022-10-31,225083280,71360704,153722576,슬로바키아,2022-10
2022-10-31,225068081,188516322,36551759,스페인,2022-10
2022-10-31,174677799,2585983,172091816,우즈베키스탄,2022-10
2022-10-31,170351299,354747293,-184395994,카자흐스탄,2022-10
2022-10-31,168539361,94323701,74215660,이스라엘,2022-10
2022-10-31,161104341,10022482,151081859,슬로베니아,2022-10
2022-10-31,157633123,56713142,100919981,방글라데시,2022-10
2022-10-31,144145850,73273881,70871969,파나마,2022-10
2022-10-31,139057026,2346708,136710318,토고,2022-10
2022-10-31,131895151,179289758,-47394607,그리스,2022-10
2022-10-31,130736115,41201,130694914,마샬군도,2022-10
2022-10-31,107971518,208465380,-100493862,오스트리아,2022-10
2022-10-31,104935111,517537911,-412602800,칠레,2022-10
2022-10-31,102445369,103651498,-1206129,스웨덴,2022-10
2022-10-31,96792930,165849767,-69056837,나이지리아,2022-10
2022-10-31,88601613,52397775,36203838,이집트,2022-10
2022-10-31,83997388,715404181,-631406793,이라크,2022-10
2022-10-31,82186350,11785772,70400578,요르단,2022-10
2022-10-31,80592373,256859076,-176266703,스위스,2022-10
2022-10-31,78713621,52315094,26398527,파키스탄,2022-10
2022-10-31,73850751,119205543,-45354792,아일랜드,2022-10
2022-10-31,65949142,329226090,-263276948,남아프리카공화국,2022-10
2022-10-31,65861756,94481537,-28619781,콜롬비아,2022-10
2022-10-31,63853493,67930,63785563,키르기스스탄,2022-10
2022-10-31,61380203,1558203091,-1496822888,카타르,2022-10
2022-10-31,55939009,134076750,-78137741,페루,2022-10
2022-10-31,45056711,83898713,-38842002,덴마크,2022-10
2022-10-31,41248451,31315113,9933338,캄보디아,2022-10
2022-10-31,41101118,182680215,-141579097,노르웨이,2022-10
2022-10-31,41068801,675265896,-634197095,쿠웨이트,2022-10
2022-10-31,38616114,14617220,23998894,탄자니아,2022-10
2022-10-31,35355652,9904095,25451557,에쿠아도르,2022-10
2022-10-31,34599831,77067569,-42467738,미얀마,2022-10
2022-10-31,33501248,34681058,-1179810,포루투갈,2022-10
2022-10-31,32886345,5910676,26975669,도미니카 공화국,2022-10
2022-10-31,32800446,4232457,28567989,몽골,2022-10
2022-10-31,32422092,260124466,-227702374,알제리,2022-10
2022-10-31,31004607,54798028,-23793421,루마니아,2022-10
2022-10-31,28781582,35646860,-6865278,푸에르토리코,2022-10
2022-10-31,28030524,76983121,-48952597,우크라이나,2022-10
2022-10-31,27602865,318716080,-291113215,오만,2022-10
2022-10-31,27226216,91602930,-64376714,핀란드,2022-10
2022-10-31,26373509,446897,25926612,리비아,2022-10
2022-10-31,25434659,314919280,-289484621,아르헨티나,2022-10
2022-10-31,23063890,6847789,16216101,에스토니아,2022-10
2022-10-31,22767618,8374792,14392826,과테말라,2022-10
2022-10-31,20135159,5639620,14495539,케냐,2022-10
2022-10-31,18546732,12974362,5572370,모로코,2022-10
2022-10-31,17756601,3610166,14146435,세르비아,2022-10
2022-10-31,16522382,15031601,1490781,코스타리카,2022-10
2022-10-31,15955200,8672105,7283095,리투아니아,2022-10
2022-10-31,15672511,3094945,12577566,엘살바도르,2022-10
2022-10-31,15034872,284409,14750463,괌,2022-10
2022-10-31,15007421,54505,14952916,아제르바이잔,2022-10
2022-10-31,14027984,395355,13632629,조지아,2022-10
2022-10-31,13896588,167547,13729041,이란,2022-10
2022-10-31,13405100,13156816,248284,불가리아,2022-10
2022-10-31,12400109,100444,12299665,타지크,2022-10
2022-10-31,10899560,2883876,8015684,가나,2022-10
2022-10-31,10253158,1420390,8832768,코트디봐르,2022-10
2022-10-31,10096319,18334771,-8238452,우루과이,2022-10
2022-10-31,9909601,65493859,-55584258,튀니지,2022-10
2022-10-31,9784859,15127469,-5342610,온두라스,2022-10
2022-10-31,9460147,12814426,-3354279,스리랑카,2022-10
2022-10-31,8454647,26737351,-18282704,모잠비크,2022-10
2022-10-31,7823472,412323954,-404500482,파푸아 뉴기니,2022-10
2022-10-31,7647405,164800,7482605,카메룬,2022-10
2022-10-31,7565028,608866,6956162,레바논,2022-10
2022-10-31,7438130,151388,7286742,수단,2022-10
2022-10-31,7054976,2544,7052432,앙골라,2022-10
2022-10-31,6983103,4459838,2523265,세네갈,2022-10
2022-10-31,6534266,54408498,-47874232,바레인,2022-10
2022-10-31,6231336,14730388,-8499052,크로아티아,2022-10
2022-10-31,6083494,0,6083494,팔라우,2022-10
2022-10-31,5832613,1260643,4571970,니카라과,2022-10
2022-10-31,5769467,6810391,-1040924,트리니다드 토바고,2022-10
2022-10-31,5740337,679450533,-673710196,기타국,2022-10
2022-10-31,5240317,839277,4401040,알바니아,2022-10
2022-10-31,5009507,3420234,1589273,라오스,2022-10
2022-10-31,4828295,33047774,-28219479,볼리비아,2022-10
2022-10-31,4403249,13045433,-8642184,파라과이,2022-10
2022-10-31,4291234,459127,3832107,네팔,2022-10
2022-10-31,4207533,465517,3742016,예맨,2022-10
2022-10-31,4198771,19565171,-15366400,에티오피아,2022-10
2022-10-31,4143656,3298,4140358,부르키나 파소,2022-10
2022-10-31,4017816,434876,3582940,사이프러스,2022-10
2022-10-31,3927164,87125,3840039,팔레스타인 해방기구,2022-10
2022-10-31,3696584,170957,3525627,자마이카,2022-10
2022-10-31,3695450,62894272,-59198822,콩고민주공화국,2022-10
2022-10-31,3432949,17425,3415524,브루나이,2022-10
2022-10-31,3271029,244052,3026977,모리셔스,2022-10
2022-10-31,3268646,33388,3235258,불령 리유니온 코모도 제도,2022-10
2022-10-31,3217159,1564424,1652735,안타티카,2022-10
2022-10-31,3198665,8199672,-5001007,라트비아,2022-10
2022-10-31,3158403,4479480,-1321077,마다카스카르,2022-10
2022-10-31,3079236,600803,2478433,벨라루스,2022-10
2022-10-31,3037915,347224,2690691,말라위,2022-10
2022-10-31,3008081,3503237,-495156,아르메니아,2022-10
2022-10-31,2886751,125793,2760958,사모아,2022-10
2022-10-31,2771125,696286,2074839,우간다,2022-10
2022-10-31,2743399,792332,1951067,피지,2022-10
2022-10-31,2382564,1665564,717000,베네주엘라,2022-10
2022-10-31,2364654,18887,2345767,시리아,2022-10
2022-10-31,2165506,52669384,-50503878,뉴 칼레도니아,2022-10
2022-10-31,2105117,71,2105046,아루바,2022-10
2022-10-31,2004290,0,2004290,키리바티,2022-10
2022-10-31,1890240,0,1890240,투르크멘,2022-10
2022-10-31,1840516,332837,1507679,아메리칸 사모아,2022-10
2022-10-31,1813119,91424,1721695,아프카니스탄,2022-10
2022-10-31,1810619,592616,1218003,기니,2022-10
2022-10-31,1783760,295464,1488296,말리,2022-10
2022-10-31,1759404,135071,1624333,마카오,2022-10
2022-10-31,1752459,40,1752419,영령 캐이맨 군도,2022-10
2022-10-31,1712232,201022,1511210,아이티,2022-10
2022-10-31,1653282,0,1653282,과델로프,2022-10
2022-10-31,1646637,3830,1642807,몰디브,2022-10
2022-10-31,1623493,386155,1237338,콩고,2022-10
2022-10-31,1545622,5320292,-3774670,몰도바,2022-10
2022-10-31,1501836,51,1501785,베닝,2022-10
2022-10-31,1500702,46036,1454666,세이쉘,2022-10
2022-10-31,1500298,7438173,-5937875,룩셈부르그,2022-10
2022-10-31,1479497,7789827,-6310330,잠비아,2022-10
2022-10-31,1477318,316416,1160902,소말리아,2022-10
2022-10-31,1258188,90,1258098,바하마,2022-10
2022-10-31,1234557,849205,385352,가봉,2022-10
2022-10-31,1231882,50107661,-48875779,적도 기니,2022-10
2022-10-31,1221835,1858457,-636622,아이슬란드,2022-10
2022-10-31,1127339,278,1127061,큐라소,2022-10
2022-10-31,1119629,928100,191529,짐바브웨,2022-10
2022-10-31,1090193,0,1090193,지부티,2022-10
2022-10-31,1031487,2126,1029361,부탄,2022-10
2022-10-31,1025751,378038,647713,르완다,2022-10
2022-10-31,1002151,69786,932365,불령 폴리네시아,2022-10
2022-10-31,983497,55131,928366,북마리아나 군도,2022-10
2022-10-31,965269,7042,958227,가이아나,2022-10
2022-10-31,949382,833544,115838,마세도니아,2022-10
2022-10-31,897410,7118681,-6221271,모리타니,2022-10
2022-10-31,875895,0,875895,세인트 마틴,2022-10
2022-10-31,859208,1968460,-1109252,리히텐슈타인,2022-10
2022-10-31,786550,0,786550,마티니크,2022-10
2022-10-31,691988,56920,635068,솔로몬 군도,2022-10
2022-10-31,677506,53314,624192,스와질랜드,2022-10
2022-10-31,604924,1216213,-611289,시에라 리온,2022-10
2022-10-31,574512,0,574512,버뮤다,2022-10
2022-10-31,555405,8181,547224,투발루,2022-10
2022-10-31,500929,625293,-124364,수리남,2022-10
2022-10-31,499927,168691,331236,벨리제,2022-10
2022-10-31,495959,10237425,-9741466,에리트리아,2022-10
2022-10-31,430570,119451,311119,안티가 바부다,2022-10
2022-10-31,368785,115606,253179,세인트 루시아,2022-10
2022-10-31,366725,621290,-254565,바누아투,2022-10
2022-10-31,366443,52611,313832,마이크로네시아,2022-10
2022-10-31,314068,1900,312168,도미니카,2022-10
2022-10-31,263008,903930,-640922,나미비아,2022-10
2022-10-31,221254,20,221234,니제르,2022-10
2022-10-31,220922,0,220922,카보 베르데,2022-10
2022-10-31,218982,0,218982,영령 버진군도,2022-10
2022-10-31,210786,5580886,-5370100,보스니아-헤르체고비나,2022-10
2022-10-31,205974,9210,196764,바베이도스,2022-10
2022-10-31,198073,0,198073,기네비소,2022-10
2022-10-31,187473,215816,-28343,감비아,2022-10
2022-10-31,181305,37,181268,부룬디,2022-10
2022-10-31,173599,0,173599,남수단,2022-10
2022-10-31,162242,11951,150291,세인트 키츠 네비스,2022-10
2022-10-31,160742,1199,159543,세인트 빈센트 그레나딘,2022-10
2022-10-31,144803,0,144803,불령 가이아나,2022-10
2022-10-31,111594,751532,-639938,쿠바,2022-10
2022-10-31,109384,1325,108059,네덜란드 열도,2022-10
2022-10-31,83075,24866447,-24783372,몬테네그로,2022-10
2022-10-31,80726,831,79895,그레나다,2022-10
2022-10-31,65995,1088,64907,지브랄타,2022-10
2022-10-31,36833,5712668,-5675835,나우루,2022-10
2022-10-31,24900,1132120,-1107220,산마리노,2022-10
2022-10-31,22892,8646,14246,안도라,2022-10
2022-10-31,21060,73885,-52825,통가,2022-10
2022-10-31,18647,48608,-29961,코모로스,2022-10
2022-10-31,12345,788,11557,건지,2022-10
2022-10-31,7264,28559,-21295,보츠와나,2022-10
2022-10-31,5750,0,5750,앙귈라,2022-10
2022-10-31,5488,0,5488,상토메 프린스페,2022-10
2022-10-31,2092,17072,-14980,미령 버진군도,2022-10
2022-10-31,1441,0,1441,쿡 아일랜드,2022-10
2022-10-31,700,17106,-16406,몬트세라트,2022-10
2022-10-31,662,0,662,세인트마틴(생마르탱),2022-10
2022-10-31,569,0,569,파로에 군도,2022-10
2022-10-31,426,0,426,투르크 & 카이코스 군도,2022-10
2022-10-31,343,231,112,그린랜드,2022-10
2022-10-31,240,7516,-7276,남조지아 & 남샌드위치 군도,2022-10
2022-10-31,180,0,180,티모르,2022-10
2022-10-31,0,3412,-3412,레소토,2022-10
2022-10-31,0,3569971,-3569971,마이너 아우틀링 합중국 군도,2022-10
2022-10-31,0,3584,-3584,토켈라우,2022-10
2022-10-31,0,465240,-465240,모나코,2022-10
2022-10-31,0,1778,-1778,저어지,2022-10
2022-10-31,0,18,-18,코스 군도,2022-10
2022-10-31,0,80536,-80536,중앙아프리카공화국,2022-10
2022-10-31,0,203,-203,크리스마스 아일랜드,2022-10
2022-10-31,0,413,-413,메요트,2022-10
2022-10-31,0,3810,-3810,불령 남부지역,2022-10
2022-11-30,11377959892,12129046026,-751086134,중국,2022-11
2022-11-30,8775693693,6529866133,2245827560,미국,2022-11
2022-11-30,4648870249,1947539026,2701331223,베트남,2022-11
2022-11-30,2301715702,4313251522,-2011535820,일본,2022-11
2022-11-30,1936578514,1982601944,-46023430,대만,2022-11
2022-11-30,1811354299,121791737,1689562562,홍콩,2022-11
2022-11-30,1753465440,3860935432,-2107469992,호주,2022-11
2022-11-30,1379462376,537507371,841955005,인도,2022-11
2022-11-30,1306892416,758060660,548831756,싱가포르,2022-11
2022-11-30,857886918,660778092,197108826,멕시코,2022-11
2022-11-30,827643989,1196758977,-369114988,말레이시아,2022-11
2022-11-30,791745784,1112093782,-320347998,러시아 연방,2022-11
2022-11-30,764052804,1156651480,-392598676,인도네시아,2022-11
2022-11-30,752153754,479568498,272585256,필리핀,2022-11
2022-11-30,670716164,564486805,106229359,태국,2022-11
2022-11-30,643186663,94826138,548360525,폴란드,2022-11
2022-11-30,628425346,2006918266,-1378492920,독일,2022-11
2022-11-30,610812168,71124733,539687435,헝가리,2022-11
2022-11-30,585960226,525364935,60595291,네덜란드,2022-11
2022-11-30,544816439,626787290,-81970851,캐나다,2022-11
2022-11-30,521888661,124541859,397346802,튀르키예,2022-11
2022-11-30,495054343,3233247205,-2738192862,사우디아라비아,2022-11
2022-11-30,413578278,739329382,-325751104,이탈리아,2022-11
2022-11-30,401507597,439141555,-37633958,벨기에,2022-11
2022-11-30,400897079,375671572,25225507,영국,2022-11
2022-11-30,382744643,54542,382690101,마샬군도,2022-11
2022-11-30,360820330,61063,360759267,라이베리아,2022-11
2022-11-30,345669297,617421494,-271752197,프랑스,2022-11
2022-11-30,319877630,711693662,-391816032,브라질,2022-11
2022-11-30,312309120,1384121009,-1071811889,아랍에미리트 연합,2022-11
2022-11-30,286772808,91148276,195624532,체코공화국,2022-11
2022-11-30,263978617,171994208,91984409,스페인,2022-11
2022-11-30,242973214,106108820,136864394,슬로바키아,2022-11
2022-11-30,207500296,144259466,63240830,뉴질랜드,2022-11
2022-11-30,196859368,411615591,-214756223,카자흐스탄,2022-11
2022-11-30,189643204,1562797,188080407,토고,2022-11
2022-11-30,179651287,8808791,170842496,슬로베니아,2022-11
2022-11-30,172513285,1699593,170813692,우즈베키스탄,2022-11
2022-11-30,171095133,458231194,-287136061,칠레,2022-11
2022-11-30,166302213,114494905,51807308,이스라엘,2022-11
2022-11-30,133192855,43926738,89266117,방글라데시,2022-11
2022-11-30,131642554,253493971,-121851417,오스트리아,2022-11
2022-11-30,127393115,206941474,-79548359,스웨덴,2022-11
2022-11-30,125975424,204694223,-78718799,남아프리카공화국,2022-11
2022-11-30,119330001,296207256,-176877255,스위스,2022-11
2022-11-30,110129639,203454485,-93324846,이집트,2022-11
2022-11-30,95204850,910870561,-815665711,이라크,2022-11
2022-11-30,88067478,8655615,79411863,몰타,2022-11
2022-11-30,79653488,97838857,-18185369,아일랜드,2022-11
2022-11-30,71638118,9353050,62285068,요르단,2022-11
2022-11-30,58841101,29741944,29099157,콜롬비아,2022-11
2022-11-30,58700031,16104610,42595421,파나마,2022-11
2022-11-30,58511319,126616364,-68105045,페루,2022-11
2022-11-30,56754942,252418485,-195663543,아르헨티나,2022-11
2022-11-30,56035288,35077567,20957721,파키스탄,2022-11
2022-11-30,53746665,64970,53681695,키르기스스탄,2022-11
2022-11-30,52187404,10720448,41466956,탄자니아,2022-11
2022-11-30,50176431,15293265,34883166,푸에르토리코,2022-11
2022-11-30,46729755,1321755288,-1275025533,카타르,2022-11
2022-11-30,44494326,37671166,6823160,포루투갈,2022-11
2022-11-30,41992060,101089791,-59097731,그리스,2022-11
2022-11-30,41439452,234633,41204819,괌,2022-11
2022-11-30,41287420,307315,40980105,피지,2022-11
2022-11-30,39032044,32186681,6845363,캄보디아,2022-11
2022-11-30,37622441,0,37622441,불령 폴리네시아,2022-11
2022-11-30,37402927,76040104,-38637177,루마니아,2022-11
2022-11-30,32567863,118974748,-86406885,노르웨이,2022-11
2022-11-30,32111206,25150281,6960925,모로코,2022-11
2022-11-30,31458712,4722752,26735960,에쿠아도르,2022-11
2022-11-30,30380745,9619035,20761710,리투아니아,2022-11
2022-11-30,29065518,129324880,-100259362,나이지리아,2022-11
2022-11-30,28867500,374040117,-345172617,오만,2022-11
2022-11-30,28045228,100637409,-72592181,덴마크,2022-11
2022-11-30,27038537,42932828,-15894291,미얀마,2022-11
2022-11-30,26754406,859890557,-833136151,쿠웨이트,2022-11
2022-11-30,26631999,7819672,18812327,도미니카 공화국,2022-11
2022-11-30,25171657,2892586,22279071,몽골,2022-11
2022-11-30,24015283,324368815,-300353532,알제리,2022-11
2022-11-30,23755618,117397251,-93641633,핀란드,2022-11
2022-11-30,21965443,56706441,-34740998,우크라이나,2022-11
2022-11-30,21703007,417604,21285403,리비아,2022-11
2022-11-30,20863431,54344600,-33481169,콩고민주공화국,2022-11
2022-11-30,19616158,10402909,9213249,과테말라,2022-11
2022-11-30,17165613,14866738,2298875,세르비아,2022-11
2022-11-30,17117462,9963345,7154117,코스타리카,2022-11
2022-11-30,16764612,228790,16535822,아제르바이잔,2022-11
2022-11-30,16472395,96091037,-79618642,튀니지,2022-11
2022-11-30,15696779,8487334,7209445,가나,2022-11
2022-11-30,15506683,7246694,8259989,케냐,2022-11
2022-11-30,15207151,19205189,-3998038,불가리아,2022-11
2022-11-30,13499327,176641,13322686,타지크,2022-11
2022-11-30,13231468,638753,12592715,코트디봐르,2022-11
2022-11-30,12879208,93983,12785225,이란,2022-11
2022-11-30,12682376,30686380,-18004004,우루과이,2022-11
2022-11-30,12200500,4866798,7333702,엘살바도르,2022-11
2022-11-30,11255905,1363317,9892588,조지아,2022-11
2022-11-30,10934715,14351207,-3416492,온두라스,2022-11
2022-11-30,10757956,8516522,2241434,스리랑카,2022-11
2022-11-30,10063787,10,10063777,앙골라,2022-11
2022-11-30,9878325,24758479,-14880154,파라과이,2022-11
2022-11-30,9496226,528282,8967944,수단,2022-11
2022-11-30,9148596,26860277,-17711681,바레인,2022-11
2022-11-30,9002041,1921433,7080608,레바논,2022-11
2022-11-30,8771745,34414621,-25642876,모잠비크,2022-11
2022-11-30,8244461,3025188,5219273,세네갈,2022-11
2022-11-30,6478483,1689699318,-1683220835,기타국,2022-11
2022-11-30,6368726,5874150,494576,크로아티아,2022-11
2022-11-30,6100697,245146,5855551,팔레스타인 해방기구,2022-11
2022-11-30,5855101,7244969,-1389868,에스토니아,2022-11
2022-11-30,5620293,9092699,-3472406,에티오피아,2022-11
2022-11-30,5528770,12961045,-7432275,니카라과,2022-11
2022-11-30,5204497,714604,4489893,콩고,2022-11
2022-11-30,4966764,412912,4553852,벨라루스,2022-11
2022-11-30,4879676,181476,4698200,브루나이,2022-11
2022-11-30,4660019,1814477,2845542,아이슬란드,2022-11
2022-11-30,4609780,3381,4606399,불령 리유니온 코모도 제도,2022-11
2022-11-30,4559190,339759,4219431,말리,2022-11
2022-11-30,4479726,509103,3970623,알바니아,2022-11
2022-11-30,4428471,180019,4248452,사이프러스,2022-11
2022-11-30,4406840,507567,3899273,네팔,2022-11
2022-11-30,4338972,2462869,1876103,예맨,2022-11
2022-11-30,4210871,5646082,-1435211,라트비아,2022-11
2022-11-30,4023148,17164,4005984,카메룬,2022-11
2022-11-30,3907118,2640434,1266684,마다카스카르,2022-11
2022-11-30,3677858,132480,3545378,기니,2022-11
2022-11-30,3631996,1096,3630900,지부티,2022-11
2022-11-30,3611174,484750,3126424,모리셔스,2022-11
2022-11-30,3486813,65512,3421301,아프카니스탄,2022-11
2022-11-30,3291758,108,3291650,가이아나,2022-11
2022-11-30,3226885,274026505,-270799620,파푸아 뉴기니,2022-11
2022-11-30,2921506,0,2921506,마티니크,2022-11
2022-11-30,2918675,80805690,-77887015,트리니다드 토바고,2022-11
2022-11-30,2802258,5802343,-3000085,룩셈부르그,2022-11
2022-11-30,2800317,7921,2792396,시리아,2022-11
2022-11-30,2670344,659,2669685,부르키나 파소,2022-11
2022-11-30,2627645,3144852,-517207,몰도바,2022-11
2022-11-30,2624854,14293139,-11668285,볼리비아,2022-11
2022-11-30,2384902,5293029,-2908127,라오스,2022-11
2022-11-30,2278368,2393,2275975,바하마,2022-11
2022-11-30,2181152,0,2181152,아루바,2022-11
2022-11-30,2140831,3028442,-887611,아르메니아,2022-11
2022-11-30,2129386,36794463,-34665077,뉴 칼레도니아,2022-11
2022-11-30,2062442,42245,2020197,자마이카,2022-11
2022-11-30,2040741,943053,1097688,베네주엘라,2022-11
2022-11-30,1958803,12991,1945812,아메리칸 사모아,2022-11
2022-11-30,1814595,63768,1750827,사모아,2022-11
2022-11-30,1547771,204160,1343611,마카오,2022-11
2022-11-30,1453418,939022,514396,가봉,2022-11
2022-11-30,1312073,672266,639807,몬테네그로,2022-11
2022-11-30,1234328,0,1234328,세인트 마틴,2022-11
2022-11-30,1232823,1762615,-529792,리히텐슈타인,2022-11
2022-11-30,1225817,52871,1172946,마세도니아,2022-11
2022-11-30,1223399,303827,919572,우간다,2022-11
2022-11-30,1159678,438,1159240,베닝,2022-11
2022-11-30,1131673,370818,760855,르완다,2022-11
2022-11-30,1111495,5566960,-4455465,모리타니,2022-11
2022-11-30,1105063,12608,1092455,잠비아,2022-11
2022-11-30,1052867,35237,1017630,북마리아나 군도,2022-11
2022-11-30,993910,892961,100949,짐바브웨,2022-11
2022-11-30,911582,3914697,-3003115,보스니아-헤르체고비나,2022-11
2022-11-30,881365,288631,592734,세이쉘,2022-11
2022-11-30,851779,210340,641439,키리바티,2022-11
2022-11-30,753020,371,752649,영령 버진군도,2022-11
2022-11-30,715804,1300,714504,몰디브,2022-11
2022-11-30,691761,185703,506058,아이티,2022-11
2022-11-30,691378,305,691073,과델로프,2022-11
2022-11-30,624720,52001,572719,세인트 루시아,2022-11
2022-11-30,620948,550,620398,버뮤다,2022-11
2022-11-30,598958,174404,424554,안티가 바부다,2022-11
2022-11-30,571128,374343,196785,시에라 리온,2022-11
2022-11-30,526307,151670,374637,소말리아,2022-11
2022-11-30,513587,95298,418289,마이크로네시아,2022-11
2022-11-30,509102,8082136,-7573034,나미비아,2022-11
2022-11-30,477457,1145936,-668479,바누아투,2022-11
2022-11-30,470446,840,469606,지브랄타,2022-11
2022-11-30,470251,391032,79219,수리남,2022-11
2022-11-30,436427,2263790,-1827363,솔로몬 군도,2022-11
2022-11-30,408040,0,408040,불령 가이아나,2022-11
2022-11-30,401610,9356,392254,니제르,2022-11
2022-11-30,374009,453,373556,그레나다,2022-11
2022-11-30,371045,0,371045,안타티카,2022-11
2022-11-30,366497,41919,324578,바베이도스,2022-11
2022-11-30,345529,34500,311029,팔라우,2022-11
2022-11-30,336119,391467,-55348,티모르,2022-11
2022-11-30,317776,158796,158980,산마리노,2022-11
2022-11-30,284486,0,284486,투르크 & 카이코스 군도,2022-11
2022-11-30,283608,514,283094,큐라소,2022-11
2022-11-30,279963,4,279959,영령 캐이맨 군도,2022-11
2022-11-30,268309,713,267596,남수단,2022-11
2022-11-30,258055,0,258055,메요트,2022-11
2022-11-30,246217,1112,245105,벨리제,2022-11
2022-11-30,244707,2049911,-1805204,말라위,2022-11
2022-11-30,241727,1123,240604,투르크멘,2022-11
2022-11-30,236378,599,235779,부룬디,2022-11
2022-11-30,222618,0,222618,부탄,2022-11
2022-11-30,207552,142908,64644,감비아,2022-11
2022-11-30,169779,489998,-320219,쿠바,2022-11
2022-11-30,112547,4509,108038,세인트 키츠 네비스,2022-11
2022-11-30,109796,0,109796,나우루,2022-11
2022-11-30,102472,452,102020,네덜란드 열도,2022-11
2022-11-30,60958,507,60451,에리트리아,2022-11
2022-11-30,54098,46246,7852,도미니카,2022-11
2022-11-30,48598,36513,12085,보츠와나,2022-11
2022-11-30,46309,376,45933,세인트 빈센트 그레나딘,2022-11
2022-11-30,38066,0,38066,챠드,2022-11
2022-11-30,37333,1,37332,중앙아프리카공화국,2022-11
2022-11-30,36028,0,36028,적도 기니,2022-11
2022-11-30,34418,151,34267,코모로스,2022-11
2022-11-30,33759,0,33759,상토메 프린스페,2022-11
2022-11-30,20867,124744,-103877,스와질랜드,2022-11
2022-11-30,18117,0,18117,왈라스 & 퓨투나 군도,2022-11
2022-11-30,6846,0,6846,카보 베르데,2022-11
2022-11-30,4546,0,4546,파로에 군도,2022-11
2022-11-30,4054,0,4054,세인트 바르탤르미,2022-11
2022-11-30,3628,2157,1471,안도라,2022-11
2022-11-30,2427,86425,-83998,모나코,2022-11
2022-11-30,1670,0,1670,기네비소,2022-11
2022-11-30,1497,0,1497,세인트마틴(생마르탱),2022-11
2022-11-30,992,33752,-32760,미령 버진군도,2022-11
2022-11-30,642,0,642,앙귈라,2022-11
2022-11-30,350,145974,-145624,그린랜드,2022-11
2022-11-30,206,756,-550,남조지아 & 남샌드위치 군도,2022-11
2022-11-30,119,2916,-2797,투발루,2022-11
2022-11-30,69,651,-582,불령 남부지역,2022-11
2022-11-30,0,3797,-3797,저어지,2022-11
2022-11-30,0,512,-512,스발비드 군도,2022-11
2022-11-30,0,315,-315,영령 인도양,2022-11
2022-11-30,0,209,-209,레소토,2022-11
2022-11-30,0,216,-216,토켈라우,2022-11
2022-11-30,0,289158,-289158,통가,2022-11
2022-11-30,0,30940,-30940,니우에,2022-11
2022-11-30,0,19765,-19765,코스 군도,2022-11
2022-11-30,0,286,-286,크리스마스 아일랜드,2022-11
2022-11-30,0,4,-4,마이너 아우틀링 합중국 군도,2022-11
2022-11-30,0,1859,-1859,보빗군도,2022-11
2022-12-31,11197864972,11810033842,-612168870,중국,2022-12
2022-12-31,9349378331,6794422285,2554956046,미국,2022-12
2022-12-31,4755951239,1867540561,2888410678,베트남,2022-12
2022-12-31,2428656289,4479917401,-2051261112,일본,2022-12
2022-12-31,1814287742,166229235,1648058507,홍콩,2022-12
2022-12-31,1803441037,2171610372,-368169335,대만,2022-12
2022-12-31,1536128944,1032059402,504069542,싱가포르,2022-12
2022-12-31,1486069896,497546033,988523863,인도,2022-12
2022-12-31,1381285859,3662002560,-2280716701,호주,2022-12
2022-12-31,925392800,882438844,42953956,멕시코,2022-12
2022-12-31,919837404,2140350730,-1220513326,독일,2022-12
2022-12-31,874362461,353686,874008775,라이베리아,2022-12
2022-12-31,868861474,88984103,779877371,헝가리,2022-12
2022-12-31,843239122,99199384,744039738,폴란드,2022-12
2022-12-31,803277297,1261340788,-458063491,말레이시아,2022-12
2022-12-31,760254774,399557189,360697585,필리핀,2022-12
2022-12-31,748048375,1511162218,-763113843,인도네시아,2022-12
2022-12-31,664414871,101439652,562975219,튀르키예,2022-12
2022-12-31,650222836,544205567,106017269,태국,2022-12
2022-12-31,645513996,764453853,-118939857,프랑스,2022-12
2022-12-31,615736463,567538593,48197870,캐나다,2022-12
2022-12-31,572119706,3195896017,-2623776311,사우디아라비아,2022-12
2022-12-31,561635362,33472,561601890,마샬군도,2022-12
2022-12-31,501729400,1065123526,-563394126,러시아 연방,2022-12
2022-12-31,499990575,341890308,158100267,벨기에,2022-12
2022-12-31,490760207,1270775658,-780015451,네덜란드,2022-12
2022-12-31,480134515,401545135,78589380,영국,2022-12
2022-12-31,373821461,64584210,309237251,파나마,2022-12
2022-12-31,362800688,695115825,-332315137,이탈리아,2022-12
2022-12-31,361077744,601037540,-239959796,브라질,2022-12
2022-12-31,354137716,112499883,241637833,뉴질랜드,2022-12
2022-12-31,310538499,1636663075,-1326124576,아랍에미리트 연합,2022-12
2022-12-31,288367804,134266901,154100903,이스라엘,2022-12
2022-12-31,279010452,91927248,187083204,체코공화국,2022-12
2022-12-31,266205874,64846897,201358977,슬로바키아,2022-12
2022-12-31,234713548,225376903,9336645,스페인,2022-12
2022-12-31,203507325,10132093,193375232,슬로베니아,2022-12
2022-12-31,195767862,1778779,193989083,우즈베키스탄,2022-12
2022-12-31,186418901,502635393,-316216492,카자흐스탄,2022-12
2022-12-31,173724528,46701001,127023527,방글라데시,2022-12
2022-12-31,166795092,2190618,164604474,토고,2022-12
2022-12-31,111784265,723682200,-611897935,이라크,2022-12
2022-12-31,105689822,275669610,-169979788,스위스,2022-12
2022-12-31,102990405,150537384,-47546979,이집트,2022-12
2022-12-31,95571242,178191234,-82619992,스웨덴,2022-12
2022-12-31,92486509,149564872,-57078363,노르웨이,2022-12
2022-12-31,91863362,14144802,77718560,탄자니아,2022-12
2022-12-31,84601309,554738733,-470137424,칠레,2022-12
2022-12-31,82546867,5347856,77199011,에쿠아도르,2022-12
2022-12-31,81150736,99621175,-18470439,아일랜드,2022-12
2022-12-31,80626126,291645194,-211019068,남아프리카공화국,2022-12
2022-12-31,79518029,44279141,35238888,파키스탄,2022-12
2022-12-31,79419289,1643228987,-1563809698,카타르,2022-12
2022-12-31,78281249,129731,78151518,괌,2022-12
2022-12-31,78108316,177309386,-99201070,콜롬비아,2022-12
2022-12-31,74221317,38398967,35822350,포루투갈,2022-12
2022-12-31,69781992,12199184,57582808,몰타,2022-12
2022-12-31,68636208,244644164,-176007956,오스트리아,2022-12
2022-12-31,65557761,4336499,61221262,요르단,2022-12
2022-12-31,60275215,99462252,-39187037,덴마크,2022-12
2022-12-31,58733590,85793,58647797,키르기스스탄,2022-12
2022-12-31,56691869,112564670,-55872801,페루,2022-12
2022-12-31,56301558,78907295,-22605737,핀란드,2022-12
2022-12-31,53800027,35224254,18575773,캄보디아,2022-12
2022-12-31,48353173,16864344,31488829,푸에르토리코,2022-12
2022-12-31,46778776,857608019,-810829243,쿠웨이트,2022-12
2022-12-31,45838376,102352110,-56513734,그리스,2022-12
2022-12-31,43498269,53213554,-9715285,루마니아,2022-12
2022-12-31,42431083,91064419,-48633336,나이지리아,2022-12
2022-12-31,37165702,404526051,-367360349,오만,2022-12
2022-12-31,34394579,708465,33686114,리비아,2022-12
2022-12-31,32246760,27605535,4641225,모로코,2022-12
2022-12-31,30250656,214444126,-184193470,아르헨티나,2022-12
2022-12-31,29830511,3432563,26397948,몽골,2022-12
2022-12-31,29079452,50935957,-21856505,콩고민주공화국,2022-12
2022-12-31,28359049,6652432,21706617,도미니카 공화국,2022-12
2022-12-31,23500000,0,23500000,맨섬,2022-12
2022-12-31,23273120,131668,23141452,아제르바이잔,2022-12
2022-12-31,22135305,37647762,-15512457,미얀마,2022-12
2022-12-31,21972644,204215181,-182242537,알제리,2022-12
2022-12-31,21913634,6378945,15534689,엘살바도르,2022-12
2022-12-31,20176309,7000310,13175999,크로아티아,2022-12
2022-12-31,20046571,8893157,11153414,과테말라,2022-12
2022-12-31,17724454,8415915,9308539,리투아니아,2022-12
2022-12-31,17658808,8558783,9100025,세르비아,2022-12
2022-12-31,17486825,413590,17073235,코트디봐르,2022-12
2022-12-31,16802351,6629025,10173326,케냐,2022-12
2022-12-31,15074308,390512028,-375437720,기타국,2022-12
2022-12-31,15023117,18636272,-3613155,불가리아,2022-12
2022-12-31,14874932,25,14874907,타지크,2022-12
2022-12-31,14639854,17159143,-2519289,우루과이,2022-12
2022-12-31,14510082,52569857,-38059775,우크라이나,2022-12
2022-12-31,14243862,351784,13892078,이란,2022-12
2022-12-31,13445090,10767506,2677584,코스타리카,2022-12
2022-12-31,13252697,1315290,11937407,조지아,2022-12
2022-12-31,12466523,1565050,10901473,가나,2022-12
2022-12-31,12042412,48214909,-36172497,바레인,2022-12
2022-12-31,11728549,14404061,-2675512,스리랑카,2022-12
2022-12-31,10776981,5938313,4838668,에스토니아,2022-12
2022-12-31,10086502,358347,9728155,수단,2022-12
2022-12-31,9785676,3220876,6564800,레바논,2022-12
2022-12-31,9769344,12096937,-2327593,온두라스,2022-12
2022-12-31,8521755,3252917,5268838,세네갈,2022-12
2022-12-31,8317193,83614650,-75297457,튀니지,2022-12
2022-12-31,8198837,26778,8172059,팔레스타인 해방기구,2022-12
2022-12-31,7681502,1202,7680300,앙골라,2022-12
2022-12-31,7154793,31653215,-24498422,파라과이,2022-12
2022-12-31,6937628,44729,6892899,북마리아나 군도,2022-12
2022-12-31,6542388,58079746,-51537358,볼리비아,2022-12
2022-12-31,6406077,40180002,-33773925,모잠비크,2022-12
2022-12-31,6322293,164628724,-158306431,파푸아 뉴기니,2022-12
2022-12-31,6265799,7657986,-1392187,라트비아,2022-12
2022-12-31,6097320,8076695,-1979375,에티오피아,2022-12
2022-12-31,5848085,31694362,-25846277,트리니다드 토바고,2022-12
2022-12-31,5374959,242476,5132483,말리,2022-12
2022-12-31,5373252,2124913,3248339,예맨,2022-12
2022-12-31,5113806,2895,5110911,불령 리유니온 코모도 제도,2022-12
2022-12-31,4947408,5219085,-271677,니카라과,2022-12
2022-12-31,4870708,91418550,-86547842,브루나이,2022-12
2022-12-31,4868239,291711,4576528,사이프러스,2022-12
2022-12-31,4785486,336,4785150,마이크로네시아,2022-12
2022-12-31,4526610,1164198,3362412,알바니아,2022-12
2022-12-31,4090920,801322,3289598,벨라루스,2022-12
2022-12-31,4073250,987761,3085489,우간다,2022-12
2022-12-31,4063008,2971000,1092008,아이슬란드,2022-12
2022-12-31,3905515,0,3905515,마티니크,2022-12
2022-12-31,3881797,31061175,-27179378,뉴 칼레도니아,2022-12
2022-12-31,3786929,0,3786929,아루바,2022-12
2022-12-31,3497946,9420,3488526,아이티,2022-12
2022-12-31,3409733,259384,3150349,모리셔스,2022-12
2022-12-31,3404776,3690401,-285625,몰도바,2022-12
2022-12-31,3297170,6732566,-3435396,라오스,2022-12
2022-12-31,3066811,419639,2647172,피지,2022-12
2022-12-31,2992705,2246412,746293,마다카스카르,2022-12
2022-12-31,2930032,0,2930032,지부티,2022-12
2022-12-31,2908103,316514,2591589,네팔,2022-12
2022-12-31,2821868,96339,2725529,아프카니스탄,2022-12
2022-12-31,2704203,5556086,-2851883,룩셈부르그,2022-12
2022-12-31,2568086,234598,2333488,자마이카,2022-12
2022-12-31,2335646,5691389,-3355743,아르메니아,2022-12
2022-12-31,2284580,70116,2214464,사모아,2022-12
2022-12-31,2232230,706532,1525698,르완다,2022-12
2022-12-31,2194635,503814,1690821,콩고,2022-12
2022-12-31,2137001,110304,2026697,가이아나,2022-12
2022-12-31,2082105,601506,1480599,카메룬,2022-12
2022-12-31,2074393,704932,1369461,베네주엘라,2022-12
2022-12-31,1973542,12722,1960820,바하마,2022-12
2022-12-31,1962962,24522,1938440,부르키나 파소,2022-12
2022-12-31,1911494,121667,1789827,키리바티,2022-12
2022-12-31,1870569,387897,1482672,마세도니아,2022-12
2022-12-31,1825733,66498,1759235,불령 폴리네시아,2022-12
2022-12-31,1758761,50610,1708151,마카오,2022-12
2022-12-31,1727202,514593,1212609,가봉,2022-12
2022-12-31,1719215,3287333,-1568118,기니,2022-12
2022-12-31,1718535,36378,1682157,시리아,2022-12
2022-12-31,1554022,119608,1434414,세이쉘,2022-12
2022-12-31,1547262,8324,1538938,니제르,2022-12
2022-12-31,1539173,2383789,-844616,리히텐슈타인,2022-12
2022-12-31,1464970,11,1464959,베닝,2022-12
2022-12-31,1350505,453400,897105,아메리칸 사모아,2022-12
2022-12-31,1295478,0,1295478,소말리아,2022-12
2022-12-31,1247469,8610610,-7363141,잠비아,2022-12
2022-12-31,1245986,318959,927027,짐바브웨,2022-12
2022-12-31,1138767,0,1138767,세인트 마틴,2022-12
2022-12-31,911706,345469,566237,솔로몬 군도,2022-12
2022-12-31,822268,0,822268,과델로프,2022-12
2022-12-31,815106,5025807,-4210701,보스니아-헤르체고비나,2022-12
2022-12-31,755296,1535148,-779852,바누아투,2022-12
2022-12-31,739147,13681,725466,바베이도스,2022-12
2022-12-31,706423,127,706296,부탄,2022-12
2022-12-31,701873,0,701873,큐라소,2022-12
2022-12-31,683821,0,683821,투르크멘,2022-12
2022-12-31,673224,0,673224,영령 캐이맨 군도,2022-12
2022-12-31,669455,1129990,-460535,시에라 리온,2022-12
2022-12-31,667814,9736114,-9068300,몬테네그로,2022-12
2022-12-31,562694,2423,560271,몰디브,2022-12
2022-12-31,497411,3292187,-2794776,모리타니,2022-12
2022-12-31,482870,0,482870,불령 가이아나,2022-12
2022-12-31,481862,4696,477166,스와질랜드,2022-12
2022-12-31,450497,0,450497,버뮤다,2022-12
2022-12-31,397323,17063,380260,팔라우,2022-12
2022-12-31,374150,65307,308843,부룬디,2022-12
2022-12-31,359854,0,359854,에리트리아,2022-12
2022-12-31,356300,258397,97903,감비아,2022-12
2022-12-31,351133,42600,308533,도미니카,2022-12
2022-12-31,329280,913089,-583809,수리남,2022-12
2022-12-31,294791,0,294791,영령 버진군도,2022-12
2022-12-31,289074,0,289074,투발루,2022-12
2022-12-31,279082,0,279082,남수단,2022-12
2022-12-31,258818,1285446,-1026628,말라위,2022-12
2022-12-31,242456,237283,5173,쿠바,2022-12
2022-12-31,214850,244,214606,지브랄타,2022-12
2022-12-31,203631,36010,167621,티모르,2022-12
2022-12-31,185679,38344,147335,벨리제,2022-12
2022-12-31,165852,1141132,-975280,산마리노,2022-12
2022-12-31,121272,160409,-39137,안티가 바부다,2022-12
2022-12-31,109343,275762,-166419,나미비아,2022-12
2022-12-31,102785,65786,36999,보츠와나,2022-12
2022-12-31,101136,205172,-104036,기네비소,2022-12
2022-12-31,99301,0,99301,메요트,2022-12
2022-12-31,94772,240,94532,네덜란드 열도,2022-12
2022-12-31,89245,0,89245,세인트 빈센트 그레나딘,2022-12
2022-12-31,79554,0,79554,투르크 & 카이코스 군도,2022-12
2022-12-31,59032,454,58578,중앙아프리카공화국,2022-12
2022-12-31,56902,461018,-404116,통가,2022-12
2022-12-31,55149,20932,34217,세인트 키츠 네비스,2022-12
2022-12-31,52266,0,52266,카보 베르데,2022-12
2022-12-31,35322,3454,31868,그레나다,2022-12
2022-12-31,32762,53460,-20698,세인트 루시아,2022-12
2022-12-31,32690,6206,26484,안도라,2022-12
2022-12-31,30032,214,29818,세인트 바르탤르미,2022-12
2022-12-31,28487,234,28253,남조지아 & 남샌드위치 군도,2022-12
2022-12-31,23820,297,23523,보네르 신트외스타티위스,2022-12
2022-12-31,9275,0,9275,안타티카,2022-12
2022-12-31,8374,500616,-492242,모나코,2022-12
2022-12-31,3600,0,3600,앙귈라,2022-12
2022-12-31,3340,1015,2325,챠드,2022-12
2022-12-31,2973,0,2973,상토메 프린스페,2022-12
2022-12-31,2263,0,2263,세인트마틴(생마르탱),2022-12
2022-12-31,1345,324,1021,미령 버진군도,2022-12
2022-12-31,553,419,134,저어지,2022-12
2022-12-31,344,5547665,-5547321,나우루,2022-12
2022-12-31,157,7762,-7605,그린랜드,2022-12
2022-12-31,30,1157,-1127,불령 남부지역,2022-12
2022-12-31,0,4860,-4860,토켈라우,2022-12
2022-12-31,0,1826,-1826,마이너 아우틀링 합중국 군도,2022-12
2022-12-31,0,245,-245,파로에 군도,2022-12
2022-12-31,0,44939424,-44939424,적도 기니,2022-12
2022-12-31,0,606,-606,서사하라,2022-12
2022-12-31,0,1955,-1955,몬트세라트,2022-12
2022-12-31,0,4783,-4783,레소토,2022-12
2022-12-31,0,5968,-5968,니우에,2022-12
2022-12-31,0,715,-715,코스 군도,2022-12
2022-12-31,0,845,-845,코모로스,2022-12
2022-12-31,0,1145,-1145,건지,2022-12
2022-12-31,0,147,-147,영령 인도양,2022-12
2022-12-31,0,245,-245,쿡 아일랜드,2022-12
2023-01-31,9207638675,13140060660,-3932421985,중국,2023-01
2023-01-31,8058603985,6995422573,1063181412,미국,2023-01
2023-01-31,3768005258,2401963268,1366041990,베트남,2023-01
2023-01-31,2295203445,3953682365,-1658478920,일본,2023-01
2023-01-31,1452738349,543955228,908783121,인도,2023-01
2023-01-31,1309949365,875161739,434787626,싱가포르,2023-01
2023-01-31,1304488440,4110352203,-2805863763,호주,2023-01
2023-01-31,1212506968,1750162107,-537655139,대만,2023-01
2023-01-31,1113867679,108797174,1005070505,홍콩,2023-01
2023-01-31,884625996,711537437,173088559,멕시코,2023-01
2023-01-31,852153630,1368578152,-516424522,말레이시아,2023-01
2023-01-31,850707223,462395817,388311406,필리핀,2023-01
2023-01-31,778814236,93030718,685783518,폴란드,2023-01
2023-01-31,734830505,1960996406,-1226165901,독일,2023-01
2023-01-31,734178219,110609841,623568378,튀르키예,2023-01
2023-01-31,716480377,61421705,655058672,헝가리,2023-01
2023-01-31,703497900,1395647329,-692149429,인도네시아,2023-01
2023-01-31,669372864,554790046,114582818,태국,2023-01
2023-01-31,644097623,460224304,183873319,캐나다,2023-01
2023-01-31,558391483,6963,558384520,마샬군도,2023-01
2023-01-31,511595127,667032240,-155437113,프랑스,2023-01
2023-01-31,476571354,792251013,-315679659,러시아 연방,2023-01
2023-01-31,473346108,184314669,289031439,벨기에,2023-01
2023-01-31,462139618,387516776,74622842,영국,2023-01
2023-01-31,459675136,528925457,-69250321,네덜란드,2023-01
2023-01-31,391328075,2768103413,-2376775338,사우디아라비아,2023-01
2023-01-31,381767757,731051455,-349283698,이탈리아,2023-01
2023-01-31,341468701,691463708,-349995007,브라질,2023-01
2023-01-31,312512238,1324980004,-1012467766,아랍에미리트 연합,2023-01
2023-01-31,267393038,271166,267121872,라이베리아,2023-01
2023-01-31,259057832,245352119,13705713,이스라엘,2023-01
2023-01-31,250130353,220797919,29332434,스페인,2023-01
2023-01-31,242670891,109970385,132700506,체코공화국,2023-01
2023-01-31,187675905,113634094,74041811,슬로바키아,2023-01
2023-01-31,183601067,1768030,181833037,우즈베키스탄,2023-01
2023-01-31,182460344,151430839,31029505,뉴질랜드,2023-01
2023-01-31,152756408,70124912,82631496,방글라데시,2023-01
2023-01-31,138863366,274437243,-135573877,카자흐스탄,2023-01
2023-01-31,122557513,612290799,-489733286,칠레,2023-01
2023-01-31,116153688,132741251,-16587563,스웨덴,2023-01
2023-01-31,106577803,180025288,-73447485,오스트리아,2023-01
2023-01-31,96213519,263818648,-167605129,스위스,2023-01
2023-01-31,94040411,16140718,77899693,슬로베니아,2023-01
2023-01-31,93979630,559842294,-465862664,이라크,2023-01
2023-01-31,89926215,136678636,-46752421,노르웨이,2023-01
2023-01-31,86333330,347372485,-261039155,이집트,2023-01
2023-01-31,85473039,15961436,69511603,토고,2023-01
2023-01-31,83098385,13382738,69715647,탄자니아,2023-01
2023-01-31,82161008,294052295,-211891287,남아프리카공화국,2023-01
2023-01-31,72220118,40511240,31708878,미얀마,2023-01
2023-01-31,66427640,41620058,24807582,포루투갈,2023-01
2023-01-31,54863147,5256715,49606432,요르단,2023-01
2023-01-31,53208828,47027789,6181039,콜롬비아,2023-01
2023-01-31,51504805,131161742,-79656937,아일랜드,2023-01
2023-01-31,51005020,95014350,-44009330,덴마크,2023-01
2023-01-31,50645928,1163392592,-1112746664,카타르,2023-01
2023-01-31,49405972,1533,49404439,키르기스스탄,2023-01
2023-01-31,49259231,279684667,-230425436,파푸아 뉴기니,2023-01
2023-01-31,47661861,44367595,3294266,캄보디아,2023-01
2023-01-31,47395934,705979992,-658584058,쿠웨이트,2023-01
2023-01-31,47155148,401565034,-354409886,페루,2023-01
2023-01-31,43616374,23921458,19694916,푸에르토리코,2023-01
2023-01-31,43422409,18750749,24671660,파키스탄,2023-01
2023-01-31,42247532,80065630,-37818098,그리스,2023-01
2023-01-31,41499301,87514565,-46015264,나이지리아,2023-01
2023-01-31,38513778,60906916,-22393138,루마니아,2023-01
2023-01-31,36567179,283406,36283773,피지,2023-01
2023-01-31,35963293,904139554,-868176261,오만,2023-01
2023-01-31,32037966,45447941,-13409975,콩고민주공화국,2023-01
2023-01-31,31338302,290018,31048284,카메룬,2023-01
2023-01-31,30944166,218046,30726120,리비아,2023-01
2023-01-31,30351276,178261646,-147910370,아르헨티나,2023-01
2023-01-31,28072247,8092238,19980009,에쿠아도르,2023-01
2023-01-31,27920823,64756767,-36835944,핀란드,2023-01
2023-01-31,26127452,4634973,21492479,몽골,2023-01
2023-01-31,25938500,19732393,6206107,모로코,2023-01
2023-01-31,22910784,8279332,14631452,도미니카 공화국,2023-01
2023-01-31,21750060,8179909,13570151,리투아니아,2023-01
2023-01-31,21060678,52135049,-31074371,파나마,2023-01
2023-01-31,20152182,46112,20106070,아제르바이잔,2023-01
2023-01-31,19986869,5385148,14601721,과테말라,2023-01
2023-01-31,19466582,68245526,-48778944,몰타,2023-01
2023-01-31,18777168,94895062,-76117894,우크라이나,2023-01
2023-01-31,18125482,2142175,15983307,엘살바도르,2023-01
2023-01-31,17621039,7220202,10400837,세르비아,2023-01
2023-01-31,17322762,518524961,-501202199,알제리,2023-01
2023-01-31,17273134,6620610,10652524,케냐,2023-01
2023-01-31,16751090,406172,16344918,코트디봐르,2023-01
2023-01-31,14267154,6163042,8104112,크로아티아,2023-01
2023-01-31,13991128,13885695,105433,코스타리카,2023-01
2023-01-31,13766537,167084,13599453,이란,2023-01
2023-01-31,13659364,1733208,11926156,가나,2023-01
2023-01-31,13622745,240458,13382287,괌,2023-01
2023-01-31,13403883,13030062,373821,불가리아,2023-01
2023-01-31,13256701,602475,12654226,조지아,2023-01
2023-01-31,12822944,25979593,-13156649,바레인,2023-01
2023-01-31,12460208,11202711,1257497,스리랑카,2023-01
2023-01-31,10154640,2278607,7876033,온두라스,2023-01
2023-01-31,9818165,31115,9787050,타지크,2023-01
2023-01-31,8786449,42668920,-33882471,모잠비크,2023-01
2023-01-31,8557375,5347,8552028,앙골라,2023-01
2023-01-31,8543934,2415173,6128761,레바논,2023-01
2023-01-31,8000882,34053136,-26052254,튀니지,2023-01
2023-01-31,6990558,17379257,-10388699,우루과이,2023-01
2023-01-31,6778959,9653405,-2874446,에티오피아,2023-01
2023-01-31,6674259,919928,5754331,수단,2023-01
2023-01-31,6466298,3479875,2986423,세네갈,2023-01
2023-01-31,6356538,24541599,-18185061,파라과이,2023-01
2023-01-31,6355000,858414,5496586,니카라과,2023-01
2023-01-31,6122504,25164314,-19041810,트리니다드 토바고,2023-01
2023-01-31,6100767,468118366,-462017599,기타국,2023-01
2023-01-31,6085477,1281584,4803893,사이프러스,2023-01
2023-01-31,6008528,1755608,4252920,아이슬란드,2023-01
2023-01-31,5565158,1064595,4500563,알바니아,2023-01
2023-01-31,5383328,0,5383328,팔레스타인 해방기구,2023-01
2023-01-31,5362331,6213662,-851331,에스토니아,2023-01
2023-01-31,5295477,12016572,-6721095,라오스,2023-01
2023-01-31,4794959,373359,4421600,벨라루스,2023-01
2023-01-31,4576061,6044373,-1468312,라트비아,2023-01
2023-01-31,4158396,193,4158203,가이아나,2023-01
2023-01-31,4141611,32759,4108852,사모아,2023-01
2023-01-31,3872319,14659428,-10787109,뉴 칼레도니아,2023-01
2023-01-31,3641110,10747,3630363,아이티,2023-01
2023-01-31,3497080,863296,2633784,자마이카,2023-01
2023-01-31,3270191,43792549,-40522358,볼리비아,2023-01
2023-01-31,3244387,2702143,542244,예맨,2023-01
2023-01-31,3215178,4601769,-1386591,브루나이,2023-01
2023-01-31,3167558,5168782,-2001224,룩셈부르그,2023-01
2023-01-31,3073930,3999428,-925498,몰도바,2023-01
2023-01-31,2965720,3664,2962056,불령 리유니온 코모도 제도,2023-01
2023-01-31,2855933,0,2855933,부르키나 파소,2023-01
2023-01-31,2685081,850756,1834325,모리셔스,2023-01
2023-01-31,2664240,22770206,-20105966,마다카스카르,2023-01
2023-01-31,2389494,0,2389494,지부티,2023-01
2023-01-31,2251358,0,2251358,큐라소,2023-01
2023-01-31,1955578,0,1955578,마티니크,2023-01
2023-01-31,1894524,151,1894373,니제르,2023-01
2023-01-31,1871071,0,1871071,베닝,2023-01
2023-01-31,1860516,109136,1751380,레소토,2023-01
2023-01-31,1827290,310558,1516732,네팔,2023-01
2023-01-31,1824952,5277451,-3452499,기니,2023-01
2023-01-31,1741272,103904,1637368,아프카니스탄,2023-01
2023-01-31,1684379,8132595,-6448216,아르메니아,2023-01
2023-01-31,1640520,88670,1551850,불령 폴리네시아,2023-01
2023-01-31,1505925,120304,1385621,마카오,2023-01
2023-01-31,1500555,1063430,437125,짐바브웨,2023-01
2023-01-31,1444219,0,1444219,아루바,2023-01
2023-01-31,1432483,715160,717323,콩고,2023-01
2023-01-31,1335383,1606808,-271425,리히텐슈타인,2023-01
2023-01-31,1238981,8062616,-6823635,잠비아,2023-01
2023-01-31,1182296,120524,1061772,부룬디,2023-01
2023-01-31,1156165,426,1155739,말리,2023-01
2023-01-31,1126340,226037,900303,르완다,2023-01
2023-01-31,1120538,1187544,-67006,베네주엘라,2023-01
2023-01-31,995859,258930,736929,마세도니아,2023-01
2023-01-31,975345,151,975194,마이크로네시아,2023-01
2023-01-31,968089,934,967155,바하마,2023-01
2023-01-31,932198,7718,924480,시리아,2023-01
2023-01-31,890452,2768204,-1877752,우간다,2023-01
2023-01-31,869833,327272,542561,북마리아나 군도,2023-01
2023-01-31,869550,0,869550,소말리아,2023-01
2023-01-31,855546,0,855546,과델로프,2023-01
2023-01-31,799034,4015,795019,몰디브,2023-01
2023-01-31,702164,0,702164,세인트 마틴,2023-01
2023-01-31,700355,0,700355,영령 캐이맨 군도,2023-01
2023-01-31,662562,2836901,-2174339,모리타니,2023-01
2023-01-31,661590,96307,565283,세이쉘,2023-01
2023-01-31,654772,5541,649231,그레나다,2023-01
2023-01-31,609788,1104931,-495143,바누아투,2023-01
2023-01-31,554094,382416,171678,수리남,2023-01
2023-01-31,553949,4066257,-3512308,보스니아-헤르체고비나,2023-01
2023-01-31,548976,1347038,-798062,시에라 리온,2023-01
2023-01-31,537780,578794,-41014,가봉,2023-01
2023-01-31,488095,108695,379400,아메리칸 사모아,2023-01
2023-01-31,405085,0,405085,불령 가이아나,2023-01
2023-01-31,349437,0,349437,투르크멘,2023-01
2023-01-31,322390,0,322390,남수단,2023-01
2023-01-31,287273,12096,275177,바베이도스,2023-01
2023-01-31,274199,47283,226916,팔라우,2023-01
2023-01-31,261866,1019544,-757678,키리바티,2023-01
2023-01-31,256781,0,256781,솔로몬 군도,2023-01
2023-01-31,250207,506056,-255849,모나코,2023-01
2023-01-31,223993,509174,-285181,감비아,2023-01
2023-01-31,216727,9397,207330,투발루,2023-01
2023-01-31,214612,36,214576,부탄,2023-01
2023-01-31,212948,0,212948,버뮤다,2023-01
2023-01-31,193195,1621,191574,벨리제,2023-01
2023-01-31,189392,187711,1681,나미비아,2023-01
2023-01-31,188930,80,188850,영령 버진군도,2023-01
2023-01-31,185470,31567,153903,스와질랜드,2023-01
2023-01-31,166023,87078,78945,안티가 바부다,2023-01
2023-01-31,152272,12088,140184,세인트 키츠 네비스,2023-01
2023-01-31,143013,190848,-47835,적도 기니,2023-01
2023-01-31,141957,0,141957,투르크 & 카이코스 군도,2023-01
2023-01-31,137583,0,137583,나우루,2023-01
2023-01-31,121785,4128,117657,도미니카,2023-01
2023-01-31,116449,18631921,-18515472,몬테네그로,2023-01
2023-01-31,88821,36270,52551,티모르,2023-01
2023-01-31,86155,0,86155,카보 베르데,2023-01
2023-01-31,81368,3349,78019,지브랄타,2023-01
2023-01-31,76956,10865663,-10788707,말라위,2023-01
2023-01-31,57581,37302,20279,세인트 루시아,2023-01
2023-01-31,53954,0,53954,세인트 빈센트 그레나딘,2023-01
2023-01-31,38609,0,38609,네덜란드 열도,2023-01
2023-01-31,28046,0,28046,상토메 프린스페,2023-01
2023-01-31,27565,0,27565,메요트,2023-01
2023-01-31,23132,283,22849,챠드,2023-01
2023-01-31,21196,5578,15618,안도라,2023-01
2023-01-31,14366,0,14366,앙귈라,2023-01
2023-01-31,9200,3998,5202,중앙아프리카공화국,2023-01
2023-01-31,8500,479451,-470951,산마리노,2023-01
2023-01-31,6787,3221,3566,건지,2023-01
2023-01-31,6094,347557,-341463,쿠바,2023-01
2023-01-31,5359,0,5359,세인트마틴(생마르탱),2023-01
2023-01-31,5111,653,4458,안타티카,2023-01
2023-01-31,4620,881,3739,코스 군도,2023-01
2023-01-31,1699,10990694,-10988995,에리트리아,2023-01
2023-01-31,557,0,557,미령 버진군도,2023-01
2023-01-31,236,0,236,그린랜드,2023-01
2023-01-31,218,0,218,몬트세라트,2023-01
2023-01-31,200,99822,-99622,통가,2023-01
2023-01-31,187,173,14,저어지,2023-01
2023-01-31,44,56816,-56772,기네비소,2023-01
2023-01-31,0,51928,-51928,보츠와나,2023-01
2023-01-31,0,6261,-6261,니우에,2023-01
2023-01-31,0,8279,-8279,보빗군도,2023-01
2023-01-31,0,422,-422,코모로스,2023-01
2023-01-31,0,149,-149,남조지아 & 남샌드위치 군도,2023-01
2023-01-31,0,86,-86,세인트 헬레나,2023-01
2023-01-31,0,300,-300,맨섬,2023-01
2023-01-31,0,1700,-1700,불령 남부지역,2023-01
2023-01-31,0,576,-576,토켈라우,2023-01
2023-01-31,0,1000,-1000,마이너 아우틀링 합중국 군도,2023-01
2023-01-31,0,968,-968,크리스마스 아일랜드,2023-01
2023-01-31,0,57,-57,세인트 바르탤르미,2023-01
2023-02-28,9885692884,11025733521,-1140040637,중국,2023-02
2023-02-28,8991831182,6011956681,2979874501,미국,2023-02
2023-02-28,4042169912,2051258031,1990911881,베트남,2023-02
2023-02-28,2345909768,4227697796,-1881788028,일본,2023-02
2023-02-28,1499353486,497612005,1001741481,인도,2023-02
2023-02-28,1435311643,3485092614,-2049780971,호주,2023-02
2023-02-28,1413002566,1898312472,-485309906,대만,2023-02
2023-02-28,1395943424,1046821261,349122163,싱가포르,2023-02
2023-02-28,1186204522,96675013,1089529509,홍콩,2023-02
2023-02-28,994145437,741033445,253111992,멕시코,2023-02
2023-02-28,813372785,127625267,685747518,튀르키예,2023-02
2023-02-28,801110883,2219022648,-1417911765,독일,2023-02
2023-02-28,795787904,1243200693,-447412789,인도네시아,2023-02
2023-02-28,787547416,81563819,705983597,헝가리,2023-02
2023-02-28,781236528,1404046363,-622809835,말레이시아,2023-02
2023-02-28,768896535,378821535,390075000,네덜란드,2023-02
2023-02-28,718223641,98424381,619799260,폴란드,2023-02
2023-02-28,709092398,416094501,292997897,캐나다,2023-02
2023-02-28,689595084,611091677,78503407,태국,2023-02
2023-02-28,641583502,401172721,240410781,필리핀,2023-02
2023-02-28,525280878,439301470,85979408,영국,2023-02
2023-02-28,513593099,868370507,-354777408,러시아 연방,2023-02
2023-02-28,509938528,155570507,354368021,벨기에,2023-02
2023-02-28,454564106,754888677,-300324571,이탈리아,2023-02
2023-02-28,435457978,1677310868,-1241852890,아랍에미리트 연합,2023-02
2023-02-28,432458984,19730,432439254,마샬군도,2023-02
2023-02-28,398244238,2688095346,-2289851108,사우디아라비아,2023-02
2023-02-28,357313956,529311,356784645,라이베리아,2023-02
2023-02-28,342709042,655940254,-313231212,브라질,2023-02
2023-02-28,309075814,600310103,-291234289,프랑스,2023-02
2023-02-28,301566898,93294580,208272318,체코공화국,2023-02
2023-02-28,281223576,97940882,183282694,슬로바키아,2023-02
2023-02-28,278085773,217166151,60919622,스페인,2023-02
2023-02-28,232296810,107237133,125059677,그리스,2023-02
2023-02-28,216869856,1192706,215677150,우즈베키스탄,2023-02
2023-02-28,203434190,120711074,82723116,이스라엘,2023-02
2023-02-28,163690293,362075933,-198385640,카자흐스탄,2023-02
2023-02-28,155096610,9862780,145233830,슬로베니아,2023-02
2023-02-28,152589285,130313752,22275533,뉴질랜드,2023-02
2023-02-28,136351642,63952560,72399082,방글라데시,2023-02
2023-02-28,124370455,270380905,-146010450,스위스,2023-02
2023-02-28,118541205,609561828,-491020623,이라크,2023-02
2023-02-28,110472399,274417566,-163945167,남아프리카공화국,2023-02
2023-02-28,107695018,163486151,-55791133,스웨덴,2023-02
2023-02-28,99973081,144964253,-44991172,이집트,2023-02
2023-02-28,93693532,5315745,88377787,케냐,2023-02
2023-02-28,90763240,610294268,-519531028,칠레,2023-02
2023-02-28,80755520,2142340,78613180,토고,2023-02
2023-02-28,78584432,124210758,-45626326,노르웨이,2023-02
2023-02-28,72520286,150408731,-77888445,오스트리아,2023-02
2023-02-28,72239882,9622287,62617595,몰타,2023-02
2023-02-28,71567979,656318,70911661,키르기스스탄,2023-02
2023-02-28,68820231,20457512,48362719,콜롬비아,2023-02
2023-02-28,68258402,3129039,65129363,파나마,2023-02
2023-02-28,66053516,12698487,53355029,파키스탄,2023-02
2023-02-28,65814206,106748626,-40934420,아일랜드,2023-02
2023-02-28,64647634,1469908907,-1405261273,카타르,2023-02
2023-02-28,60942343,48623326,12319017,포루투갈,2023-02
2023-02-28,55902713,6905255,48997458,요르단,2023-02
2023-02-28,50570164,306305,50263859,괌,2023-02
2023-02-28,49395073,218014268,-168619195,페루,2023-02
2023-02-28,48942184,145636906,-96694722,나이지리아,2023-02
2023-02-28,47528463,49548832,-2020369,루마니아,2023-02
2023-02-28,47502538,3093569,44408969,리비아,2023-02
2023-02-28,46368873,86199687,-39830814,덴마크,2023-02
2023-02-28,42498465,46920041,-4421576,캄보디아,2023-02
2023-02-28,41589414,767964536,-726375122,오만,2023-02
2023-02-28,40682783,32976131,7706652,푸에르토리코,2023-02
2023-02-28,39377629,766683857,-727306228,쿠웨이트,2023-02
2023-02-28,36417464,7830629,28586835,도미니카 공화국,2023-02
2023-02-28,36271331,7979531,28291800,리투아니아,2023-02
2023-02-28,35947994,54731941,-18783947,미얀마,2023-02
2023-02-28,35497943,230980962,-195483019,알제리,2023-02
2023-02-28,34844085,5791743,29052342,몽골,2023-02
2023-02-28,33881290,5352523,28528767,에쿠아도르,2023-02
2023-02-28,32377838,25307239,7070599,모로코,2023-02
2023-02-28,26913959,140212998,-113299039,아르헨티나,2023-02
2023-02-28,24840289,12211661,12628628,과테말라,2023-02
2023-02-28,23620993,75763901,-52142908,핀란드,2023-02
2023-02-28,21963509,20770020,1193489,우크라이나,2023-02
2023-02-28,20244435,412231,19832204,조지아,2023-02
2023-02-28,19720154,28479242,-8759088,바레인,2023-02
2023-02-28,18638508,11344175,7294333,세르비아,2023-02
2023-02-28,18352033,632995,17719038,코트디봐르,2023-02
2023-02-28,17994230,462622,17531608,아제르바이잔,2023-02
2023-02-28,16874328,10339387,6534941,크로아티아,2023-02
2023-02-28,16164335,19933263,-3768928,불가리아,2023-02
2023-02-28,16022810,12070523,3952287,코스타리카,2023-02
2023-02-28,15651685,117320,15534365,이란,2023-02
2023-02-28,15311456,108423029,-93111573,튀니지,2023-02
2023-02-28,13776878,10261134,3515744,스리랑카,2023-02
2023-02-28,12664899,17810673,-5145774,온두라스,2023-02
2023-02-28,12511367,4541282,7970085,엘살바도르,2023-02
2023-02-28,11985068,35268424,-23283356,콩고민주공화국,2023-02
2023-02-28,11775875,31718145,-19942270,탄자니아,2023-02
2023-02-28,11260138,3825432,7434706,가나,2023-02
2023-02-28,10135470,5146,10130324,타지크,2023-02
2023-02-28,10001765,29847121,-19845356,우루과이,2023-02
2023-02-28,9944139,2885714,7058425,레바논,2023-02
2023-02-28,9235945,6331130,2904815,예맨,2023-02
2023-02-28,9213348,3323164,5890184,파라과이,2023-02
2023-02-28,8302697,3719874,4582823,세네갈,2023-02
2023-02-28,8294539,7921713,372826,라오스,2023-02
2023-02-28,8066516,613060,7453456,수단,2023-02
2023-02-28,7814727,717116,7097611,알바니아,2023-02
2023-02-28,7342531,507,7342024,마이크로네시아,2023-02
2023-02-28,6736586,548771864,-542035278,기타국,2023-02
2023-02-28,6561066,1295114,5265952,니카라과,2023-02
2023-02-28,5965738,0,5965738,팔레스타인 해방기구,2023-02
2023-02-28,5913455,6412884,-499429,에티오피아,2023-02
2023-02-28,5760765,815,5759950,앙골라,2023-02
2023-02-28,5526022,237900,5288122,벨라루스,2023-02
2023-02-28,5457186,9743416,-4286230,모잠비크,2023-02
2023-02-28,5342156,8574283,-3232127,에스토니아,2023-02
2023-02-28,5327858,3266437,2061421,몰도바,2023-02
2023-02-28,5244104,508788,4735316,아메리칸 사모아,2023-02
2023-02-28,5169938,905350,4264588,사이프러스,2023-02
2023-02-28,5155644,5115,5150529,불령 리유니온 코모도 제도,2023-02
2023-02-28,5020240,1823185,3197055,아이슬란드,2023-02
2023-02-28,4716236,34949574,-30233338,트리니다드 토바고,2023-02
2023-02-28,4703345,9112665,-4409320,라트비아,2023-02
2023-02-28,4625221,26600,4598621,사모아,2023-02
2023-02-28,4233008,167508707,-163275699,파푸아 뉴기니,2023-02
2023-02-28,4193508,68927549,-64734041,브루나이,2023-02
2023-02-28,4090750,268647,3822103,아이티,2023-02
2023-02-28,3684300,25158,3659142,피지,2023-02
2023-02-28,3682065,2146163,1535902,아르메니아,2023-02
2023-02-28,3677152,67101,3610051,자마이카,2023-02
2023-02-28,3528802,1035286,2493516,모리셔스,2023-02
2023-02-28,3206743,4325015,-1118272,룩셈부르그,2023-02
2023-02-28,3071086,0,3071086,부르키나 파소,2023-02
2023-02-28,2853397,79,2853318,베닝,2023-02
2023-02-28,2766419,7678298,-4911879,나미비아,2023-02
2023-02-28,2685909,368157,2317752,베네주엘라,2023-02
2023-02-28,2668150,21894064,-19225914,마다카스카르,2023-02
2023-02-28,2557333,56245,2501088,불령 폴리네시아,2023-02
2023-02-28,2387915,131,2387784,마티니크,2023-02
2023-02-28,2374988,0,2374988,아루바,2023-02
2023-02-28,2248876,6246092,-3997216,짐바브웨,2023-02
2023-02-28,2213902,11745415,-9531513,볼리비아,2023-02
2023-02-28,2183005,32380471,-30197466,뉴 칼레도니아,2023-02
2023-02-28,2115987,294818,1821169,네팔,2023-02
2023-02-28,1997799,47,1997752,지부티,2023-02
2023-02-28,1884834,168184,1716650,세이쉘,2023-02
2023-02-28,1874231,610205,1264026,콩고,2023-02
2023-02-28,1717959,114516,1603443,카메룬,2023-02
2023-02-28,1670556,34279,1636277,르완다,2023-02
2023-02-28,1631320,4144,1627176,가이아나,2023-02
2023-02-28,1585468,1403859,181609,리히텐슈타인,2023-02
2023-02-28,1577867,6686490,-5108623,기니,2023-02
2023-02-28,1538803,219,1538584,과델로프,2023-02
2023-02-28,1512408,0,1512408,큐라소,2023-02
2023-02-28,1487096,132778,1354318,마카오,2023-02
2023-02-28,1413572,26644,1386928,잠비아,2023-02
2023-02-28,1357729,1594,1356135,버뮤다,2023-02
2023-02-28,1331423,2663578,-1332155,우간다,2023-02
2023-02-28,1300810,114594,1186216,북마리아나 군도,2023-02
2023-02-28,1299676,0,1299676,키리바티,2023-02
2023-02-28,1271613,665456,606157,마세도니아,2023-02
2023-02-28,1200179,480425,719754,벨리제,2023-02
2023-02-28,1032821,91609,941212,아프카니스탄,2023-02
2023-02-28,1020270,0,1020270,소말리아,2023-02
2023-02-28,990048,4379389,-3389341,보스니아-헤르체고비나,2023-02
2023-02-28,959889,251,959638,몰디브,2023-02
2023-02-28,900275,3725,896550,말리,2023-02
2023-02-28,883565,718234,165331,바누아투,2023-02
2023-02-28,877228,0,877228,세인트 마틴,2023-02
2023-02-28,828653,1778,826875,시리아,2023-02
2023-02-28,804419,711853,92566,시에라 리온,2023-02
2023-02-28,573071,0,573071,투르크멘,2023-02
2023-02-28,559877,440,559437,영령 캐이맨 군도,2023-02
2023-02-28,549585,0,549585,세인트 루시아,2023-02
2023-02-28,522133,47011,475122,바하마,2023-02
2023-02-28,494015,2155147,-1661132,모리타니,2023-02
2023-02-28,475951,25839,450112,바베이도스,2023-02
2023-02-28,466291,126976,339315,안티가 바부다,2023-02
2023-02-28,453689,795096,-341407,수리남,2023-02
2023-02-28,453071,2014347,-1561276,가봉,2023-02
2023-02-28,418887,0,418887,부탄,2023-02
2023-02-28,397622,0,397622,불령 가이아나,2023-02
2023-02-28,375833,44668,331165,니제르,2023-02
2023-02-28,365190,2444071,-2078881,솔로몬 군도,2023-02
2023-02-28,299081,0,299081,영령 버진군도,2023-02
2023-02-28,234742,457,234285,지브랄타,2023-02
2023-02-28,219257,21174555,-20955298,몬테네그로,2023-02
2023-02-28,207041,13,207028,남수단,2023-02
2023-02-28,197343,771191,-573848,감비아,2023-02
2023-02-28,174400,0,174400,세인트 빈센트 그레나딘,2023-02
2023-02-28,173489,379,173110,세인트 키츠 네비스,2023-02
2023-02-28,155817,47997,107820,팔라우,2023-02
2023-02-28,143861,12719,131142,보츠와나,2023-02
2023-02-28,142643,200,142443,도미니카,2023-02
2023-02-28,139836,4562437,-4422601,말라위,2023-02
2023-02-28,115095,64524,50571,스와질랜드,2023-02
2023-02-28,99882,568344,-468462,쿠바,2023-02
2023-02-28,86820,0,86820,카보 베르데,2023-02
2023-02-28,79104,54839,24265,부룬디,2023-02
2023-02-28,76908,3244,73664,투발루,2023-02
2023-02-28,62675,0,62675,그레나다,2023-02
2023-02-28,58002,0,58002,투르크 & 카이코스 군도,2023-02
2023-02-28,56763,0,56763,챠드,2023-02
2023-02-28,51326,0,51326,티모르,2023-02
2023-02-28,50347,0,50347,앙귈라,2023-02
2023-02-28,43196,265216,-222020,산마리노,2023-02
2023-02-28,40058,166830705,-166790647,적도 기니,2023-02
2023-02-28,37009,0,37009,나우루,2023-02
2023-02-28,30021,0,30021,에리트리아,2023-02
2023-02-28,23481,17945,5536,네덜란드 열도,2023-02
2023-02-28,20381,17193,3188,통가,2023-02
2023-02-28,19535,521,19014,포클랜드 군도,2023-02
2023-02-28,9782,0,9782,안타티카,2023-02
2023-02-28,7645,8550,-905,메요트,2023-02
2023-02-28,7428,2420,5008,안도라,2023-02
2023-02-28,6088,167,5921,미령 버진군도,2023-02
2023-02-28,5402,0,5402,세인트 바르탤르미,2023-02
2023-02-28,4027,0,4027,중앙아프리카공화국,2023-02
2023-02-28,2538,0,2538,세인트마틴(생마르탱),2023-02
2023-02-28,2423,0,2423,건지,2023-02
2023-02-28,1827,56,1771,그린랜드,2023-02
2023-02-28,1675,0,1675,보네르 신트외스타티위스,2023-02
2023-02-28,78,159704,-159626,모나코,2023-02
2023-02-28,0,182,-182,알랜드 군도,2023-02
2023-02-28,0,4111,-4111,코스 군도,2023-02
2023-02-28,0,1457,-1457,크리스마스 아일랜드,2023-02
2023-02-28,0,2869,-2869,몬트세라트,2023-02
2023-02-28,0,12012,-12012,세인트 헬레나,2023-02
2023-02-28,0,1294,-1294,코모로스,2023-02
2023-02-28,0,6734,-6734,저어지,2023-02
2023-02-28,0,1194645,-1194645,마이너 아우틀링 합중국 군도,2023-02
2023-02-28,0,354885,-354885,기네비소,2023-02
2023-02-28,0,182773,-182773,허드 앤 맥도날드 군도,2023-02
2023-02-28,0,3582,-3582,레소토,2023-02
2023-02-28,0,19701,-19701,니우에,2023-02
2023-02-28,0,2619,-2619,토켈라우,2023-02
2023-02-28,0,322208,-322208,파로에 군도,2023-02
2023-02-28,0,295,-295,남조지아 & 남샌드위치 군도,2023-02
2023-02-28,0,7,-7,피트카이른,2023-02
2023-02-28,0,1573,-1573,불령 남부지역,2023-02
2023-03-31,10478065040,13189604934,-2711539894,중국,2023-03
2023-03-31,9775067552,6675930868,3099136684,미국,2023-03
2023-03-31,4629033970,2327728473,2301305497,베트남,2023-03
2023-03-31,2411769873,4478961369,-2067191496,일본,2023-03
2023-03-31,2204145780,179947449,2024198331,홍콩,2023-03
2023-03-31,1663556830,830378595,833178235,싱가포르,2023-03
2023-03-31,1657083183,2450546396,-793463213,대만,2023-03
2023-03-31,1575912971,615275606,960637365,인도,2023-03
2023-03-31,1385115362,2770418612,-1385303250,호주,2023-03
2023-03-31,1086239282,647156876,439082406,멕시코,2023-03
2023-03-31,918459040,1100657732,-182198692,인도네시아,2023-03
2023-03-31,902576870,139841908,762734962,튀르키예,2023-03
2023-03-31,895024433,1962421686,-1067397253,독일,2023-03
2023-03-31,822295505,105651595,716643910,폴란드,2023-03
2023-03-31,790070777,413623717,376447060,필리핀,2023-03
2023-03-31,758261418,1373198252,-614936834,말레이시아,2023-03
2023-03-31,755376947,696619830,58757117,캐나다,2023-03
2023-03-31,716378002,722129359,-5751357,태국,2023-03
2023-03-31,678126741,73712962,604413779,헝가리,2023-03
2023-03-31,677196658,915576942,-238380284,러시아 연방,2023-03
2023-03-31,625620853,3016324637,-2390703784,사우디아라비아,2023-03
2023-03-31,574957631,442290741,132666890,영국,2023-03
2023-03-31,567926997,741785284,-173858287,네덜란드,2023-03
2023-03-31,532016815,667660084,-135643269,프랑스,2023-03
2023-03-31,491031590,190615659,300415931,벨기에,2023-03
2023-03-31,486866987,139357,486727630,마샬군도,2023-03
2023-03-31,465068207,695870618,-230802411,이탈리아,2023-03
2023-03-31,430259854,660549367,-230289513,브라질,2023-03
2023-03-31,413685763,1413473217,-999787454,아랍에미리트 연합,2023-03
2023-03-31,323483134,213434877,110048257,스페인,2023-03
2023-03-31,278670274,102622334,176047940,슬로바키아,2023-03
2023-03-31,268627944,95955390,172672554,체코공화국,2023-03
2023-03-31,252724721,72399093,180325628,방글라데시,2023-03
2023-03-31,231937402,22581337,209356065,우즈베키스탄,2023-03
2023-03-31,226844921,200877828,25967093,이스라엘,2023-03
2023-03-31,221750989,132017720,89733269,뉴질랜드,2023-03
2023-03-31,195465824,2255799,193210025,토고,2023-03
2023-03-31,164117760,485943812,-321826052,카자흐스탄,2023-03
2023-03-31,149278515,11727418,137551097,슬로베니아,2023-03
2023-03-31,144220560,1024571,143195989,라이베리아,2023-03
2023-03-31,142544495,266783272,-124238777,스웨덴,2023-03
2023-03-31,119328443,6605676,112722767,에쿠아도르,2023-03
2023-03-31,111997202,8344837,103652365,이집트,2023-03
2023-03-31,105208849,850235828,-745026979,칠레,2023-03
2023-03-31,101728232,165660335,-63932103,오스트리아,2023-03
2023-03-31,100192247,301250755,-201058508,스위스,2023-03
2023-03-31,97275902,336372673,-239096771,페루,2023-03
2023-03-31,86562024,46753734,39808290,포루투갈,2023-03
2023-03-31,83421842,84148,83337694,키르기스스탄,2023-03
2023-03-31,81334926,398688075,-317353149,남아프리카공화국,2023-03
2023-03-31,79547099,54053085,25494014,콜롬비아,2023-03
2023-03-31,74755162,677713897,-602958735,이라크,2023-03
2023-03-31,73550487,4890220,68660267,요르단,2023-03
2023-03-31,71718750,1566,71717184,바하마,2023-03
2023-03-31,62641371,142848820,-80207449,아르헨티나,2023-03
2023-03-31,60393058,215456004,-155062946,나이지리아,2023-03
2023-03-31,58953713,32354594,26599119,푸에르토리코,2023-03
2023-03-31,58684430,129172592,-70488162,노르웨이,2023-03
2023-03-31,57271858,19383708,37888150,모로코,2023-03
2023-03-31,55560069,57623241,-2063172,파키스탄,2023-03
2023-03-31,51867573,108878626,-57011053,아일랜드,2023-03
2023-03-31,50782728,40086648,10696080,캄보디아,2023-03
2023-03-31,49894375,1695337053,-1645442678,카타르,2023-03
2023-03-31,48571391,2438139,46133252,리비아,2023-03
2023-03-31,44712267,63309271,-18597004,그리스,2023-03
2023-03-31,44468331,60628888,-16160557,루마니아,2023-03
2023-03-31,39072828,9734856,29337972,몽골,2023-03
2023-03-31,38540305,505032581,-466492276,오만,2023-03
2023-03-31,37859633,7067856,30791777,도미니카 공화국,2023-03
2023-03-31,36574956,850793422,-814218466,쿠웨이트,2023-03
2023-03-31,36005706,93155182,-57149476,덴마크,2023-03
2023-03-31,34383648,7368785,27014863,리투아니아,2023-03
2023-03-31,34224182,56995216,-22771034,미얀마,2023-03
2023-03-31,33154897,31608231,1546666,파나마,2023-03
2023-03-31,31847924,86444254,-54596330,핀란드,2023-03
2023-03-31,31709483,13292316,18417167,코스타리카,2023-03
2023-03-31,30389005,25478201,4910804,우크라이나,2023-03
2023-03-31,30197256,426131,29771125,피지,2023-03
2023-03-31,28410503,22741536,5668967,과테말라,2023-03
2023-03-31,24309553,659335,23650218,아제르바이잔,2023-03
2023-03-31,24258586,1309043,22949543,탄자니아,2023-03
2023-03-31,22032227,33120210,-11087983,몰타,2023-03
2023-03-31,21478269,9139574,12338695,세르비아,2023-03
2023-03-31,18130110,2612295,15517815,온두라스,2023-03
2023-03-31,17878381,529483,17348898,코트디봐르,2023-03
2023-03-31,17737007,2957168,14779839,케냐,2023-03
2023-03-31,17682495,625180,17057315,조지아,2023-03
2023-03-31,17569822,4842250,12727572,가나,2023-03
2023-03-31,16665916,15733539,932377,불가리아,2023-03
2023-03-31,15839320,14336282,1503038,엘살바도르,2023-03
2023-03-31,15452073,61931952,-46479879,바레인,2023-03
2023-03-31,15323945,260225236,-244901291,알제리,2023-03
2023-03-31,14814975,1842186,12972789,크로아티아,2023-03
2023-03-31,14360700,351283,14009417,괌,2023-03
2023-03-31,14149865,3537,14146328,타지크,2023-03
2023-03-31,13938628,12216773,1721855,스리랑카,2023-03
2023-03-31,12891184,14070265,-1179081,파라과이,2023-03
2023-03-31,12025954,6352590,5673364,우루과이,2023-03
2023-03-31,11394924,601,11394323,앙골라,2023-03
2023-03-31,10861918,1272180,9589738,수단,2023-03
2023-03-31,9964522,49869516,-39904994,튀니지,2023-03
2023-03-31,9343149,107997726,-98654577,기타국,2023-03
2023-03-31,8827846,4406906,4420940,세네갈,2023-03
2023-03-31,8672709,3637662,5035047,레바논,2023-03
2023-03-31,8647281,11784357,-3137076,라오스,2023-03
2023-03-31,8505685,2642057,5863628,아이슬란드,2023-03
2023-03-31,8504206,878192,7626014,알바니아,2023-03
2023-03-31,8429779,232074,8197705,쿠바,2023-03
2023-03-31,8151123,71634323,-63483200,모잠비크,2023-03
2023-03-31,7898043,30786616,-22888573,니카라과,2023-03
2023-03-31,7417743,155389,7262354,말라위,2023-03
2023-03-31,7255533,7348757,-93224,에스토니아,2023-03
2023-03-31,7083066,307642,6775424,벨라루스,2023-03
2023-03-31,6768003,474361,6293642,이란,2023-03
2023-03-31,6315469,1230620,5084849,사이프러스,2023-03
2023-03-31,5980129,219828885,-213848756,파푸아 뉴기니,2023-03
2023-03-31,5728967,71552,5657415,팔레스타인 해방기구,2023-03
2023-03-31,5550880,5118532,432348,에티오피아,2023-03
2023-03-31,5546654,0,5546654,불령 리유니온 코모도 제도,2023-03
2023-03-31,5476696,39307,5437389,불령 폴리네시아,2023-03
2023-03-31,5365395,28293,5337102,자마이카,2023-03
2023-03-31,5085048,1164672,3920376,부르키나 파소,2023-03
2023-03-31,5011704,16608,4995096,사모아,2023-03
2023-03-31,4927947,75075086,-70147139,콩고민주공화국,2023-03
2023-03-31,4783328,8045268,-3261940,라트비아,2023-03
2023-03-31,4585694,28458118,-23872424,트리니다드 토바고,2023-03
2023-03-31,4461284,2776244,1685040,브루나이,2023-03
2023-03-31,4450133,633145,3816988,모리셔스,2023-03
2023-03-31,4442106,8573270,-4131164,룩셈부르그,2023-03
2023-03-31,4352641,5139509,-786868,예맨,2023-03
2023-03-31,3947847,0,3947847,마티니크,2023-03
2023-03-31,3924642,168,3924474,지부티,2023-03
2023-03-31,3893141,34789897,-30896756,마다카스카르,2023-03
2023-03-31,3892242,4174800,-282558,몰도바,2023-03
2023-03-31,3838341,57318373,-53480032,볼리비아,2023-03
2023-03-31,3837687,202174,3635513,아이티,2023-03
2023-03-31,3704683,9584619,-5879936,아르메니아,2023-03
2023-03-31,3077468,0,3077468,과델로프,2023-03
2023-03-31,2969135,0,2969135,큐라소,2023-03
2023-03-31,2803161,6268,2796893,가이아나,2023-03
2023-03-31,2664658,150078,2514580,카메룬,2023-03
2023-03-31,2636392,2618238,18154,마세도니아,2023-03
2023-03-31,2495794,436221,2059573,네팔,2023-03
2023-03-31,2414437,453960,1960477,우간다,2023-03
2023-03-31,2359061,60206846,-57847785,뉴 칼레도니아,2023-03
2023-03-31,2165954,99157,2066797,마카오,2023-03
2023-03-31,2142659,0,2142659,아루바,2023-03
2023-03-31,2132541,145492,1987049,베네주엘라,2023-03
2023-03-31,2107705,143176,1964529,아메리칸 사모아,2023-03
2023-03-31,1807993,4245855,-2437862,기니,2023-03
2023-03-31,1785428,11,1785417,베닝,2023-03
2023-03-31,1649958,861,1649097,시리아,2023-03
2023-03-31,1526812,18903,1507909,아프카니스탄,2023-03
2023-03-31,1507574,0,1507574,불령 가이아나,2023-03
2023-03-31,1500809,3168035,-1667226,짐바브웨,2023-03
2023-03-31,1482928,333190,1149738,소말리아,2023-03
2023-03-31,1469058,1829633,-360575,리히텐슈타인,2023-03
2023-03-31,1348539,606516,742023,콩고,2023-03
2023-03-31,1277777,22295,1255482,바베이도스,2023-03
2023-03-31,1269394,17030985,-15761591,몬테네그로,2023-03
2023-03-31,1193413,370237,823176,안티가 바부다,2023-03
2023-03-31,1103722,32520,1071202,네덜란드 열도,2023-03
2023-03-31,1077485,3863705,-2786220,보스니아-헤르체고비나,2023-03
2023-03-31,1057143,47505,1009638,르완다,2023-03
2023-03-31,1019007,0,1019007,메요트,2023-03
2023-03-31,996532,0,996532,벨리제,2023-03
2023-03-31,985138,82201,902937,북마리아나 군도,2023-03
2023-03-31,979430,665,978765,버뮤다,2023-03
2023-03-31,856831,2894,853937,말리,2023-03
2023-03-31,847518,5518861,-4671343,모리타니,2023-03
2023-03-31,834112,171231,662881,세이쉘,2023-03
2023-03-31,769125,0,769125,세인트 마틴,2023-03
2023-03-31,763149,0,763149,솔로몬 군도,2023-03
2023-03-31,748484,3196760,-2448276,잠비아,2023-03
2023-03-31,736978,77125534,-76388556,가봉,2023-03
2023-03-31,681933,16442,665491,키리바티,2023-03
2023-03-31,681905,387,681518,투르크멘,2023-03
2023-03-31,656029,802225,-146196,수리남,2023-03
2023-03-31,481130,2713,478417,몰디브,2023-03
2023-03-31,474752,2357,472395,니제르,2023-03
2023-03-31,446533,1130786,-684253,바누아투,2023-03
2023-03-31,432929,5456,427473,그레나다,2023-03
2023-03-31,404749,11744725,-11339976,에리트리아,2023-03
2023-03-31,395377,721,394656,부탄,2023-03
2023-03-31,374480,3254,371226,영령 버진군도,2023-03
2023-03-31,374095,258797,115298,나미비아,2023-03
2023-03-31,360935,1605031,-1244096,시에라 리온,2023-03
2023-03-31,351274,2849,348425,투발루,2023-03
2023-03-31,299430,30832,268598,세인트 루시아,2023-03
2023-03-31,270304,0,270304,영령 캐이맨 군도,2023-03
2023-03-31,259294,74105,185189,마이크로네시아,2023-03
2023-03-31,227920,0,227920,카보 베르데,2023-03
2023-03-31,220698,0,220698,투르크 & 카이코스 군도,2023-03
2023-03-31,195785,382775,-186990,감비아,2023-03
2023-03-31,169700,37504,132196,보츠와나,2023-03
2023-03-31,159741,544,159197,세인트 키츠 네비스,2023-03
2023-03-31,121277,17619,103658,팔라우,2023-03
2023-03-31,113999,4545735,-4431736,나우루,2023-03
2023-03-31,99331,0,99331,지브랄타,2023-03
2023-03-31,93775,47891,45884,스와질랜드,2023-03
2023-03-31,88105,0,88105,챠드,2023-03
2023-03-31,72959,35137,37822,도미니카,2023-03
2023-03-31,67884,8801,59083,부룬디,2023-03
2023-03-31,67581,6400,61181,미령 버진군도,2023-03
2023-03-31,38612,343,38269,코모로스,2023-03
2023-03-31,38452,0,38452,중앙아프리카공화국,2023-03
2023-03-31,29665,326077,-296412,모나코,2023-03
2023-03-31,24901,0,24901,남수단,2023-03
2023-03-31,23204,32416,-9212,티모르,2023-03
2023-03-31,19700,0,19700,통가,2023-03
2023-03-31,15500,130447,-114947,산마리노,2023-03
2023-03-31,14007,0,14007,왈라스 & 퓨투나 군도,2023-03
2023-03-31,9698,344,9354,세인트 헬레나,2023-03
2023-03-31,9510,0,9510,영령 인도양,2023-03
2023-03-31,8780,0,8780,적도 기니,2023-03
2023-03-31,7827,543,7284,세인트 빈센트 그레나딘,2023-03
2023-03-31,4292,0,4292,상토메 프린스페,2023-03
2023-03-31,4163,962,3201,그린랜드,2023-03
2023-03-31,3222,0,3222,세인트 바르탤르미,2023-03
2023-03-31,2146,25,2121,쿡 아일랜드,2023-03
2023-03-31,1852,0,1852,보네르 신트외스타티위스,2023-03
2023-03-31,1668,2413,-745,안도라,2023-03
2023-03-31,1277,315,962,코스 군도,2023-03
2023-03-31,781,0,781,세인트마틴(생마르탱),2023-03
2023-03-31,257,373,-116,건지,2023-03
2023-03-31,91,0,91,교황청,2023-03
2023-03-31,35,3085,-3050,저어지,2023-03
2023-03-31,0,283,-283,남조지아 & 남샌드위치 군도,2023-03
2023-03-31,0,4546,-4546,레소토,2023-03
2023-03-31,0,3778,-3778,니우에,2023-03
2023-03-31,0,98,-98,안타티카,2023-03
2023-03-31,0,133493,-133493,기네비소,2023-03
2023-03-31,0,413,-413,불령 남부지역,2023-03
2023-03-31,0,812,-812,앙귈라,2023-03
2023-03-31,0,1395,-1395,토켈라우,2023-03
2023-03-31,0,4924,-4924,몬트세라트,2023-03
2023-03-31,0,28,-28,마이너 아우틀링 합중국 군도,2023-03
2023-04-30,9522776682,11794075744,-2271299062,중국,2023-04
2023-04-30,9181046987,5510740294,3670306693,미국,2023-04
2023-04-30,3798916347,1891768284,1907148063,베트남,2023-04
2023-04-30,2066010633,4032396436,-1966385803,일본,2023-04
2023-04-30,1545393780,1136358127,409035653,싱가포르,2023-04
2023-04-30,1490712531,1895947328,-405234797,대만,2023-04
2023-04-30,1469549072,238333622,1231215450,홍콩,2023-04
2023-04-30,1330360499,518938158,811422341,인도,2023-04
2023-04-30,1264421636,2512287428,-1247865792,호주,2023-04
2023-04-30,914414688,670450585,243964103,멕시코,2023-04
2023-04-30,898219850,1932092568,-1033872718,독일,2023-04
2023-04-30,791112025,335070929,456041096,필리핀,2023-04
2023-04-30,778111542,871189439,-93077897,인도네시아,2023-04
2023-04-30,773507167,82690205,690816962,폴란드,2023-04
2023-04-30,745629121,816894991,-71265870,러시아 연방,2023-04
2023-04-30,738355743,150653737,587702006,튀르키예,2023-04
2023-04-30,669371540,458248554,211122986,캐나다,2023-04
2023-04-30,649433866,1027783836,-378349970,말레이시아,2023-04
2023-04-30,601321677,64262208,537059469,헝가리,2023-04
2023-04-30,594093762,589867058,4226704,태국,2023-04
2023-04-30,584712123,96897933,487814190,벨기에,2023-04
2023-04-30,575572680,717579245,-142006565,프랑스,2023-04
2023-04-30,567593639,960546434,-392952795,네덜란드,2023-04
2023-04-30,547082590,358360798,188721792,영국,2023-04
2023-04-30,509370934,666456694,-157085760,이탈리아,2023-04
2023-04-30,480652554,4579,480647975,마샬군도,2023-04
2023-04-30,410842521,2870403247,-2459560726,사우디아라비아,2023-04
2023-04-30,379242604,1017650953,-638408349,아랍에미리트 연합,2023-04
2023-04-30,344039762,437376843,-93337081,브라질,2023-04
2023-04-30,314320632,611175,313709457,라이베리아,2023-04
2023-04-30,292126952,211135729,80991223,스페인,2023-04
2023-04-30,244358622,112254561,132104061,체코공화국,2023-04
2023-04-30,230654228,90729434,139924794,슬로바키아,2023-04
2023-04-30,194101400,153242957,40858443,이스라엘,2023-04
2023-04-30,193828756,1534351,192294405,우즈베키스탄,2023-04
2023-04-30,187754610,42962058,144792552,방글라데시,2023-04
2023-04-30,187630028,415901239,-228271211,카자흐스탄,2023-04
2023-04-30,161327024,5920635,155406389,이집트,2023-04
2023-04-30,158975458,171253043,-12277585,뉴질랜드,2023-04
2023-04-30,141724828,13333639,128391189,토고,2023-04
2023-04-30,140946592,135943115,5003477,스웨덴,2023-04
2023-04-30,117695101,8408041,109287060,슬로베니아,2023-04
2023-04-30,114631765,231137657,-116505892,오스트리아,2023-04
2023-04-30,111956899,484389511,-372432612,이라크,2023-04
2023-04-30,93721582,861648735,-767927153,칠레,2023-04
2023-04-30,86322404,35636611,50685793,포루투갈,2023-04
2023-04-30,85443916,15542698,69901218,파키스탄,2023-04
2023-04-30,81210730,152,81210578,앙골라,2023-04
2023-04-30,79990543,404881,79585662,키르기스스탄,2023-04
2023-04-30,78511299,86885189,-8373890,콜롬비아,2023-04
2023-04-30,78438365,263127718,-184689353,스위스,2023-04
2023-04-30,74312021,349321290,-275009269,남아프리카공화국,2023-04
2023-04-30,73276709,1354847872,-1281571163,카타르,2023-04
2023-04-30,62554814,2131161,60423653,리비아,2023-04
2023-04-30,61466778,74117294,-12650516,덴마크,2023-04
2023-04-30,58467713,110084638,-51616925,아일랜드,2023-04
2023-04-30,56085401,3722265,52363136,요르단,2023-04
2023-04-30,50607107,5529220,45077887,나이지리아,2023-04
2023-04-30,49709621,38769643,10939978,캄보디아,2023-04
2023-04-30,49253626,61259818,-12006192,푸에르토리코,2023-04
2023-04-30,47753802,201237093,-153483291,페루,2023-04
2023-04-30,46123018,67683155,-21560137,그리스,2023-04
2023-04-30,43654502,304736767,-261082265,오만,2023-04
2023-04-30,43036664,57520406,-14483742,루마니아,2023-04
2023-04-30,41577887,96235932,-54658045,아르헨티나,2023-04
2023-04-30,40412886,1872921,38539965,몽골,2023-04
2023-04-30,38330235,7181115,31149120,리투아니아,2023-04
2023-04-30,37485620,16624367,20861253,모로코,2023-04
2023-04-30,36692817,6548872,30143945,에쿠아도르,2023-04
2023-04-30,35155237,711844495,-676689258,쿠웨이트,2023-04
2023-04-30,34777120,59219602,-24442482,우크라이나,2023-04
2023-04-30,32425772,17936503,14489269,세르비아,2023-04
2023-04-30,32156001,366028,31789973,괌,2023-04
2023-04-30,31126803,71504075,-40377272,핀란드,2023-04
2023-04-30,27936407,14230946,13705461,코스타리카,2023-04
2023-04-30,27871539,17928002,9943537,과테말라,2023-04
2023-04-30,27281955,42888546,-15606591,미얀마,2023-04
2023-04-30,25416558,16226214,9190344,도미니카 공화국,2023-04
2023-04-30,24631479,25969451,-1337972,파나마,2023-04
2023-04-30,24360130,181871824,-157511694,노르웨이,2023-04
2023-04-30,23318255,229213766,-205895511,알제리,2023-04
2023-04-30,22783690,62857,22720833,코트디봐르,2023-04
2023-04-30,22170391,231920,21938471,피지,2023-04
2023-04-30,20569386,21208774,-639388,엘살바도르,2023-04
2023-04-30,20307351,61325,20246026,아제르바이잔,2023-04
2023-04-30,17365016,2377831,14987185,탄자니아,2023-04
2023-04-30,16787074,1483627,15303447,가나,2023-04
2023-04-30,16772276,14255043,2517233,불가리아,2023-04
2023-04-30,15953440,1108863,14844577,조지아,2023-04
2023-04-30,14838473,6209144,8629329,케냐,2023-04
2023-04-30,13851116,12668739,1182377,몰타,2023-04
2023-04-30,13111488,3110423,10001065,온두라스,2023-04
2023-04-30,13002552,265343,12737209,이란,2023-04
2023-04-30,12962180,7861209,5100971,스리랑카,2023-04
2023-04-30,11757263,7904581,3852682,우루과이,2023-04
2023-04-30,11509136,1324903,10184233,시에라 리온,2023-04
2023-04-30,11288192,48002827,-36714635,바레인,2023-04
2023-04-30,10993233,3256288,7736945,크로아티아,2023-04
2023-04-30,10740176,3458920,7281256,에티오피아,2023-04
2023-04-30,10593308,53007761,-42414453,튀니지,2023-04
2023-04-30,10158672,178318591,-168159919,기타국,2023-04
2023-04-30,10124948,2600252,7524696,예맨,2023-04
2023-04-30,9603991,5166092,4437899,에스토니아,2023-04
2023-04-30,9518232,2362684,7155548,알바니아,2023-04
2023-04-30,8614055,35613,8578442,타지크,2023-04
2023-04-30,8194339,120394,8073945,마이크로네시아,2023-04
2023-04-30,8112844,10622986,-2510142,라오스,2023-04
2023-04-30,7974476,899,7973577,불령 리유니온 코모도 제도,2023-04
2023-04-30,7885880,496669,7389211,팔레스타인 해방기구,2023-04
2023-04-30,7496467,215909,7280558,말리,2023-04
2023-04-30,7415519,148079,7267440,불령 폴리네시아,2023-04
2023-04-30,7147473,862456,6285017,아이슬란드,2023-04
2023-04-30,6848984,6476556,372428,파푸아 뉴기니,2023-04
2023-04-30,6845166,1408801,5436365,모리셔스,2023-04
2023-04-30,6672177,65203457,-58531280,콩고민주공화국,2023-04
2023-04-30,6550336,4602155,1948181,니카라과,2023-04
2023-04-30,6458276,24600279,-18142003,파라과이,2023-04
2023-04-30,6380428,2641808,3738620,레바논,2023-04
2023-04-30,6218463,22798416,-16579953,트리니다드 토바고,2023-04
2023-04-30,5750005,8923803,-3173798,라트비아,2023-04
2023-04-30,5696913,518755,5178158,벨라루스,2023-04
2023-04-30,5594045,3563081,2030964,세네갈,2023-04
2023-04-30,5471376,35923,5435453,자마이카,2023-04
2023-04-30,4788731,87097,4701634,수단,2023-04
2023-04-30,4701538,16214,4685324,사모아,2023-04
2023-04-30,4692344,39939,4652405,팔라우,2023-04
2023-04-30,4680845,3661375,1019470,몰도바,2023-04
2023-04-30,4313374,4,4313370,부르키나 파소,2023-04
2023-04-30,4262439,77156,4185283,아이티,2023-04
2023-04-30,4146748,5829370,-1682622,아르메니아,2023-04
2023-04-30,3960575,1423524,2537051,사이프러스,2023-04
2023-04-30,3851405,12729617,-8878212,마다카스카르,2023-04
2023-04-30,3779469,595214,3184255,쿠바,2023-04
2023-04-30,3655681,4850190,-1194509,룩셈부르그,2023-04
2023-04-30,3608921,50274619,-46665698,모잠비크,2023-04
2023-04-30,2936976,495279,2441697,베네주엘라,2023-04
2023-04-30,2568903,172182,2396721,카메룬,2023-04
2023-04-30,2521390,2271,2519119,베닝,2023-04
2023-04-30,2497710,0,2497710,지부티,2023-04
2023-04-30,2482648,13895290,-11412642,몬테네그로,2023-04
2023-04-30,2445368,104,2445264,시리아,2023-04
2023-04-30,2397964,106804,2291160,말라위,2023-04
2023-04-30,2387487,103954,2283533,브루나이,2023-04
2023-04-30,2270430,0,2270430,마티니크,2023-04
2023-04-30,2161143,176224,1984919,마카오,2023-04
2023-04-30,2101085,245165,1855920,우간다,2023-04
2023-04-30,2029991,321193,1708798,네팔,2023-04
2023-04-30,1773457,19704394,-17930937,볼리비아,2023-04
2023-04-30,1699292,4902285,-3202993,기니,2023-04
2023-04-30,1677579,644,1676935,가이아나,2023-04
2023-04-30,1625576,0,1625576,아루바,2023-04
2023-04-30,1426023,934750,491273,리히텐슈타인,2023-04
2023-04-30,1418116,60597,1357519,아프카니스탄,2023-04
2023-04-30,1322827,5640,1317187,몰디브,2023-04
2023-04-30,1321451,12370,1309081,르완다,2023-04
2023-04-30,1290408,1007233,283175,마세도니아,2023-04
2023-04-30,1282219,0,1282219,불령 가이아나,2023-04
2023-04-30,1277688,33572,1244116,세이쉘,2023-04
2023-04-30,1250651,330591,920060,콩고,2023-04
2023-04-30,1196436,0,1196436,과델로프,2023-04
2023-04-30,1193596,0,1193596,세인트 마틴,2023-04
2023-04-30,1119716,8764,1110952,바하마,2023-04
2023-04-30,991059,295437,695622,가봉,2023-04
2023-04-30,956369,93086,863283,북마리아나 군도,2023-04
2023-04-30,934963,2687392,-1752429,짐바브웨,2023-04
2023-04-30,851604,14411474,-13559870,잠비아,2023-04
2023-04-30,844957,210,844747,투르크멘,2023-04
2023-04-30,806619,34787,771832,스와질랜드,2023-04
2023-04-30,799352,0,799352,메요트,2023-04
2023-04-30,755002,0,755002,남수단,2023-04
2023-04-30,656420,29160586,-28504166,뉴 칼레도니아,2023-04
2023-04-30,653380,2252906,-1599526,보스니아-헤르체고비나,2023-04
2023-04-30,586467,317667,268800,소말리아,2023-04
2023-04-30,580649,4600,576049,안티가 바부다,2023-04
2023-04-30,472268,3974,468294,나우루,2023-04
2023-04-30,458839,42523,416316,세인트 루시아,2023-04
2023-04-30,432544,24453,408091,부탄,2023-04
2023-04-30,416627,637546,-220919,아메리칸 사모아,2023-04
2023-04-30,411281,268009,143272,바누아투,2023-04
2023-04-30,396786,2596712,-2199926,모리타니,2023-04
2023-04-30,379045,2221561,-1842516,솔로몬 군도,2023-04
2023-04-30,378426,456426,-78000,큐라소,2023-04
2023-04-30,373873,363592,10281,감비아,2023-04
2023-04-30,349747,34250,315497,네덜란드 열도,2023-04
2023-04-30,347700,968536,-620836,수리남,2023-04
2023-04-30,332582,81314657,-80982075,니제르,2023-04
2023-04-30,310100,0,310100,세인트마틴(생마르탱),2023-04
2023-04-30,306955,18287,288668,보츠와나,2023-04
2023-04-30,302718,24216,278502,바베이도스,2023-04
2023-04-30,283433,18850,264583,키리바티,2023-04
2023-04-30,250171,954,249217,벨리제,2023-04
2023-04-30,195430,0,195430,영령 캐이맨 군도,2023-04
2023-04-30,191876,11,191865,그레나다,2023-04
2023-04-30,191751,5792,185959,도미니카,2023-04
2023-04-30,167173,141745,25428,티모르,2023-04
2023-04-30,145585,0,145585,중앙아프리카공화국,2023-04
2023-04-30,144552,0,144552,버뮤다,2023-04
2023-04-30,138266,15,138251,카보 베르데,2023-04
2023-04-30,135174,1966,133208,세인트 키츠 네비스,2023-04
2023-04-30,134296,0,134296,지브랄타,2023-04
2023-04-30,105927,0,105927,상토메 프린스페,2023-04
2023-04-30,103100,123150,-20050,교황청,2023-04
2023-04-30,85230,7584,77646,레소토,2023-04
2023-04-30,75412,60,75352,부룬디,2023-04
2023-04-30,73779,0,73779,투발루,2023-04
2023-04-30,60419,71414,-10995,나미비아,2023-04
2023-04-30,45550,403995,-358445,산마리노,2023-04
2023-04-30,43349,0,43349,건지,2023-04
2023-04-30,41470,35859,5611,적도 기니,2023-04
2023-04-30,41181,0,41181,챠드,2023-04
2023-04-30,38460,13884,24576,통가,2023-04
2023-04-30,37796,0,37796,투르크 & 카이코스 군도,2023-04
2023-04-30,25334,0,25334,영령 버진군도,2023-04
2023-04-30,11963,130,11833,코모로스,2023-04
2023-04-30,11155,2047,9108,미령 버진군도,2023-04
2023-04-30,4604,180700,-176096,기네비소,2023-04
2023-04-30,3376,0,3376,세인트 바르탤르미,2023-04
2023-04-30,1193,144794,-143601,그린랜드,2023-04
2023-04-30,116,405,-289,저어지,2023-04
2023-04-30,109,21114,-21005,파로에 군도,2023-04
2023-04-30,17,3113,-3096,쿡 아일랜드,2023-04
2023-04-30,0,306302,-306302,모나코,2023-04
2023-04-30,0,2357,-2357,안도라,2023-04
2023-04-30,0,202,-202,몬트세라트,2023-04
2023-04-30,0,17,-17,에리트리아,2023-04
2023-04-30,0,3530,-3530,토켈라우,2023-04
2023-04-30,0,227,-227,남조지아 & 남샌드위치 군도,2023-04
2023-04-30,0,86,-86,피트카이른,2023-04
2023-04-30,0,11,-11,세인트 빈센트 그레나딘,2023-04
2023-04-30,0,21738,-21738,니우에,2023-04
2023-04-30,0,2746868,-2746868,안타티카,2023-04
2023-04-30,0,3749,-3749,코스 군도,2023-04
2023-04-30,0,770,-770,불령 남부지역,2023-04
2023-05-31,10579849482,12379598055,-1799748573,중국,2023-05
2023-05-31,9459648284,6017115831,3442532453,미국,2023-05
2023-05-31,4268866107,1922485526,2346380581,베트남,2023-05
2023-05-31,2565088740,3722639956,-1157551216,일본,2023-05
2023-05-31,1866607841,139213869,1727393972,홍콩,2023-05
2023-05-31,1604416805,2438869428,-834452623,호주,2023-05
2023-05-31,1597982154,2123176254,-525194100,대만,2023-05
2023-05-31,1347610005,562548768,785061237,인도,2023-05
2023-05-31,1167727742,853154015,314573727,싱가포르,2023-05
2023-05-31,1042118697,570414383,471704314,멕시코,2023-05
2023-05-31,815506565,2108696301,-1293189736,독일,2023-05
2023-05-31,793813112,142819203,650993909,튀르키예,2023-05
2023-05-31,768500789,376976793,391523996,필리핀,2023-05
2023-05-31,744438809,941480408,-197041599,인도네시아,2023-05
2023-05-31,710612570,115495317,595117253,폴란드,2023-05
2023-05-31,706205436,741438686,-35233250,캐나다,2023-05
2023-05-31,651712141,1388023730,-736311589,말레이시아,2023-05
2023-05-31,649845002,684943370,-35098368,태국,2023-05
2023-05-31,637894683,806343819,-168449136,러시아 연방,2023-05
2023-05-31,631576527,972282117,-340705590,네덜란드,2023-05
2023-05-31,581459813,476012473,105447340,영국,2023-05
2023-05-31,581270834,68251480,513019354,헝가리,2023-05
2023-05-31,577100345,179501724,397598621,벨기에,2023-05
2023-05-31,471013656,783169436,-312155780,이탈리아,2023-05
2023-05-31,401490095,2445652799,-2044162704,사우디아라비아,2023-05
2023-05-31,394711160,1289064226,-894353066,아랍에미리트 연합,2023-05
2023-05-31,387641947,687932946,-300290999,브라질,2023-05
2023-05-31,377024470,637588233,-260563763,프랑스,2023-05
2023-05-31,375328573,744052,374584521,라이베리아,2023-05
2023-05-31,352198998,234736574,117462424,스페인,2023-05
2023-05-31,313988329,2037,313986292,마샬군도,2023-05
2023-05-31,277499803,152146118,125353685,뉴질랜드,2023-05
2023-05-31,253351862,102868534,150483328,체코공화국,2023-05
2023-05-31,243750075,83821778,159928297,슬로바키아,2023-05
2023-05-31,199592530,2753875,196838655,우즈베키스탄,2023-05
2023-05-31,175012745,152662188,22350557,이스라엘,2023-05
2023-05-31,170273919,560706292,-390432373,카자흐스탄,2023-05
2023-05-31,147502352,137214282,10288070,스웨덴,2023-05
2023-05-31,120037505,11252442,108785063,슬로베니아,2023-05
2023-05-31,114523348,118489776,-3966428,아일랜드,2023-05
2023-05-31,109940846,40686566,69254280,방글라데시,2023-05
2023-05-31,109880492,284085865,-174205373,스위스,2023-05
2023-05-31,108670385,56333021,52337364,이집트,2023-05
2023-05-31,105034970,671330054,-566295084,칠레,2023-05
2023-05-31,101350294,100123,101250171,키르기스스탄,2023-05
2023-05-31,100080573,783336064,-683255491,이라크,2023-05
2023-05-31,92568260,165221459,-72653199,오스트리아,2023-05
2023-05-31,90680000,26,90679974,맨섬,2023-05
2023-05-31,87002783,17505314,69497469,파키스탄,2023-05
2023-05-31,78300476,47069509,31230967,포루투갈,2023-05
2023-05-31,77063173,218779953,-141716780,남아프리카공화국,2023-05
2023-05-31,70501270,611,70500659,지브랄타,2023-05
2023-05-31,67046529,1409974161,-1342927632,카타르,2023-05
2023-05-31,66166100,1336812,64829288,토고,2023-05
2023-05-31,65603317,7531710,58071607,요르단,2023-05
2023-05-31,61602300,34266148,27336152,캄보디아,2023-05
2023-05-31,60039415,78576719,-18537304,콜롬비아,2023-05
2023-05-31,56413955,96008683,-39594728,덴마크,2023-05
2023-05-31,55200058,298585614,-243385556,페루,2023-05
2023-05-31,53773530,2679341,51094189,리비아,2023-05
2023-05-31,52206851,8193559,44013292,나이지리아,2023-05
2023-05-31,48422234,4871038,43551196,몽골,2023-05
2023-05-31,48196393,75417449,-27221056,아르헨티나,2023-05
2023-05-31,47342309,43926203,3416106,푸에르토리코,2023-05
2023-05-31,46934269,230365779,-183431510,오만,2023-05
2023-05-31,46403222,109397804,-62994582,루마니아,2023-05
2023-05-31,43956471,43779910,176561,파나마,2023-05
2023-05-31,42798436,63314308,-20515872,그리스,2023-05
2023-05-31,38920556,9771388,29149168,리투아니아,2023-05
2023-05-31,34388508,156798724,-122410216,핀란드,2023-05
2023-05-31,33572573,16575459,16997114,모로코,2023-05
2023-05-31,31701255,7796673,23904582,에쿠아도르,2023-05
2023-05-31,30730122,18547812,12182310,미얀마,2023-05
2023-05-31,27934990,181088450,-153153460,알제리,2023-05
2023-05-31,27628208,16167490,11460718,과테말라,2023-05
2023-05-31,27481739,804547254,-777065515,쿠웨이트,2023-05
2023-05-31,23854180,112966026,-89111846,노르웨이,2023-05
2023-05-31,23748502,16128011,7620491,도미니카 공화국,2023-05
2023-05-31,23742063,0,23742063,아제르바이잔,2023-05
2023-05-31,23626681,1198520,22428161,조지아,2023-05
2023-05-31,23378660,12203045,11175615,코스타리카,2023-05
2023-05-31,22890046,548145,22341901,괌,2023-05
2023-05-31,22289932,76162617,-53872685,우크라이나,2023-05
2023-05-31,19249660,7617749,11631911,세르비아,2023-05
2023-05-31,18607765,21056602,-2448837,불가리아,2023-05
2023-05-31,18549251,1563164,16986087,탄자니아,2023-05
2023-05-31,16864702,2317529,14547173,엘살바도르,2023-05
2023-05-31,16396117,1034378,15361739,코트디봐르,2023-05
2023-05-31,15814839,5476108,10338731,케냐,2023-05
2023-05-31,14732838,15009290,-276452,튀니지,2023-05
2023-05-31,14638543,3294222,11344321,온두라스,2023-05
2023-05-31,13646298,22887462,-9241164,몰타,2023-05
2023-05-31,13587082,1170703,12416379,가나,2023-05
2023-05-31,12921964,198105,12723859,이란,2023-05
2023-05-31,12846768,1312039,11534729,알바니아,2023-05
2023-05-31,12112179,9306985,2805194,스리랑카,2023-05
2023-05-31,12062196,15619779,-3557583,우루과이,2023-05
2023-05-31,11230417,45444267,-34213850,바레인,2023-05
2023-05-31,11125547,2347,11123200,타지크,2023-05
2023-05-31,10021948,257676426,-247654478,기타국,2023-05
2023-05-31,9844001,3464461,6379540,세네갈,2023-05
2023-05-31,9697955,2310446,7387509,크로아티아,2023-05
2023-05-31,9311978,1004203,8307775,레바논,2023-05
2023-05-31,9284389,18307167,-9022778,파라과이,2023-05
2023-05-31,8739192,8119331,619861,라오스,2023-05
2023-05-31,8305945,6395752,1910193,에스토니아,2023-05
2023-05-31,8281156,34735283,-26454127,모잠비크,2023-05
2023-05-31,8038136,0,8038136,앙골라,2023-05
2023-05-31,7739166,47110871,-39371705,브루나이,2023-05
2023-05-31,7421444,1817270,5604174,니카라과,2023-05
2023-05-31,7226249,565,7225684,불령 리유니온 코모도 제도,2023-05
2023-05-31,7032210,52827962,-45795752,파푸아 뉴기니,2023-05
2023-05-31,6937159,204742,6732417,말리,2023-05
2023-05-31,6895790,8387281,-1491491,라트비아,2023-05
2023-05-31,6193048,440463,5752585,팔레스타인 해방기구,2023-05
2023-05-31,5596424,1271124,4325300,짐바브웨,2023-05
2023-05-31,4900453,1295608,3604845,부르키나 파소,2023-05
2023-05-31,4739499,230558,4508941,사이프러스,2023-05
2023-05-31,4739342,0,4739342,사모아,2023-05
2023-05-31,4659585,4424763,234822,몬테네그로,2023-05
2023-05-31,4532350,472582,4059768,모리셔스,2023-05
2023-05-31,4381739,3532631,849108,아이슬란드,2023-05
2023-05-31,4294218,75640593,-71346375,볼리비아,2023-05
2023-05-31,4051099,8645718,-4594619,에티오피아,2023-05
2023-05-31,3979576,1613505,2366071,쿠바,2023-05
2023-05-31,3941604,0,3941604,가이아나,2023-05
2023-05-31,3931029,1961138,1969891,예맨,2023-05
2023-05-31,3856415,10546329,-6689914,몰도바,2023-05
2023-05-31,3697199,12432457,-8735258,트리니다드 토바고,2023-05
2023-05-31,3611846,3494159,117687,아르메니아,2023-05
2023-05-31,3589129,592,3588537,니제르,2023-05
2023-05-31,3261640,0,3261640,지부티,2023-05
2023-05-31,3214841,651332,2563509,벨라루스,2023-05
2023-05-31,3200224,419664,2780560,아이티,2023-05
2023-05-31,3084620,154,3084466,마티니크,2023-05
2023-05-31,3050327,22815875,-19765548,마다카스카르,2023-05
2023-05-31,3004447,6873570,-3869123,룩셈부르그,2023-05
2023-05-31,2741626,21720320,-18978694,뉴 칼레도니아,2023-05
2023-05-31,2674331,1284469,1389862,시에라 리온,2023-05
2023-05-31,2498523,317890,2180633,자마이카,2023-05
2023-05-31,2321703,500459,1821244,카메룬,2023-05
2023-05-31,2317786,0,2317786,아루바,2023-05
2023-05-31,2315525,68124309,-65808784,콩고민주공화국,2023-05
2023-05-31,2240140,90940,2149200,아프카니스탄,2023-05
2023-05-31,2167411,21,2167390,베닝,2023-05
2023-05-31,2140757,61066,2079691,불령 폴리네시아,2023-05
2023-05-31,2117546,32756,2084790,시리아,2023-05
2023-05-31,2109564,403268,1706296,베네주엘라,2023-05
2023-05-31,1983307,572270,1411037,가봉,2023-05
2023-05-31,1754111,3213929,-1459818,기니,2023-05
2023-05-31,1736232,239182,1497050,피지,2023-05
2023-05-31,1723498,86285,1637213,아메리칸 사모아,2023-05
2023-05-31,1626092,781720,844372,네팔,2023-05
2023-05-31,1545154,637702,907452,콩고,2023-05
2023-05-31,1530530,356376,1174154,우간다,2023-05
2023-05-31,1438701,408901,1029800,르완다,2023-05
2023-05-31,1386951,5338,1381613,소말리아,2023-05
2023-05-31,1326927,131383,1195544,마카오,2023-05
2023-05-31,1318199,1803949,-485750,리히텐슈타인,2023-05
2023-05-31,1200531,702695,497836,수리남,2023-05
2023-05-31,1193685,1757020,-563335,마세도니아,2023-05
2023-05-31,1162588,4880972,-3718384,모리타니,2023-05
2023-05-31,1120010,134876,985134,큐라소,2023-05
2023-05-31,1103417,6771,1096646,벨리제,2023-05
2023-05-31,1063960,1830,1062130,바하마,2023-05
2023-05-31,993988,65105,928883,북마리아나 군도,2023-05
2023-05-31,992299,40,992259,투르크멘,2023-05
2023-05-31,942545,1318444,-375899,잠비아,2023-05
2023-05-31,866535,4547,861988,몰디브,2023-05
2023-05-31,763086,4872,758214,영령 버진군도,2023-05
2023-05-31,755093,47547,707546,세인트 루시아,2023-05
2023-05-31,739563,51959,687604,보츠와나,2023-05
2023-05-31,670149,2500,667649,영령 캐이맨 군도,2023-05
2023-05-31,645446,4864239,-4218793,보스니아-헤르체고비나,2023-05
2023-05-31,641844,0,641844,세인트 마틴,2023-05
2023-05-31,582218,23100,559118,키리바티,2023-05
2023-05-31,540264,16,540248,그레나다,2023-05
2023-05-31,526723,124686,402037,세이쉘,2023-05
2023-05-31,504725,1885407,-1380682,바누아투,2023-05
2023-05-31,492897,0,492897,불령 가이아나,2023-05
2023-05-31,487054,35654,451400,마이크로네시아,2023-05
2023-05-31,464894,0,464894,적도 기니,2023-05
2023-05-31,455293,373,454920,버뮤다,2023-05
2023-05-31,449406,0,449406,솔로몬 군도,2023-05
2023-05-31,435586,130,435456,안티가 바부다,2023-05
2023-05-31,432827,0,432827,부탄,2023-05
2023-05-31,425063,0,425063,팔라우,2023-05
2023-05-31,419955,4479,415476,투발루,2023-05
2023-05-31,364775,745939,-381164,수단,2023-05
2023-05-31,329916,7042,322874,바베이도스,2023-05
2023-05-31,318656,647716,-329060,감비아,2023-05
2023-05-31,266717,20,266697,세인트 키츠 네비스,2023-05
2023-05-31,254939,0,254939,투르크 & 카이코스 군도,2023-05
2023-05-31,242121,2714,239407,남수단,2023-05
2023-05-31,234191,4,234187,세인트 빈센트 그레나딘,2023-05
2023-05-31,214367,22455493,-22241126,나미비아,2023-05
2023-05-31,196220,14657,181563,스와질랜드,2023-05
2023-05-31,157149,956693,-799544,나우루,2023-05
2023-05-31,143758,0,143758,세인트 바르탤르미,2023-05
2023-05-31,141031,0,141031,메요트,2023-05
2023-05-31,120667,1418,119249,과델로프,2023-05
2023-05-31,91708,10103,81605,도미니카,2023-05
2023-05-31,80536,275099,-194563,산마리노,2023-05
2023-05-31,61034,496328,-435294,말라위,2023-05
2023-05-31,60723,0,60723,카보 베르데,2023-05
2023-05-31,43144,0,43144,상토메 프린스페,2023-05
2023-05-31,39985,0,39985,챠드,2023-05
2023-05-31,39319,16140,23179,네덜란드 열도,2023-05
2023-05-31,37551,4394,33157,부룬디,2023-05
2023-05-31,23166,0,23166,코스 군도,2023-05
2023-05-31,22384,27897,-5513,통가,2023-05
2023-05-31,16077,0,16077,에리트리아,2023-05
2023-05-31,11550,0,11550,쿡 아일랜드,2023-05
2023-05-31,11528,0,11528,왈라스 & 퓨투나 군도,2023-05
2023-05-31,9288,80186,-70898,티모르,2023-05
2023-05-31,8900,0,8900,보네르 신트외스타티위스,2023-05
2023-05-31,8894,2323,6571,미령 버진군도,2023-05
2023-05-31,8140,0,8140,앙귈라,2023-05
2023-05-31,4784,118193,-113409,기네비소,2023-05
2023-05-31,4345,109383,-105038,그린랜드,2023-05
2023-05-31,2523,0,2523,세인트마틴(생마르탱),2023-05
2023-05-31,1810,6739,-4929,안도라,2023-05
2023-05-31,754,129,625,건지,2023-05
2023-05-31,688,40429,-39741,니우에,2023-05
2023-05-31,412,6631,-6219,토켈라우,2023-05
2023-05-31,244,10,234,저어지,2023-05
2023-05-31,46,25157,-25111,파로에 군도,2023-05
2023-05-31,10,64,-54,몬트세라트,2023-05
2023-05-31,0,2194,-2194,중앙아프리카공화국,2023-05
2023-05-31,0,275257,-275257,모나코,2023-05
2023-05-31,0,277170,-277170,포클랜드 군도,2023-05
2023-05-31,0,204,-204,레소토,2023-05
2023-05-31,0,1699,-1699,코모로스,2023-05
2023-05-31,0,227,-227,마이너 아우틀링 합중국 군도,2023-05
2023-05-31,0,83,-83,남조지아 & 남샌드위치 군도,2023-05
2023-05-31,0,806,-806,불령 남부지역,2023-05
2023-06-30,10501951575,11799601629,-1297650054,중국,2023-06
2023-06-30,9599198241,5531065977,4068132264,미국,2023-06
2023-06-30,4314221682,2036281442,2277940240,베트남,2023-06
2023-06-30,2555961043,4332565122,-1776604079,일본,2023-06
2023-06-30,2359142854,151950477,2207192377,홍콩,2023-06
2023-06-30,1839430685,1936737475,-97306790,대만,2023-06
2023-06-30,1427371823,554432191,872939632,인도,2023-06
2023-06-30,1343337734,2487238908,-1143901174,호주,2023-06
2023-06-30,1231512002,2529181598,-1297669596,독일,2023-06
2023-06-30,1221124137,1068764845,152359292,싱가포르,2023-06
2023-06-30,1110313643,693534823,416778820,멕시코,2023-06
2023-06-30,826716414,996696532,-169980118,인도네시아,2023-06
2023-06-30,805664667,542367740,263296927,캐나다,2023-06
2023-06-30,763983719,102278081,661705638,튀르키예,2023-06
2023-06-30,763373763,793255,762580508,라이베리아,2023-06
2023-06-30,759755215,1407500806,-647745591,말레이시아,2023-06
2023-06-30,741087161,749080205,-7993044,러시아 연방,2023-06
2023-06-30,731138665,87433166,643705499,폴란드,2023-06
2023-06-30,671678862,688321555,-16642693,태국,2023-06
2023-06-30,658421764,378556111,279865653,필리핀,2023-06
2023-06-30,595308247,774782287,-179474040,네덜란드,2023-06
2023-06-30,574915138,637672202,-62757064,프랑스,2023-06
2023-06-30,568425709,88095498,480330211,헝가리,2023-06
2023-06-30,541982487,31448896,510533591,파나마,2023-06
2023-06-30,536850979,414505344,122345635,영국,2023-06
2023-06-30,478008012,2243516830,-1765508818,사우디아라비아,2023-06
2023-06-30,434055592,708363663,-274308071,이탈리아,2023-06
2023-06-30,407487669,1166569878,-759082209,아랍에미리트 연합,2023-06
2023-06-30,403636028,138099,403497929,마샬군도,2023-06
2023-06-30,389636065,549849444,-160213379,브라질,2023-06
2023-06-30,387974940,176890839,211084101,벨기에,2023-06
2023-06-30,265059166,207966375,57092791,스페인,2023-06
2023-06-30,262934501,110799421,152135080,체코공화국,2023-06
2023-06-30,259201041,119991112,139209929,슬로바키아,2023-06
2023-06-30,225258565,159866713,65391852,뉴질랜드,2023-06
2023-06-30,220253001,371671425,-151418424,카자흐스탄,2023-06
2023-06-30,179511089,1782873,177728216,우즈베키스탄,2023-06
2023-06-30,166659685,123330678,43329007,이스라엘,2023-06
2023-06-30,135415995,35611219,99804776,방글라데시,2023-06
2023-06-30,133724132,121427,133602705,키르기스스탄,2023-06
2023-06-30,126353298,91880068,34473230,덴마크,2023-06
2023-06-30,119141012,148151419,-29010407,아일랜드,2023-06
2023-06-30,107949712,727164654,-619214942,칠레,2023-06
2023-06-30,106535562,29387281,77148281,이집트,2023-06
2023-06-30,105602530,263935860,-158333330,스웨덴,2023-06
2023-06-30,102141024,6516917,95624107,슬로베니아,2023-06
2023-06-30,89434235,19952195,69482040,파키스탄,2023-06
2023-06-30,87717227,270834493,-183117266,스위스,2023-06
2023-06-30,87387217,231728012,-144340795,오스트리아,2023-06
2023-06-30,83083768,7638936,75444832,몰타,2023-06
2023-06-30,81762966,679394521,-597631555,이라크,2023-06
2023-06-30,74554474,1090720104,-1016165630,카타르,2023-06
2023-06-30,74008243,56420351,17587892,포루투갈,2023-06
2023-06-30,73638210,7387028,66251182,요르단,2023-06
2023-06-30,71731323,54076326,17654997,푸에르토리코,2023-06
2023-06-30,67029807,275643059,-208613252,남아프리카공화국,2023-06
2023-06-30,61652480,189051912,-127399432,페루,2023-06
2023-06-30,56258772,93485823,-37227051,우크라이나,2023-06
2023-06-30,54542351,96716938,-42174587,콜롬비아,2023-06
2023-06-30,50908152,53098625,-2190473,캄보디아,2023-06
2023-06-30,46046475,256044916,-209998441,오만,2023-06
2023-06-30,44067182,3222096,40845086,몽골,2023-06
2023-06-30,43056182,1140171,41916011,리비아,2023-06
2023-06-30,41764447,49714806,-7950359,나이지리아,2023-06
2023-06-30,39194482,82925559,-43731077,아르헨티나,2023-06
2023-06-30,37463489,12740515,24722974,모로코,2023-06
2023-06-30,37144399,117486220,-80341821,루마니아,2023-06
2023-06-30,34753240,62573495,-27820255,에쿠아도르,2023-06
2023-06-30,34021389,111086205,-77064816,파푸아 뉴기니,2023-06
2023-06-30,32486345,24001072,8485273,미얀마,2023-06
2023-06-30,31484942,687293897,-655808955,쿠웨이트,2023-06
2023-06-30,30630678,10817123,19813555,리투아니아,2023-06
2023-06-30,30424941,438588,29986353,괌,2023-06
2023-06-30,29782450,109482799,-79700349,핀란드,2023-06
2023-06-30,29651744,15847633,13804111,그리스,2023-06
2023-06-30,26671564,15036609,11634955,도미니카 공화국,2023-06
2023-06-30,24815110,8966738,15848372,과테말라,2023-06
2023-06-30,24552968,13832599,10720369,세르비아,2023-06
2023-06-30,23183049,119059940,-95876891,노르웨이,2023-06
2023-06-30,22246083,239822,22006261,이란,2023-06
2023-06-30,21391634,194724318,-173332684,알제리,2023-06
2023-06-30,20114487,28025976,-7911489,바레인,2023-06
2023-06-30,20057535,2998091,17059444,조지아,2023-06
2023-06-30,18844153,48294,18795859,아제르바이잔,2023-06
2023-06-30,17734415,10378049,7356366,스리랑카,2023-06
2023-06-30,17478922,844711,16634211,코트디봐르,2023-06
2023-06-30,17462080,13292606,4169474,코스타리카,2023-06
2023-06-30,15128819,5049737,10079082,탄자니아,2023-06
2023-06-30,14259181,15906735,-1647554,불가리아,2023-06
2023-06-30,13904109,2285833,11618276,엘살바도르,2023-06
2023-06-30,13254754,1974164,11280590,가나,2023-06
2023-06-30,13251297,394442,12856855,알바니아,2023-06
2023-06-30,13223064,46596164,-33373100,튀니지,2023-06
2023-06-30,12823486,4184716,8638770,온두라스,2023-06
2023-06-30,12720083,4990535,7729548,케냐,2023-06
2023-06-30,12403360,16904489,-4501129,우루과이,2023-06
2023-06-30,11507092,6379711,5127381,라오스,2023-06
2023-06-30,11500312,21390290,-9889978,크로아티아,2023-06
2023-06-30,11372944,730596,10642348,쿠바,2023-06
2023-06-30,11307645,3553,11304092,타지크,2023-06
2023-06-30,9278462,1261213,8017249,시에라 리온,2023-06
2023-06-30,8928819,3818544,5110275,세네갈,2023-06
2023-06-30,8521725,183347,8338378,말라위,2023-06
2023-06-30,8484668,7738658,746010,라트비아,2023-06
2023-06-30,8103387,10402730,-2299343,파라과이,2023-06
2023-06-30,7460150,52110,7408040,마이크로네시아,2023-06
2023-06-30,7332731,10841425,-3508694,에티오피아,2023-06
2023-06-30,7134379,4275911,2858468,레바논,2023-06
2023-06-30,6583133,785730,5797403,벨라루스,2023-06
2023-06-30,6482746,1009533,5473213,니카라과,2023-06
2023-06-30,6208271,2451266,3757005,몰도바,2023-06
2023-06-30,5995156,1528586,4466570,예맨,2023-06
2023-06-30,5639140,4805612,833528,에스토니아,2023-06
2023-06-30,5599856,168741,5431115,카메룬,2023-06
2023-06-30,5336560,58729111,-53392551,모잠비크,2023-06
2023-06-30,5335624,57309737,-51974113,콩고민주공화국,2023-06
2023-06-30,4989864,539146,4450718,모리셔스,2023-06
2023-06-30,4772686,62942,4709744,브루나이,2023-06
2023-06-30,4708754,993897,3714857,토고,2023-06
2023-06-30,4459993,45134,4414859,자마이카,2023-06
2023-06-30,4450859,47510957,-43060098,뉴 칼레도니아,2023-06
2023-06-30,4322940,145996,4176944,팔레스타인 해방기구,2023-06
2023-06-30,4192369,3664114,528255,아르메니아,2023-06
2023-06-30,3988343,143333,3845010,아이티,2023-06
2023-06-30,3970290,0,3970290,불령 리유니온 코모도 제도,2023-06
2023-06-30,3955496,240857,3714639,베네주엘라,2023-06
2023-06-30,3931079,2264471,1666608,아이슬란드,2023-06
2023-06-30,3897490,5582968,-1685478,트리니다드 토바고,2023-06
2023-06-30,3739462,6568043,-2828581,룩셈부르그,2023-06
2023-06-30,3649900,221851812,-218201912,기타국,2023-06
2023-06-30,3614232,372069,3242163,피지,2023-06
2023-06-30,3547158,30833,3516325,사모아,2023-06
2023-06-30,3375097,0,3375097,가이아나,2023-06
2023-06-30,3315320,24958295,-21642975,볼리비아,2023-06
2023-06-30,3275683,1557,3274126,앙골라,2023-06
2023-06-30,3219786,976349,2243437,사이프러스,2023-06
2023-06-30,2706399,1298102,1408297,부르키나 파소,2023-06
2023-06-30,2681484,26743722,-24062238,나미비아,2023-06
2023-06-30,2426249,2432209,-5960,기니,2023-06
2023-06-30,2370103,20,2370083,지부티,2023-06
2023-06-30,2318836,40155364,-37836528,마다카스카르,2023-06
2023-06-30,2193888,13875,2180013,통가,2023-06
2023-06-30,2166461,311984,1854477,네팔,2023-06
2023-06-30,2109474,44297,2065177,아프카니스탄,2023-06
2023-06-30,2027336,616,2026720,마티니크,2023-06
2023-06-30,2019055,44545,1974510,과델로프,2023-06
2023-06-30,2007681,183,2007498,벨리제,2023-06
2023-06-30,1986642,404676,1581966,우간다,2023-06
2023-06-30,1967054,1281,1965773,니제르,2023-06
2023-06-30,1920419,0,1920419,베닝,2023-06
2023-06-30,1844040,102516,1741524,르완다,2023-06
2023-06-30,1777886,745205,1032681,마카오,2023-06
2023-06-30,1551483,630797,920686,수단,2023-06
2023-06-30,1540028,48966,1491062,시리아,2023-06
2023-06-30,1523104,9895,1513209,바하마,2023-06
2023-06-30,1405120,0,1405120,챠드,2023-06
2023-06-30,1395940,439549,956391,짐바브웨,2023-06
2023-06-30,1289703,0,1289703,아루바,2023-06
2023-06-30,1213468,4699355,-3485887,잠비아,2023-06
2023-06-30,1213192,203073,1010119,가봉,2023-06
2023-06-30,1133053,43100,1089953,큐라소,2023-06
2023-06-30,1108994,1092695,16299,리히텐슈타인,2023-06
2023-06-30,1007052,202459,804593,콩고,2023-06
2023-06-30,1005684,324,1005360,투르크멘,2023-06
2023-06-30,983916,497131,486785,소말리아,2023-06
2023-06-30,972362,3444689,-2472327,모리타니,2023-06
2023-06-30,958936,97113,861823,불령 폴리네시아,2023-06
2023-06-30,922079,5229,916850,몰디브,2023-06
2023-06-30,900525,29602,870923,솔로몬 군도,2023-06
2023-06-30,891099,4133987,-3242888,보스니아-헤르체고비나,2023-06
2023-06-30,859419,0,859419,버뮤다,2023-06
2023-06-30,846990,924066,-77076,수리남,2023-06
2023-06-30,822836,0,822836,세인트 마틴,2023-06
2023-06-30,708155,1621,706534,바베이도스,2023-06
2023-06-30,690115,413437,276678,아메리칸 사모아,2023-06
2023-06-30,688968,1779741,-1090773,몬테네그로,2023-06
2023-06-30,674390,106937,567453,북마리아나 군도,2023-06
2023-06-30,662394,21321,641073,보츠와나,2023-06
2023-06-30,648823,1027,647796,영령 캐이맨 군도,2023-06
2023-06-30,612307,318900,293407,세이쉘,2023-06
2023-06-30,557276,108228,449048,바누아투,2023-06
2023-06-30,540784,21675,519109,키리바티,2023-06
2023-06-30,476131,345653,130478,투발루,2023-06
2023-06-30,475846,0,475846,그레나다,2023-06
2023-06-30,475633,290250,185383,부탄,2023-06
2023-06-30,472219,0,472219,불령 가이아나,2023-06
2023-06-30,439385,97188,342197,마세도니아,2023-06
2023-06-30,379734,482465,-102731,감비아,2023-06
2023-06-30,364825,66538,298287,스와질랜드,2023-06
2023-06-30,312018,1095,310923,세인트 키츠 네비스,2023-06
2023-06-30,296943,20,296923,부룬디,2023-06
2023-06-30,283515,0,283515,영령 버진군도,2023-06
2023-06-30,260572,0,260572,중앙아프리카공화국,2023-06
2023-06-30,220595,368,220227,도미니카,2023-06
2023-06-30,205326,250,205076,안티가 바부다,2023-06
2023-06-30,149629,947,148682,티모르,2023-06
2023-06-30,144547,0,144547,세인트 빈센트 그레나딘,2023-06
2023-06-30,130940,57545,73395,세인트 루시아,2023-06
2023-06-30,111857,45535,66322,팔라우,2023-06
2023-06-30,108684,0,108684,카보 베르데,2023-06
2023-06-30,72292,293911,-221619,모나코,2023-06
2023-06-30,66926,42,66884,말리,2023-06
2023-06-30,53075,0,53075,몬트세라트,2023-06
2023-06-30,52532,820,51712,투르크 & 카이코스 군도,2023-06
2023-06-30,49868,0,49868,남수단,2023-06
2023-06-30,31945,0,31945,나우루,2023-06
2023-06-30,27883,16,27867,지브랄타,2023-06
2023-06-30,23050,10396422,-10373372,에리트리아,2023-06
2023-06-30,20172,0,20172,적도 기니,2023-06
2023-06-30,19080,58,19022,네덜란드 열도,2023-06
2023-06-30,17993,0,17993,건지,2023-06
2023-06-30,15000,603431,-588431,산마리노,2023-06
2023-06-30,11240,0,11240,세인트마틴(생마르탱),2023-06
2023-06-30,11140,0,11140,앙귈라,2023-06
2023-06-30,6698,0,6698,보네르 신트외스타티위스,2023-06
2023-06-30,5320,0,5320,안타티카,2023-06
2023-06-30,4518,156260,-151742,그린랜드,2023-06
2023-06-30,3558,1327,2231,안도라,2023-06
2023-06-30,1865,213,1652,세인트 바르탤르미,2023-06
2023-06-30,877,0,877,코모로스,2023-06
2023-06-30,649,0,649,기네비소,2023-06
2023-06-30,243,0,243,미령 버진군도,2023-06
2023-06-30,0,100,-100,맨섬,2023-06
2023-06-30,0,4101,-4101,마이너 아우틀링 합중국 군도,2023-06
2023-06-30,0,2555,-2555,니우에,2023-06
2023-06-30,0,111223,-111223,레소토,2023-06
2023-06-30,0,36032,-36032,토켈라우,2023-06
2023-06-30,0,1462,-1462,상토메 프린스페,2023-06
2023-06-30,0,146,-146,불령 남부지역,2023-06
2023-06-30,0,430,-430,남조지아 & 남샌드위치 군도,2023-06
2023-06-30,0,585,-585,코스 군도,2023-06
2023-07-31,9928339464,11172937979,-1244598515,중국,2023-07
2023-07-31,9309186009,5319601532,3989584477,미국,2023-07
2023-07-31,4416950741,2276216809,2140733932,베트남,2023-07
2023-07-31,2363451042,3876241550,-1512790508,일본,2023-07
2023-07-31,1734290220,137573205,1596717015,홍콩,2023-07
2023-07-31,1533744348,2057423383,-523679035,호주,2023-07
2023-07-31,1477333539,1135535720,341797819,싱가포르,2023-07
2023-07-31,1430715883,544606769,886109114,인도,2023-07
2023-07-31,1416002175,2065090321,-649088146,대만,2023-07
2023-07-31,1051158953,549103089,502055864,멕시코,2023-07
2023-07-31,973241115,1623136256,-649895141,독일,2023-07
2023-07-31,905188644,104089942,801098702,폴란드,2023-07
2023-07-31,830545770,389090699,441455071,필리핀,2023-07
2023-07-31,737681573,715250441,22431132,인도네시아,2023-07
2023-07-31,713204004,88353496,624850508,튀르키예,2023-07
2023-07-31,675941962,418208115,257733847,캐나다,2023-07
2023-07-31,663329572,1150303988,-486974416,말레이시아,2023-07
2023-07-31,652953756,665274581,-12320825,태국,2023-07
2023-07-31,590728025,487755520,102972505,네덜란드,2023-07
2023-07-31,527977833,343622783,184355050,영국,2023-07
2023-07-31,515364657,59428189,455936468,헝가리,2023-07
2023-07-31,463323985,2539245379,-2075921394,사우디아라비아,2023-07
2023-07-31,422458937,1940,422456997,마샬군도,2023-07
2023-07-31,415939134,735239855,-319300721,이탈리아,2023-07
2023-07-31,407103163,851818720,-444715557,러시아 연방,2023-07
2023-07-31,406236463,386761,405849702,라이베리아,2023-07
2023-07-31,380526675,125235580,255291095,벨기에,2023-07
2023-07-31,345483760,460787877,-115304117,브라질,2023-07
2023-07-31,339769699,783277789,-443508090,아랍에미리트 연합,2023-07
2023-07-31,307794155,197600367,110193788,스페인,2023-07
2023-07-31,295366637,660018898,-364652261,프랑스,2023-07
2023-07-31,280498563,167396054,113102509,뉴질랜드,2023-07
2023-07-31,269147698,137228716,131918982,체코공화국,2023-07
2023-07-31,253150954,32425453,220725501,슬로바키아,2023-07
2023-07-31,201640146,1536196,200103950,우즈베키스탄,2023-07
2023-07-31,161917625,255328432,-93410807,카자흐스탄,2023-07
2023-07-31,122764397,103307036,19457361,이스라엘,2023-07
2023-07-31,119228732,415074020,-295845288,이라크,2023-07
2023-07-31,115956245,10521242,105435003,슬로베니아,2023-07
2023-07-31,108037789,148464,107889325,키르기스스탄,2023-07
2023-07-31,101275969,6578058,94697911,이집트,2023-07
2023-07-31,94876616,571849769,-476973153,칠레,2023-07
2023-07-31,91745355,126838371,-35093016,스웨덴,2023-07
2023-07-31,90809841,179956233,-89146392,오스트리아,2023-07
2023-07-31,86791820,16781975,70009845,파키스탄,2023-07
2023-07-31,79818162,25602911,54215251,파나마,2023-07
2023-07-31,79566082,257308513,-177742431,스위스,2023-07
2023-07-31,78673382,300,78673082,지브랄타,2023-07
2023-07-31,78550257,1103143423,-1024593166,카타르,2023-07
2023-07-31,75371022,5646127,69724895,몰타,2023-07
2023-07-31,70607127,329310028,-258702901,남아프리카공화국,2023-07
2023-07-31,66648913,47901890,18747023,방글라데시,2023-07
2023-07-31,62726752,78361707,-15634955,포루투갈,2023-07
2023-07-31,61931850,6450436,55481414,요르단,2023-07
2023-07-31,59623052,126122749,-66499697,아일랜드,2023-07
2023-07-31,57811185,81040819,-23229634,아르헨티나,2023-07
2023-07-31,57030729,96125451,-39094722,콜롬비아,2023-07
2023-07-31,53200375,318631693,-265431318,페루,2023-07
2023-07-31,51345219,39188509,12156710,나이지리아,2023-07
2023-07-31,49665525,73815234,-24149709,덴마크,2023-07
2023-07-31,49485812,37094387,12391425,푸에르토리코,2023-07
2023-07-31,45955055,3220742,42734313,몽골,2023-07
2023-07-31,45552370,125699200,-80146830,루마니아,2023-07
2023-07-31,43195244,41868150,1327094,캄보디아,2023-07
2023-07-31,40261172,1377664,38883508,리비아,2023-07
2023-07-31,38196248,109451170,-71254922,우크라이나,2023-07
2023-07-31,37470448,292226133,-254755685,오만,2023-07
2023-07-31,35145499,89223732,-54078233,핀란드,2023-07
2023-07-31,34318828,75795033,-41476205,에쿠아도르,2023-07
2023-07-31,30235636,6622597,23613039,세르비아,2023-07
2023-07-31,29698350,417417,29280933,괌,2023-07
2023-07-31,28776913,15476421,13300492,코스타리카,2023-07
2023-07-31,28595461,21711818,6883643,그리스,2023-07
2023-07-31,25868058,957095703,-931227645,쿠웨이트,2023-07
2023-07-31,25179038,52822639,-27643601,미얀마,2023-07
2023-07-31,24447811,416852,24030959,탄자니아,2023-07
2023-07-31,24194405,11275208,12919197,모로코,2023-07
2023-07-31,24153765,9634596,14519169,리투아니아,2023-07
2023-07-31,22101445,7453803,14647642,과테말라,2023-07
2023-07-31,19436770,803963,18632807,아제르바이잔,2023-07
2023-07-31,18134441,17365177,769264,불가리아,2023-07
2023-07-31,17510322,13502833,4007489,도미니카 공화국,2023-07
2023-07-31,17196373,94368079,-77171706,알제리,2023-07
2023-07-31,16557362,1627701,14929661,엘살바도르,2023-07
2023-07-31,15707865,191,15707674,앙골라,2023-07
2023-07-31,14024687,105474779,-91450092,노르웨이,2023-07
2023-07-31,13753865,1139038,12614827,시에라 리온,2023-07
2023-07-31,13202715,403314,12799401,코트디봐르,2023-07
2023-07-31,13131466,1661645,11469821,가나,2023-07
2023-07-31,12652075,1470166,11181909,조지아,2023-07
2023-07-31,12384997,1427430,10957567,브루나이,2023-07
2023-07-31,12065060,764078,11300982,알바니아,2023-07
2023-07-31,11716902,11720812,-3910,스리랑카,2023-07
2023-07-31,11655052,7573524,4081528,튀니지,2023-07
2023-07-31,11522113,740898,10781215,이란,2023-07
2023-07-31,11488444,4864819,6623625,케냐,2023-07
2023-07-31,11455291,430,11454861,타지크,2023-07
2023-07-31,11218824,11458379,-239555,우루과이,2023-07
2023-07-31,10713547,5748813,4964734,온두라스,2023-07
2023-07-31,9539977,9351910,188067,에티오피아,2023-07
2023-07-31,9104467,3803105,5301362,세네갈,2023-07
2023-07-31,8652521,2024842,6627679,파라과이,2023-07
2023-07-31,8449878,6243217,2206661,라오스,2023-07
2023-07-31,7869693,4965408,2904285,크로아티아,2023-07
2023-07-31,7418526,1361100,6057426,니카라과,2023-07
2023-07-31,7275657,14068014,-6792357,바레인,2023-07
2023-07-31,6731512,1786644,4944868,예맨,2023-07
2023-07-31,6156637,2882512,3274125,레바논,2023-07
2023-07-31,6047720,7663419,-1615699,라트비아,2023-07
2023-07-31,5924238,6066769,-142531,몰도바,2023-07
2023-07-31,5885545,5880388,5157,에스토니아,2023-07
2023-07-31,5094277,40808260,-35713983,모잠비크,2023-07
2023-07-31,4987750,10843761,-5856011,트리니다드 토바고,2023-07
2023-07-31,4675061,11705569,-7030508,파푸아 뉴기니,2023-07
2023-07-31,4570252,170982216,-166411964,기타국,2023-07
2023-07-31,4409384,85046,4324338,불령 폴리네시아,2023-07
2023-07-31,4369255,577,4368678,불령 리유니온 코모도 제도,2023-07
2023-07-31,4352026,155567,4196459,베네주엘라,2023-07
2023-07-31,4339597,0,4339597,안타티카,2023-07
2023-07-31,4223574,461562,3762012,모리셔스,2023-07
2023-07-31,4126118,987522,3138596,사이프러스,2023-07
2023-07-31,4049849,179215,3870634,피지,2023-07
2023-07-31,3999004,35,3998969,부르키나 파소,2023-07
2023-07-31,3880594,315499,3565095,아이티,2023-07
2023-07-31,3777695,419657,3358038,벨라루스,2023-07
2023-07-31,3740800,6869534,-3128734,룩셈부르그,2023-07
2023-07-31,3598193,0,3598193,팔레스타인 해방기구,2023-07
2023-07-31,3532612,29,3532583,가이아나,2023-07
2023-07-31,3495448,1282786,2212662,우간다,2023-07
2023-07-31,3170422,51507323,-48336901,콩고민주공화국,2023-07
2023-07-31,2886293,121207,2765086,자마이카,2023-07
2023-07-31,2765613,1782681,982932,토고,2023-07
2023-07-31,2520413,6358169,-3837756,마다카스카르,2023-07
2023-07-31,2509016,1712706,796310,아이슬란드,2023-07
2023-07-31,2424146,717739,1706407,가봉,2023-07
2023-07-31,2059196,0,2059196,지부티,2023-07
2023-07-31,2020276,0,2020276,과델로프,2023-07
2023-07-31,1999066,52895,1946171,시리아,2023-07
2023-07-31,1829066,7415398,-5586332,아르메니아,2023-07
2023-07-31,1793805,318928,1474877,네팔,2023-07
2023-07-31,1767643,66736,1700907,콩고,2023-07
2023-07-31,1729661,0,1729661,수단,2023-07
2023-07-31,1716690,398351,1318339,카메룬,2023-07
2023-07-31,1664837,0,1664837,베닝,2023-07
2023-07-31,1655392,14353177,-12697785,뉴 칼레도니아,2023-07
2023-07-31,1651989,42754,1609235,아프카니스탄,2023-07
2023-07-31,1611549,142141,1469408,소말리아,2023-07
2023-07-31,1500827,13797424,-12296597,볼리비아,2023-07
2023-07-31,1430478,275327,1155151,아메리칸 사모아,2023-07
2023-07-31,1425460,0,1425460,아루바,2023-07
2023-07-31,1356133,0,1356133,사모아,2023-07
2023-07-31,1297583,0,1297583,메요트,2023-07
2023-07-31,1242135,2105781,-863646,잠비아,2023-07
2023-07-31,1218992,4174313,-2955321,기니,2023-07
2023-07-31,1141106,1811,1139295,투르크멘,2023-07
2023-07-31,1098329,107581,990748,북마리아나 군도,2023-07
2023-07-31,1053384,1247670,-194286,마세도니아,2023-07
2023-07-31,1032722,193713,839009,마카오,2023-07
2023-07-31,1029103,2215,1026888,르완다,2023-07
2023-07-31,1010895,996,1009899,벨리제,2023-07
2023-07-31,965211,665627,299584,짐바브웨,2023-07
2023-07-31,951830,1237919,-286089,리히텐슈타인,2023-07
2023-07-31,944485,30113,914372,보츠와나,2023-07
2023-07-31,890112,0,890112,세인트 마틴,2023-07
2023-07-31,886881,8080,878801,말리,2023-07
2023-07-31,837223,3797637,-2960414,보스니아-헤르체고비나,2023-07
2023-07-31,814545,100,814445,영령 캐이맨 군도,2023-07
2023-07-31,800871,1822797,-1021926,몬테네그로,2023-07
2023-07-31,704795,7301,697494,바하마,2023-07
2023-07-31,700252,0,700252,마티니크,2023-07
2023-07-31,665272,40022,625250,통가,2023-07
2023-07-31,648921,140,648781,몰디브,2023-07
2023-07-31,625005,154083,470922,세이쉘,2023-07
2023-07-31,593874,597,593277,니제르,2023-07
2023-07-31,546213,16102,530111,팔라우,2023-07
2023-07-31,543776,3246122,-2702346,모리타니,2023-07
2023-07-31,448659,6438,442221,마이크로네시아,2023-07
2023-07-31,437602,498,437104,부탄,2023-07
2023-07-31,433609,20699,412910,세인트 루시아,2023-07
2023-07-31,429122,254274,174848,쿠바,2023-07
2023-07-31,421117,2253409,-1832292,바누아투,2023-07
2023-07-31,417092,0,417092,버뮤다,2023-07
2023-07-31,412987,1587,411400,티모르,2023-07
2023-07-31,410733,298,410435,큐라소,2023-07
2023-07-31,407460,1006444,-598984,수리남,2023-07
2023-07-31,384142,2394854,-2010712,솔로몬 군도,2023-07
2023-07-31,372124,0,372124,적도 기니,2023-07
2023-07-31,371016,807896,-436880,키리바티,2023-07
2023-07-31,328603,14907,313696,바베이도스,2023-07
2023-07-31,275941,0,275941,투르크 & 카이코스 군도,2023-07
2023-07-31,230909,76498,154411,안티가 바부다,2023-07
2023-07-31,226928,33,226895,세인트 키츠 네비스,2023-07
2023-07-31,163367,221204,-57837,말라위,2023-07
2023-07-31,162272,125019,37253,도미니카,2023-07
2023-07-31,143521,425,143096,카보 베르데,2023-07
2023-07-31,132070,8767784,-8635714,나미비아,2023-07
2023-07-31,128115,94273,33842,그린랜드,2023-07
2023-07-31,127245,0,127245,불령 가이아나,2023-07
2023-07-31,120238,47082,73156,스와질랜드,2023-07
2023-07-31,108286,831577,-723291,감비아,2023-07
2023-07-31,98651,0,98651,영령 버진군도,2023-07
2023-07-31,87850,79,87771,부룬디,2023-07
2023-07-31,75154,0,75154,세인트 빈센트 그레나딘,2023-07
2023-07-31,64075,0,64075,챠드,2023-07
2023-07-31,54225,0,54225,남수단,2023-07
2023-07-31,36600,207302,-170702,산마리노,2023-07
2023-07-31,35988,226208,-190220,투발루,2023-07
2023-07-31,29300,0,29300,그레나다,2023-07
2023-07-31,22331,0,22331,네덜란드 열도,2023-07
2023-07-31,17524,4058120,-4040596,나우루,2023-07
2023-07-31,16690,3647,13043,건지,2023-07
2023-07-31,14861,0,14861,알랜드 군도,2023-07
2023-07-31,5059,742,4317,코모로스,2023-07
2023-07-31,3006,19438,-16432,상토메 프린스페,2023-07
2023-07-31,2380,0,2380,노폴크 아일랜드,2023-07
2023-07-31,1549,315,1234,세인트 바르탤르미,2023-07
2023-07-31,1512,7327,-5815,앙귈라,2023-07
2023-07-31,1298,0,1298,세인트마틴(생마르탱),2023-07
2023-07-31,700,766,-66,안도라,2023-07
2023-07-31,596,0,596,미령 버진군도,2023-07
2023-07-31,475,0,475,중앙아프리카공화국,2023-07
2023-07-31,312,156507,-156195,모나코,2023-07
2023-07-31,125,0,125,파로에 군도,2023-07
2023-07-31,111,212,-101,에리트리아,2023-07
2023-07-31,0,348,-348,남조지아 & 남샌드위치 군도,2023-07
2023-07-31,0,721,-721,크리스마스 아일랜드,2023-07
2023-07-31,0,1057,-1057,저어지,2023-07
2023-07-31,0,150,-150,맨섬,2023-07
2023-07-31,0,415,-415,불령 남부지역,2023-07
2023-07-31,0,279422,-279422,포클랜드 군도,2023-07
2023-07-31,0,3707,-3707,레소토,2023-07
2023-07-31,0,10105,-10105,몬트세라트,2023-07
2023-07-31,0,31,-31,코스 군도,2023-07
2023-07-31,0,1364,-1364,마이너 아우틀링 합중국 군도,2023-07
2023-07-31,0,462,-462,니우에,2023-07
2023-07-31,0,54,-54,국제통화기금,2023-07
2023-07-31,0,15419,-15419,토켈라우,2023-07
2023-08-31,10515041465,11688869797,-1173828332,중국,2023-08
2023-08-31,8959140624,5390721597,3568419027,미국,2023-08
2023-08-31,4946444699,2412212890,2534231809,베트남,2023-08
2023-08-31,2363482376,3656641370,-1293158994,일본,2023-08
2023-08-31,2293513930,114825558,2178688372,홍콩,2023-08
2023-08-31,1845128281,2115727722,-270599441,대만,2023-08
2023-08-31,1602896331,596406980,1006489351,인도,2023-08
2023-08-31,1488687547,899441734,589245813,싱가포르,2023-08
2023-08-31,1462698955,2516678540,-1053979585,호주,2023-08
2023-08-31,1058215571,359237258,698978313,멕시코,2023-08
2023-08-31,996971225,1108664793,-111693568,말레이시아,2023-08
2023-08-31,797405528,381792492,415613036,필리핀,2023-08
2023-08-31,788038561,87441677,700596884,폴란드,2023-08
2023-08-31,773615739,1095404235,-321788496,인도네시아,2023-08
2023-08-31,757478081,90988654,666489427,튀르키예,2023-08
2023-08-31,700175093,1724785748,-1024610655,독일,2023-08
2023-08-31,583247481,603123286,-19875805,태국,2023-08
2023-08-31,568346279,548151705,20194574,캐나다,2023-08
2023-08-31,566435793,612087202,-45651409,네덜란드,2023-08
2023-08-31,540954780,61760623,479194157,헝가리,2023-08
2023-08-31,452190989,669223735,-217032746,이탈리아,2023-08
2023-08-31,446211644,2692434531,-2246222887,사우디아라비아,2023-08
2023-08-31,411105199,539559,410565640,라이베리아,2023-08
2023-08-31,410832677,429854634,-19021957,영국,2023-08
2023-08-31,396486532,620368224,-223881692,프랑스,2023-08
2023-08-31,372974794,572534968,-199560174,러시아 연방,2023-08
2023-08-31,335317490,378264792,-42947302,브라질,2023-08
2023-08-31,299379455,132246986,167132469,벨기에,2023-08
2023-08-31,295114545,1430555806,-1135441261,아랍에미리트 연합,2023-08
2023-08-31,281265677,95539962,185725715,체코공화국,2023-08
2023-08-31,262301685,36698467,225603218,슬로바키아,2023-08
2023-08-31,239315319,185212395,54102924,스페인,2023-08
2023-08-31,232408022,122063986,110344036,뉴질랜드,2023-08
2023-08-31,214665602,23150197,191515405,그리스,2023-08
2023-08-31,196281159,1843688,194437471,우즈베키스탄,2023-08
2023-08-31,171504126,187068429,-15564303,카자흐스탄,2023-08
2023-08-31,169998979,86195561,83803418,이스라엘,2023-08
2023-08-31,151700204,37969308,113730896,포루투갈,2023-08
2023-08-31,121952468,711111764,-589159296,칠레,2023-08
2023-08-31,121549394,50407,121498987,마샬군도,2023-08
2023-08-31,118191593,148668695,-30477102,스웨덴,2023-08
2023-08-31,115682867,7661886,108020981,슬로베니아,2023-08
2023-08-31,113454547,65219562,48234985,방글라데시,2023-08
2023-08-31,107413825,56744,107357081,키르기스스탄,2023-08
2023-08-31,101412868,6128779,95284089,이집트,2023-08
2023-08-31,91000730,2484201,88516529,토고,2023-08
2023-08-31,87064965,634189594,-547124629,이라크,2023-08
2023-08-31,78476744,8007921,70468823,몰타,2023-08
2023-08-31,77915000,130365272,-52450272,오스트리아,2023-08
2023-08-31,77176001,16981034,60194967,파키스탄,2023-08
2023-08-31,68368835,242943157,-174574322,스위스,2023-08
2023-08-31,66870828,2129402,64741426,요르단,2023-08
2023-08-31,60191871,1418865244,-1358673373,카타르,2023-08
2023-08-31,57266093,228636668,-171370575,콜롬비아,2023-08
2023-08-31,57167075,201,57166874,지브랄타,2023-08
2023-08-31,56607491,36123824,20483667,파나마,2023-08
2023-08-31,56483251,356603170,-300119919,남아프리카공화국,2023-08
2023-08-31,56058081,92611813,-36553732,루마니아,2023-08
2023-08-31,54643071,187266334,-132623263,페루,2023-08
2023-08-31,53076895,36662513,16414382,푸에르토리코,2023-08
2023-08-31,52882374,86958732,-34076358,덴마크,2023-08
2023-08-31,50933604,2152764,48780840,리비아,2023-08
2023-08-31,45223477,39941120,5282357,나이지리아,2023-08
2023-08-31,43917715,4396119,39521596,에쿠아도르,2023-08
2023-08-31,42650059,5214506,37435553,몽골,2023-08
2023-08-31,41866414,520112,41346302,괌,2023-08
2023-08-31,41274333,92478274,-51203941,아일랜드,2023-08
2023-08-31,39369426,38634909,734517,캄보디아,2023-08
2023-08-31,39329926,131525597,-92195671,아르헨티나,2023-08
2023-08-31,36404549,86164021,-49759472,핀란드,2023-08
2023-08-31,31927705,85160373,-53232668,노르웨이,2023-08
2023-08-31,31267473,537572,30729901,피지,2023-08
2023-08-31,30931261,923318210,-892386949,쿠웨이트,2023-08
2023-08-31,29152973,8514107,20638866,리투아니아,2023-08
2023-08-31,27298460,458514333,-431215873,오만,2023-08
2023-08-31,27191654,10382598,16809056,과테말라,2023-08
2023-08-31,25607830,62784027,-37176197,미얀마,2023-08
2023-08-31,25241559,11938147,13303412,모로코,2023-08
2023-08-31,25176978,12284428,12892550,도미니카 공화국,2023-08
2023-08-31,22375221,82888747,-60513526,우크라이나,2023-08
2023-08-31,19705269,9303137,10402132,세르비아,2023-08
2023-08-31,19572731,12161349,7411382,코스타리카,2023-08
2023-08-31,18709637,792153,17917484,아제르바이잔,2023-08
2023-08-31,17200499,36506879,-19306380,불가리아,2023-08
2023-08-31,17102230,151195,16951035,이란,2023-08
2023-08-31,16473988,4530206,11943782,탄자니아,2023-08
2023-08-31,15852181,6039037,9813144,우루과이,2023-08
2023-08-31,14977403,757535,14219868,조지아,2023-08
2023-08-31,14687237,1928287,12758950,엘살바도르,2023-08
2023-08-31,14522905,9273133,5249772,스리랑카,2023-08
2023-08-31,14291892,736106,13555786,코트디봐르,2023-08
2023-08-31,14207268,3772140,10435128,케냐,2023-08
2023-08-31,12693010,1576914,11116096,가나,2023-08
2023-08-31,12661180,643522,12017658,알바니아,2023-08
2023-08-31,12143188,13360693,-1217505,나미비아,2023-08
2023-08-31,12003125,4421594,7581531,온두라스,2023-08
2023-08-31,11996437,54557641,-42561204,알제리,2023-08
2023-08-31,9838877,0,9838877,앙골라,2023-08
2023-08-31,9793381,40873363,-31079982,모잠비크,2023-08
2023-08-31,9524544,640,9523904,마이크로네시아,2023-08
2023-08-31,9421253,74503,9346750,타지크,2023-08
2023-08-31,9393510,59796909,-50403399,튀니지,2023-08
2023-08-31,8269183,10160130,-1890947,바레인,2023-08
2023-08-31,7954665,13058262,-5103597,에티오피아,2023-08
2023-08-31,7914920,4760709,3154211,세네갈,2023-08
2023-08-31,7465510,63888,7401622,불령 폴리네시아,2023-08
2023-08-31,7458655,57491834,-50033179,콩고민주공화국,2023-08
2023-08-31,7441554,6300814,1140740,에스토니아,2023-08
2023-08-31,7026907,1238981,5787926,시에라 리온,2023-08
2023-08-31,6993475,72815379,-65821904,기타국,2023-08
2023-08-31,6756638,1868281,4888357,니카라과,2023-08
2023-08-31,6587894,2867868,3720026,레바논,2023-08
2023-08-31,6205629,6589175,-383546,라트비아,2023-08
2023-08-31,5939388,660513,5278875,파라과이,2023-08
2023-08-31,5814266,12017,5802249,팔레스타인 해방기구,2023-08
2023-08-31,5247783,4671988,575795,크로아티아,2023-08
2023-08-31,4876524,453809,4422715,베네주엘라,2023-08
2023-08-31,4838859,2110614,2728245,아이슬란드,2023-08
2023-08-31,4831885,369139,4462746,벨라루스,2023-08
2023-08-31,4712669,8811527,-4098858,몰도바,2023-08
2023-08-31,4426490,69951124,-65524634,볼리비아,2023-08
2023-08-31,4291415,589850,3701565,사이프러스,2023-08
2023-08-31,4234499,175205,4059294,카메룬,2023-08
2023-08-31,4016265,4857093,-840828,라오스,2023-08
2023-08-31,3893351,2283532,1609819,예맨,2023-08
2023-08-31,3646500,37710,3608790,부르키나 파소,2023-08
2023-08-31,3567186,554852,3012334,아이티,2023-08
2023-08-31,3472299,37499305,-34027006,뉴 칼레도니아,2023-08
2023-08-31,3463447,22089615,-18626168,트리니다드 토바고,2023-08
2023-08-31,3273767,0,3273767,지부티,2023-08
2023-08-31,3139426,345616,2793810,모리셔스,2023-08
2023-08-31,3046256,209737,2836519,아프카니스탄,2023-08
2023-08-31,2997814,11132013,-8134199,마다카스카르,2023-08
2023-08-31,2524807,0,2524807,가이아나,2023-08
2023-08-31,2495877,765,2495112,불령 리유니온 코모도 제도,2023-08
2023-08-31,2461805,11505794,-9043989,아르메니아,2023-08
2023-08-31,2447439,4540954,-2093515,잠비아,2023-08
2023-08-31,2279730,22135981,-19856251,파푸아 뉴기니,2023-08
2023-08-31,2219764,6539156,-4319392,룩셈부르그,2023-08
2023-08-31,2174750,1150204,1024546,콩고,2023-08
2023-08-31,2168592,39295236,-37126644,브루나이,2023-08
2023-08-31,1905939,589467,1316472,쿠바,2023-08
2023-08-31,1902218,16292,1885926,사모아,2023-08
2023-08-31,1883690,452,1883238,말리,2023-08
2023-08-31,1874544,4969816,-3095272,기니,2023-08
2023-08-31,1845551,0,1845551,아루바,2023-08
2023-08-31,1820094,16474,1803620,자마이카,2023-08
2023-08-31,1799519,320,1799199,소말리아,2023-08
2023-08-31,1782918,65351,1717567,북마리아나 군도,2023-08
2023-08-31,1751177,10,1751167,안타티카,2023-08
2023-08-31,1724735,323161,1401574,수단,2023-08
2023-08-31,1675369,651700,1023669,네팔,2023-08
2023-08-31,1628265,233109,1395156,가봉,2023-08
2023-08-31,1488959,407058,1081901,마카오,2023-08
2023-08-31,1432004,17,1431987,베닝,2023-08
2023-08-31,1404488,1457402,-52914,말라위,2023-08
2023-08-31,1341263,2856236,-1514973,보스니아-헤르체고비나,2023-08
2023-08-31,1215404,0,1215404,솔로몬 군도,2023-08
2023-08-31,1166518,614772,551746,우간다,2023-08
2023-08-31,1135289,56117,1079172,벨리제,2023-08
2023-08-31,1097242,49325,1047917,시리아,2023-08
2023-08-31,1062335,500,1061835,영령 캐이맨 군도,2023-08
2023-08-31,1049019,16125940,-15076921,몬테네그로,2023-08
2023-08-31,880450,0,880450,과델로프,2023-08
2023-08-31,867474,23535,843939,르완다,2023-08
2023-08-31,809685,0,809685,세인트 마틴,2023-08
2023-08-31,798861,479011,319850,짐바브웨,2023-08
2023-08-31,731856,0,731856,키리바티,2023-08
2023-08-31,703080,467565,235515,아메리칸 사모아,2023-08
2023-08-31,686833,0,686833,큐라소,2023-08
2023-08-31,663886,0,663886,투르크멘,2023-08
2023-08-31,652192,483,651709,몰디브,2023-08
2023-08-31,590811,9807,581004,바베이도스,2023-08
2023-08-31,579820,972249,-392429,리히텐슈타인,2023-08
2023-08-31,494772,198551,296221,바하마,2023-08
2023-08-31,473922,575469,-101547,모리타니,2023-08
2023-08-31,446528,1630120,-1183592,바누아투,2023-08
2023-08-31,441939,13920,428019,세인트 루시아,2023-08
2023-08-31,429068,0,429068,마티니크,2023-08
2023-08-31,423337,1180,422157,챠드,2023-08
2023-08-31,408268,3645,404623,도미니카,2023-08
2023-08-31,406303,3355156,-2948853,마세도니아,2023-08
2023-08-31,368283,2473,365810,티모르,2023-08
2023-08-31,332315,2570,329745,투발루,2023-08
2023-08-31,316819,0,316819,팔라우,2023-08
2023-08-31,245157,403288,-158131,수리남,2023-08
2023-08-31,244135,400,243735,버뮤다,2023-08
2023-08-31,239393,0,239393,영령 버진군도,2023-08
2023-08-31,235107,308082,-72975,세이쉘,2023-08
2023-08-31,220033,6271,213762,부룬디,2023-08
2023-08-31,210997,1410,209587,상토메 프린스페,2023-08
2023-08-31,184579,36613730,-36429151,적도 기니,2023-08
2023-08-31,180994,825,180169,그레나다,2023-08
2023-08-31,169043,569488,-400445,모나코,2023-08
2023-08-31,163331,633505,-470174,감비아,2023-08
2023-08-31,150251,187500,-37249,부탄,2023-08
2023-08-31,149880,12936,136944,스와질랜드,2023-08
2023-08-31,129758,0,129758,불령 가이아나,2023-08
2023-08-31,129510,0,129510,남수단,2023-08
2023-08-31,118216,16413,101803,산마리노,2023-08
2023-08-31,93859,1262,92597,카보 베르데,2023-08
2023-08-31,62678,575,62103,네덜란드 열도,2023-08
2023-08-31,55000,0,55000,레소토,2023-08
2023-08-31,42850,23469,19381,니제르,2023-08
2023-08-31,30255,0,30255,메요트,2023-08
2023-08-31,23077,28731,-5654,중앙아프리카공화국,2023-08
2023-08-31,22875,1724,21151,에리트리아,2023-08
2023-08-31,20508,19634,874,보츠와나,2023-08
2023-08-31,19451,40,19411,세인트 키츠 네비스,2023-08
2023-08-31,17524,0,17524,나우루,2023-08
2023-08-31,12301,1977,10324,미령 버진군도,2023-08
2023-08-31,11832,0,11832,건지,2023-08
2023-08-31,11416,0,11416,안티가 바부다,2023-08
2023-08-31,3967,0,3967,노폴크 아일랜드,2023-08
2023-08-31,2790,0,2790,그린랜드,2023-08
2023-08-31,2500,190,2310,세인트 바르탤르미,2023-08
2023-08-31,1762,6564,-4802,안도라,2023-08
2023-08-31,1663,0,1663,세인트마틴(생마르탱),2023-08
2023-08-31,1635,13369,-11734,통가,2023-08
2023-08-31,1307,0,1307,세인트 빈센트 그레나딘,2023-08
2023-08-31,716,0,716,투르크 & 카이코스 군도,2023-08
2023-08-31,637,1137,-500,앙귈라,2023-08
2023-08-31,263,1575,-1312,저어지,2023-08
2023-08-31,0,17868,-17868,세인트 헬레나,2023-08
2023-08-31,0,276985,-276985,기네비소,2023-08
2023-08-31,0,161822,-161822,포클랜드 군도,2023-08
2023-08-31,0,1562,-1562,크리스마스 아일랜드,2023-08
2023-08-31,0,727,-727,불령 남부지역,2023-08
2023-08-31,0,271,-271,쿡 아일랜드,2023-08
2023-08-31,0,14,-14,국제통화기금,2023-08
2023-08-31,0,684,-684,몬트세라트,2023-08
2023-08-31,0,11845,-11845,마이너 아우틀링 합중국 군도,2023-08
2023-08-31,0,1450,-1450,토켈라우,2023-08
2023-09-30,10997619447,11143265400,-145645953,중국,2023-09
2023-09-30,10078333710,5122090022,4956243688,미국,2023-09
2023-09-30,4919326611,2255613838,2663712773,베트남,2023-09
2023-09-30,2512162147,3804957999,-1292795852,일본,2023-09
2023-09-30,2440824387,158123234,2282701153,홍콩,2023-09
2023-09-30,2145494086,1961988618,183505468,대만,2023-09
2023-09-30,1706134037,2274174720,-568040683,호주,2023-09
2023-09-30,1638479892,552159132,1086320760,인도,2023-09
2023-09-30,1604598433,803279245,801319188,싱가포르,2023-09
2023-09-30,1084411050,818704668,265706382,멕시코,2023-09
2023-09-30,939329345,1710586870,-771257525,독일,2023-09
2023-09-30,783620306,1130890172,-347269866,말레이시아,2023-09
2023-09-30,762835491,90884704,671950787,폴란드,2023-09
2023-09-30,738417159,986086931,-247669772,인도네시아,2023-09
2023-09-30,727520779,122710388,604810391,튀르키예,2023-09
2023-09-30,711564734,320072835,391491899,필리핀,2023-09
2023-09-30,575590373,405560134,170030239,캐나다,2023-09
2023-09-30,565942353,801869424,-235927071,네덜란드,2023-09
2023-09-30,560554834,563927006,-3372172,태국,2023-09
2023-09-30,525689799,691847065,-166157266,프랑스,2023-09
2023-09-30,485915365,309839240,176076125,영국,2023-09
2023-09-30,473693105,59767359,413925746,헝가리,2023-09
2023-09-30,372589317,637344754,-264755437,브라질,2023-09
2023-09-30,372447037,2996730706,-2624283669,사우디아라비아,2023-09
2023-09-30,368742519,627670151,-258927632,러시아 연방,2023-09
2023-09-30,350525511,609813683,-259288172,이탈리아,2023-09
2023-09-30,322558140,350316563,-27758423,벨기에,2023-09
2023-09-30,297991468,1862812775,-1564821307,아랍에미리트 연합,2023-09
2023-09-30,295860933,89649455,206211478,체코공화국,2023-09
2023-09-30,284384017,145496607,138887410,뉴질랜드,2023-09
2023-09-30,271830704,50440256,221390448,슬로바키아,2023-09
2023-09-30,258534092,177866017,80668075,스페인,2023-09
2023-09-30,219863038,5839173,214023865,몰타,2023-09
2023-09-30,201333419,400,201333019,영령 캐이맨 군도,2023-09
2023-09-30,192635945,51880435,140755510,우즈베키스탄,2023-09
2023-09-30,182526796,193580,182333216,라이베리아,2023-09
2023-09-30,141663025,5185442,136477583,에쿠아도르,2023-09
2023-09-30,136243807,125969425,10274382,카자흐스탄,2023-09
2023-09-30,127997381,2146760,125850621,토고,2023-09
2023-09-30,127830312,5915651,121914661,이집트,2023-09
2023-09-30,114468329,488122,113980207,키르기스스탄,2023-09
2023-09-30,113512941,86906852,26606089,이스라엘,2023-09
2023-09-30,112503681,578348048,-465844367,칠레,2023-09
2023-09-30,109775335,8209895,101565440,슬로베니아,2023-09
2023-09-30,105527897,152707915,-47180018,그리스,2023-09
2023-09-30,98775240,210195031,-111419791,스웨덴,2023-09
2023-09-30,87995814,73738639,14257175,방글라데시,2023-09
2023-09-30,83289625,75771220,7518405,포루투갈,2023-09
2023-09-30,82868452,14430850,68437602,파키스탄,2023-09
2023-09-30,82841951,5476588,77365363,요르단,2023-09
2023-09-30,81820050,273498452,-191678402,스위스,2023-09
2023-09-30,78823812,1491487108,-1412663296,카타르,2023-09
2023-09-30,76939463,106108052,-29168589,오스트리아,2023-09
2023-09-30,71803940,94037605,-22233665,콜롬비아,2023-09
2023-09-30,70466685,639216097,-568749412,이라크,2023-09
2023-09-30,69996697,769,69995928,바하마,2023-09
2023-09-30,62415425,553837,61861588,괌,2023-09
2023-09-30,60960788,23844814,37115974,파나마,2023-09
2023-09-30,58524435,349097517,-290573082,남아프리카공화국,2023-09
2023-09-30,56389496,8218715,48170781,스리랑카,2023-09
2023-09-30,54005649,218863532,-164857883,페루,2023-09
2023-09-30,51687993,78650236,-26962243,덴마크,2023-09
2023-09-30,50475378,34654148,15821230,캄보디아,2023-09
2023-09-30,49402019,9260437,40141582,나이지리아,2023-09
2023-09-30,47584315,347096,47237219,리비아,2023-09
2023-09-30,46855951,109123798,-62267847,아일랜드,2023-09
2023-09-30,46381909,54308204,-7926295,루마니아,2023-09
2023-09-30,45634577,29790438,15844139,푸에르토리코,2023-09
2023-09-30,45328321,40247,45288074,마샬군도,2023-09
2023-09-30,43075302,7360207,35715095,몽골,2023-09
2023-09-30,42184288,16188457,25995831,우크라이나,2023-09
2023-09-30,41503377,269159628,-227656251,알제리,2023-09
2023-09-30,37852110,78281278,-40429168,노르웨이,2023-09
2023-09-30,35394943,338165713,-302770770,오만,2023-09
2023-09-30,34216066,554306,33661760,피지,2023-09
2023-09-30,31802712,102074421,-70271709,아르헨티나,2023-09
2023-09-30,31702088,7724531,23977557,리투아니아,2023-09
2023-09-30,25919414,67845790,-41926376,핀란드,2023-09
2023-09-30,25708289,65467193,-39758904,미얀마,2023-09
2023-09-30,25548978,849530340,-823981362,쿠웨이트,2023-09
2023-09-30,25548151,6626116,18922035,에스토니아,2023-09
2023-09-30,24837316,15327554,9509762,도미니카 공화국,2023-09
2023-09-30,23536222,10509365,13026857,모로코,2023-09
2023-09-30,23153068,2871087,20281981,케냐,2023-09
2023-09-30,22140278,694316,21445962,탄자니아,2023-09
2023-09-30,21406062,251,21405811,아제르바이잔,2023-09
2023-09-30,21155843,9768312,11387531,과테말라,2023-09
2023-09-30,18576323,87003451,-68427128,바레인,2023-09
2023-09-30,18365192,6689199,11675993,세르비아,2023-09
2023-09-30,17890059,1068395,16821664,코트디봐르,2023-09
2023-09-30,17538148,63514572,-45976424,콩고민주공화국,2023-09
2023-09-30,17238541,2116445,15122096,엘살바도르,2023-09
2023-09-30,17230843,11539788,5691055,코스타리카,2023-09
2023-09-30,15561168,188123,15373045,이란,2023-09
2023-09-30,15427484,48205021,-32777537,불가리아,2023-09
2023-09-30,15139801,4594202,10545599,세네갈,2023-09
2023-09-30,14967404,4007488,10959916,온두라스,2023-09
2023-09-30,14318839,2537395,11781444,가나,2023-09
2023-09-30,13784885,11418192,2366693,우루과이,2023-09
2023-09-30,13724337,861221,12863116,알바니아,2023-09
2023-09-30,13673670,1371506,12302164,조지아,2023-09
2023-09-30,12925106,5736387,7188719,튀니지,2023-09
2023-09-30,12800396,6295060,6505336,라트비아,2023-09
2023-09-30,12322850,1317901,11004949,시에라 리온,2023-09
2023-09-30,10625998,7023,10618975,불령 폴리네시아,2023-09
2023-09-30,8870371,2531965,6338406,아이슬란드,2023-09
2023-09-30,8681085,414432,8266653,파라과이,2023-09
2023-09-30,8203712,7446442,757270,라오스,2023-09
2023-09-30,7841435,7165239,676196,룩셈부르그,2023-09
2023-09-30,7762745,13025966,-5263221,파푸아 뉴기니,2023-09
2023-09-30,7105578,1393472,5712106,레바논,2023-09
2023-09-30,7065610,37040218,-29974608,모잠비크,2023-09
2023-09-30,6682728,2137437,4545291,크로아티아,2023-09
2023-09-30,6610557,2189,6608368,타지크,2023-09
2023-09-30,5998024,1699576,4298448,니카라과,2023-09
2023-09-30,5709650,1316,5708334,앙골라,2023-09
2023-09-30,5700058,0,5700058,팔라우,2023-09
2023-09-30,5412997,275175,5137822,벨라루스,2023-09
2023-09-30,5325770,11972496,-6646726,트리니다드 토바고,2023-09
2023-09-30,4252798,1722560,2530238,부르키나 파소,2023-09
2023-09-30,4195449,2265765,1929684,예맨,2023-09
2023-09-30,4192675,14457586,-10264911,마다카스카르,2023-09
2023-09-30,4079509,89187,3990322,아이티,2023-09
2023-09-30,4029282,33242545,-29213263,기타국,2023-09
2023-09-30,3855818,966855,2888963,브루나이,2023-09
2023-09-30,3635368,1279046,2356322,베네주엘라,2023-09
2023-09-30,3590803,136,3590667,불령 리유니온 코모도 제도,2023-09
2023-09-30,3577018,2798436,778582,몰도바,2023-09
2023-09-30,3573299,354882,3218417,사이프러스,2023-09
2023-09-30,3473761,204156,3269605,자마이카,2023-09
2023-09-30,3454274,436190,3018084,콩고,2023-09
2023-09-30,3335221,287123,3048098,모리셔스,2023-09
2023-09-30,3217021,0,3217021,투르크멘,2023-09
2023-09-30,3214791,15635944,-12421153,에티오피아,2023-09
2023-09-30,3041875,535099,2506776,카메룬,2023-09
2023-09-30,2982324,11793,2970531,말리,2023-09
2023-09-30,2888798,10582862,-7694064,아르메니아,2023-09
2023-09-30,2836483,1,2836482,지부티,2023-09
2023-09-30,2778034,34,2778000,사모아,2023-09
2023-09-30,2755816,0,2755816,팔레스타인 해방기구,2023-09
2023-09-30,2169384,3219049,-1049665,기니,2023-09
2023-09-30,2085537,113647,1971890,아프카니스탄,2023-09
2023-09-30,1983539,2726048,-742509,가봉,2023-09
2023-09-30,1974225,3254172,-1279947,보스니아-헤르체고비나,2023-09
2023-09-30,1840009,1728,1838281,가이아나,2023-09
2023-09-30,1812740,389786,1422954,네팔,2023-09
2023-09-30,1803617,177854,1625763,마카오,2023-09
2023-09-30,1789463,368398,1421065,쿠바,2023-09
2023-09-30,1788388,325968,1462420,수단,2023-09
2023-09-30,1565181,37974861,-36409680,뉴 칼레도니아,2023-09
2023-09-30,1479585,42127552,-40647967,몬테네그로,2023-09
2023-09-30,1474410,0,1474410,아루바,2023-09
2023-09-30,1345875,322757,1023118,우간다,2023-09
2023-09-30,1251460,18530,1232930,북마리아나 군도,2023-09
2023-09-30,1242534,928,1241606,몰디브,2023-09
2023-09-30,1242499,1806007,-563508,잠비아,2023-09
2023-09-30,1157704,0,1157704,과델로프,2023-09
2023-09-30,1143542,241251,902291,소말리아,2023-09
2023-09-30,1137858,30039,1107819,베닝,2023-09
2023-09-30,1130303,6788,1123515,벨리제,2023-09
2023-09-30,1055026,2264532,-1209506,모리타니,2023-09
2023-09-30,1032581,15058169,-14025588,볼리비아,2023-09
2023-09-30,1021462,696340,325122,짐바브웨,2023-09
2023-09-30,974569,985396,-10827,바누아투,2023-09
2023-09-30,959882,9723,950159,시리아,2023-09
2023-09-30,957504,466826,490678,마세도니아,2023-09
2023-09-30,866010,238319,627691,르완다,2023-09
2023-09-30,777723,645441,132282,아메리칸 사모아,2023-09
2023-09-30,763742,4541,759201,니제르,2023-09
2023-09-30,762599,0,762599,세인트 마틴,2023-09
2023-09-30,713360,0,713360,큐라소,2023-09
2023-09-30,677147,0,677147,챠드,2023-09
2023-09-30,631859,0,631859,적도 기니,2023-09
2023-09-30,550626,1188600,-637974,부탄,2023-09
2023-09-30,528517,1207371,-678854,키리바티,2023-09
2023-09-30,513187,785880,-272693,세이쉘,2023-09
2023-09-30,507955,33914,474041,부룬디,2023-09
2023-09-30,495544,27,495517,솔로몬 군도,2023-09
2023-09-30,464579,39690,424889,마이크로네시아,2023-09
2023-09-30,443283,286822,156461,수리남,2023-09
2023-09-30,433540,1115111,-681571,리히텐슈타인,2023-09
2023-09-30,365902,0,365902,남수단,2023-09
2023-09-30,342098,40,342058,그레나다,2023-09
2023-09-30,322451,37504,284947,도미니카,2023-09
2023-09-30,314753,558130,-243377,감비아,2023-09
2023-09-30,296234,0,296234,에리트리아,2023-09
2023-09-30,296156,137327,158829,말라위,2023-09
2023-09-30,260809,3004,257805,티모르,2023-09
2023-09-30,252671,0,252671,마티니크,2023-09
2023-09-30,252084,0,252084,안티가 바부다,2023-09
2023-09-30,229009,0,229009,투발루,2023-09
2023-09-30,227298,0,227298,세인트 루시아,2023-09
2023-09-30,210151,0,210151,불령 가이아나,2023-09
2023-09-30,173518,53268,120250,스와질랜드,2023-09
2023-09-30,170447,4666,165781,바베이도스,2023-09
2023-09-30,158737,125033,33704,산마리노,2023-09
2023-09-30,126823,11112635,-10985812,나미비아,2023-09
2023-09-30,124589,0,124589,세인트 빈센트 그레나딘,2023-09
2023-09-30,102107,0,102107,메요트,2023-09
2023-09-30,98181,12685,85496,보츠와나,2023-09
2023-09-30,82755,200,82555,버뮤다,2023-09
2023-09-30,80630,124,80506,영령 버진군도,2023-09
2023-09-30,60884,16803,44081,네덜란드 열도,2023-09
2023-09-30,47307,1480,45827,세인트 키츠 네비스,2023-09
2023-09-30,36762,13538,23224,통가,2023-09
2023-09-30,29793,0,29793,코모로스,2023-09
2023-09-30,26401,0,26401,카보 베르데,2023-09
2023-09-30,19993,3474782,-3454789,나우루,2023-09
2023-09-30,16650,0,16650,투르크 & 카이코스 군도,2023-09
2023-09-30,3302,647,2655,몬트세라트,2023-09
2023-09-30,3250,1272,1978,코스 군도,2023-09
2023-09-30,2753,608,2145,지브랄타,2023-09
2023-09-30,2448,0,2448,보네르 신트외스타티위스,2023-09
2023-09-30,2070,17568,-15498,안도라,2023-09
2023-09-30,1966,5785,-3819,그린랜드,2023-09
2023-09-30,1195,1989,-794,미령 버진군도,2023-09
2023-09-30,1020,0,1020,세인트마틴(생마르탱),2023-09
2023-09-30,971,452,519,남조지아 & 남샌드위치 군도,2023-09
2023-09-30,644,548,96,앙귈라,2023-09
2023-09-30,320,369,-49,저어지,2023-09
2023-09-30,105,0,105,중앙아프리카공화국,2023-09
2023-09-30,69,448703,-448634,파로에 군도,2023-09
2023-09-30,65,211069,-211004,모나코,2023-09
2023-09-30,18,0,18,쿡 아일랜드,2023-09
2023-09-30,0,44696,-44696,레소토,2023-09
2023-09-30,0,355,-355,영령 인도양,2023-09
2023-09-30,0,10,-10,크리스마스 아일랜드,2023-09
2023-09-30,0,483,-483,마이너 아우틀링 합중국 군도,2023-09
2023-09-30,0,13,-13,국제통화기금,2023-09
2023-09-30,0,2554,-2554,토켈라우,2023-09
2023-09-30,0,646,-646,불령 남부지역,2023-09
2023-09-30,0,254169,-254169,기네비소,2023-09
2023-09-30,0,11,-11,안타티카,2023-09
2023-09-30,0,207855,-207855,맨섬,2023-09
2023-09-30,0,22,-22,니우에,2023-09
2023-10-31,10993481489,12549077951,-1555596462,중국,2023-10
2023-10-31,10059688605,6212985705,3846702900,미국,2023-10
2023-10-31,4832318494,2266381858,2565936636,베트남,2023-10
2023-10-31,2492282609,3932137045,-1439854436,일본,2023-10
2023-10-31,2430687603,193223778,2237463825,홍콩,2023-10
2023-10-31,2238050041,880184514,1357865527,싱가포르,2023-10
2023-10-31,1926977207,2601077600,-674100393,호주,2023-10
2023-10-31,1702459511,2168181678,-465722167,대만,2023-10
2023-10-31,1531651230,598427169,933224061,인도,2023-10
2023-10-31,999501479,1286527095,-287025616,말레이시아,2023-10
2023-10-31,974431281,564996340,409434941,멕시코,2023-10
2023-10-31,809955526,410276834,399678692,필리핀,2023-10
2023-10-31,775010861,71190110,703820751,폴란드,2023-10
2023-10-31,739269109,127096448,612172661,튀르키예,2023-10
2023-10-31,712266659,1931809072,-1219542413,독일,2023-10
2023-10-31,709530560,439503921,270026639,캐나다,2023-10
2023-10-31,652550561,797384293,-144833732,인도네시아,2023-10
2023-10-31,602572159,567663386,34908773,태국,2023-10
2023-10-31,507481570,799799017,-292317447,프랑스,2023-10
2023-10-31,460715111,42656,460672455,마샬군도,2023-10
2023-10-31,442835714,418655730,24179984,네덜란드,2023-10
2023-10-31,423588736,579908892,-156320156,영국,2023-10
2023-10-31,416073200,65610844,350462356,헝가리,2023-10
2023-10-31,409101142,2569486061,-2160384919,사우디아라비아,2023-10
2023-10-31,384949156,596106805,-211157649,러시아 연방,2023-10
2023-10-31,357206691,1453030940,-1095824249,아랍에미리트 연합,2023-10
2023-10-31,344417573,123607985,220809588,벨기에,2023-10
2023-10-31,333797589,686140959,-352343370,브라질,2023-10
2023-10-31,332667813,66045285,266622528,미얀마,2023-10
2023-10-31,306812456,635274959,-328462503,이탈리아,2023-10
2023-10-31,282098905,519462,281579443,라이베리아,2023-10
2023-10-31,270036870,154947669,115089201,뉴질랜드,2023-10
2023-10-31,220775785,125902113,94873672,체코공화국,2023-10
2023-10-31,217820190,57084285,160735905,슬로바키아,2023-10
2023-10-31,202925325,1446571,201478754,우즈베키스탄,2023-10
2023-10-31,195632783,163818017,31814766,스페인,2023-10
2023-10-31,183937127,88212060,95725067,그리스,2023-10
2023-10-31,153031805,540,153031265,앙골라,2023-10
2023-10-31,149384918,211750426,-62365508,카자흐스탄,2023-10
2023-10-31,139547347,48800086,90747261,몰타,2023-10
2023-10-31,133793587,14171,133779416,키르기스스탄,2023-10
2023-10-31,131268925,56938262,74330663,방글라데시,2023-10
2023-10-31,121090419,3077611,118012808,파나마,2023-10
2023-10-31,119657483,1001020688,-881363205,쿠웨이트,2023-10
2023-10-31,115057868,78657534,36400334,이스라엘,2023-10
2023-10-31,112069158,922516548,-810447390,이라크,2023-10
2023-10-31,103013914,6867932,96145982,이집트,2023-10
2023-10-31,101955324,5000360,96954964,에쿠아도르,2023-10
2023-10-31,98877470,8654490,90222980,슬로베니아,2023-10
2023-10-31,98192994,166729898,-68536904,스웨덴,2023-10
2023-10-31,92098440,273292339,-181193899,스위스,2023-10
2023-10-31,80794521,21357652,59436869,파키스탄,2023-10
2023-10-31,77005349,248540918,-171535569,남아프리카공화국,2023-10
2023-10-31,75783704,509949054,-434165350,칠레,2023-10
2023-10-31,66781024,132543260,-65762236,오스트리아,2023-10
2023-10-31,61901834,64405693,-2503859,콜롬비아,2023-10
2023-10-31,60382692,5539496,54843196,요르단,2023-10
2023-10-31,60147019,231967780,-171820761,오만,2023-10
2023-10-31,57829247,25111765,32717482,푸에르토리코,2023-10
2023-10-31,55034530,27980620,27053910,포루투갈,2023-10
2023-10-31,52832964,69669865,-16836901,덴마크,2023-10
2023-10-31,52736957,939417811,-886680854,카타르,2023-10
2023-10-31,52380199,204050086,-151669887,페루,2023-10
2023-10-31,51327494,172968795,-121641301,나이지리아,2023-10
2023-10-31,49123441,26551947,22571494,리비아,2023-10
2023-10-31,46341799,131839984,-85498185,아일랜드,2023-10
2023-10-31,43873710,29506875,14366835,캄보디아,2023-10
2023-10-31,38882948,4428786,34454162,몽골,2023-10
2023-10-31,38626400,59016714,-20390314,루마니아,2023-10
2023-10-31,38053968,53665617,-15611649,파푸아 뉴기니,2023-10
2023-10-31,36804460,2140873,34663587,탄자니아,2023-10
2023-10-31,33885454,41519687,-7634233,콩고민주공화국,2023-10
2023-10-31,28516248,63430939,-34914691,핀란드,2023-10
2023-10-31,27142696,11044782,16097914,모로코,2023-10
2023-10-31,27121928,8222027,18899901,리투아니아,2023-10
2023-10-31,24813392,15315864,9497528,우크라이나,2023-10
2023-10-31,24755864,176089825,-151333961,아르헨티나,2023-10
2023-10-31,22933025,7971701,14961324,세르비아,2023-10
2023-10-31,21872653,6811536,15061117,도미니카 공화국,2023-10
2023-10-31,20346390,21773,20324617,아제르바이잔,2023-10
2023-10-31,20237176,368575,19868601,코트디봐르,2023-10
2023-10-31,20219842,258425,19961417,괌,2023-10
2023-10-31,18470206,7195768,11274438,과테말라,2023-10
2023-10-31,18259410,14831893,3427517,코스타리카,2023-10
2023-10-31,17234399,2005039,15229360,가나,2023-10
2023-10-31,16616300,377585363,-360969063,알제리,2023-10
2023-10-31,16523768,298619,16225149,이란,2023-10
2023-10-31,16167019,64903074,-48736055,불가리아,2023-10
2023-10-31,15445585,3361865,12083720,엘살바도르,2023-10
2023-10-31,15429754,7926929,7502825,스리랑카,2023-10
2023-10-31,14842049,81456504,-66614455,노르웨이,2023-10
2023-10-31,14671926,648831,14023095,알바니아,2023-10
2023-10-31,14338194,21656568,-7318374,온두라스,2023-10
2023-10-31,13939531,858175,13081356,조지아,2023-10
2023-10-31,12596005,4235946,8360059,세네갈,2023-10
2023-10-31,12558017,5253780,7304237,케냐,2023-10
2023-10-31,10241598,10897450,-655852,트리니다드 토바고,2023-10
2023-10-31,10063212,213141,9850071,콩고,2023-10
2023-10-31,10039343,5907242,4132101,우루과이,2023-10
2023-10-31,9152318,6257,9146061,타지크,2023-10
2023-10-31,9039789,5239828,3799961,라오스,2023-10
2023-10-31,8662959,64774159,-56111200,튀니지,2023-10
2023-10-31,8219488,59247020,-51027532,바레인,2023-10
2023-10-31,8191288,50752778,-42561490,모잠비크,2023-10
2023-10-31,8119895,1328357,6791538,시에라 리온,2023-10
2023-10-31,7931304,36808,7894496,마이크로네시아,2023-10
2023-10-31,6550343,295178,6255165,벨라루스,2023-10
2023-10-31,6506752,16454117,-9947365,에티오피아,2023-10
2023-10-31,6141122,763498,5377624,파라과이,2023-10
2023-10-31,5903572,3109402,2794170,예맨,2023-10
2023-10-31,5424113,3944952,1479161,레바논,2023-10
2023-10-31,5367197,7043661,-1676464,크로아티아,2023-10
2023-10-31,4942037,7536269,-2594232,에스토니아,2023-10
2023-10-31,4834358,8316604,-3482246,라트비아,2023-10
2023-10-31,4571853,1540392,3031461,니카라과,2023-10
2023-10-31,4192871,617205,3575666,사이프러스,2023-10
2023-10-31,4132533,18836645,-14704112,볼리비아,2023-10
2023-10-31,4004238,92841,3911397,팔레스타인 해방기구,2023-10
2023-10-31,3936620,0,3936620,과델로프,2023-10
2023-10-31,3742682,0,3742682,안타티카,2023-10
2023-10-31,3525869,256642,3269227,모리셔스,2023-10
2023-10-31,3511760,66543,3445217,자마이카,2023-10
2023-10-31,3487858,551579,2936279,네팔,2023-10
2023-10-31,3214462,8683453,-5468991,마다카스카르,2023-10
2023-10-31,3204552,2849395,355157,브루나이,2023-10
2023-10-31,3169034,185840,2983194,피지,2023-10
2023-10-31,3077755,5246198,-2168443,룩셈부르그,2023-10
2023-10-31,3071677,1752055,1319622,토고,2023-10
2023-10-31,2910839,190469,2720370,불령 폴리네시아,2023-10
2023-10-31,2730262,55730125,-52999863,기타국,2023-10
2023-10-31,2678332,2727798,-49466,몰도바,2023-10
2023-10-31,2597259,1895910,701349,베네주엘라,2023-10
2023-10-31,2593472,45987,2547485,아이티,2023-10
2023-10-31,2524502,119082,2405420,아프카니스탄,2023-10
2023-10-31,2469569,13980,2455589,사모아,2023-10
2023-10-31,2389676,637874,1751802,카메룬,2023-10
2023-10-31,2335956,0,2335956,마티니크,2023-10
2023-10-31,2305406,11802846,-9497440,아르메니아,2023-10
2023-10-31,2263662,20,2263642,가이아나,2023-10
2023-10-31,2044203,31541,2012662,부르키나 파소,2023-10
2023-10-31,1830886,907578,923308,기니,2023-10
2023-10-31,1805180,740591,1064589,수단,2023-10
2023-10-31,1734512,1877952,-143440,잠비아,2023-10
2023-10-31,1635049,10312584,-8677535,몬테네그로,2023-10
2023-10-31,1602878,9280,1593598,벨리제,2023-10
2023-10-31,1590423,0,1590423,지부티,2023-10
2023-10-31,1399804,179612,1220192,베닝,2023-10
2023-10-31,1351312,1783549,-432237,아이슬란드,2023-10
2023-10-31,1312332,65186,1247146,북마리아나 군도,2023-10
2023-10-31,1188825,282373,906452,소말리아,2023-10
2023-10-31,1181027,84,1180943,불령 리유니온 코모도 제도,2023-10
2023-10-31,1179964,334093,845871,아메리칸 사모아,2023-10
2023-10-31,1175481,0,1175481,영령 캐이맨 군도,2023-10
2023-10-31,1120244,26171122,-25050878,뉴 칼레도니아,2023-10
2023-10-31,1117123,338365,778758,마세도니아,2023-10
2023-10-31,1111705,186256,925449,세이쉘,2023-10
2023-10-31,1009148,412335,596813,마카오,2023-10
2023-10-31,1007386,3310716,-2303330,보스니아-헤르체고비나,2023-10
2023-10-31,992157,0,992157,아루바,2023-10
2023-10-31,954885,160530,794355,가봉,2023-10
2023-10-31,927532,298311,629221,르완다,2023-10
2023-10-31,926027,986446,-60419,쿠바,2023-10
2023-10-31,897084,587445,309639,바누아투,2023-10
2023-10-31,849049,2726260,-1877211,짐바브웨,2023-10
2023-10-31,711600,2858,708742,시리아,2023-10
2023-10-31,692349,20798,671551,바하마,2023-10
2023-10-31,683153,3300262,-2617109,투발루,2023-10
2023-10-31,606108,1679841,-1073733,리히텐슈타인,2023-10
2023-10-31,596458,269922,326536,감비아,2023-10
2023-10-31,595880,141,595739,몰디브,2023-10
2023-10-31,562701,2947899,-2385198,모리타니,2023-10
2023-10-31,535202,1903,533299,세인트 루시아,2023-10
2023-10-31,486421,93009546,-92523125,챠드,2023-10
2023-10-31,485817,2442764,-1956947,솔로몬 군도,2023-10
2023-10-31,460847,11,460836,버뮤다,2023-10
2023-10-31,449225,2646141,-2196916,말라위,2023-10
2023-10-31,434932,914316,-479384,부탄,2023-10
2023-10-31,426845,21949,404896,바베이도스,2023-10
2023-10-31,410521,208942,201579,우간다,2023-10
2023-10-31,408540,880770,-472230,수리남,2023-10
2023-10-31,376822,0,376822,세인트 마틴,2023-10
2023-10-31,371756,0,371756,메요트,2023-10
2023-10-31,357838,25877,331961,팔라우,2023-10
2023-10-31,352511,147002,205509,티모르,2023-10
2023-10-31,332450,0,332450,큐라소,2023-10
2023-10-31,321833,23908,297925,키리바티,2023-10
2023-10-31,295847,42129719,-41833872,적도 기니,2023-10
2023-10-31,293221,0,293221,불령 가이아나,2023-10
2023-10-31,272422,0,272422,안티가 바부다,2023-10
2023-10-31,222609,839,221770,지브랄타,2023-10
2023-10-31,212082,141,211941,세인트 빈센트 그레나딘,2023-10
2023-10-31,204817,0,204817,투르크멘,2023-10
2023-10-31,194060,0,194060,카보 베르데,2023-10
2023-10-31,188145,0,188145,그레나다,2023-10
2023-10-31,168059,0,168059,남수단,2023-10
2023-10-31,162934,206,162728,부룬디,2023-10
2023-10-31,150937,13758,137179,도미니카,2023-10
2023-10-31,138143,10775,127368,보츠와나,2023-10
2023-10-31,119272,49805,69467,스와질랜드,2023-10
2023-10-31,96596,1144,95452,말리,2023-10
2023-10-31,90255,1946,88309,네덜란드 열도,2023-10
2023-10-31,79482,0,79482,에리트리아,2023-10
2023-10-31,66817,21407,45410,세인트 키츠 네비스,2023-10
2023-10-31,64702,11,64691,영령 버진군도,2023-10
2023-10-31,52697,26860162,-26807465,나미비아,2023-10
2023-10-31,38350,143817,-105467,산마리노,2023-10
2023-10-31,26019,0,26019,상토메 프린스페,2023-10
2023-10-31,18609,1694,16915,니제르,2023-10
2023-10-31,9200,0,9200,쿡 아일랜드,2023-10
2023-10-31,6877,0,6877,앙귈라,2023-10
2023-10-31,6041,0,6041,세인트 바르탤르미,2023-10
2023-10-31,2371,74776,-72405,그린랜드,2023-10
2023-10-31,2050,4275,-2225,통가,2023-10
2023-10-31,2023,77,1946,안도라,2023-10
2023-10-31,1959,0,1959,기네비소,2023-10
2023-10-31,1917,1441,476,건지,2023-10
2023-10-31,1660,0,1660,중앙아프리카공화국,2023-10
2023-10-31,1637,0,1637,세인트마틴(생마르탱),2023-10
2023-10-31,590,93289,-92699,모나코,2023-10
2023-10-31,270,96,174,미령 버진군도,2023-10
2023-10-31,261,2814,-2553,몬트세라트,2023-10
2023-10-31,245,0,245,파로에 군도,2023-10
2023-10-31,0,105,-105,투르크 & 카이코스 군도,2023-10
2023-10-31,0,44,-44,영령 인도양,2023-10
2023-10-31,0,1490,-1490,코스 군도,2023-10
2023-10-31,0,776,-776,스발비드 군도,2023-10
2023-10-31,0,171,-171,불령 남부지역,2023-10
2023-10-31,0,2,-2,국제통화기금,2023-10
2023-10-31,0,58505,-58505,니우에,2023-10
2023-10-31,0,2518,-2518,저어지,2023-10
2023-10-31,0,12564,-12564,마이너 아우틀링 합중국 군도,2023-10
2023-10-31,0,403,-403,나우루,2023-10
2023-10-31,0,193,-193,피트카이른,2023-10
2023-10-31,0,120797,-120797,교황청,2023-10
2023-10-31,0,264,-264,남조지아 & 남샌드위치 군도,2023-10
2023-10-31,0,2722,-2722,토켈라우,2023-10
2023-11-30,11342928349,12087236707,-744308358,중국,2023-11
2023-11-30,10943600066,6204912236,4738687830,미국,2023-11
2023-11-30,4913358495,1994821689,2918536806,베트남,2023-11
2023-11-30,2753503670,183056210,2570447460,홍콩,2023-11
2023-11-30,2542676598,3717928114,-1175251516,일본,2023-11
2023-11-30,1691821017,2068736611,-376915594,대만,2023-11
2023-11-30,1684766296,851918087,832848209,싱가포르,2023-11
2023-11-30,1523664455,603715436,919949019,인도,2023-11
2023-11-30,1389097791,2494498667,-1105400876,호주,2023-11
2023-11-30,1051184546,538424907,512759639,멕시코,2023-11
2023-11-30,940532136,1247292723,-306760587,말레이시아,2023-11
2023-11-30,858698073,1999468366,-1140770293,독일,2023-11
2023-11-30,805858702,896620236,-90761534,인도네시아,2023-11
2023-11-30,801807369,512199719,289607650,캐나다,2023-11
2023-11-30,758248828,402982921,355265907,필리핀,2023-11
2023-11-30,742263136,72240413,670022723,폴란드,2023-11
2023-11-30,670873238,141156159,529717079,튀르키예,2023-11
2023-11-30,589256583,536153731,53102852,태국,2023-11
2023-11-30,537548316,457020106,80528210,네덜란드,2023-11
2023-11-30,524965007,561170778,-36205771,프랑스,2023-11
2023-11-30,413562230,64882018,348680212,헝가리,2023-11
2023-11-30,403634177,594996691,-191362514,영국,2023-11
2023-11-30,396212026,613765348,-217553322,러시아 연방,2023-11
2023-11-30,379631363,2951579002,-2571947639,사우디아라비아,2023-11
2023-11-30,369346117,730166668,-360820551,이탈리아,2023-11
2023-11-30,348413744,39313,348374431,마샬군도,2023-11
2023-11-30,338667743,1463943197,-1125275454,아랍에미리트 연합,2023-11
2023-11-30,333313176,383632426,-50319250,브라질,2023-11
2023-11-30,294121214,115632450,178488764,벨기에,2023-11
2023-11-30,275511192,178641992,96869200,스페인,2023-11
2023-11-30,269397944,136856898,132541046,뉴질랜드,2023-11
2023-11-30,267619463,63127770,204491693,슬로바키아,2023-11
2023-11-30,263474989,113507017,149967972,체코공화국,2023-11
2023-11-30,259302297,236162,259066135,라이베리아,2023-11
2023-11-30,229166047,34068459,195097588,포루투갈,2023-11
2023-11-30,205960773,821472,205139301,우즈베키스탄,2023-11
2023-11-30,161867434,35,161867399,앙골라,2023-11
2023-11-30,154473962,205320020,-50846058,카자흐스탄,2023-11
2023-11-30,144765367,39831251,104934116,방글라데시,2023-11
2023-11-30,118911395,812064489,-693153094,이라크,2023-11
2023-11-30,110380262,7582262,102798000,이집트,2023-11
2023-11-30,110216880,139770407,-29553527,스웨덴,2023-11
2023-11-30,108575282,19272,108556010,키르기스스탄,2023-11
2023-11-30,107276889,12206402,95070487,슬로베니아,2023-11
2023-11-30,101768579,245903331,-144134752,스위스,2023-11
2023-11-30,81895028,9477692,72417336,토고,2023-11
2023-11-30,79302994,445606556,-366303562,칠레,2023-11
2023-11-30,78979246,28878095,50101151,파키스탄,2023-11
2023-11-30,74914656,114193949,-39279293,오스트리아,2023-11
2023-11-30,70004536,130766793,-60762257,아일랜드,2023-11
2023-11-30,69726031,61325159,8400872,콜롬비아,2023-11
2023-11-30,68937529,81551778,-12614249,이스라엘,2023-11
2023-11-30,64170269,158431968,-94261699,페루,2023-11
2023-11-30,63460882,163514598,-100053716,남아프리카공화국,2023-11
2023-11-30,59007789,561675408,-502667619,오만,2023-11
2023-11-30,55540014,803042828,-747502814,카타르,2023-11
2023-11-30,55486415,84393907,-28907492,덴마크,2023-11
2023-11-30,53037220,3297536,49739684,요르단,2023-11
2023-11-30,53021418,80648373,-27626955,나이지리아,2023-11
2023-11-30,52411510,45521782,6889728,푸에르토리코,2023-11
2023-11-30,50271008,77611270,-27340262,콩고민주공화국,2023-11
2023-11-30,50057812,2026635,48031177,리비아,2023-11
2023-11-30,49017215,12656076,36361139,코스타리카,2023-11
2023-11-30,47240558,38249737,8990821,캄보디아,2023-11
2023-11-30,47165641,556381,46609260,괌,2023-11
2023-11-30,46839259,88522377,-41683118,루마니아,2023-11
2023-11-30,38237117,5083611,33153506,에쿠아도르,2023-11
2023-11-30,37031273,6796798,30234475,몽골,2023-11
2023-11-30,36669456,17725397,18944059,도미니카 공화국,2023-11
2023-11-30,36295192,96883871,-60588679,노르웨이,2023-11
2023-11-30,33201711,606471,32595240,피지,2023-11
2023-11-30,33065812,12326326,20739486,모로코,2023-11
2023-11-30,31369815,27354645,4015170,우크라이나,2023-11
2023-11-30,30784344,332174306,-301389962,알제리,2023-11
2023-11-30,30466962,134697567,-104230605,그리스,2023-11
2023-11-30,30178213,8997564,21180649,리투아니아,2023-11
2023-11-30,28903203,740364992,-711461789,쿠웨이트,2023-11
2023-11-30,27120492,4754187,22366305,탄자니아,2023-11
2023-11-30,26768081,6663698,20104383,과테말라,2023-11
2023-11-30,26338031,55711569,-29373538,핀란드,2023-11
2023-11-30,25196008,31413789,-6217781,미얀마,2023-11
2023-11-30,23233285,68883029,-45649744,몰타,2023-11
2023-11-30,23127934,255663,22872271,코트디봐르,2023-11
2023-11-30,22775935,192431909,-169655974,아르헨티나,2023-11
2023-11-30,20898211,43052,20855159,아제르바이잔,2023-11
2023-11-30,18625212,2836481,15788731,엘살바도르,2023-11
2023-11-30,18435733,6248667,12187066,세르비아,2023-11
2023-11-30,18207319,69723981,-51516662,불가리아,2023-11
2023-11-30,17960031,12601405,5358626,파푸아 뉴기니,2023-11
2023-11-30,17811637,2484959,15326678,가나,2023-11
2023-11-30,17302829,23527405,-6224576,파나마,2023-11
2023-11-30,16220436,8436706,7783730,파라과이,2023-11
2023-11-30,15374325,231895,15142430,이란,2023-11
2023-11-30,15243142,583248,14659894,알바니아,2023-11
2023-11-30,15160720,9555281,5605439,스리랑카,2023-11
2023-11-30,15055384,168529033,-153473649,모잠비크,2023-11
2023-11-30,14674534,3626594,11047940,케냐,2023-11
2023-11-30,14057376,1533175,12524201,온두라스,2023-11
2023-11-30,13390173,1072407,12317766,조지아,2023-11
2023-11-30,12112913,7253070,4859843,튀니지,2023-11
2023-11-30,10701642,12053508,-1351866,우루과이,2023-11
2023-11-30,9937328,75270407,-65333079,바레인,2023-11
2023-11-30,9526825,2378242,7148583,세네갈,2023-11
2023-11-30,9329619,7234184,2095435,라오스,2023-11
2023-11-30,9231701,747443,8484258,시에라 리온,2023-11
2023-11-30,9029659,1248882,7780777,니카라과,2023-11
2023-11-30,7798485,620171,7178314,수단,2023-11
2023-11-30,7772556,2998783,4773773,레바논,2023-11
2023-11-30,7537366,512072,7025294,네팔,2023-11
2023-11-30,7096977,4083420,3013557,예맨,2023-11
2023-11-30,6669656,421552,6248104,벨라루스,2023-11
2023-11-30,6628450,120759787,-114131337,브루나이,2023-11
2023-11-30,6398608,10232377,-3833769,에티오피아,2023-11
2023-11-30,6360878,10938866,-4577988,크로아티아,2023-11
2023-11-30,6239108,7466,6231642,타지크,2023-11
2023-11-30,6049336,6002153,47183,라트비아,2023-11
2023-11-30,5440456,706239,4734217,사이프러스,2023-11
2023-11-30,5066431,25643,5040788,자마이카,2023-11
2023-11-30,4897586,4745134,152452,에스토니아,2023-11
2023-11-30,4722491,7947471,-3224980,트리니다드 토바고,2023-11
2023-11-30,4657598,7862,4649736,불령 폴리네시아,2023-11
2023-11-30,4109496,734910,3374586,모리셔스,2023-11
2023-11-30,3772501,15263996,-11491495,몰도바,2023-11
2023-11-30,3725893,1390319,2335574,몬테네그로,2023-11
2023-11-30,3725485,4709027,-983542,룩셈부르그,2023-11
2023-11-30,3467128,470984,2996144,아메리칸 사모아,2023-11
2023-11-30,3370481,19640770,-16270289,기타국,2023-11
2023-11-30,3348568,137276,3211292,부르키나 파소,2023-11
2023-11-30,2981195,10870227,-7889032,아르메니아,2023-11
2023-11-30,2791267,133875,2657392,아프카니스탄,2023-11
2023-11-30,2739862,50133,2689729,아이티,2023-11
2023-11-30,2685274,158226,2527048,카메룬,2023-11
2023-11-30,2639614,0,2639614,가이아나,2023-11
2023-11-30,2604780,867953,1736827,베네주엘라,2023-11
2023-11-30,2577386,0,2577386,팔레스타인 해방기구,2023-11
2023-11-30,2555498,1276,2554222,마티니크,2023-11
2023-11-30,2532404,43998,2488406,사모아,2023-11
2023-11-30,2513158,14307943,-11794785,마다카스카르,2023-11
2023-11-30,2438928,1985078,453850,기니,2023-11
2023-11-30,2310038,88056,2221982,세이쉘,2023-11
2023-11-30,2186907,107375,2079532,벨리제,2023-11
2023-11-30,2161313,42438731,-40277418,뉴 칼레도니아,2023-11
2023-11-30,2149880,0,2149880,지부티,2023-11
2023-11-30,2004713,118681,1886032,베닝,2023-11
2023-11-30,1962443,1327311,635132,아이슬란드,2023-11
2023-11-30,1905901,54718101,-52812200,볼리비아,2023-11
2023-11-30,1856021,1275005,581016,콩고,2023-11
2023-11-30,1566805,309879,1256926,가봉,2023-11
2023-11-30,1559171,0,1559171,불령 리유니온 코모도 제도,2023-11
2023-11-30,1511076,29663,1481413,시리아,2023-11
2023-11-30,1464769,706115,758654,마카오,2023-11
2023-11-30,1427604,312567,1115037,소말리아,2023-11
2023-11-30,1426976,0,1426976,과델로프,2023-11
2023-11-30,1401371,291065,1110306,쿠바,2023-11
2023-11-30,1277922,1138328,139594,잠비아,2023-11
2023-11-30,1145755,21634,1124121,북마리아나 군도,2023-11
2023-11-30,1063907,799422,264485,짐바브웨,2023-11
2023-11-30,1060123,7310,1052813,영령 캐이맨 군도,2023-11
2023-11-30,1052818,216767,836051,우간다,2023-11
2023-11-30,1038893,109084,929809,아루바,2023-11
2023-11-30,990003,0,990003,상토메 프린스페,2023-11
2023-11-30,971729,23806,947923,몰디브,2023-11
2023-11-30,759800,2116923,-1357123,바누아투,2023-11
2023-11-30,684778,568349,116429,마세도니아,2023-11
2023-11-30,683515,3739730,-3056215,보스니아-헤르체고비나,2023-11
2023-11-30,682393,50794,631599,나미비아,2023-11
2023-11-30,670340,3862,666478,바하마,2023-11
2023-11-30,670155,1306,668849,르완다,2023-11
2023-11-30,663211,354614,308597,솔로몬 군도,2023-11
2023-11-30,632833,287,632546,투르크멘,2023-11
2023-11-30,621394,1512256,-890862,리히텐슈타인,2023-11
2023-11-30,610671,0,610671,팔라우,2023-11
2023-11-30,581560,0,581560,큐라소,2023-11
2023-11-30,550587,721847,-171260,수리남,2023-11
2023-11-30,544353,6960,537393,세인트 루시아,2023-11
2023-11-30,532755,5129,527626,마이크로네시아,2023-11
2023-11-30,517825,4162837,-3645012,모리타니,2023-11
2023-11-30,517646,37188,480458,키리바티,2023-11
2023-11-30,434072,158,433914,영령 버진군도,2023-11
2023-11-30,405488,1001,404487,지브랄타,2023-11
2023-11-30,379383,0,379383,그레나다,2023-11
2023-11-30,370546,0,370546,불령 가이아나,2023-11
2023-11-30,347311,387241,-39930,감비아,2023-11
2023-11-30,340844,864,339980,에리트리아,2023-11
2023-11-30,338203,740,337463,투발루,2023-11
2023-11-30,319067,106,318961,챠드,2023-11
2023-11-30,311619,0,311619,세인트 마틴,2023-11
2023-11-30,291739,20020,271719,바베이도스,2023-11
2023-11-30,282161,408,281753,투르크 & 카이코스 군도,2023-11
2023-11-30,260104,31988,228116,안티가 바부다,2023-11
2023-11-30,224234,375347,-151113,부탄,2023-11
2023-11-30,209055,4916,204139,티모르,2023-11
2023-11-30,208586,8001,200585,부룬디,2023-11
2023-11-30,176780,2954918,-2778138,말라위,2023-11
2023-11-30,176674,50937,125737,보츠와나,2023-11
2023-11-30,141978,767,141211,카보 베르데,2023-11
2023-11-30,124188,74181,50007,스와질랜드,2023-11
2023-11-30,110298,1233662,-1123364,도미니카,2023-11
2023-11-30,74137,1055353,-981216,산마리노,2023-11
2023-11-30,68661,0,68661,적도 기니,2023-11
2023-11-30,57625,0,57625,남수단,2023-11
2023-11-30,53553,0,53553,말리,2023-11
2023-11-30,41616,119803,-78187,통가,2023-11
2023-11-30,31769,0,31769,안타티카,2023-11
2023-11-30,29640,1740,27900,보네르 신트외스타티위스,2023-11
2023-11-30,25002,0,25002,버뮤다,2023-11
2023-11-30,19404,1696,17708,니제르,2023-11
2023-11-30,18081,101658,-83577,기네비소,2023-11
2023-11-30,17076,0,17076,나우루,2023-11
2023-11-30,16504,35181,-18677,토켈라우,2023-11
2023-11-30,14597,0,14597,세인트 빈센트 그레나딘,2023-11
2023-11-30,12000,7279,4721,쿡 아일랜드,2023-11
2023-11-30,11862,0,11862,메요트,2023-11
2023-11-30,10701,18335,-7634,네덜란드 열도,2023-11
2023-11-30,6450,2212,4238,몬트세라트,2023-11
2023-11-30,4681,16788,-12107,안도라,2023-11
2023-11-30,4399,0,4399,건지,2023-11
2023-11-30,4209,0,4209,세인트 바르탤르미,2023-11
2023-11-30,4025,15877,-11852,파로에 군도,2023-11
2023-11-30,3865,198152,-194287,그린랜드,2023-11
2023-11-30,3625,26377,-22752,코모로스,2023-11
2023-11-30,2621,30055,-27434,미령 버진군도,2023-11
2023-11-30,2526,0,2526,앙귈라,2023-11
2023-11-30,2116,0,2116,포클랜드 군도,2023-11
2023-11-30,1711,0,1711,세인트마틴(생마르탱),2023-11
2023-11-30,278,480916,-480638,모나코,2023-11
2023-11-30,150,2077,-1927,세인트 키츠 네비스,2023-11
2023-11-30,89,25,64,저어지,2023-11
2023-11-30,0,5,-5,국제통화기금,2023-11
2023-11-30,0,4940,-4940,레소토,2023-11
2023-11-30,0,100,-100,맨섬,2023-11
2023-11-30,0,1017,-1017,불령 남부지역,2023-11
2023-11-30,0,976,-976,니우에,2023-11
2023-11-30,0,681,-681,마이너 아우틀링 합중국 군도,2023-11
2023-11-30,0,326,-326,세인트 헬레나,2023-11
2023-12-31,11280989026,6279486485,5001502541,미국,2023-12
2023-12-31,10864297912,10887275327,-22977415,중국,2023-12
2023-12-31,4629922384,2105050077,2524872307,베트남,2023-12
2023-12-31,3341215936,130151565,3211064371,홍콩,2023-12
2023-12-31,2486617962,3920619133,-1434001171,일본,2023-12
2023-12-31,2167142636,1936032666,231109970,대만,2023-12
2023-12-31,1954858988,797606986,1157252002,싱가포르,2023-12
2023-12-31,1845438805,22905,1845415900,마샬군도,2023-12
2023-12-31,1588847052,540284372,1048562680,인도,2023-12
2023-12-31,1435610240,3074842614,-1639232374,호주,2023-12
2023-12-31,970734134,766125289,204608845,멕시코,2023-12
2023-12-31,923568130,1344332316,-420764186,말레이시아,2023-12
2023-12-31,813465961,556007359,257458602,캐나다,2023-12
2023-12-31,757206010,1908972375,-1151766365,독일,2023-12
2023-12-31,665103695,1106283170,-441179475,인도네시아,2023-12
2023-12-31,633793076,94465488,539327588,튀르키예,2023-12
2023-12-31,600507546,373077092,227430454,필리핀,2023-12
2023-12-31,568630629,579304044,-10673415,태국,2023-12
2023-12-31,561099959,927416660,-366316701,네덜란드,2023-12
2023-12-31,548450921,2980977241,-2432526320,사우디아라비아,2023-12
2023-12-31,513997586,95005132,418992454,폴란드,2023-12
2023-12-31,494614770,80112605,414502165,헝가리,2023-12
2023-12-31,478720046,371603643,107116403,영국,2023-12
2023-12-31,460212995,1540091823,-1079878828,아랍에미리트 연합,2023-12
2023-12-31,411481672,681572950,-270091278,러시아 연방,2023-12
2023-12-31,405166275,611014309,-205848034,이탈리아,2023-12
2023-12-31,387537882,494993780,-107455898,브라질,2023-12
2023-12-31,379857775,804514893,-424657118,프랑스,2023-12
2023-12-31,359872692,113420084,246452608,벨기에,2023-12
2023-12-31,300989739,116687172,184302567,뉴질랜드,2023-12
2023-12-31,298751447,282637695,16113752,스페인,2023-12
2023-12-31,270866009,1006912,269859097,라이베리아,2023-12
2023-12-31,221823118,80914918,140908200,슬로바키아,2023-12
2023-12-31,212769302,103224381,109544921,체코공화국,2023-12
2023-12-31,165087937,1157673,163930264,우즈베키스탄,2023-12
2023-12-31,150270879,2195582,148075297,토고,2023-12
2023-12-31,150039890,111939677,38100213,카자흐스탄,2023-12
2023-12-31,138564252,6394957,132169295,몰타,2023-12
2023-12-31,136718989,422182169,-285463180,칠레,2023-12
2023-12-31,124130357,3656795,120473562,에쿠아도르,2023-12
2023-12-31,116150697,4982911,111167786,이집트,2023-12
2023-12-31,110650148,11645379,99004769,슬로베니아,2023-12
2023-12-31,110063711,660489388,-550425677,쿠웨이트,2023-12
2023-12-31,109143326,206270266,-97126940,스웨덴,2023-12
2023-12-31,107157056,681969590,-574812534,이라크,2023-12
2023-12-31,106910503,39506317,67404186,방글라데시,2023-12
2023-12-31,104253103,289170000,-184916897,스위스,2023-12
2023-12-31,98283345,110017282,-11733937,이스라엘,2023-12
2023-12-31,84977114,16908354,68068760,파키스탄,2023-12
2023-12-31,79965712,126117,79839595,키르기스스탄,2023-12
2023-12-31,79131153,142792901,-63661748,아일랜드,2023-12
2023-12-31,65400355,231472454,-166072099,남아프리카공화국,2023-12
2023-12-31,65122918,68510041,-3387123,핀란드,2023-12
2023-12-31,64486310,77147545,-12661235,포루투갈,2023-12
2023-12-31,64469558,128949896,-64480338,오스트리아,2023-12
2023-12-31,61479978,139860509,-78380531,콜롬비아,2023-12
2023-12-31,59686928,5835928,53851000,과테말라,2023-12
2023-12-31,58340369,1058792396,-1000452027,카타르,2023-12
2023-12-31,57294055,173672575,-116378520,나이지리아,2023-12
2023-12-31,56473462,37769403,18704059,푸에르토리코,2023-12
2023-12-31,54088500,4065567,50022933,요르단,2023-12
2023-12-31,52034535,204438163,-152403628,페루,2023-12
2023-12-31,50817426,90130857,-39313431,덴마크,2023-12
2023-12-31,47827051,2126035,45701016,리비아,2023-12
2023-12-31,47770265,36793135,10977130,캄보디아,2023-12
2023-12-31,37908426,96834171,-58925745,루마니아,2023-12
2023-12-31,35897355,5641411,30255944,몽골,2023-12
2023-12-31,34969123,10342336,24626787,모로코,2023-12
2023-12-31,31138283,514441452,-483303169,오만,2023-12
2023-12-31,31115082,28257452,2857630,우크라이나,2023-12
2023-12-31,31060227,112422164,-81361937,노르웨이,2023-12
2023-12-31,30466232,25844975,4621257,미얀마,2023-12
2023-12-31,29838669,7782469,22056200,리투아니아,2023-12
2023-12-31,29232248,100445058,-71212810,그리스,2023-12
2023-12-31,28174574,12464422,15710152,도미니카 공화국,2023-12
2023-12-31,26509088,18373426,8135662,세르비아,2023-12
2023-12-31,25250077,410257447,-385007370,알제리,2023-12
2023-12-31,22873739,649939,22223800,이란,2023-12
2023-12-31,21822897,1476290,20346607,케냐,2023-12
2023-12-31,20124143,229278052,-209153909,아르헨티나,2023-12
2023-12-31,19588021,3876019,15712002,가나,2023-12
2023-12-31,18665150,29111649,-10446499,파나마,2023-12
2023-12-31,18492348,12037947,6454401,코스타리카,2023-12
2023-12-31,18210011,342827,17867184,코트디봐르,2023-12
2023-12-31,18053219,2381563,15671656,엘살바도르,2023-12
2023-12-31,17693182,35388,17657794,아제르바이잔,2023-12
2023-12-31,16445127,823197,15621930,알바니아,2023-12
2023-12-31,15925001,1199286,14725715,온두라스,2023-12
2023-12-31,15052780,21730720,-6677940,불가리아,2023-12
2023-12-31,14461970,10566017,3895953,스리랑카,2023-12
2023-12-31,14315471,249293,14066178,조지아,2023-12
2023-12-31,13722324,10500501,3221823,튀니지,2023-12
2023-12-31,11705287,472851,11232436,괌,2023-12
2023-12-31,11557748,5025690,6532058,라오스,2023-12
2023-12-31,11285292,367983,10917309,탄자니아,2023-12
2023-12-31,11026590,4197715,6828875,에스토니아,2023-12
2023-12-31,10927987,15808644,-4880657,바레인,2023-12
2023-12-31,10813844,27161276,-16347432,파라과이,2023-12
2023-12-31,10368232,0,10368232,앙골라,2023-12
2023-12-31,9862187,8282879,1579308,우루과이,2023-12
2023-12-31,9542657,158083611,-148540954,모잠비크,2023-12
2023-12-31,9494936,2236940,7257996,세네갈,2023-12
2023-12-31,9007335,1360042,7647293,아이슬란드,2023-12
2023-12-31,8821005,78892727,-70071722,콩고민주공화국,2023-12
2023-12-31,8512204,384526,8127678,니카라과,2023-12
2023-12-31,8062443,19439383,-11376940,크로아티아,2023-12
2023-12-31,6983778,2013,6981765,타지크,2023-12
2023-12-31,6619706,0,6619706,투르크멘,2023-12
2023-12-31,6521861,6262523,259338,라트비아,2023-12
2023-12-31,6518764,2131825,4386939,레바논,2023-12
2023-12-31,6517451,6726271,-208820,트리니다드 토바고,2023-12
2023-12-31,6340214,461849,5878365,사이프러스,2023-12
2023-12-31,6291599,10256572,-3964973,에티오피아,2023-12
2023-12-31,6183051,22,6183029,자마이카,2023-12
2023-12-31,5529908,3938330,1591578,몬테네그로,2023-12
2023-12-31,5455607,83191477,-77735870,파푸아 뉴기니,2023-12
2023-12-31,5238188,116744872,-111506684,브루나이,2023-12
2023-12-31,4653647,303589,4350058,벨라루스,2023-12
2023-12-31,4282093,2671840,1610253,예맨,2023-12
2023-12-31,3748370,526117,3222253,모리셔스,2023-12
2023-12-31,3715091,0,3715091,네덜란드 열도,2023-12
2023-12-31,3713914,60486306,-56772392,기타국,2023-12
2023-12-31,3531114,1767981,1763133,시에라 리온,2023-12
2023-12-31,3481389,11254,3470135,가이아나,2023-12
2023-12-31,3191495,438795,2752700,베네주엘라,2023-12
2023-12-31,3093441,66955788,-63862347,볼리비아,2023-12
2023-12-31,3092675,12332748,-9240073,몰도바,2023-12
2023-12-31,3033680,12152,3021528,아루바,2023-12
2023-12-31,2967308,146,2967162,사모아,2023-12
2023-12-31,2962483,11759575,-8797092,마다카스카르,2023-12
2023-12-31,2911252,15367,2895885,아프카니스탄,2023-12
2023-12-31,2720868,5362782,-2641914,룩셈부르그,2023-12
2023-12-31,2468159,0,2468159,지부티,2023-12
2023-12-31,2425666,29808,2395858,아이티,2023-12
2023-12-31,2395343,464717,1930626,마카오,2023-12
2023-12-31,2294433,217173,2077260,피지,2023-12
2023-12-31,2121459,275135,1846324,콩고,2023-12
2023-12-31,2092947,476629,1616318,우간다,2023-12
2023-12-31,2072157,119263,1952894,베닝,2023-12
2023-12-31,2069728,11800001,-9730273,아르메니아,2023-12
2023-12-31,2051844,2400,2049444,불령 리유니온 코모도 제도,2023-12
2023-12-31,1994063,480241,1513822,네팔,2023-12
2023-12-31,1945583,18339,1927244,카메룬,2023-12
2023-12-31,1836945,127250,1709695,불령 폴리네시아,2023-12
2023-12-31,1687262,619765,1067497,짐바브웨,2023-12
2023-12-31,1576948,11963,1564985,바하마,2023-12
2023-12-31,1559308,245805,1313503,쿠바,2023-12
2023-12-31,1532947,792,1532155,부르키나 파소,2023-12
2023-12-31,1473270,293132,1180138,르완다,2023-12
2023-12-31,1466865,243286,1223579,키리바티,2023-12
2023-12-31,1361126,71652,1289474,소말리아,2023-12
2023-12-31,1360160,23816135,-22455975,뉴 칼레도니아,2023-12
2023-12-31,1311478,3567080,-2255602,기니,2023-12
2023-12-31,1132288,351967,780321,가봉,2023-12
2023-12-31,1105598,10682315,-9576717,잠비아,2023-12
2023-12-31,1067007,0,1067007,불령 가이아나,2023-12
2023-12-31,1055610,5770,1049840,벨리제,2023-12
2023-12-31,1035171,43,1035128,마티니크,2023-12
2023-12-31,991634,3132822,-2141188,모리타니,2023-12
2023-12-31,983216,31,983185,말리,2023-12
2023-12-31,902984,38,902946,세인트 마틴,2023-12
2023-12-31,832592,20038,812554,몰디브,2023-12
2023-12-31,816936,188526,628410,북마리아나 군도,2023-12
2023-12-31,792467,2135509,-1343042,바누아투,2023-12
2023-12-31,779919,0,779919,영령 버진군도,2023-12
2023-12-31,756642,7296,749346,시리아,2023-12
2023-12-31,752311,111599,640712,티모르,2023-12
2023-12-31,742835,11421,731414,그레나다,2023-12
2023-12-31,716324,2358399,-1642075,리히텐슈타인,2023-12
2023-12-31,657846,0,657846,큐라소,2023-12
2023-12-31,570542,105,570437,영령 캐이맨 군도,2023-12
2023-12-31,547710,453006,94704,아메리칸 사모아,2023-12
2023-12-31,538545,1498082,-959537,보스니아-헤르체고비나,2023-12
2023-12-31,514845,18199,496646,과델로프,2023-12
2023-12-31,498867,700,498167,버뮤다,2023-12
2023-12-31,473477,569213,-95736,감비아,2023-12
2023-12-31,459773,0,459773,지브랄타,2023-12
2023-12-31,456321,652923,-196602,수단,2023-12
2023-12-31,429228,750050,-320822,수리남,2023-12
2023-12-31,408462,22177,386285,나미비아,2023-12
2023-12-31,393958,58,393900,세인트 루시아,2023-12
2023-12-31,384562,54327,330235,세이쉘,2023-12
2023-12-31,348708,81295,267413,마세도니아,2023-12
2023-12-31,347906,5405,342501,마이크로네시아,2023-12
2023-12-31,344874,28215,316659,솔로몬 군도,2023-12
2023-12-31,335903,19405,316498,남수단,2023-12
2023-12-31,334106,0,334106,안티가 바부다,2023-12
2023-12-31,331437,25095,306342,바베이도스,2023-12
2023-12-31,288870,0,288870,부탄,2023-12
2023-12-31,285394,1332,284062,카보 베르데,2023-12
2023-12-31,277532,29,277503,니제르,2023-12
2023-12-31,247739,3605629,-3357890,말라위,2023-12
2023-12-31,239644,0,239644,팔라우,2023-12
2023-12-31,235454,0,235454,투르크 & 카이코스 군도,2023-12
2023-12-31,226074,87516,138558,보츠와나,2023-12
2023-12-31,205298,0,205298,적도 기니,2023-12
2023-12-31,188688,13223,175465,도미니카,2023-12
2023-12-31,186352,328,186024,세인트 키츠 네비스,2023-12
2023-12-31,153102,848,152254,투발루,2023-12
2023-12-31,140219,253599,-113380,팔레스타인 해방기구,2023-12
2023-12-31,76035,0,76035,세인트마틴(생마르탱),2023-12
2023-12-31,72700,145716,-73016,기네비소,2023-12
2023-12-31,41714,142,41572,부룬디,2023-12
2023-12-31,38459,4811186,-4772727,나우루,2023-12
2023-12-31,31970,822056,-790086,산마리노,2023-12
2023-12-31,22070,100984,-78914,상토메 프린스페,2023-12
2023-12-31,16378,0,16378,챠드,2023-12
2023-12-31,8415,128600,-120185,스와질랜드,2023-12
2023-12-31,7860,0,7860,코모로스,2023-12
2023-12-31,5137,8931321,-8926184,에리트리아,2023-12
2023-12-31,4225,0,4225,보네르 신트외스타티위스,2023-12
2023-12-31,3085,0,3085,세인트 바르탤르미,2023-12
2023-12-31,1855,0,1855,건지,2023-12
2023-12-31,1699,2631,-932,안도라,2023-12
2023-12-31,1504,1760,-256,미령 버진군도,2023-12
2023-12-31,1461,39823,-38362,모나코,2023-12
2023-12-31,874,32979,-32105,중앙아프리카공화국,2023-12
2023-12-31,832,0,832,세인트 빈센트 그레나딘,2023-12
2023-12-31,141,0,141,저어지,2023-12
2023-12-31,128,82883,-82755,그린랜드,2023-12
2023-12-31,90,306,-216,앙귈라,2023-12
2023-12-31,40,0,40,쿡 아일랜드,2023-12
2023-12-31,0,270,-270,맨섬,2023-12
2023-12-31,0,894,-894,불령 남부지역,2023-12
2023-12-31,0,174,-174,남조지아 & 남샌드위치 군도,2023-12
2023-12-31,0,5643,-5643,몬트세라트,2023-12
2023-12-31,0,87663,-87663,통가,2023-12
2023-12-31,0,60032,-60032,레소토,2023-12
2023-12-31,0,3,-3,스발비드 군도,2023-12
2023-12-31,0,398,-398,파로에 군도,2023-12
2023-12-31,0,677,-677,영령 인도양,2023-12
2023-12-31,0,27968,-27968,니우에,2023-12
2024-01-31,10695827418,12396979945,-1701152527,중국,2024-01
2024-01-31,10252307887,6138061715,4114246172,미국,2024-01
2024-01-31,4189457681,2653857544,1535600137,베트남,2024-01
2024-01-31,2678153562,189044214,2489109348,홍콩,2024-01
2024-01-31,2542908586,3755030685,-1212122099,일본,2024-01
2024-01-31,1773976498,2196893122,-422916624,대만,2024-01
2024-01-31,1757141736,986295152,770846584,싱가포르,2024-01
2024-01-31,1538077633,543855913,994221720,인도,2024-01
2024-01-31,1454836276,3308750394,-1853914118,호주,2024-01
2024-01-31,1107425961,772680845,334745116,멕시코,2024-01
2024-01-31,905864322,593573427,312290895,캐나다,2024-01
2024-01-31,864311575,258495328,605816247,영국,2024-01
2024-01-31,795849430,132783369,663066061,튀르키예,2024-01
2024-01-31,774737143,1367470084,-592732941,말레이시아,2024-01
2024-01-31,759403885,1517820937,-758417052,독일,2024-01
2024-01-31,756011281,78811392,677199889,폴란드,2024-01
2024-01-31,708967313,398091588,310875725,필리핀,2024-01
2024-01-31,637271150,551773386,85497764,태국,2024-01
2024-01-31,614796454,1337315209,-722518755,인도네시아,2024-01
2024-01-31,541249433,47499135,493750298,헝가리,2024-01
2024-01-31,537972762,288615892,249356870,네덜란드,2024-01
2024-01-31,503059765,2662074694,-2159014929,사우디아라비아,2024-01
2024-01-31,498254764,1881176038,-1382921274,아랍에미리트 연합,2024-01
2024-01-31,421342189,680252964,-258910775,브라질,2024-01
2024-01-31,396023426,167203,395856223,라이베리아,2024-01
2024-01-31,381462310,531097673,-149635363,러시아 연방,2024-01
2024-01-31,374975276,665369707,-290394431,이탈리아,2024-01
2024-01-31,358192766,1225,358191541,마샬군도,2024-01
2024-01-31,320671809,107026149,213645660,벨기에,2024-01
2024-01-31,275673634,85034193,190639441,체코공화국,2024-01
2024-01-31,271950271,588468515,-316518244,프랑스,2024-01
2024-01-31,266464753,187033787,79430966,스페인,2024-01
2024-01-31,249217130,219499019,29718111,그리스,2024-01
2024-01-31,246514558,74656752,171857806,슬로바키아,2024-01
2024-01-31,230312605,57380636,172931969,포루투갈,2024-01
2024-01-31,224567570,78663506,145904064,덴마크,2024-01
2024-01-31,196536876,152919070,43617806,뉴질랜드,2024-01
2024-01-31,167814104,280608800,-112794696,칠레,2024-01
2024-01-31,162570079,274905342,-112335263,카자흐스탄,2024-01
2024-01-31,158335815,3636,158332179,앙골라,2024-01
2024-01-31,156357703,67111483,89246220,방글라데시,2024-01
2024-01-31,141817700,1749107,140068593,우즈베키스탄,2024-01
2024-01-31,135220299,28204853,107015446,파키스탄,2024-01
2024-01-31,132068531,615718076,-483649545,이라크,2024-01
2024-01-31,120494744,126773009,-6278265,스웨덴,2024-01
2024-01-31,110912773,120357105,-9444332,이스라엘,2024-01
2024-01-31,108291853,58400200,49891653,이집트,2024-01
2024-01-31,108253195,281679888,-173426693,스위스,2024-01
2024-01-31,102645043,4969651,97675392,슬로베니아,2024-01
2024-01-31,83565088,32245205,51319883,몰타,2024-01
2024-01-31,80705103,77797752,2907351,오스트리아,2024-01
2024-01-31,77228464,840835,76387629,토고,2024-01
2024-01-31,71238508,100762610,-29524102,아일랜드,2024-01
2024-01-31,71096245,669193,70427052,키르기스스탄,2024-01
2024-01-31,69518085,22939844,46578241,푸에르토리코,2024-01
2024-01-31,65257641,65161650,95991,나이지리아,2024-01
2024-01-31,61915035,86225215,-24310180,루마니아,2024-01
2024-01-31,61645569,74030927,-12385358,콜롬비아,2024-01
2024-01-31,59121565,221255848,-162134283,남아프리카공화국,2024-01
2024-01-31,56741708,1195178613,-1138436905,카타르,2024-01
2024-01-31,55731875,6180345,49551530,리투아니아,2024-01
2024-01-31,55341830,49339109,6002721,캄보디아,2024-01
2024-01-31,53468332,4880233,48588099,에쿠아도르,2024-01
2024-01-31,53360880,472469402,-419108522,오만,2024-01
2024-01-31,52110288,3174645,48935643,요르단,2024-01
2024-01-31,48306355,173245167,-124938812,페루,2024-01
2024-01-31,47822938,1779,47821159,버뮤다,2024-01
2024-01-31,36993802,2443553,34550249,몽골,2024-01
2024-01-31,33344926,101887897,-68542971,노르웨이,2024-01
2024-01-31,30231773,12811183,17420590,도미니카 공화국,2024-01
2024-01-31,30198709,1204315,28994394,리비아,2024-01
2024-01-31,28175200,25033684,3141516,모로코,2024-01
2024-01-31,27723266,7521372,20201894,과테말라,2024-01
2024-01-31,27134163,598328,26535835,피지,2024-01
2024-01-31,26733630,80948855,-54215225,핀란드,2024-01
2024-01-31,26704519,800380876,-773676357,쿠웨이트,2024-01
2024-01-31,25582631,41026540,-15443909,우크라이나,2024-01
2024-01-31,24265437,16932300,7333137,세르비아,2024-01
2024-01-31,24246536,1549000,22697536,케냐,2024-01
2024-01-31,21947738,53653504,-31705766,미얀마,2024-01
2024-01-31,21279299,365380620,-344101321,알제리,2024-01
2024-01-31,20642329,2433059,18209270,엘살바도르,2024-01
2024-01-31,20445500,2640127,17805373,온두라스,2024-01
2024-01-31,18485989,18713348,-227359,불가리아,2024-01
2024-01-31,18192529,80480936,-62288407,아르헨티나,2024-01
2024-01-31,17852185,14662011,3190174,코스타리카,2024-01
2024-01-31,17200535,9216482,7984053,스리랑카,2024-01
2024-01-31,15412675,864386,14548289,가나,2024-01
2024-01-31,14808952,65107,14743845,아제르바이잔,2024-01
2024-01-31,13669482,390759,13278723,코트디봐르,2024-01
2024-01-31,13569760,757484,12812276,이란,2024-01
2024-01-31,12954122,12544258,409864,파나마,2024-01
2024-01-31,12854608,574464,12280144,괌,2024-01
2024-01-31,11993287,631880,11361407,알바니아,2024-01
2024-01-31,11386327,12262271,-875944,탄자니아,2024-01
2024-01-31,11260680,8579594,2681086,우루과이,2024-01
2024-01-31,10392046,19661517,-9269471,파라과이,2024-01
2024-01-31,9864261,2118723,7745538,조지아,2024-01
2024-01-31,9842985,12660191,-2817206,라오스,2024-01
2024-01-31,9425446,2605947,6819499,세네갈,2024-01
2024-01-31,8441219,11171831,-2730612,튀니지,2024-01
2024-01-31,8433920,24039306,-15605386,기타국,2024-01
2024-01-31,8033443,6768134,1265309,트리니다드 토바고,2024-01
2024-01-31,7925402,7781,7917621,불령 폴리네시아,2024-01
2024-01-31,7341030,2261,7338769,타지크,2024-01
2024-01-31,7226917,95862429,-88635512,브루나이,2024-01
2024-01-31,6920775,303209,6617566,벨라루스,2024-01
2024-01-31,6855753,868261,5987492,니카라과,2024-01
2024-01-31,6708086,5360089,1347997,크로아티아,2024-01
2024-01-31,6683015,13001135,-6318120,바레인,2024-01
2024-01-31,6310083,242944059,-236633976,모잠비크,2024-01
2024-01-31,5844188,1690304,4153884,레바논,2024-01
2024-01-31,5212586,685087,4527499,사이프러스,2024-01
2024-01-31,4311165,8559367,-4248202,짐바브웨,2024-01
2024-01-31,4297643,6212621,-1914978,라트비아,2024-01
2024-01-31,4263154,71032,4192122,사모아,2024-01
2024-01-31,4262263,78480372,-74218109,파푸아 뉴기니,2024-01
2024-01-31,3953548,61385,3892163,아이티,2024-01
2024-01-31,3933552,300733,3632819,카메룬,2024-01
2024-01-31,3888260,469584,3418676,수단,2024-01
2024-01-31,3835399,6036367,-2200968,에스토니아,2024-01
2024-01-31,3747133,255995,3491138,베네주엘라,2024-01
2024-01-31,3698974,436554,3262420,모리셔스,2024-01
2024-01-31,3548859,64553018,-61004159,콩고민주공화국,2024-01
2024-01-31,3510095,29188,3480907,부르키나 파소,2024-01
2024-01-31,3437593,19024250,-15586657,몰도바,2024-01
2024-01-31,3421306,41138810,-37717504,볼리비아,2024-01
2024-01-31,3334439,6806,3327633,자마이카,2024-01
2024-01-31,3280936,4020962,-740026,룩셈부르그,2024-01
2024-01-31,3046021,1448121,1597900,마다카스카르,2024-01
2024-01-31,2960934,500533,2460401,네팔,2024-01
2024-01-31,2227154,0,2227154,아루바,2024-01
2024-01-31,2154291,1621051,533240,아이슬란드,2024-01
2024-01-31,2067560,0,2067560,불령 리유니온 코모도 제도,2024-01
2024-01-31,2053703,18,2053685,가이아나,2024-01
2024-01-31,2002910,6433421,-4430511,말라위,2024-01
2024-01-31,1966992,93828,1873164,콩고,2024-01
2024-01-31,1931548,4078208,-2146660,잠비아,2024-01
2024-01-31,1873867,44767719,-42893852,몬테네그로,2024-01
2024-01-31,1811499,514693,1296806,마카오,2024-01
2024-01-31,1771671,1323367,448304,우간다,2024-01
2024-01-31,1766304,1981744,-215440,예맨,2024-01
2024-01-31,1719643,2986592,-1266949,기니,2024-01
2024-01-31,1711647,93930,1617717,가봉,2024-01
2024-01-31,1682458,0,1682458,세인트 마틴,2024-01
2024-01-31,1630568,1670529,-39961,아르메니아,2024-01
2024-01-31,1602448,6567141,-4964693,에티오피아,2024-01
2024-01-31,1552918,29629,1523289,팔레스타인 해방기구,2024-01
2024-01-31,1503712,14736,1488976,바베이도스,2024-01
2024-01-31,1357068,6940,1350128,지부티,2024-01
2024-01-31,1345022,34096,1310926,니제르,2024-01
2024-01-31,1309266,177811,1131455,아프카니스탄,2024-01
2024-01-31,1235511,25237688,-24002177,뉴 칼레도니아,2024-01
2024-01-31,1234440,28771,1205669,르완다,2024-01
2024-01-31,1219894,291,1219603,바하마,2024-01
2024-01-31,1119653,1935279,-815626,모리타니,2024-01
2024-01-31,1109225,90,1109135,영령 버진군도,2024-01
2024-01-31,997484,59,997425,마티니크,2024-01
2024-01-31,989141,219386,769755,투발루,2024-01
2024-01-31,978421,260969,717452,바누아투,2024-01
2024-01-31,930340,0,930340,몰디브,2024-01
2024-01-31,929963,6521,923442,말리,2024-01
2024-01-31,897242,592625,304617,아메리칸 사모아,2024-01
2024-01-31,859091,59,859032,베닝,2024-01
2024-01-31,835073,366,834707,벨리제,2024-01
2024-01-31,824682,512,824170,큐라소,2024-01
2024-01-31,780636,230169,550467,북마리아나 군도,2024-01
2024-01-31,764763,1773905,-1009142,쿠바,2024-01
2024-01-31,683768,11721,672047,시리아,2024-01
2024-01-31,666814,74443,592371,나미비아,2024-01
2024-01-31,643299,201635,441664,안티가 바부다,2024-01
2024-01-31,641795,3496238,-2854443,보스니아-헤르체고비나,2024-01
2024-01-31,638536,0,638536,과델로프,2024-01
2024-01-31,632539,1365464,-732925,리히텐슈타인,2024-01
2024-01-31,576695,2468777,-1892082,마이크로네시아,2024-01
2024-01-31,571950,0,571950,투르크멘,2024-01
2024-01-31,567208,29148,538060,소말리아,2024-01
2024-01-31,544750,33813,510937,팔라우,2024-01
2024-01-31,538780,350,538430,영령 캐이맨 군도,2024-01
2024-01-31,533177,2494537,-1961360,솔로몬 군도,2024-01
2024-01-31,459818,678732,-218914,감비아,2024-01
2024-01-31,439681,423857,15824,키리바티,2024-01
2024-01-31,418044,0,418044,불령 가이아나,2024-01
2024-01-31,382385,0,382385,그레나다,2024-01
2024-01-31,355910,0,355910,세인트 루시아,2024-01
2024-01-31,339043,0,339043,부탄,2024-01
2024-01-31,315613,0,315613,챠드,2024-01
2024-01-31,309651,1950,307701,도미니카,2024-01
2024-01-31,305731,414180,-108449,마세도니아,2024-01
2024-01-31,276326,77928665,-77652339,적도 기니,2024-01
2024-01-31,233728,0,233728,남수단,2024-01
2024-01-31,211328,217724,-6396,세이쉘,2024-01
2024-01-31,193992,818942,-624950,시에라 리온,2024-01
2024-01-31,168538,727,167811,지브랄타,2024-01
2024-01-31,159443,0,159443,메요트,2024-01
2024-01-31,146374,22,146352,카보 베르데,2024-01
2024-01-31,133979,317,133662,세인트 키츠 네비스,2024-01
2024-01-31,125114,10776,114338,스와질랜드,2024-01
2024-01-31,124771,482934,-358163,수리남,2024-01
2024-01-31,91082,12060,79022,보츠와나,2024-01
2024-01-31,77474,0,77474,세인트마틴(생마르탱),2024-01
2024-01-31,52360,551,51809,투르크 & 카이코스 군도,2024-01
2024-01-31,48113,432,47681,네덜란드 열도,2024-01
2024-01-31,45260,152438,-107178,통가,2024-01
2024-01-31,42195,0,42195,안타티카,2024-01
2024-01-31,41617,2806,38811,티모르,2024-01
2024-01-31,34934,1031293,-996359,산마리노,2024-01
2024-01-31,24636,487,24149,부룬디,2024-01
2024-01-31,13103,151,12952,세인트 빈센트 그레나딘,2024-01
2024-01-31,12420,0,12420,포클랜드 군도,2024-01
2024-01-31,12149,0,12149,나우루,2024-01
2024-01-31,10111,41,10070,에리트리아,2024-01
2024-01-31,7125,1691,5434,건지,2024-01
2024-01-31,4937,205129,-200192,그린랜드,2024-01
2024-01-31,4480,3027,1453,코모로스,2024-01
2024-01-31,1879,1451,428,안도라,2024-01
2024-01-31,1477,158,1319,미령 버진군도,2024-01
2024-01-31,1140,0,1140,파로에 군도,2024-01
2024-01-31,627,0,627,보네르 신트외스타티위스,2024-01
2024-01-31,531,0,531,중앙아프리카공화국,2024-01
2024-01-31,332,5575,-5243,레소토,2024-01
2024-01-31,138,273042,-272904,모나코,2024-01
2024-01-31,137,200,-63,저어지,2024-01
2024-01-31,100,0,100,앙귈라,2024-01
2024-01-31,54,0,54,영령 인도양,2024-01
2024-01-31,20,0,20,상토메 프린스페,2024-01
2024-01-31,0,79458,-79458,기네비소,2024-01
2024-01-31,0,19719,-19719,세인트 헬레나,2024-01
2024-01-31,0,693,-693,토켈라우,2024-01
2024-01-31,0,32171,-32171,니우에,2024-01
2024-01-31,0,1652,-1652,세인트 바르탤르미,2024-01
2024-01-31,0,4381,-4381,맨섬,2024-01
2024-01-31,0,583,-583,쿡 아일랜드,2024-01
2024-01-31,0,156,-156,불령 남부지역,2024-01
2024-02-29,9809052632,5612523135,4196529497,미국,2024-02
2024-02-29,9644036815,9429122808,214914007,중국,2024-02
2024-02-29,4207879953,2127366893,2080513060,베트남,2024-02
2024-02-29,2983274078,222994352,2760279726,홍콩,2024-02
2024-02-29,2374211317,3722297932,-1348086615,일본,2024-02
2024-02-29,1531944766,2191751275,-659806509,대만,2024-02
2024-02-29,1474545406,557305743,917239663,인도,2024-02
2024-02-29,1259267427,2338062639,-1078795212,호주,2024-02
2024-02-29,1116630494,796749161,319881333,싱가포르,2024-02
2024-02-29,1091333973,420913498,670420475,멕시코,2024-02
2024-02-29,938590866,1116085286,-177494420,말레이시아,2024-02
2024-02-29,871714415,397651997,474062418,필리핀,2024-02
2024-02-29,850552349,1732735869,-882183520,독일,2024-02
2024-02-29,807827333,82476506,725350827,튀르키예,2024-02
2024-02-29,771374463,554625510,216748953,캐나다,2024-02
2024-02-29,682255240,603016229,79239011,러시아 연방,2024-02
2024-02-29,681344196,1066665101,-385320905,인도네시아,2024-02
2024-02-29,608839060,554798428,54040632,태국,2024-02
2024-02-29,606942940,45489970,561452970,몰타,2024-02
2024-02-29,587082766,564399590,22683176,네덜란드,2024-02
2024-02-29,531683554,540493395,-8809841,영국,2024-02
2024-02-29,499909009,73925794,425983215,헝가리,2024-02
2024-02-29,495449081,80697257,414751824,폴란드,2024-02
2024-02-29,412913515,662163878,-249250363,브라질,2024-02
2024-02-29,410379335,1379498191,-969118856,아랍에미리트 연합,2024-02
2024-02-29,409281432,2367819453,-1958538021,사우디아라비아,2024-02
2024-02-29,397849860,602865851,-205015991,이탈리아,2024-02
2024-02-29,380642954,112108283,268534671,벨기에,2024-02
2024-02-29,334998110,544239400,-209241290,프랑스,2024-02
2024-02-29,302020300,40102,301980198,라이베리아,2024-02
2024-02-29,298714842,138858008,159856834,뉴질랜드,2024-02
2024-02-29,294308665,101608212,192700453,체코공화국,2024-02
2024-02-29,279535389,167505179,112030210,스페인,2024-02
2024-02-29,254311740,77777146,176534594,슬로바키아,2024-02
2024-02-29,242676789,80789,242596000,마샬군도,2024-02
2024-02-29,177339496,3752589,173586907,파나마,2024-02
2024-02-29,177127169,552800312,-375673143,칠레,2024-02
2024-02-29,169479940,19240829,150239111,카자흐스탄,2024-02
2024-02-29,149347361,620535,148726826,우즈베키스탄,2024-02
2024-02-29,140815699,66972603,73843096,방글라데시,2024-02
2024-02-29,122128110,699082905,-576954795,이라크,2024-02
2024-02-29,119714763,11756,119703007,키르기스스탄,2024-02
2024-02-29,117936594,149401710,-31465116,스웨덴,2024-02
2024-02-29,116433132,8018296,108414836,슬로베니아,2024-02
2024-02-29,111399035,88466581,22932454,이집트,2024-02
2024-02-29,109878273,110476411,-598138,이스라엘,2024-02
2024-02-29,94943035,29546641,65396394,파키스탄,2024-02
2024-02-29,92178105,77505478,14672627,오스트리아,2024-02
2024-02-29,89908209,91637057,-1728848,에쿠아도르,2024-02
2024-02-29,88396620,261371731,-172975111,스위스,2024-02
2024-02-29,83384352,49136663,34247689,콜롬비아,2024-02
2024-02-29,82820846,29049667,53771179,푸에르토리코,2024-02
2024-02-29,80764660,35415561,45349099,포루투갈,2024-02
2024-02-29,75330622,2186698,73143924,토고,2024-02
2024-02-29,62447362,99213049,-36765687,루마니아,2024-02
2024-02-29,60261685,6664204,53597481,탄자니아,2024-02
2024-02-29,56295514,288087504,-231791990,남아프리카공화국,2024-02
2024-02-29,51988855,334269779,-282280924,페루,2024-02
2024-02-29,50247901,81458906,-31211005,나이지리아,2024-02
2024-02-29,48831840,1147373393,-1098541553,카타르,2024-02
2024-02-29,48359184,109555553,-61196369,아일랜드,2024-02
2024-02-29,47459414,1130249,46329165,요르단,2024-02
2024-02-29,47337745,49024349,-1686604,캄보디아,2024-02
2024-02-29,41119736,6527556,34592180,그리스,2024-02
2024-02-29,37761232,1653244,36107988,몽골,2024-02
2024-02-29,33995369,75832354,-41836985,덴마크,2024-02
2024-02-29,33810203,5775123,28035080,리투아니아,2024-02
2024-02-29,32871027,144524215,-111653188,노르웨이,2024-02
2024-02-29,32347901,890078567,-857730666,쿠웨이트,2024-02
2024-02-29,31077065,518814491,-487737426,오만,2024-02
2024-02-29,29850358,49544342,-19693984,우크라이나,2024-02
2024-02-29,26411395,6844390,19567005,도미니카 공화국,2024-02
2024-02-29,25972945,4685324,21287621,과테말라,2024-02
2024-02-29,25693363,16453544,9239819,모로코,2024-02
2024-02-29,25588233,53929452,-28341219,미얀마,2024-02
2024-02-29,22170995,1040657,21130338,리비아,2024-02
2024-02-29,21868991,520900,21348091,괌,2024-02
2024-02-29,21535995,442416,21093579,아제르바이잔,2024-02
2024-02-29,20857808,663348,20194460,알바니아,2024-02
2024-02-29,20223523,277730094,-257506571,알제리,2024-02
2024-02-29,20132594,79324336,-59191742,아르헨티나,2024-02
2024-02-29,19092872,12928476,6164396,코스타리카,2024-02
2024-02-29,17445022,1690679,15754343,가나,2024-02
2024-02-29,16697340,30652550,-13955210,세르비아,2024-02
2024-02-29,15367424,54824707,-39457283,핀란드,2024-02
2024-02-29,15285375,584359,14701016,코트디봐르,2024-02
2024-02-29,14856393,580041,14276352,네팔,2024-02
2024-02-29,14695230,24193705,-9498475,온두라스,2024-02
2024-02-29,14385419,27014398,-12628979,불가리아,2024-02
2024-02-29,14238707,1581712,12656995,엘살바도르,2024-02
2024-02-29,13933247,2479540,11453707,케냐,2024-02
2024-02-29,13925846,1301,13924545,타지크,2024-02
2024-02-29,13820778,2189565,11631213,조지아,2024-02
2024-02-29,12413112,421176,11991936,이란,2024-02
2024-02-29,11787555,20538922,-8751367,바레인,2024-02
2024-02-29,11714941,4916713,6798228,에티오피아,2024-02
2024-02-29,11158769,24077904,-12919135,스리랑카,2024-02
2024-02-29,9923427,14042353,-4118926,우루과이,2024-02
2024-02-29,8140428,8901604,-761176,튀니지,2024-02
2024-02-29,7934658,1280173,6654485,세네갈,2024-02
2024-02-29,7232061,1542497,5689564,레바논,2024-02
2024-02-29,6896980,588703,6308277,벨라루스,2024-02
2024-02-29,6704398,5550463,1153935,에스토니아,2024-02
2024-02-29,6121686,12156268,-6034582,라오스,2024-02
2024-02-29,6065040,5564390,500650,크로아티아,2024-02
2024-02-29,6041733,7989547,-1947814,몰도바,2024-02
2024-02-29,6015458,3793272,2222186,우간다,2024-02
2024-02-29,5981521,0,5981521,사모아,2024-02
2024-02-29,5896303,0,5896303,앙골라,2024-02
2024-02-29,5740190,25243323,-19503133,파라과이,2024-02
2024-02-29,5681571,64365121,-58683550,모잠비크,2024-02
2024-02-29,4804358,1189,4803169,자마이카,2024-02
2024-02-29,4588220,4030899,557321,라트비아,2024-02
2024-02-29,4376973,855505,3521468,베네주엘라,2024-02
2024-02-29,4294870,1020612,3274258,니카라과,2024-02
2024-02-29,4154278,612,4153666,투르크멘,2024-02
2024-02-29,3878778,1613360,2265418,사이프러스,2024-02
2024-02-29,3842929,41603097,-37760168,콩고민주공화국,2024-02
2024-02-29,3827014,8589099,-4762085,룩셈부르그,2024-02
2024-02-29,3517374,2068902,1448472,아이슬란드,2024-02
2024-02-29,3359404,27789080,-24429676,기타국,2024-02
2024-02-29,3356016,359667,2996349,카메룬,2024-02
2024-02-29,3285190,13089038,-9803848,트리니다드 토바고,2024-02
2024-02-29,3266611,52123811,-48857200,브루나이,2024-02
2024-02-29,3135579,641596,2493983,모리셔스,2024-02
2024-02-29,2919540,694040,2225500,부르키나 파소,2024-02
2024-02-29,2680441,15244398,-12563957,마다카스카르,2024-02
2024-02-29,2674703,4157315,-1482612,예맨,2024-02
2024-02-29,2632509,59985,2572524,아이티,2024-02
2024-02-29,2632461,13651013,-11018552,파푸아 뉴기니,2024-02
2024-02-29,2482250,3759653,-1277403,기니,2024-02
2024-02-29,2446416,85656,2360760,피지,2024-02
2024-02-29,2397380,4380,2393000,가이아나,2024-02
2024-02-29,2361421,347123,2014298,짐바브웨,2024-02
2024-02-29,2294562,170159,2124403,팔레스타인 해방기구,2024-02
2024-02-29,2279883,18574,2261309,아루바,2024-02
2024-02-29,2158583,3367,2155216,아프카니스탄,2024-02
2024-02-29,1984735,425,1984310,불령 리유니온 코모도 제도,2024-02
2024-02-29,1974635,62850,1911785,불령 폴리네시아,2024-02
2024-02-29,1897494,2200240,-302746,아르메니아,2024-02
2024-02-29,1890197,61324702,-59434505,볼리비아,2024-02
2024-02-29,1783408,33000,1750408,네덜란드 열도,2024-02
2024-02-29,1747268,604801,1142467,르완다,2024-02
2024-02-29,1721484,4082715,-2361231,잠비아,2024-02
2024-02-29,1638629,1842713,-204084,키리바티,2024-02
2024-02-29,1622679,107202,1515477,북마리아나 군도,2024-02
2024-02-29,1473479,0,1473479,지부티,2024-02
2024-02-29,1458941,26646,1432295,콩고,2024-02
2024-02-29,1272082,0,1272082,마티니크,2024-02
2024-02-29,1265172,10433,1254739,가봉,2024-02
2024-02-29,1261462,226566,1034896,시리아,2024-02
2024-02-29,1202946,17219304,-16016358,몬테네그로,2024-02
2024-02-29,1148761,0,1148761,큐라소,2024-02
2024-02-29,1102452,87,1102365,베닝,2024-02
2024-02-29,1057032,0,1057032,세인트 마틴,2024-02
2024-02-29,1026280,19460425,-18434145,뉴 칼레도니아,2024-02
2024-02-29,937913,1006,936907,몰디브,2024-02
2024-02-29,897410,303849,593561,마카오,2024-02
2024-02-29,842100,114856,727244,나미비아,2024-02
2024-02-29,838917,0,838917,소말리아,2024-02
2024-02-29,797086,27594,769492,벨리제,2024-02
2024-02-29,794228,4258,789970,바하마,2024-02
2024-02-29,712028,134757,577271,세이쉘,2024-02
2024-02-29,702818,1282820,-580002,리히텐슈타인,2024-02
2024-02-29,623919,1698500,-1074581,보스니아-헤르체고비나,2024-02
2024-02-29,614082,68,614014,아메리칸 사모아,2024-02
2024-02-29,602869,771780,-168911,모리타니,2024-02
2024-02-29,591737,0,591737,마이크로네시아,2024-02
2024-02-29,556528,10512,546016,안티가 바부다,2024-02
2024-02-29,556314,514714,41600,수단,2024-02
2024-02-29,538377,366568,171809,쿠바,2024-02
2024-02-29,529434,866937,-337503,부탄,2024-02
2024-02-29,518233,0,518233,그레나다,2024-02
2024-02-29,506519,583,505936,남수단,2024-02
2024-02-29,505291,0,505291,솔로몬 군도,2024-02
2024-02-29,504693,1501130,-996437,시에라 리온,2024-02
2024-02-29,502109,538490,-36381,수리남,2024-02
2024-02-29,463956,16568,447388,팔라우,2024-02
2024-02-29,443890,11618,432272,바누아투,2024-02
2024-02-29,440209,0,440209,영령 캐이맨 군도,2024-02
2024-02-29,415301,0,415301,과델로프,2024-02
2024-02-29,413804,0,413804,불령 가이아나,2024-02
2024-02-29,366885,0,366885,바베이도스,2024-02
2024-02-29,347858,0,347858,세인트 루시아,2024-02
2024-02-29,340602,1001045,-660443,마세도니아,2024-02
2024-02-29,280853,3676,277177,투발루,2024-02
2024-02-29,279613,0,279613,세인트 빈센트 그레나딘,2024-02
2024-02-29,240246,163008,77238,스와질랜드,2024-02
2024-02-29,230585,0,230585,영령 버진군도,2024-02
2024-02-29,224010,13078,210932,버뮤다,2024-02
2024-02-29,218229,386185,-167956,감비아,2024-02
2024-02-29,179022,1139719,-960697,도미니카,2024-02
2024-02-29,172811,2664,170147,카보 베르데,2024-02
2024-02-29,153701,4498,149203,니제르,2024-02
2024-02-29,148935,3787279,-3638344,말라위,2024-02
2024-02-29,102525,0,102525,보츠와나,2024-02
2024-02-29,84308,4683,79625,세인트 키츠 네비스,2024-02
2024-02-29,82133,151241,-69108,산마리노,2024-02
2024-02-29,71004,633,70371,투르크 & 카이코스 군도,2024-02
2024-02-29,62008,1012,60996,상토메 프린스페,2024-02
2024-02-29,44528,446,44082,챠드,2024-02
2024-02-29,39442,60,39382,말리,2024-02
2024-02-29,36829,266,36563,나우루,2024-02
2024-02-29,36322,0,36322,코모로스,2024-02
2024-02-29,35418,2404,33014,안도라,2024-02
2024-02-29,33428,0,33428,지브랄타,2024-02
2024-02-29,31576,37813,-6237,티모르,2024-02
2024-02-29,25290,54,25236,통가,2024-02
2024-02-29,23973,307,23666,부룬디,2024-02
2024-02-29,15667,18,15649,세인트 바르탤르미,2024-02
2024-02-29,12116,35117621,-35105505,적도 기니,2024-02
2024-02-29,10380,4393,5987,레소토,2024-02
2024-02-29,6907,2952,3955,미령 버진군도,2024-02
2024-02-29,5296,119406,-114110,그린랜드,2024-02
2024-02-29,1719,1968,-249,건지,2024-02
2024-02-29,1590,0,1590,중앙아프리카공화국,2024-02
2024-02-29,1334,331,1003,저어지,2024-02
2024-02-29,938,432,506,세인트마틴(생마르탱),2024-02
2024-02-29,900,0,900,쿡 아일랜드,2024-02
2024-02-29,739,0,739,안타티카,2024-02
2024-02-29,472,0,472,포클랜드 군도,2024-02
2024-02-29,139,213333,-213194,모나코,2024-02
2024-02-29,45,4454,-4409,앙귈라,2024-02
2024-02-29,40,0,40,파로에 군도,2024-02
2024-02-29,0,252,-252,니우에,2024-02
2024-02-29,0,66424,-66424,기네비소,2024-02
2024-02-29,0,2464,-2464,영령 인도양,2024-02
2024-02-29,0,12708,-12708,맨섬,2024-02
2024-02-29,0,288,-288,마이너 아우틀링 합중국 군도,2024-02
2024-02-29,0,572,-572,남조지아 & 남샌드위치 군도,2024-02
2024-02-29,0,145,-145,보빗군도,2024-02
2024-03-31,10880792519,5975810637,4904981882,미국,2024-03
2024-03-31,10520354820,11409747500,-889392680,중국,2024-03
2024-03-31,4830493739,2313999928,2516493811,베트남,2024-03
2024-03-31,3698704701,291246508,3407458193,홍콩,2024-03
2024-03-31,2127248532,4080885372,-1953636840,일본,2024-03
2024-03-31,1988527762,2129273601,-140745839,대만,2024-03
2024-03-31,1950908238,883605641,1067302597,싱가포르,2024-03
2024-03-31,1589357946,2401773352,-812415406,호주,2024-03
2024-03-31,1512488515,497623285,1014865230,인도,2024-03
2024-03-31,1181040231,427353238,753686993,멕시코,2024-03
2024-03-31,919201852,112622983,806578869,튀르키예,2024-03
2024-03-31,868836290,699638205,169198085,캐나다,2024-03
2024-03-31,805262270,1061066136,-255803866,말레이시아,2024-03
2024-03-31,797172328,1815955912,-1018783584,독일,2024-03
2024-03-31,706082382,692047334,14035048,네덜란드,2024-03
2024-03-31,677320317,421855537,255464780,필리핀,2024-03
2024-03-31,605606949,601694474,3912475,태국,2024-03
2024-03-31,555555124,84907813,470647311,폴란드,2024-03
2024-03-31,540519343,467187545,73331798,영국,2024-03
2024-03-31,503339091,613462185,-110123094,프랑스,2024-03
2024-03-31,495930769,1028617224,-532686455,인도네시아,2024-03
2024-03-31,460375353,25244442,435130911,라이베리아,2024-03
2024-03-31,453936900,450516119,3420781,브라질,2024-03
2024-03-31,447730460,2739089,444991371,파나마,2024-03
2024-03-31,431939572,59727822,372211750,헝가리,2024-03
2024-03-31,430756511,1809469133,-1378712622,아랍에미리트 연합,2024-03
2024-03-31,412694707,735552420,-322857713,이탈리아,2024-03
2024-03-31,384381715,2608414432,-2224032717,사우디아라비아,2024-03
2024-03-31,383854921,103807139,280047782,벨기에,2024-03
2024-03-31,345868935,200871101,144997834,스페인,2024-03
2024-03-31,323087349,103374861,219712488,뉴질랜드,2024-03
2024-03-31,308285366,557420967,-249135601,러시아 연방,2024-03
2024-03-31,303004595,102088501,200916094,체코공화국,2024-03
2024-03-31,259034406,76050654,182983752,슬로바키아,2024-03
2024-03-31,219571313,86050083,133521230,덴마크,2024-03
2024-03-31,171874800,195257960,-23383160,카자흐스탄,2024-03
2024-03-31,138798685,198419469,-59620784,스웨덴,2024-03
2024-03-31,137781081,89920128,47860953,이스라엘,2024-03
2024-03-31,133745085,1016490,132728595,우즈베키스탄,2024-03
2024-03-31,119653297,4967247,114686050,이집트,2024-03
2024-03-31,113663618,392124409,-278460791,오만,2024-03
2024-03-31,111260487,839448342,-728187855,이라크,2024-03
2024-03-31,108940344,287511327,-178570983,스위스,2024-03
2024-03-31,107911431,464696940,-356785509,칠레,2024-03
2024-03-31,104568897,12494359,92074538,슬로베니아,2024-03
2024-03-31,98892501,6792,98885709,키르기스스탄,2024-03
2024-03-31,92608209,8102620,84505589,에쿠아도르,2024-03
2024-03-31,91252287,145370535,-54118248,오스트리아,2024-03
2024-03-31,84915750,19349449,65566301,파키스탄,2024-03
2024-03-31,83334849,71696454,11638395,방글라데시,2024-03
2024-03-31,81940693,6817826,75122867,몰타,2024-03
2024-03-31,75743484,85595544,-9852060,포루투갈,2024-03
2024-03-31,75742900,68502778,7240122,콜롬비아,2024-03
2024-03-31,75657585,168747498,-93089913,아일랜드,2024-03
2024-03-31,66885643,162350727,-95465084,남아프리카공화국,2024-03
2024-03-31,58390560,58244740,145820,나이지리아,2024-03
2024-03-31,56906594,354658128,-297751534,페루,2024-03
2024-03-31,55403480,41552277,13851203,캄보디아,2024-03
2024-03-31,52553244,70219438,-17666194,루마니아,2024-03
2024-03-31,47450517,58038351,-10587834,마샬군도,2024-03
2024-03-31,47246677,1081926899,-1034680222,카타르,2024-03
2024-03-31,45450322,165820588,-120370266,그리스,2024-03
2024-03-31,45122711,3163767,41958944,몽골,2024-03
2024-03-31,44543211,35372998,9170213,푸에르토리코,2024-03
2024-03-31,41740223,383483454,-341743231,알제리,2024-03
2024-03-31,39069480,8356339,30713141,요르단,2024-03
2024-03-31,37876643,9580216,28296427,리투아니아,2024-03
2024-03-31,35672320,6400333,29271987,에티오피아,2024-03
2024-03-31,35312883,5840345,29472538,과테말라,2024-03
2024-03-31,34421974,64539849,-30117875,우크라이나,2024-03
2024-03-31,33610040,99660458,-66050418,노르웨이,2024-03
2024-03-31,32290782,65450005,-33159223,핀란드,2024-03
2024-03-31,31972321,19759756,12212565,모로코,2024-03
2024-03-31,31736467,53839197,-22102730,아르헨티나,2024-03
2024-03-31,29968275,6692652,23275623,도미니카 공화국,2024-03
2024-03-31,28126283,2967960,25158323,온두라스,2024-03
2024-03-31,26724788,687219919,-660495131,쿠웨이트,2024-03
2024-03-31,26678096,3383555,23294541,리비아,2024-03
2024-03-31,25805606,152038,25653568,피지,2024-03
2024-03-31,25312791,18624939,6687852,불가리아,2024-03
2024-03-31,24559629,42815101,-18255472,세르비아,2024-03
2024-03-31,24506289,14045268,10461021,코스타리카,2024-03
2024-03-31,23837791,26964,23810827,아제르바이잔,2024-03
2024-03-31,23559463,45083849,-21524386,미얀마,2024-03
2024-03-31,21854836,1758180,20096656,엘살바도르,2024-03
2024-03-31,16097506,6976612,9120894,탄자니아,2024-03
2024-03-31,15943795,593760,15350035,괌,2024-03
2024-03-31,15395945,273511,15122434,코트디봐르,2024-03
2024-03-31,15268918,2594815,12674103,조지아,2024-03
2024-03-31,13896113,1111480,12784633,알바니아,2024-03
2024-03-31,13615906,2612834,11003072,케냐,2024-03
2024-03-31,12892108,10384079,2508029,스리랑카,2024-03
2024-03-31,12504922,255,12504667,앙골라,2024-03
2024-03-31,12351012,2893621,9457391,가나,2024-03
2024-03-31,12036370,2000267,10036103,타지크,2024-03
2024-03-31,11100846,721792,10379054,이란,2024-03
2024-03-31,10914749,11302946,-388197,튀니지,2024-03
2024-03-31,10805952,29295813,-18489861,우루과이,2024-03
2024-03-31,9780370,7825907,1954463,파라과이,2024-03
2024-03-31,9329012,4803558,4525454,트리니다드 토바고,2024-03
2024-03-31,9040042,6206097,2833945,몰도바,2024-03
2024-03-31,8934715,4125,8930590,불령 폴리네시아,2024-03
2024-03-31,8391845,5598598,2793247,라오스,2024-03
2024-03-31,8144001,1655310,6488691,레바논,2024-03
2024-03-31,8115399,3004539,5110860,세네갈,2024-03
2024-03-31,7881596,2203149,5678447,크로아티아,2024-03
2024-03-31,7784973,3433,7781540,투르크멘,2024-03
2024-03-31,7684861,18119909,-10435048,바레인,2024-03
2024-03-31,6648010,1176125,5471885,니카라과,2024-03
2024-03-31,6031474,37230908,-31199434,모잠비크,2024-03
2024-03-31,5978376,643560,5334816,모리셔스,2024-03
2024-03-31,5861317,44770301,-38908984,기타국,2024-03
2024-03-31,5755571,14283108,-8527537,에스토니아,2024-03
2024-03-31,5730345,102537,5627808,브루나이,2024-03
2024-03-31,5644477,2931431,2713046,잠비아,2024-03
2024-03-31,5451091,913894,4537197,벨라루스,2024-03
2024-03-31,5373701,1678173,3695528,예맨,2024-03
2024-03-31,5110006,17497803,-12387797,라트비아,2024-03
2024-03-31,4197754,0,4197754,사모아,2024-03
2024-03-31,4071378,56981055,-52909677,콩고민주공화국,2024-03
2024-03-31,4030109,0,4030109,지부티,2024-03
2024-03-31,3778873,12057,3766816,부르키나 파소,2024-03
2024-03-31,3774823,4755736,-980913,룩셈부르그,2024-03
2024-03-31,3707542,42583,3664959,가이아나,2024-03
2024-03-31,3706157,1225712,2480445,아이슬란드,2024-03
2024-03-31,3566165,469143,3097022,베네주엘라,2024-03
2024-03-31,3502062,0,3502062,소말리아,2024-03
2024-03-31,3442422,495,3441927,몬테네그로,2024-03
2024-03-31,3353805,5938,3347867,아루바,2024-03
2024-03-31,3276467,1055810,2220657,사이프러스,2024-03
2024-03-31,3180054,587229,2592825,네팔,2024-03
2024-03-31,3149095,40426494,-37277399,파푸아 뉴기니,2024-03
2024-03-31,3020348,69949,2950399,아프카니스탄,2024-03
2024-03-31,2855569,80,2855489,불령 리유니온 코모도 제도,2024-03
2024-03-31,2783432,14081535,-11298103,마다카스카르,2024-03
2024-03-31,2777384,2464639,312745,말라위,2024-03
2024-03-31,2674001,309767,2364234,카메룬,2024-03
2024-03-31,2567498,121027,2446471,자마이카,2024-03
2024-03-31,2559015,116930,2442085,쿠바,2024-03
2024-03-31,2339667,2239858,99809,가봉,2024-03
2024-03-31,2276251,2477052,-200801,토고,2024-03
2024-03-31,2014086,23839,1990247,벨리제,2024-03
2024-03-31,2002695,422253,1580442,바누아투,2024-03
2024-03-31,1824284,22119,1802165,콩고,2024-03
2024-03-31,1822611,1166021,656590,우간다,2024-03
2024-03-31,1706377,367615,1338762,마카오,2024-03
2024-03-31,1593156,630515,962641,수단,2024-03
2024-03-31,1541233,0,1541233,마티니크,2024-03
2024-03-31,1497043,156167,1340876,르완다,2024-03
2024-03-31,1459643,2251443,-791800,짐바브웨,2024-03
2024-03-31,1445207,6356114,-4910907,아르메니아,2024-03
2024-03-31,1441586,63052164,-61610578,볼리비아,2024-03
2024-03-31,1373543,122888,1250655,북마리아나 군도,2024-03
2024-03-31,1291986,2595008,-1303022,모리타니,2024-03
2024-03-31,1271975,563,1271412,바하마,2024-03
2024-03-31,1171144,276505,894639,베닝,2024-03
2024-03-31,1158356,81223,1077133,아이티,2024-03
2024-03-31,1112708,7445007,-6332299,기니,2024-03
2024-03-31,1034655,28876,1005779,세이쉘,2024-03
2024-03-31,993746,0,993746,키리바티,2024-03
2024-03-31,888793,1187250,-298457,투발루,2024-03
2024-03-31,873934,16352836,-15478902,뉴 칼레도니아,2024-03
2024-03-31,872055,0,872055,큐라소,2024-03
2024-03-31,860669,266813,593856,팔레스타인 해방기구,2024-03
2024-03-31,850459,8343,842116,시리아,2024-03
2024-03-31,778770,571127,207643,마세도니아,2024-03
2024-03-31,741577,1312759,-571182,리히텐슈타인,2024-03
2024-03-31,706840,14542,692298,바베이도스,2024-03
2024-03-31,701065,0,701065,버뮤다,2024-03
2024-03-31,623145,67,623078,세인트 루시아,2024-03
2024-03-31,601438,367,601071,적도 기니,2024-03
2024-03-31,587600,0,587600,세인트 마틴,2024-03
2024-03-31,571405,4998,566407,몰디브,2024-03
2024-03-31,560561,1844912,-1284351,시에라 리온,2024-03
2024-03-31,553168,0,553168,카보 베르데,2024-03
2024-03-31,548009,1747,546262,티모르,2024-03
2024-03-31,487433,35662,451771,과델로프,2024-03
2024-03-31,473684,30285,443399,영령 캐이맨 군도,2024-03
2024-03-31,420207,43503,376704,스와질랜드,2024-03
2024-03-31,420074,2373677,-1953603,보스니아-헤르체고비나,2024-03
2024-03-31,408577,407923,654,아메리칸 사모아,2024-03
2024-03-31,406973,1358410,-951437,감비아,2024-03
2024-03-31,389152,0,389152,안티가 바부다,2024-03
2024-03-31,352627,1092,351535,마이크로네시아,2024-03
2024-03-31,336271,846472,-510201,부탄,2024-03
2024-03-31,275996,66411740,-66135744,나미비아,2024-03
2024-03-31,275127,1313293,-1038166,도미니카,2024-03
2024-03-31,261592,855202,-593610,수리남,2024-03
2024-03-31,260866,0,260866,솔로몬 군도,2024-03
2024-03-31,239372,0,239372,메요트,2024-03
2024-03-31,235887,0,235887,팔라우,2024-03
2024-03-31,232676,110,232566,영령 버진군도,2024-03
2024-03-31,224399,21643,202756,보츠와나,2024-03
2024-03-31,197816,40,197776,세인트 키츠 네비스,2024-03
2024-03-31,177297,12252,165045,남수단,2024-03
2024-03-31,113281,0,113281,세인트 빈센트 그레나딘,2024-03
2024-03-31,107727,0,107727,그레나다,2024-03
2024-03-31,85811,5252,80559,말리,2024-03
2024-03-31,84380,215,84165,부룬디,2024-03
2024-03-31,76176,0,76176,투르크 & 카이코스 군도,2024-03
2024-03-31,69780,46182,23598,기네비소,2024-03
2024-03-31,68886,0,68886,불령 가이아나,2024-03
2024-03-31,66751,166,66585,지브랄타,2024-03
2024-03-31,54202,4194,50008,네덜란드 열도,2024-03
2024-03-31,38675,0,38675,코모로스,2024-03
2024-03-31,27960,53130,-25170,에리트리아,2024-03
2024-03-31,26332,0,26332,포클랜드 군도,2024-03
2024-03-31,25737,5850,19887,레소토,2024-03
2024-03-31,22462,9501,12961,미령 버진군도,2024-03
2024-03-31,15518,431427,-415909,모나코,2024-03
2024-03-31,14549,0,14549,통가,2024-03
2024-03-31,11047,0,11047,세인트마틴(생마르탱),2024-03
2024-03-31,8800,4,8796,중앙아프리카공화국,2024-03
2024-03-31,6925,9267,-2342,건지,2024-03
2024-03-31,2650,320493,-317843,그린랜드,2024-03
2024-03-31,1375,4000,-2625,안도라,2024-03
2024-03-31,547,445,102,앙귈라,2024-03
2024-03-31,414,274,140,저어지,2024-03
2024-03-31,161,0,161,챠드,2024-03
2024-03-31,99,363,-264,파로에 군도,2024-03
2024-03-31,38,0,38,몬트세라트,2024-03
2024-03-31,0,824,-824,니제르,2024-03
2024-03-31,0,676,-676,나우루,2024-03
2024-03-31,0,281,-281,영령 인도양,2024-03
2024-03-31,0,37,-37,교황청,2024-03
2024-03-31,0,101,-101,니우에,2024-03
2024-03-31,0,801,-801,피트카이른,2024-03
2024-03-31,0,1500,-1500,맨섬,2024-03
2024-03-31,0,217,-217,불령 남부지역,2024-03
2024-03-31,0,941,-941,토켈라우,2024-03
2024-03-31,0,8,-8,국제통화기금,2024-03
2024-03-31,0,32,-32,코스 군도,2024-03
2024-03-31,0,98448,-98448,산마리노,2024-03
2024-03-31,0,1100,-1100,안타티카,2024-03
2024-03-31,0,212,-212,마이너 아우틀링 합중국 군도,2024-03
2024-03-31,0,659,-659,남조지아 & 남샌드위치 군도,2024-03
2024-04-30,11400587279,6012892595,5387694684,미국,2024-04
2024-04-30,10475410103,12425106138,-1949696035,중국,2024-04
2024-04-30,4552004233,2249763765,2302240468,베트남,2024-04
2024-04-30,2933525212,376418043,2557107169,홍콩,2024-04
2024-04-30,2438707645,4130443190,-1691735545,일본,2024-04
2024-04-30,2086950941,2298493317,-211542376,대만,2024-04
2024-04-30,1568003902,520352257,1047651645,인도,2024-04
2024-04-30,1427200511,2975064817,-1547864306,호주,2024-04
2024-04-30,1355783563,861347059,494436504,싱가포르,2024-04
2024-04-30,1141357731,634691547,506666184,멕시코,2024-04
2024-04-30,972095566,636774572,335320994,캐나다,2024-04
2024-04-30,918763117,1949845474,-1031082357,독일,2024-04
2024-04-30,912615475,135437462,777178013,튀르키예,2024-04
2024-04-30,862002818,1028087151,-166084333,말레이시아,2024-04
2024-04-30,847145984,466355054,380790930,필리핀,2024-04
2024-04-30,712806842,111964359,600842483,폴란드,2024-04
2024-04-30,668783333,635057132,33726201,태국,2024-04
2024-04-30,650345415,1077469790,-427124375,인도네시아,2024-04
2024-04-30,577685991,468367516,109318475,네덜란드,2024-04
2024-04-30,503822052,640792547,-136970495,프랑스,2024-04
2024-04-30,496174428,650668278,-154493850,브라질,2024-04
2024-04-30,492779250,688897811,-196118561,이탈리아,2024-04
2024-04-30,479810077,2800137203,-2320327126,사우디아라비아,2024-04
2024-04-30,468386595,369952905,98433690,영국,2024-04
2024-04-30,451815439,1995491597,-1543676158,아랍에미리트 연합,2024-04
2024-04-30,445551151,57243306,388307845,헝가리,2024-04
2024-04-30,366374352,21824358,344549994,라이베리아,2024-04
2024-04-30,362425960,111235778,251190182,벨기에,2024-04
2024-04-30,316426886,528178082,-211751196,러시아 연방,2024-04
2024-04-30,286327650,250497841,35829809,스페인,2024-04
2024-04-30,276636334,122089275,154547059,체코공화국,2024-04
2024-04-30,251920660,202313735,49606925,뉴질랜드,2024-04
2024-04-30,236410399,39830684,196579715,슬로바키아,2024-04
2024-04-30,230730602,4680,230725922,마샬군도,2024-04
2024-04-30,207917882,15538,207902344,버뮤다,2024-04
2024-04-30,174701733,108498506,66203227,카자흐스탄,2024-04
2024-04-30,144054576,542025,143512551,우즈베키스탄,2024-04
2024-04-30,131531799,108918292,22613507,이스라엘,2024-04
2024-04-30,124505448,354205475,-229700027,스위스,2024-04
2024-04-30,123958614,136776083,-12817469,그리스,2024-04
2024-04-30,123570524,18201,123552323,키르기스스탄,2024-04
2024-04-30,122099636,131976232,-9876596,스웨덴,2024-04
2024-04-30,115682221,576986461,-461304240,이라크,2024-04
2024-04-30,114373830,413111441,-298737611,칠레,2024-04
2024-04-30,113591728,5960790,107630938,이집트,2024-04
2024-04-30,102637441,2093745,100543696,파나마,2024-04
2024-04-30,99873480,144325944,-44452464,오스트리아,2024-04
2024-04-30,91589695,11440488,80149207,슬로베니아,2024-04
2024-04-30,90319307,43340724,46978583,파키스탄,2024-04
2024-04-30,84766969,37645609,47121360,포루투갈,2024-04
2024-04-30,81184483,97905059,-16720576,아일랜드,2024-04
2024-04-30,79118943,1495168764,-1416049821,카타르,2024-04
2024-04-30,78294187,411,78293776,앙골라,2024-04
2024-04-30,78286839,58937170,19349669,방글라데시,2024-04
2024-04-30,73085421,75768364,-2682943,콜롬비아,2024-04
2024-04-30,67369308,604561654,-537192346,오만,2024-04
2024-04-30,56606967,242153587,-185546620,페루,2024-04
2024-04-30,55375942,200454785,-145078843,남아프리카공화국,2024-04
2024-04-30,54890858,41477379,13413479,나이지리아,2024-04
2024-04-30,54844146,37043656,17800490,캄보디아,2024-04
2024-04-30,50288444,3077810,47210634,몽골,2024-04
2024-04-30,47604225,66932919,-19328694,루마니아,2024-04
2024-04-30,47505772,507360,46998412,괌,2024-04
2024-04-30,46778555,8855274,37923281,에쿠아도르,2024-04
2024-04-30,46292008,6785645,39506363,요르단,2024-04
2024-04-30,45955544,18525580,27429964,불가리아,2024-04
2024-04-30,42638447,83156471,-40518024,덴마크,2024-04
2024-04-30,41937663,30770278,11167385,푸에르토리코,2024-04
2024-04-30,37845169,2517651,35327518,리비아,2024-04
2024-04-30,37184785,62960836,-25776051,파푸아 뉴기니,2024-04
2024-04-30,36873997,117663107,-80789110,아르헨티나,2024-04
2024-04-30,36357293,8382166,27975127,도미니카 공화국,2024-04
2024-04-30,35526855,10713534,24813321,모로코,2024-04
2024-04-30,34296227,8078935,26217292,리투아니아,2024-04
2024-04-30,30760276,227550665,-196790389,알제리,2024-04
2024-04-30,30040457,40611222,-10570765,미얀마,2024-04
2024-04-30,29140972,672283542,-643142570,쿠웨이트,2024-04
2024-04-30,29134459,32125775,-2991316,과테말라,2024-04
2024-04-30,28661660,40985208,-12323548,우크라이나,2024-04
2024-04-30,27957809,15361378,12596431,코스타리카,2024-04
2024-04-30,26700041,27968902,-1268861,세르비아,2024-04
2024-04-30,24473844,103227595,-78753751,노르웨이,2024-04
2024-04-30,22774246,79390556,-56616310,핀란드,2024-04
2024-04-30,22248632,9010468,13238164,에티오피아,2024-04
2024-04-30,21750976,11536133,10214843,스리랑카,2024-04
2024-04-30,19859066,3822075,16036991,케냐,2024-04
2024-04-30,18794873,644577,18150296,아제르바이잔,2024-04
2024-04-30,18590039,621004,17969035,알바니아,2024-04
2024-04-30,16305521,3459298,12846223,가나,2024-04
2024-04-30,15470535,15442457,28078,온두라스,2024-04
2024-04-30,15290235,1658367,13631868,엘살바도르,2024-04
2024-04-30,14285129,4671224,9613905,탄자니아,2024-04
2024-04-30,13554598,2819088,10735510,세네갈,2024-04
2024-04-30,12689938,1893666,10796272,타지크,2024-04
2024-04-30,12526654,42633,12484021,코트디봐르,2024-04
2024-04-30,12504419,1154913,11349506,조지아,2024-04
2024-04-30,11970538,27942189,-15971651,몰타,2024-04
2024-04-30,11263040,7223782,4039258,우루과이,2024-04
2024-04-30,9106709,425960,8680749,이란,2024-04
2024-04-30,8744953,27000713,-18255760,파라과이,2024-04
2024-04-30,8208351,2139142,6069209,레바논,2024-04
2024-04-30,8073366,19967048,-11893682,에스토니아,2024-04
2024-04-30,7649712,56410222,-48760510,바레인,2024-04
2024-04-30,7347371,10203246,-2855875,튀니지,2024-04
2024-04-30,7300367,862572,6437795,우간다,2024-04
2024-04-30,6959756,9597492,-2637736,니카라과,2024-04
2024-04-30,6822937,10721038,-3898101,몰도바,2024-04
2024-04-30,6791230,8749301,-1958071,라오스,2024-04
2024-04-30,6738252,5877160,861092,마다카스카르,2024-04
2024-04-30,6366656,2008152,4358504,예맨,2024-04
2024-04-30,6030088,125771767,-119741679,모잠비크,2024-04
2024-04-30,5925598,598212,5327386,벨라루스,2024-04
2024-04-30,5546098,76578108,-71032010,기타국,2024-04
2024-04-30,5457793,2188297,3269496,크로아티아,2024-04
2024-04-30,5381480,1004565,4376915,사이프러스,2024-04
2024-04-30,5272271,647697,4624574,부르키나 파소,2024-04
2024-04-30,5212727,17064,5195663,사모아,2024-04
2024-04-30,4887103,97794890,-92907787,콩고민주공화국,2024-04
2024-04-30,4868796,13800,4854996,팔라우,2024-04
2024-04-30,4756334,369292,4387042,모리셔스,2024-04
2024-04-30,4669090,11105434,-6436344,나미비아,2024-04
2024-04-30,4487567,6476075,-1988508,라트비아,2024-04
2024-04-30,4487138,987711,3499427,아이슬란드,2024-04
2024-04-30,4040301,41833,3998468,아프카니스탄,2024-04
2024-04-30,3704976,5722015,-2017039,룩셈부르그,2024-04
2024-04-30,3552515,3409116,143399,토고,2024-04
2024-04-30,3550798,579453,2971345,베네주엘라,2024-04
2024-04-30,3497148,22195723,-18698575,트리니다드 토바고,2024-04
2024-04-30,3481250,35709356,-32228106,브루나이,2024-04
2024-04-30,3199162,26450664,-23251502,카메룬,2024-04
2024-04-30,3158357,32096,3126261,자마이카,2024-04
2024-04-30,3138637,5337,3133300,지부티,2024-04
2024-04-30,2996299,3264741,-268442,모리타니,2024-04
2024-04-30,2939326,14585298,-11645972,볼리비아,2024-04
2024-04-30,2908463,737178,2171285,수단,2024-04
2024-04-30,2689677,37078,2652599,벨리제,2024-04
2024-04-30,2509578,81919,2427659,피지,2024-04
2024-04-30,2434850,78258,2356592,스와질랜드,2024-04
2024-04-30,2339913,30194,2309719,잠비아,2024-04
2024-04-30,2335204,4459757,-2124553,아르메니아,2024-04
2024-04-30,2273533,478799,1794734,네팔,2024-04
2024-04-30,2052796,0,2052796,아루바,2024-04
2024-04-30,2025173,88241,1936932,르완다,2024-04
2024-04-30,2016142,12085,2004057,불령 폴리네시아,2024-04
2024-04-30,1912464,2512787,-600323,가봉,2024-04
2024-04-30,1888925,363,1888562,가이아나,2024-04
2024-04-30,1822777,0,1822777,팔레스타인 해방기구,2024-04
2024-04-30,1785386,2955041,-1169655,짐바브웨,2024-04
2024-04-30,1747370,0,1747370,베닝,2024-04
2024-04-30,1713270,0,1713270,투르크멘,2024-04
2024-04-30,1668424,2808777,-1140353,기니,2024-04
2024-04-30,1528675,303113,1225562,콩고,2024-04
2024-04-30,1485579,1565,1484014,바하마,2024-04
2024-04-30,1455262,0,1455262,큐라소,2024-04
2024-04-30,1277314,615929,661385,아메리칸 사모아,2024-04
2024-04-30,1227165,3610926,-2383761,보스니아-헤르체고비나,2024-04
2024-04-30,1218551,19442729,-18224178,뉴 칼레도니아,2024-04
2024-04-30,1210743,1711016,-500273,리히텐슈타인,2024-04
2024-04-30,1173090,3179,1169911,영령 캐이맨 군도,2024-04
2024-04-30,1137299,5616,1131683,소말리아,2024-04
2024-04-30,1114304,180207,934097,북마리아나 군도,2024-04
2024-04-30,1090564,21300,1069264,키리바티,2024-04
2024-04-30,1074524,526,1073998,몬테네그로,2024-04
2024-04-30,1001297,4745630,-3744333,말리,2024-04
2024-04-30,955608,0,955608,세인트 마틴,2024-04
2024-04-30,929150,1290917,-361767,시에라 리온,2024-04
2024-04-30,893297,0,893297,챠드,2024-04
2024-04-30,834198,645540,188658,마세도니아,2024-04
2024-04-30,800312,0,800312,안티가 바부다,2024-04
2024-04-30,791639,501369,290270,수리남,2024-04
2024-04-30,790585,845,789740,불령 리유니온 코모도 제도,2024-04
2024-04-30,748328,112632,635696,기네비소,2024-04
2024-04-30,711368,3268,708100,몰디브,2024-04
2024-04-30,672877,188144,484733,마카오,2024-04
2024-04-30,668677,0,668677,마이크로네시아,2024-04
2024-04-30,652714,394707,258007,보츠와나,2024-04
2024-04-30,648288,548890,99398,바누아투,2024-04
2024-04-30,581235,18817,562418,바베이도스,2024-04
2024-04-30,553021,0,553021,마티니크,2024-04
2024-04-30,505118,17805,487313,솔로몬 군도,2024-04
2024-04-30,469140,39,469101,시리아,2024-04
2024-04-30,373788,132810,240978,세이쉘,2024-04
2024-04-30,344145,443631,-99486,부탄,2024-04
2024-04-30,329860,1304,328556,티모르,2024-04
2024-04-30,290479,2892,287587,세인트 루시아,2024-04
2024-04-30,255946,6914,249032,영령 버진군도,2024-04
2024-04-30,249892,678294,-428402,감비아,2024-04
2024-04-30,247392,348840,-101448,쿠바,2024-04
2024-04-30,244615,107,244508,부룬디,2024-04
2024-04-30,175498,36886,138612,도미니카,2024-04
2024-04-30,157147,163,156984,상토메 프린스페,2024-04
2024-04-30,156503,21527,134976,그레나다,2024-04
2024-04-30,155870,3015,152855,중앙아프리카공화국,2024-04
2024-04-30,142901,91848,51053,아이티,2024-04
2024-04-30,141231,2742956,-2601725,말라위,2024-04
2024-04-30,140887,7257,133630,투발루,2024-04
2024-04-30,132282,18531,113751,통가,2024-04
2024-04-30,120815,73668,47147,세인트 빈센트 그레나딘,2024-04
2024-04-30,78726,16500,62226,네덜란드 열도,2024-04
2024-04-30,70775,0,70775,적도 기니,2024-04
2024-04-30,61370,1795,59575,세인트 키츠 네비스,2024-04
2024-04-30,49873,0,49873,과델로프,2024-04
2024-04-30,48484,0,48484,불령 가이아나,2024-04
2024-04-30,46223,0,46223,남조지아 & 남샌드위치 군도,2024-04
2024-04-30,28600,0,28600,세인트마틴(생마르탱),2024-04
2024-04-30,27462,17423,10039,코모로스,2024-04
2024-04-30,25000,116633,-91633,산마리노,2024-04
2024-04-30,21930,20,21910,카보 베르데,2024-04
2024-04-30,15986,0,15986,남수단,2024-04
2024-04-30,9869,0,9869,왈라스 & 퓨투나 군도,2024-04
2024-04-30,9290,205,9085,포클랜드 군도,2024-04
2024-04-30,8017,0,8017,세인트 바르탤르미,2024-04
2024-04-30,6744,61,6683,니제르,2024-04
2024-04-30,6063,3834,2229,안도라,2024-04
2024-04-30,5181,0,5181,지브랄타,2024-04
2024-04-30,4017,0,4017,앙귈라,2024-04
2024-04-30,3626,186480,-182854,그린랜드,2024-04
2024-04-30,1530,0,1530,교황청,2024-04
2024-04-30,1284,64,1220,몬트세라트,2024-04
2024-04-30,1252,7174,-5922,미령 버진군도,2024-04
2024-04-30,580,264403,-263823,모나코,2024-04
2024-04-30,506,207,299,투르크 & 카이코스 군도,2024-04
2024-04-30,185,56,129,건지,2024-04
2024-04-30,133,0,133,저어지,2024-04
2024-04-30,131,0,131,쿡 아일랜드,2024-04
2024-04-30,129,0,129,메요트,2024-04
2024-04-30,50,245935,-245885,파로에 군도,2024-04
2024-04-30,0,3496,-3496,레소토,2024-04
2024-04-30,0,6465,-6465,안타티카,2024-04
2024-04-30,0,238,-238,마이너 아우틀링 합중국 군도,2024-04
2024-04-30,0,36,-36,국제통화기금,2024-04
2024-04-30,0,26,-26,크리스마스 아일랜드,2024-04
2024-04-30,0,169,-169,토켈라우,2024-04
2024-04-30,0,272,-272,니우에,2024-04
2024-04-30,0,4769985,-4769985,나우루,2024-04
2024-04-30,0,230534,-230534,맨섬,2024-04
2024-04-30,0,100,-100,세인트 헬레나,2024-04
2024-04-30,0,1591,-1591,영령 인도양,2024-04
2024-04-30,0,9751019,-9751019,에리트리아,2024-04
2024-04-30,0,215,-215,불령 남부지역,2024-04
2024-05-31,11378216923,12287459379,-909242456,중국,2024-05
2024-05-31,10930528725,6375264221,4555264504,미국,2024-05
2024-05-31,5115764337,2040070098,3075694239,베트남,2024-05
2024-05-31,2706662729,141282280,2565380449,홍콩,2024-05
2024-05-31,2606050053,3443525924,-837475871,일본,2024-05
2024-05-31,2516983862,2792060666,-275076804,대만,2024-05
2024-05-31,1776947189,887799124,889148065,싱가포르,2024-05
2024-05-31,1678332820,478546531,1199786289,인도,2024-05
2024-05-31,1253380477,2271404789,-1018024312,호주,2024-05
2024-05-31,1179960928,662549668,517411260,멕시코,2024-05
2024-05-31,984922212,357150247,627771965,필리핀,2024-05
2024-05-31,942684601,424966595,517718006,캐나다,2024-05
2024-05-31,912421040,1972092787,-1059671747,독일,2024-05
2024-05-31,834674696,1016349065,-181674369,말레이시아,2024-05
2024-05-31,750433247,97090481,653342766,튀르키예,2024-05
2024-05-31,679128232,1084435209,-405306977,인도네시아,2024-05
2024-05-31,646805909,608571698,38234211,태국,2024-05
2024-05-31,608222852,75904983,532317869,폴란드,2024-05
2024-05-31,550288331,539537609,10750722,네덜란드,2024-05
2024-05-31,540368251,272514943,267853308,영국,2024-05
2024-05-31,459856496,51444464,408412032,헝가리,2024-05
2024-05-31,452050484,654813475,-202762991,브라질,2024-05
2024-05-31,445552959,3040379800,-2594826841,사우디아라비아,2024-05
2024-05-31,403686050,632275275,-228589225,이탈리아,2024-05
2024-05-31,395643631,1267426495,-871782864,아랍에미리트 연합,2024-05
2024-05-31,385088297,171486279,213602018,벨기에,2024-05
2024-05-31,332411529,163722,332247807,라이베리아,2024-05
2024-05-31,330628121,615882250,-285254129,프랑스,2024-05
2024-05-31,324584790,13511685,311073105,몰타,2024-05
2024-05-31,313514175,619769227,-306255052,러시아 연방,2024-05
2024-05-31,288014700,86718763,201295937,체코공화국,2024-05
2024-05-31,276878697,203040530,73838167,스페인,2024-05
2024-05-31,274109874,86147,274023727,마샬군도,2024-05
2024-05-31,271122806,145054174,126068632,뉴질랜드,2024-05
2024-05-31,240581726,42477241,198104485,슬로바키아,2024-05
2024-05-31,233440102,107774805,125665297,덴마크,2024-05
2024-05-31,209901771,803,209900968,버뮤다,2024-05
2024-05-31,152758130,251712906,-98954776,카자흐스탄,2024-05
2024-05-31,151221675,1836160,149385515,파나마,2024-05
2024-05-31,146461203,1255382,145205821,우즈베키스탄,2024-05
2024-05-31,144762962,28546,144734416,키르기스스탄,2024-05
2024-05-31,127149958,171268783,-44118825,그리스,2024-05
2024-05-31,125404405,152969968,-27565563,오스트리아,2024-05
2024-05-31,124316502,102777102,21539400,이스라엘,2024-05
2024-05-31,123931998,174537468,-50605470,스웨덴,2024-05
2024-05-31,121432800,290405873,-168973073,스위스,2024-05
2024-05-31,110507032,4665916,105841116,이집트,2024-05
2024-05-31,104881585,10618,104870967,앙골라,2024-05
2024-05-31,94251305,870389290,-776137985,이라크,2024-05
2024-05-31,93806121,2067190,91738931,탄자니아,2024-05
2024-05-31,92509154,155086751,-62577597,아일랜드,2024-05
2024-05-31,80376535,197196436,-116819901,콜롬비아,2024-05
2024-05-31,80245580,23454302,56791278,파키스탄,2024-05
2024-05-31,80003320,576655603,-496652283,칠레,2024-05
2024-05-31,79456762,8433789,71022973,슬로베니아,2024-05
2024-05-31,79372344,32837396,46534948,방글라데시,2024-05
2024-05-31,79324496,50533913,28790583,포루투갈,2024-05
2024-05-31,77350313,1288,77349025,지브랄타,2024-05
2024-05-31,62020893,42355750,19665143,루마니아,2024-05
2024-05-31,60515623,3124835,57390788,몽골,2024-05
2024-05-31,56510006,38213454,18296552,캄보디아,2024-05
2024-05-31,54429518,2499999,51929519,세네갈,2024-05
2024-05-31,54347532,207906152,-153558620,페루,2024-05
2024-05-31,52023716,298667272,-246643556,남아프리카공화국,2024-05
2024-05-31,50303236,1153924884,-1103621648,카타르,2024-05
2024-05-31,48844150,119540973,-70696823,노르웨이,2024-05
2024-05-31,47888973,12019706,35869267,에쿠아도르,2024-05
2024-05-31,45485944,7763125,37722819,리투아니아,2024-05
2024-05-31,40694215,144853221,-104159006,나이지리아,2024-05
2024-05-31,38668767,85558642,-46889875,아르헨티나,2024-05
2024-05-31,36619517,9473906,27145611,요르단,2024-05
2024-05-31,36105942,751548444,-715442502,쿠웨이트,2024-05
2024-05-31,35550105,2068255,33481850,리비아,2024-05
2024-05-31,33025743,25687103,7338640,푸에르토리코,2024-05
2024-05-31,32502701,24487163,8015538,미얀마,2024-05
2024-05-31,31848802,86410362,-54561560,우크라이나,2024-05
2024-05-31,31319768,10632436,20687332,바레인,2024-05
2024-05-31,30386914,506990001,-476603087,오만,2024-05
2024-05-31,29434701,19146187,10288514,모로코,2024-05
2024-05-31,25998977,8051980,17946997,과테말라,2024-05
2024-05-31,25774135,6777016,18997119,도미니카 공화국,2024-05
2024-05-31,24207579,13714936,10492643,코스타리카,2024-05
2024-05-31,21614596,9724094,11890502,엘살바도르,2024-05
2024-05-31,20773860,56372225,-35598365,핀란드,2024-05
2024-05-31,19933797,587073,19346724,알바니아,2024-05
2024-05-31,19907378,10572154,9335224,세르비아,2024-05
2024-05-31,19304346,22905758,-3601412,불가리아,2024-05
2024-05-31,19110687,43813,19066874,아제르바이잔,2024-05
2024-05-31,17753393,7328971,10424422,튀니지,2024-05
2024-05-31,17444317,941041,16503276,이란,2024-05
2024-05-31,17351439,2000,17349439,투르크멘,2024-05
2024-05-31,16562919,338966817,-322403898,알제리,2024-05
2024-05-31,15398662,17027792,-1629130,우루과이,2024-05
2024-05-31,15359900,4459927,10899973,케냐,2024-05
2024-05-31,14685794,334719,14351075,코트디봐르,2024-05
2024-05-31,14166155,7078861,7087294,온두라스,2024-05
2024-05-31,13403607,5249449,8154158,가나,2024-05
2024-05-31,12764086,9964841,2799245,스리랑카,2024-05
2024-05-31,12686485,2959132,9727353,조지아,2024-05
2024-05-31,11628831,684037,10944794,시에라 리온,2024-05
2024-05-31,10074349,6269769,3804580,예맨,2024-05
2024-05-31,9993187,2102528,7890659,타지크,2024-05
2024-05-31,8821664,0,8821664,수단,2024-05
2024-05-31,8476791,2246400,6230391,파라과이,2024-05
2024-05-31,8280261,6774621,1505640,에티오피아,2024-05
2024-05-31,7874932,6534878,1340054,라오스,2024-05
2024-05-31,7373344,623247,6750097,괌,2024-05
2024-05-31,7355959,21242552,-13886593,트리니다드 토바고,2024-05
2024-05-31,7230333,618395,6611938,벨라루스,2024-05
2024-05-31,7096296,1516404,5579892,레바논,2024-05
2024-05-31,6711163,9339411,-2628248,에스토니아,2024-05
2024-05-31,6467217,18020366,-11553149,니카라과,2024-05
2024-05-31,5458473,865831,4592642,사이프러스,2024-05
2024-05-31,5431489,2043927,3387562,크로아티아,2024-05
2024-05-31,5267186,8299986,-3032800,라트비아,2024-05
2024-05-31,5163918,5294851,-130933,몰도바,2024-05
2024-05-31,4433838,15815,4418023,사모아,2024-05
2024-05-31,4428802,280790,4148012,모리셔스,2024-05
2024-05-31,4154829,6049,4148780,아프카니스탄,2024-05
2024-05-31,4054910,39781581,-35726671,모잠비크,2024-05
2024-05-31,3890168,5460558,-1570390,룩셈부르그,2024-05
2024-05-31,3599140,52038784,-48439644,파푸아 뉴기니,2024-05
2024-05-31,3393865,105027,3288838,북마리아나 군도,2024-05
2024-05-31,3340192,11904,3328288,아루바,2024-05
2024-05-31,3334664,0,3334664,지부티,2024-05
2024-05-31,3331658,0,3331658,가이아나,2024-05
2024-05-31,3225837,172444,3053393,자마이카,2024-05
2024-05-31,3211672,10839896,-7628224,마다카스카르,2024-05
2024-05-31,2988351,385730,2602621,베네주엘라,2024-05
2024-05-31,2865266,2615,2862651,불령 리유니온 코모도 제도,2024-05
2024-05-31,2857484,293324,2564160,아메리칸 사모아,2024-05
2024-05-31,2619088,6876327,-4257239,아르메니아,2024-05
2024-05-31,2493909,33,2493876,베닝,2024-05
2024-05-31,2489945,6051,2483894,불령 폴리네시아,2024-05
2024-05-31,2479920,193633,2286287,피지,2024-05
2024-05-31,2385499,32370682,-29985183,카메룬,2024-05
2024-05-31,2311594,45923020,-43611426,기타국,2024-05
2024-05-31,2204562,86167458,-83962896,콩고민주공화국,2024-05
2024-05-31,2189702,22144,2167558,팔레스타인 해방기구,2024-05
2024-05-31,2164715,56126918,-53962203,볼리비아,2024-05
2024-05-31,2162859,1172403,990456,토고,2024-05
2024-05-31,2087990,4672888,-2584898,부르키나 파소,2024-05
2024-05-31,2040710,40716,1999994,르완다,2024-05
2024-05-31,1652677,677151,975526,짐바브웨,2024-05
2024-05-31,1596531,200165,1396366,가봉,2024-05
2024-05-31,1568799,659054,909745,우간다,2024-05
2024-05-31,1439297,0,1439297,코모로스,2024-05
2024-05-31,1431288,2123735,-692447,브루나이,2024-05
2024-05-31,1308936,13177,1295759,콩고,2024-05
2024-05-31,1302977,3844591,-2541614,기니,2024-05
2024-05-31,1286662,0,1286662,마티니크,2024-05
2024-05-31,1233901,398875,835026,네팔,2024-05
2024-05-31,1116401,3157395,-2040994,보스니아-헤르체고비나,2024-05
2024-05-31,1101170,2733939,-1632769,모리타니,2024-05
2024-05-31,1055307,1252,1054055,바하마,2024-05
2024-05-31,983691,21709,961982,시리아,2024-05
2024-05-31,973684,55926,917758,과델로프,2024-05
2024-05-31,964875,265430,699445,마세도니아,2024-05
2024-05-31,927764,262006,665758,마카오,2024-05
2024-05-31,905802,0,905802,불령 가이아나,2024-05
2024-05-31,884220,967522,-83302,잠비아,2024-05
2024-05-31,858167,1107373,-249206,바누아투,2024-05
2024-05-31,848362,24479,823883,보츠와나,2024-05
2024-05-31,786232,181388,604844,세이쉘,2024-05
2024-05-31,753111,76256,676855,소말리아,2024-05
2024-05-31,744078,1253731,-509653,수리남,2024-05
2024-05-31,740643,1397934,-657291,아이슬란드,2024-05
2024-05-31,718466,3,718463,큐라소,2024-05
2024-05-31,714669,134,714535,벨리제,2024-05
2024-05-31,694893,12,694881,바베이도스,2024-05
2024-05-31,676535,2093789,-1417254,리히텐슈타인,2024-05
2024-05-31,647308,20,647288,말리,2024-05
2024-05-31,599934,85677,514257,아이티,2024-05
2024-05-31,582744,22650,560094,키리바티,2024-05
2024-05-31,565973,5924723,-5358750,나미비아,2024-05
2024-05-31,541257,981,540276,몰디브,2024-05
2024-05-31,529867,809585,-279718,쿠바,2024-05
2024-05-31,519430,26940,492490,마이크로네시아,2024-05
2024-05-31,459978,5853,454125,세인트 루시아,2024-05
2024-05-31,406287,0,406287,티모르,2024-05
2024-05-31,393175,3569,389606,영령 캐이맨 군도,2024-05
2024-05-31,372275,1117165,-744890,부탄,2024-05
2024-05-31,342513,3665,338848,투발루,2024-05
2024-05-31,340507,0,340507,세인트 마틴,2024-05
2024-05-31,335934,1984074,-1648140,솔로몬 군도,2024-05
2024-05-31,279754,0,279754,영령 버진군도,2024-05
2024-05-31,256422,0,256422,카보 베르데,2024-05
2024-05-31,248788,0,248788,적도 기니,2024-05
2024-05-31,239562,22679354,-22439792,뉴 칼레도니아,2024-05
2024-05-31,231282,416,230866,그레나다,2024-05
2024-05-31,229847,35022,194825,도미니카,2024-05
2024-05-31,223619,656060,-432441,감비아,2024-05
2024-05-31,185907,72053,113854,팔라우,2024-05
2024-05-31,175178,5639,169539,스와질랜드,2024-05
2024-05-31,105480,10838,94642,안티가 바부다,2024-05
2024-05-31,85087,0,85087,네덜란드 열도,2024-05
2024-05-31,79619,0,79619,세인트마틴(생마르탱),2024-05
2024-05-31,79140,164060,-84920,기네비소,2024-05
2024-05-31,72698,0,72698,중앙아프리카공화국,2024-05
2024-05-31,70990,0,70990,챠드,2024-05
2024-05-31,60723,122314,-61591,말라위,2024-05
2024-05-31,57453,0,57453,에리트리아,2024-05
2024-05-31,50700,0,50700,노폴크 아일랜드,2024-05
2024-05-31,49129,329,48800,투르크 & 카이코스 군도,2024-05
2024-05-31,45002,13435,31567,통가,2024-05
2024-05-31,42041,1911,40130,저어지,2024-05
2024-05-31,41515,127788,-86273,부룬디,2024-05
2024-05-31,37988,16412545,-16374557,몬테네그로,2024-05
2024-05-31,37025,0,37025,미령 버진군도,2024-05
2024-05-31,36314,966,35348,세인트 키츠 네비스,2024-05
2024-05-31,31612,72,31540,니제르,2024-05
2024-05-31,15147,5725,9422,쿡 아일랜드,2024-05
2024-05-31,11887,0,11887,메요트,2024-05
2024-05-31,6578,0,6578,상토메 프린스페,2024-05
2024-05-31,5528,178039,-172511,그린랜드,2024-05
2024-05-31,3160,326270,-323110,산마리노,2024-05
2024-05-31,2889,4732,-1843,세인트 빈센트 그레나딘,2024-05
2024-05-31,2641,47742,-45101,안도라,2024-05
2024-05-31,2396,199,2197,세인트 바르탤르미,2024-05
2024-05-31,1588,135,1453,교황청,2024-05
2024-05-31,1030,0,1030,앙귈라,2024-05
2024-05-31,977,0,977,남수단,2024-05
2024-05-31,723,150056,-149333,모나코,2024-05
2024-05-31,84,4794,-4710,건지,2024-05
2024-05-31,0,528,-528,불령 남부지역,2024-05
2024-05-31,0,475,-475,크리스마스 아일랜드,2024-05
2024-05-31,0,149,-149,코스 군도,2024-05
2024-05-31,0,50,-50,맨섬,2024-05
2024-05-31,0,4160,-4160,토켈라우,2024-05
2024-05-31,0,7395,-7395,안타티카,2024-05
2024-05-31,0,92,-92,마이너 아우틀링 합중국 군도,2024-05
2024-05-31,0,714,-714,몬트세라트,2024-05
2024-05-31,0,12704,-12704,레소토,2024-05
2024-05-31,0,2962,-2962,니우에,2024-05
2024-05-31,0,1047,-1047,포클랜드 군도,2024-05
2024-06-30,11295692974,5496912330,5798780644,미국,2024-06
2024-06-30,10706131450,10941026339,-234894889,중국,2024-06
2024-06-30,5124411966,2201438602,2922973364,베트남,2024-06
2024-06-30,3430045242,91408514,3338636728,홍콩,2024-06
2024-06-30,3314386079,2175690308,1138695771,대만,2024-06
2024-06-30,2382040521,3507948302,-1125907781,일본,2024-06
2024-06-30,1554083158,517579826,1036503332,인도,2024-06
2024-06-30,1419482669,671151047,748331622,싱가포르,2024-06
2024-06-30,1213090817,526482490,686608327,멕시코,2024-06
2024-06-30,1169208610,2369176994,-1199968384,호주,2024-06
2024-06-30,892872619,586266888,306605731,캐나다,2024-06
2024-06-30,841755449,1135522622,-293767173,말레이시아,2024-06
2024-06-30,771475387,97253587,674221800,폴란드,2024-06
2024-06-30,770305706,314716459,455589247,필리핀,2024-06
2024-06-30,715608931,814900534,-99291603,인도네시아,2024-06
2024-06-30,669829467,2054950691,-1385121224,독일,2024-06
2024-06-30,629600675,157744,629442931,라이베리아,2024-06
2024-06-30,602249240,118712365,483536875,튀르키예,2024-06
2024-06-30,599050564,620340434,-21289870,태국,2024-06
2024-06-30,517007414,413637888,103369526,영국,2024-06
2024-06-30,506899425,2405557737,-1898658312,사우디아라비아,2024-06
2024-06-30,480559356,721329555,-240770199,네덜란드,2024-06
2024-06-30,468581831,63990968,404590863,헝가리,2024-06
2024-06-30,447899406,1632576514,-1184677108,아랍에미리트 연합,2024-06
2024-06-30,437406734,283155905,154250829,브라질,2024-06
2024-06-30,434033054,733388615,-299355561,프랑스,2024-06
2024-06-30,402977419,106355380,296622039,벨기에,2024-06
2024-06-30,358275029,453788580,-95513551,러시아 연방,2024-06
2024-06-30,353808121,659887155,-306079034,이탈리아,2024-06
2024-06-30,327905738,165735463,162170275,뉴질랜드,2024-06
2024-06-30,276970850,208036712,68934138,스페인,2024-06
2024-06-30,218005521,94192739,123812782,체코공화국,2024-06
2024-06-30,207863038,862,207862176,버뮤다,2024-06
2024-06-30,201866610,48068436,153798174,슬로바키아,2024-06
2024-06-30,169266033,1660519,167605514,우즈베키스탄,2024-06
2024-06-30,153584597,16499078,137085519,카자흐스탄,2024-06
2024-06-30,150404252,1100122,149304130,키르기스스탄,2024-06
2024-06-30,147342682,95799452,51543230,이스라엘,2024-06
2024-06-30,118030707,182976798,-64946091,스웨덴,2024-06
2024-06-30,109535773,923107337,-813571564,이라크,2024-06
2024-06-30,105431707,95386335,10045372,그리스,2024-06
2024-06-30,104278991,39759551,64519440,방글라데시,2024-06
2024-06-30,104033420,272641152,-168607732,스위스,2024-06
2024-06-30,100664847,153160988,-52496141,오스트리아,2024-06
2024-06-30,99969607,37991,99931616,앙골라,2024-06
2024-06-30,94275957,88074414,6201543,아일랜드,2024-06
2024-06-30,87009956,4359822,82650134,이집트,2024-06
2024-06-30,80873507,7859255,73014252,슬로베니아,2024-06
2024-06-30,78541677,414569940,-336028263,칠레,2024-06
2024-06-30,77526819,108118,77418701,지브랄타,2024-06
2024-06-30,76000064,36549399,39450665,포루투갈,2024-06
2024-06-30,72724279,1255927033,-1183202754,카타르,2024-06
2024-06-30,72297413,174650563,-102353150,남아프리카공화국,2024-06
2024-06-30,65817222,23341169,42476053,파키스탄,2024-06
2024-06-30,62486238,107638957,-45152719,콜롬비아,2024-06
2024-06-30,55270987,685240588,-629969601,쿠웨이트,2024-06
2024-06-30,55138349,3140,55135209,마샬군도,2024-06
2024-06-30,54879648,34702204,20177444,캄보디아,2024-06
2024-06-30,53955953,3101917,50854036,몽골,2024-06
2024-06-30,51285939,30460911,20825028,푸에르토리코,2024-06
2024-06-30,46591881,10013868,36578013,요르단,2024-06
2024-06-30,46441255,195640887,-149199632,페루,2024-06
2024-06-30,41293497,46952351,-5658854,루마니아,2024-06
2024-06-30,39956120,479253,39476867,괌,2024-06
2024-06-30,39351729,1975426,37376303,리비아,2024-06
2024-06-30,35951991,91447335,-55495344,덴마크,2024-06
2024-06-30,35842047,41335174,-5493127,우크라이나,2024-06
2024-06-30,32877437,415299,32462138,피지,2024-06
2024-06-30,32614738,167521032,-134906294,나이지리아,2024-06
2024-06-30,32325402,11896181,20429221,리투아니아,2024-06
2024-06-30,29455477,13764803,15690674,에쿠아도르,2024-06
2024-06-30,29418311,251735404,-222317093,알제리,2024-06
2024-06-30,28315883,89745560,-61429677,노르웨이,2024-06
2024-06-30,28250686,46038244,-17787558,바레인,2024-06
2024-06-30,27266156,29652669,-2386513,미얀마,2024-06
2024-06-30,26850944,12917258,13933686,코스타리카,2024-06
2024-06-30,26488193,151295467,-124807274,아르헨티나,2024-06
2024-06-30,26477847,65519273,-39041426,핀란드,2024-06
2024-06-30,26389417,373640778,-347251361,오만,2024-06
2024-06-30,25928500,12828539,13099961,모로코,2024-06
2024-06-30,23333517,10521287,12812230,도미니카 공화국,2024-06
2024-06-30,21765152,8996606,12768546,튀니지,2024-06
2024-06-30,21434959,11177140,10257819,과테말라,2024-06
2024-06-30,19324296,13494531,5829765,에스토니아,2024-06
2024-06-30,18745940,12752608,5993332,세르비아,2024-06
2024-06-30,17836651,498619,17338032,알바니아,2024-06
2024-06-30,17192169,1592056,15600113,파나마,2024-06
2024-06-30,15648615,7188283,8460332,온두라스,2024-06
2024-06-30,15039706,21125319,-6085613,불가리아,2024-06
2024-06-30,14929039,24424235,-9495196,엘살바도르,2024-06
2024-06-30,13879556,254735,13624821,이란,2024-06
2024-06-30,13632365,26690632,-13058267,우루과이,2024-06
2024-06-30,13308389,653328,12655061,조지아,2024-06
2024-06-30,13271938,7668816,5603122,스리랑카,2024-06
2024-06-30,13142647,3075199,10067448,가나,2024-06
2024-06-30,12983401,20098,12963303,아제르바이잔,2024-06
2024-06-30,11978252,22656784,-10678532,몰타,2024-06
2024-06-30,11773777,1077,11772700,타지크,2024-06
2024-06-30,11713902,1803550,9910352,케냐,2024-06
2024-06-30,10927661,592671,10334990,파라과이,2024-06
2024-06-30,10907277,264230,10643047,벨라루스,2024-06
2024-06-30,10084691,218282,9866409,코트디봐르,2024-06
2024-06-30,9541087,1464437,8076650,탄자니아,2024-06
2024-06-30,8858923,800532,8058391,쿠바,2024-06
2024-06-30,8595879,2869653,5726226,레바논,2024-06
2024-06-30,8586203,8217189,369014,라오스,2024-06
2024-06-30,8298707,15486394,-7187687,니카라과,2024-06
2024-06-30,7973522,2336695,5636827,크로아티아,2024-06
2024-06-30,6385770,91140707,-84754937,콩고민주공화국,2024-06
2024-06-30,6007463,9096927,-3089464,라트비아,2024-06
2024-06-30,5957698,23204073,-17246375,트리니다드 토바고,2024-06
2024-06-30,5612918,70463083,-64850165,파푸아 뉴기니,2024-06
2024-06-30,5484114,2560593,2923521,세네갈,2024-06
2024-06-30,5060863,16616734,-11555871,모잠비크,2024-06
2024-06-30,4982980,3018122,1964858,몰도바,2024-06
2024-06-30,4382737,362441,4020296,모리셔스,2024-06
2024-06-30,4206263,387739,3818524,가이아나,2024-06
2024-06-30,4071754,0,4071754,사모아,2024-06
2024-06-30,4026997,3013495,1013502,예맨,2024-06
2024-06-30,4026553,1272476,2754077,사이프러스,2024-06
2024-06-30,3937079,49694016,-45756937,볼리비아,2024-06
2024-06-30,3751985,0,3751985,지부티,2024-06
2024-06-30,3444417,189916,3254501,아루바,2024-06
2024-06-30,3238144,5899591,-2661447,룩셈부르그,2024-06
2024-06-30,3154249,1675107,1479142,베네주엘라,2024-06
2024-06-30,3090568,1666,3088902,투르크멘,2024-06
2024-06-30,3059743,3730171,-670428,브루나이,2024-06
2024-06-30,2812702,5370418,-2557716,아르메니아,2024-06
2024-06-30,2768999,123636,2645363,자마이카,2024-06
2024-06-30,2653959,39828709,-37174750,기타국,2024-06
2024-06-30,2485664,6816,2478848,불령 리유니온 코모도 제도,2024-06
2024-06-30,2382820,2114234,268586,보스니아-헤르체고비나,2024-06
2024-06-30,2302371,11065415,-8763044,에티오피아,2024-06
2024-06-30,2293519,656877,1636642,우간다,2024-06
2024-06-30,2248125,786162,1461963,네팔,2024-06
2024-06-30,2218764,104,2218660,벨리제,2024-06
2024-06-30,1972819,674817,1298002,짐바브웨,2024-06
2024-06-30,1952518,3490120,-1537602,아이슬란드,2024-06
2024-06-30,1925761,3388624,-1462863,토고,2024-06
2024-06-30,1912961,0,1912961,세인트 마틴,2024-06
2024-06-30,1869334,7921957,-6052623,마다카스카르,2024-06
2024-06-30,1842570,4773,1837797,아프카니스탄,2024-06
2024-06-30,1750281,40030,1710251,르완다,2024-06
2024-06-30,1644280,40050,1604230,시리아,2024-06
2024-06-30,1429113,1529538,-100425,카메룬,2024-06
2024-06-30,1405456,0,1405456,불령 폴리네시아,2024-06
2024-06-30,1376703,86607,1290096,아이티,2024-06
2024-06-30,1185853,4556085,-3370232,뉴 칼레도니아,2024-06
2024-06-30,1182314,181180,1001134,큐라소,2024-06
2024-06-30,1176829,2401164,-1224335,잠비아,2024-06
2024-06-30,1145978,3735956,-2589978,부르키나 파소,2024-06
2024-06-30,1110768,1858305,-747537,가봉,2024-06
2024-06-30,1056594,218736,837858,수단,2024-06
2024-06-30,1027061,29792,997269,베닝,2024-06
2024-06-30,1022559,76556,946003,소말리아,2024-06
2024-06-30,986653,1740598,-753945,모리타니,2024-06
2024-06-30,922248,1950,920298,그레나다,2024-06
2024-06-30,880191,441365,438826,콩고,2024-06
2024-06-30,851965,3111708,-2259743,기니,2024-06
2024-06-30,850015,231673,618342,북마리아나 군도,2024-06
2024-06-30,820518,622127,198391,바누아투,2024-06
2024-06-30,802382,1893789,-1091407,리히텐슈타인,2024-06
2024-06-30,775718,199439,576279,말라위,2024-06
2024-06-30,749215,176187,573028,팔레스타인 해방기구,2024-06
2024-06-30,719549,53435,666114,세이쉘,2024-06
2024-06-30,711007,126339,584668,마세도니아,2024-06
2024-06-30,707488,0,707488,에리트리아,2024-06
2024-06-30,677764,0,677764,영령 캐이맨 군도,2024-06
2024-06-30,673126,4929,668197,몰디브,2024-06
2024-06-30,631055,1438371,-807316,시에라 리온,2024-06
2024-06-30,627379,2579,624800,바하마,2024-06
2024-06-30,595914,73122,522792,키리바티,2024-06
2024-06-30,556840,197361,359479,마카오,2024-06
2024-06-30,545892,0,545892,과델로프,2024-06
2024-06-30,533724,233630,300094,솔로몬 군도,2024-06
2024-06-30,528090,17584,510506,세인트 루시아,2024-06
2024-06-30,511994,733368,-221374,부탄,2024-06
2024-06-30,495811,550039,-54228,감비아,2024-06
2024-06-30,425879,0,425879,투르크 & 카이코스 군도,2024-06
2024-06-30,425805,0,425805,안티가 바부다,2024-06
2024-06-30,423367,1398189,-974822,니제르,2024-06
2024-06-30,417672,0,417672,적도 기니,2024-06
2024-06-30,417315,0,417315,마티니크,2024-06
2024-06-30,409809,15828,393981,바베이도스,2024-06
2024-06-30,409187,5805,403382,마이크로네시아,2024-06
2024-06-30,402735,123,402612,영령 버진군도,2024-06
2024-06-30,399584,466480,-66896,아메리칸 사모아,2024-06
2024-06-30,376808,17641,359167,도미니카,2024-06
2024-06-30,308122,620254,-312132,수리남,2024-06
2024-06-30,262483,109798,152685,팔라우,2024-06
2024-06-30,200712,5901,194811,세인트 키츠 네비스,2024-06
2024-06-30,193410,403661,-210251,그린랜드,2024-06
2024-06-30,150228,7136,143092,스와질랜드,2024-06
2024-06-30,127733,14,127719,말리,2024-06
2024-06-30,123669,12350,111319,세인트 빈센트 그레나딘,2024-06
2024-06-30,113638,0,113638,투발루,2024-06
2024-06-30,111780,0,111780,카보 베르데,2024-06
2024-06-30,110850,880,109970,몬테네그로,2024-06
2024-06-30,109888,11,109877,남수단,2024-06
2024-06-30,104739,178,104561,나우루,2024-06
2024-06-30,92071,0,92071,챠드,2024-06
2024-06-30,75908,0,75908,네덜란드 열도,2024-06
2024-06-30,74209,5838,68371,나미비아,2024-06
2024-06-30,68394,33983,34411,부룬디,2024-06
2024-06-30,64445,14476,49969,보츠와나,2024-06
2024-06-30,52052,0,52052,불령 가이아나,2024-06
2024-06-30,46867,808,46059,토켈라우,2024-06
2024-06-30,43564,338661,-295097,산마리노,2024-06
2024-06-30,33037,0,33037,세인트마틴(생마르탱),2024-06
2024-06-30,15159,0,15159,중앙아프리카공화국,2024-06
2024-06-30,12895,0,12895,메요트,2024-06
2024-06-30,9450,16688,-7238,티모르,2024-06
2024-06-30,5701,2667,3034,안도라,2024-06
2024-06-30,3437,441,2996,코스 군도,2024-06
2024-06-30,3371,0,3371,상토메 프린스페,2024-06
2024-06-30,2630,4856,-2226,남조지아 & 남샌드위치 군도,2024-06
2024-06-30,2607,0,2607,교황청,2024-06
2024-06-30,2501,0,2501,앙귈라,2024-06
2024-06-30,2090,2159,-69,미령 버진군도,2024-06
2024-06-30,590,437,153,저어지,2024-06
2024-06-30,488,0,488,파로에 군도,2024-06
2024-06-30,51,198688,-198637,모나코,2024-06
2024-06-30,32,0,32,쿡 아일랜드,2024-06
2024-06-30,0,6,-6,몬트세라트,2024-06
2024-06-30,0,195,-195,코모로스,2024-06
2024-06-30,0,332,-332,세인트 바르탤르미,2024-06
2024-06-30,0,143,-143,영령 인도양,2024-06
2024-06-30,0,717,-717,불령 남부지역,2024-06
2024-06-30,0,101914,-101914,기네비소,2024-06
2024-06-30,0,2441,-2441,안타티카,2024-06
2024-06-30,0,5470,-5470,알랜드 군도,2024-06
2024-06-30,0,3158,-3158,건지,2024-06
2024-06-30,0,282039,-282039,포클랜드 군도,2024-06
2024-06-30,0,1079,-1079,왈라스 & 퓨투나 군도,2024-06
2024-06-30,0,20420,-20420,니우에,2024-06
2024-06-30,0,1352,-1352,세인트 헬레나,2024-06
2024-06-30,0,11672,-11672,레소토,2024-06
2024-07-31,11388071073,11942845677,-554774604,중국,2024-07
2024-07-31,10184398776,7921852061,2262546715,미국,2024-07
2024-07-31,4968829762,2493154147,2475675615,베트남,2024-07
2024-07-31,2773161214,2555216577,217944637,대만,2024-07
2024-07-31,2597690351,4107365096,-1509674745,일본,2024-07
2024-07-31,2594654474,103876277,2490778197,홍콩,2024-07
2024-07-31,1616302689,570073635,1046229054,인도,2024-07
2024-07-31,1443109888,907389123,535720765,싱가포르,2024-07
2024-07-31,1374641647,1874512024,-499870377,호주,2024-07
2024-07-31,1327739759,880205352,447534407,멕시코,2024-07
2024-07-31,968539554,103104249,865435305,폴란드,2024-07
2024-07-31,944801515,1048846765,-104045250,말레이시아,2024-07
2024-07-31,941186352,553694076,387492276,캐나다,2024-07
2024-07-31,911836649,379940659,531895990,필리핀,2024-07
2024-07-31,795980240,1174615509,-378635269,카타르,2024-07
2024-07-31,773150292,683555211,89595081,태국,2024-07
2024-07-31,758552056,954829778,-196277722,인도네시아,2024-07
2024-07-31,717288102,95632155,621655947,튀르키예,2024-07
2024-07-31,625647507,1974759928,-1349112421,독일,2024-07
2024-07-31,618512417,264056992,354455425,네덜란드,2024-07
2024-07-31,530001298,1256010319,-726009021,아랍에미리트 연합,2024-07
2024-07-31,499528312,58356192,441172120,헝가리,2024-07
2024-07-31,498012432,381853959,116158473,영국,2024-07
2024-07-31,482536163,627546311,-145010148,브라질,2024-07
2024-07-31,429985387,701332437,-271347050,이탈리아,2024-07
2024-07-31,379386993,502587182,-123200189,러시아 연방,2024-07
2024-07-31,366768476,2760011018,-2393242542,사우디아라비아,2024-07
2024-07-31,348618372,152540534,196077838,뉴질랜드,2024-07
2024-07-31,319539487,102359950,217179537,벨기에,2024-07
2024-07-31,293632299,234667315,58964984,스페인,2024-07
2024-07-31,292363188,137740743,154622445,체코공화국,2024-07
2024-07-31,267948239,646511638,-378563399,프랑스,2024-07
2024-07-31,249665095,78165274,171499821,슬로바키아,2024-07
2024-07-31,222997105,12203,222984902,라이베리아,2024-07
2024-07-31,220493821,109150561,111343260,덴마크,2024-07
2024-07-31,208763734,1218,208762516,버뮤다,2024-07
2024-07-31,199202982,26222,199176760,키르기스스탄,2024-07
2024-07-31,187847022,43837604,144009418,카자흐스탄,2024-07
2024-07-31,141807404,1236464,140570940,우즈베키스탄,2024-07
2024-07-31,139225125,89241192,49983933,이스라엘,2024-07
2024-07-31,115546053,97879033,17667020,오스트리아,2024-07
2024-07-31,110334926,165846096,-55511170,스웨덴,2024-07
2024-07-31,109923884,695859648,-585935764,이라크,2024-07
2024-07-31,109043313,6931915,102111398,이집트,2024-07
2024-07-31,101781559,41976233,59805326,방글라데시,2024-07
2024-07-31,99389463,10614319,88775144,슬로베니아,2024-07
2024-07-31,89706001,420022830,-330316829,칠레,2024-07
2024-07-31,87839696,2759,87836937,앙골라,2024-07
2024-07-31,81337075,327353770,-246016695,스위스,2024-07
2024-07-31,74348708,36569554,37779154,몰타,2024-07
2024-07-31,69354526,200159842,-130805316,콜롬비아,2024-07
2024-07-31,67054701,341319,66713382,탄자니아,2024-07
2024-07-31,66143920,39441976,26701944,포루투갈,2024-07
2024-07-31,65160406,9307323,55853083,리투아니아,2024-07
2024-07-31,64886740,126364389,-61477649,남아프리카공화국,2024-07
2024-07-31,64548183,19338499,45209684,파키스탄,2024-07
2024-07-31,63979605,51120169,12859436,캄보디아,2024-07
2024-07-31,59046528,189201412,-130154884,나이지리아,2024-07
2024-07-31,58565367,115531077,-56965710,아일랜드,2024-07
2024-07-31,54747549,16030233,38717316,파나마,2024-07
2024-07-31,49918377,74983350,-25064973,핀란드,2024-07
2024-07-31,48630354,6816717,41813637,요르단,2024-07
2024-07-31,48274485,261436653,-213162168,페루,2024-07
2024-07-31,48151056,4101865,44049191,몽골,2024-07
2024-07-31,46609410,26956207,19653203,푸에르토리코,2024-07
2024-07-31,46043098,55999687,-9956589,루마니아,2024-07
2024-07-31,45743956,638363165,-592619209,쿠웨이트,2024-07
2024-07-31,43080361,2834445,40245916,리비아,2024-07
2024-07-31,32855065,37136185,-4281120,우크라이나,2024-07
2024-07-31,32804515,192339507,-159534992,아르헨티나,2024-07
2024-07-31,31765482,13244197,18521285,모로코,2024-07
2024-07-31,30537280,38423785,-7886505,미얀마,2024-07
2024-07-31,29025391,13758010,15267381,에쿠아도르,2024-07
2024-07-31,28526001,96253071,-67727070,노르웨이,2024-07
2024-07-31,28336580,15406402,12930178,그리스,2024-07
2024-07-31,24929150,7380004,17549146,도미니카 공화국,2024-07
2024-07-31,24909955,411752,24498203,피지,2024-07
2024-07-31,22462707,9788643,12674064,과테말라,2024-07
2024-07-31,22130814,16784583,5346231,코스타리카,2024-07
2024-07-31,22016579,362362012,-340345433,오만,2024-07
2024-07-31,19603153,2047119,17556034,엘살바도르,2024-07
2024-07-31,19400346,14007180,5393166,세르비아,2024-07
2024-07-31,18398723,15971312,2427411,우루과이,2024-07
2024-07-31,17839305,205357986,-187518681,알제리,2024-07
2024-07-31,17727817,10201023,7526794,스리랑카,2024-07
2024-07-31,16844464,21358485,-4514021,불가리아,2024-07
2024-07-31,16734437,1673,16732764,타지크,2024-07
2024-07-31,16316848,757794,15559054,알바니아,2024-07
2024-07-31,15912602,26090,15886512,아제르바이잔,2024-07
2024-07-31,15627361,601105,15026256,괌,2024-07
2024-07-31,14932008,2515285,12416723,세네갈,2024-07
2024-07-31,14674195,1208714,13465481,이란,2024-07
2024-07-31,14021030,17256806,-3235776,에티오피아,2024-07
2024-07-31,13123559,286286,12837273,파라과이,2024-07
2024-07-31,12673152,5032049,7641103,가나,2024-07
2024-07-31,12228546,4299316,7929230,코트디봐르,2024-07
2024-07-31,12061765,5144535,6917230,온두라스,2024-07
2024-07-31,12039858,1062229,10977629,조지아,2024-07
2024-07-31,11100236,766949,10333287,벨라루스,2024-07
2024-07-31,9953218,59210415,-49257197,바레인,2024-07
2024-07-31,9750322,1324275,8426047,니카라과,2024-07
2024-07-31,9144013,3277189,5866824,레바논,2024-07
2024-07-31,9059076,6045474,3013602,케냐,2024-07
2024-07-31,8982810,6677612,2305198,에스토니아,2024-07
2024-07-31,8859890,10773451,-1913561,튀니지,2024-07
2024-07-31,8821519,1980742,6840777,크로아티아,2024-07
2024-07-31,8273812,72534447,-64260635,기타국,2024-07
2024-07-31,8256596,710227,7546369,모잠비크,2024-07
2024-07-31,7970754,5141326,2829428,라오스,2024-07
2024-07-31,6365921,21981,6343940,브루나이,2024-07
2024-07-31,5931443,19550547,-13619104,트리니다드 토바고,2024-07
2024-07-31,5711778,2635256,3076522,몰도바,2024-07
2024-07-31,5148097,60738374,-55590277,파푸아 뉴기니,2024-07
2024-07-31,5044580,600420,4444160,모리셔스,2024-07
2024-07-31,4853422,18589683,-13736261,마다카스카르,2024-07
2024-07-31,4784815,1488,4783327,불령 리유니온 코모도 제도,2024-07
2024-07-31,4441340,546802,3894538,베네주엘라,2024-07
2024-07-31,4042154,33636,4008518,사모아,2024-07
2024-07-31,4016699,3516192,500507,예맨,2024-07
2024-07-31,3895238,8567638,-4672400,룩셈부르그,2024-07
2024-07-31,3819348,200,3819148,가이아나,2024-07
2024-07-31,3743479,1505922,2237557,사이프러스,2024-07
2024-07-31,3725108,8957336,-5232228,라트비아,2024-07
2024-07-31,3573463,103484,3469979,자마이카,2024-07
2024-07-31,3559064,0,3559064,안타티카,2024-07
2024-07-31,3452242,2857142,595100,카메룬,2024-07
2024-07-31,3200965,1152671,2048294,짐바브웨,2024-07
2024-07-31,3199341,0,3199341,아루바,2024-07
2024-07-31,3145797,917562,2228235,우간다,2024-07
2024-07-31,2818877,6828474,-4009597,아르메니아,2024-07
2024-07-31,2737692,107161,2630531,벨리제,2024-07
2024-07-31,2450339,38463,2411876,베닝,2024-07
2024-07-31,2437879,59632161,-57194282,볼리비아,2024-07
2024-07-31,2428604,663568,1765036,네팔,2024-07
2024-07-31,2276294,149,2276145,투르크멘,2024-07
2024-07-31,2079187,0,2079187,세인트 마틴,2024-07
2024-07-31,2050814,21263,2029551,부르키나 파소,2024-07
2024-07-31,2007136,214044,1793092,콩고,2024-07
2024-07-31,1965001,16100,1948901,불령 폴리네시아,2024-07
2024-07-31,1893563,6254,1887309,아프카니스탄,2024-07
2024-07-31,1816903,247520,1569383,지부티,2024-07
2024-07-31,1739973,10739,1729234,아이티,2024-07
2024-07-31,1678297,1251795,426502,아이슬란드,2024-07
2024-07-31,1655796,2575402,-919606,보스니아-헤르체고비나,2024-07
2024-07-31,1641961,88634,1553327,수단,2024-07
2024-07-31,1612252,10993696,-9381444,토고,2024-07
2024-07-31,1340936,2352428,-1011492,기니,2024-07
2024-07-31,1318713,322959,995754,쿠바,2024-07
2024-07-31,1294155,19213114,-17918959,뉴 칼레도니아,2024-07
2024-07-31,1282196,26036,1256160,바베이도스,2024-07
2024-07-31,1236041,147345428,-146109387,콩고민주공화국,2024-07
2024-07-31,1234105,5815,1228290,시리아,2024-07
2024-07-31,1210251,123044,1087207,북마리아나 군도,2024-07
2024-07-31,1201615,86622,1114993,가봉,2024-07
2024-07-31,1182843,2055020,-872177,리히텐슈타인,2024-07
2024-07-31,1142247,103064,1039183,잠비아,2024-07
2024-07-31,1096694,5631,1091063,바하마,2024-07
2024-07-31,1091639,310645,780994,마카오,2024-07
2024-07-31,1043493,217766,825727,안티가 바부다,2024-07
2024-07-31,978825,471107,507718,바누아투,2024-07
2024-07-31,952947,482903,470044,마세도니아,2024-07
2024-07-31,905001,0,905001,큐라소,2024-07
2024-07-31,901716,33234,868482,르완다,2024-07
2024-07-31,882227,654468,227759,수리남,2024-07
2024-07-31,878268,7778,870490,말리,2024-07
2024-07-31,857020,174000,683020,소말리아,2024-07
2024-07-31,767670,277,767393,지브랄타,2024-07
2024-07-31,753301,221955,531346,니제르,2024-07
2024-07-31,684001,389,683612,몰디브,2024-07
2024-07-31,605345,230240,375105,세이쉘,2024-07
2024-07-31,569476,0,569476,적도 기니,2024-07
2024-07-31,558127,0,558127,솔로몬 군도,2024-07
2024-07-31,529111,789536,-260425,아메리칸 사모아,2024-07
2024-07-31,527749,0,527749,세인트 바르탤르미,2024-07
2024-07-31,525777,1592,524185,마이크로네시아,2024-07
2024-07-31,515710,0,515710,키리바티,2024-07
2024-07-31,471666,4187631,-3715965,모리타니,2024-07
2024-07-31,445779,3612,442167,투발루,2024-07
2024-07-31,418432,170125,248307,팔레스타인 해방기구,2024-07
2024-07-31,392288,0,392288,카보 베르데,2024-07
2024-07-31,377655,0,377655,팔라우,2024-07
2024-07-31,365611,880,364731,마티니크,2024-07
2024-07-31,326892,0,326892,불령 가이아나,2024-07
2024-07-31,314978,1241546,-926568,몬테네그로,2024-07
2024-07-31,311914,80412,231502,마샬군도,2024-07
2024-07-31,293701,44567489,-44273788,나미비아,2024-07
2024-07-31,284446,0,284446,세인트 루시아,2024-07
2024-07-31,282289,1,282288,중앙아프리카공화국,2024-07
2024-07-31,267671,1614,266057,영령 버진군도,2024-07
2024-07-31,259476,99231,160245,보츠와나,2024-07
2024-07-31,249181,0,249181,세인트 빈센트 그레나딘,2024-07
2024-07-31,247214,1581418,-1334204,부탄,2024-07
2024-07-31,243940,412,243528,그레나다,2024-07
2024-07-31,231621,1288,230333,과델로프,2024-07
2024-07-31,210755,1480614,-1269859,시에라 리온,2024-07
2024-07-31,187891,0,187891,투르크 & 카이코스 군도,2024-07
2024-07-31,164054,0,164054,챠드,2024-07
2024-07-31,156816,1216,155600,에리트리아,2024-07
2024-07-31,121261,21286,99975,스와질랜드,2024-07
2024-07-31,116642,108123,8519,부룬디,2024-07
2024-07-31,113060,935719,-822659,감비아,2024-07
2024-07-31,99282,1307,97975,세인트 키츠 네비스,2024-07
2024-07-31,84583,4359,80224,코모로스,2024-07
2024-07-31,75905,0,75905,영령 캐이맨 군도,2024-07
2024-07-31,69614,0,69614,세인트마틴(생마르탱),2024-07
2024-07-31,69334,150505,-81171,그린랜드,2024-07
2024-07-31,68364,1371398,-1303034,도미니카,2024-07
2024-07-31,54758,642279,-587521,말라위,2024-07
2024-07-31,33320,0,33320,네덜란드 열도,2024-07
2024-07-31,29537,1,29536,남수단,2024-07
2024-07-31,21042,0,21042,상토메 프린스페,2024-07
2024-07-31,18000,166482,-148482,산마리노,2024-07
2024-07-31,17452,6010,11442,통가,2024-07
2024-07-31,13022,2816,10206,티모르,2024-07
2024-07-31,9532,161,9371,남조지아 & 남샌드위치 군도,2024-07
2024-07-31,7099,426,6673,앙귈라,2024-07
2024-07-31,4692,2397,2295,건지,2024-07
2024-07-31,3316,102211,-98895,기네비소,2024-07
2024-07-31,1858,21481,-19623,미령 버진군도,2024-07
2024-07-31,1162,2942,-1780,몬트세라트,2024-07
2024-07-31,475,0,475,교황청,2024-07
2024-07-31,264,0,264,저어지,2024-07
2024-07-31,141,542483,-542342,모나코,2024-07
2024-07-31,109,0,109,파로에 군도,2024-07
2024-07-31,42,0,42,쿡 아일랜드,2024-07
2024-07-31,0,10062,-10062,니우에,2024-07
2024-07-31,0,290,-290,영령 인도양,2024-07
2024-07-31,0,210,-210,불령 남부지역,2024-07
2024-07-31,0,393,-393,세인트 헬레나,2024-07
2024-07-31,0,4774,-4774,마이너 아우틀링 합중국 군도,2024-07
2024-07-31,0,725,-725,안도라,2024-07
2024-07-31,0,18039,-18039,레소토,2024-07
2024-07-31,0,86,-86,토켈라우,2024-07
2024-07-31,0,15756,-15756,나우루,2024-07
2024-07-31,0,910,-910,크리스마스 아일랜드,2024-07
2024-07-31,0,454,-454,알랜드 군도,2024-07
2024-08-31,11340798613,11482790952,-141992339,중국,2024-08
2024-08-31,9937503517,6257982509,3679521008,미국,2024-08
2024-08-31,5049342550,2589553342,2459789208,베트남,2024-08
2024-08-31,3146044833,2573664977,572379856,대만,2024-08
2024-08-31,2966812593,235626433,2731186160,홍콩,2024-08
2024-08-31,2500141119,3914420512,-1414279393,일본,2024-08
2024-08-31,1636205538,584788706,1051416832,인도,2024-08
2024-08-31,1397637294,911314950,486322344,싱가포르,2024-08
2024-08-31,1236194740,2745492917,-1509298177,호주,2024-08
2024-08-31,1085010022,729718280,355291742,멕시코,2024-08
2024-08-31,921760264,1256219103,-334458839,말레이시아,2024-08
2024-08-31,882275830,357097014,525178816,필리핀,2024-08
2024-08-31,867481173,1838261264,-970780091,독일,2024-08
2024-08-31,837685705,90678088,747007617,폴란드,2024-08
2024-08-31,797290596,808423227,-11132631,프랑스,2024-08
2024-08-31,782091395,518527945,263563450,캐나다,2024-08
2024-08-31,755965013,1203242391,-447277378,인도네시아,2024-08
2024-08-31,644288009,122020526,522267483,튀르키예,2024-08
2024-08-31,638203161,618702181,19500980,태국,2024-08
2024-08-31,509512268,350891004,158621264,영국,2024-08
2024-08-31,497721100,394461554,103259546,네덜란드,2024-08
2024-08-31,468925966,583947285,-115021319,이탈리아,2024-08
2024-08-31,464051706,64592550,399459156,헝가리,2024-08
2024-08-31,463950280,413218641,50731639,브라질,2024-08
2024-08-31,422794638,2559625829,-2136831191,사우디아라비아,2024-08
2024-08-31,420557563,105178,420452385,마샬군도,2024-08
2024-08-31,380507219,897401931,-516894712,러시아 연방,2024-08
2024-08-31,375597829,563731,375034098,라이베리아,2024-08
2024-08-31,359929021,101512344,258416677,벨기에,2024-08
2024-08-31,334947667,140594170,194353497,뉴질랜드,2024-08
2024-08-31,328174511,1471817986,-1143643475,아랍에미리트 연합,2024-08
2024-08-31,283772765,91132151,192640614,체코공화국,2024-08
2024-08-31,267484756,37800649,229684107,몰타,2024-08
2024-08-31,255096902,211042163,44054739,스페인,2024-08
2024-08-31,229817553,24092465,205725088,그리스,2024-08
2024-08-31,220236588,105321,220131267,키르기스스탄,2024-08
2024-08-31,206165794,962,206164832,버뮤다,2024-08
2024-08-31,205720460,65944405,139776055,슬로바키아,2024-08
2024-08-31,197368386,50612214,146756172,포루투갈,2024-08
2024-08-31,196865329,240771831,-43906502,카자흐스탄,2024-08
2024-08-31,161394083,118845559,42548524,이스라엘,2024-08
2024-08-31,145787949,144191688,1596261,스웨덴,2024-08
2024-08-31,145693125,357046353,-211353228,칠레,2024-08
2024-08-31,138815897,140374960,-1559063,오스트리아,2024-08
2024-08-31,123446513,19591967,103854546,파나마,2024-08
2024-08-31,123210820,1676064,121534756,우즈베키스탄,2024-08
2024-08-31,107288040,678,107287362,바하마,2024-08
2024-08-31,95880345,5126656,90753689,이집트,2024-08
2024-08-31,91352595,834025359,-742672764,이라크,2024-08
2024-08-31,88650918,8609915,80041003,슬로베니아,2024-08
2024-08-31,84050915,42810125,41240790,방글라데시,2024-08
2024-08-31,83060055,53977426,29082629,루마니아,2024-08
2024-08-31,82560657,264142731,-181582074,스위스,2024-08
2024-08-31,74750718,207091734,-132341016,콜롬비아,2024-08
2024-08-31,63291512,15909576,47381936,파키스탄,2024-08
2024-08-31,61686900,157850753,-96163853,아일랜드,2024-08
2024-08-31,59481881,138103816,-78621935,남아프리카공화국,2024-08
2024-08-31,56724158,196636659,-139912501,나이지리아,2024-08
2024-08-31,53992076,2660961,51331115,몽골,2024-08
2024-08-31,52263970,51309254,954716,캄보디아,2024-08
2024-08-31,51447549,1213078859,-1161631310,카타르,2024-08
2024-08-31,49884214,37444761,12439453,푸에르토리코,2024-08
2024-08-31,48495676,119632315,-71136639,페루,2024-08
2024-08-31,45825290,103158024,-57332734,덴마크,2024-08
2024-08-31,44981014,2614808,42366206,리비아,2024-08
2024-08-31,44540732,1119,44539613,지브랄타,2024-08
2024-08-31,41238145,8123389,33114756,요르단,2024-08
2024-08-31,38357162,68964109,-30606947,핀란드,2024-08
2024-08-31,36094348,35486561,607787,우크라이나,2024-08
2024-08-31,35464547,147553501,-112088954,아르헨티나,2024-08
2024-08-31,33972462,492145,33480317,괌,2024-08
2024-08-31,28332114,10297791,18034323,모로코,2024-08
2024-08-31,27790983,15014886,12776097,코스타리카,2024-08
2024-08-31,27593759,9500931,18092828,리투아니아,2024-08
2024-08-31,27082869,41284391,-14201522,미얀마,2024-08
2024-08-31,26998240,1020457231,-993458991,쿠웨이트,2024-08
2024-08-31,25977910,9375437,16602473,도미니카 공화국,2024-08
2024-08-31,25806968,97853924,-72046956,에쿠아도르,2024-08
2024-08-31,25641337,160081094,-134439757,노르웨이,2024-08
2024-08-31,23069893,13982673,9087220,과테말라,2024-08
2024-08-31,20528291,506464607,-485936316,오만,2024-08
2024-08-31,19511226,0,19511226,타지크,2024-08
2024-08-31,17707147,18231050,-523903,우루과이,2024-08
2024-08-31,17045785,364058567,-347012782,알제리,2024-08
2024-08-31,17040586,779608,16260978,알바니아,2024-08
2024-08-31,16163154,117110,16046044,아제르바이잔,2024-08
2024-08-31,16138549,23913943,-7775394,바레인,2024-08
2024-08-31,15731243,2701193,13030050,케냐,2024-08
2024-08-31,13758959,15004361,-1245402,코트디봐르,2024-08
2024-08-31,13755015,11205756,2549259,가나,2024-08
2024-08-31,13125674,3379876,9745798,온두라스,2024-08
2024-08-31,13025147,2967631,10057516,엘살바도르,2024-08
2024-08-31,13009117,517299,12491818,파라과이,2024-08
2024-08-31,12968295,26781494,-13813199,불가리아,2024-08
2024-08-31,12899051,11025178,1873873,스리랑카,2024-08
2024-08-31,12175894,1818477,10357417,조지아,2024-08
2024-08-31,11703429,851334,10852095,벨라루스,2024-08
2024-08-31,11448024,1070036,10377988,탄자니아,2024-08
2024-08-31,11357958,1223820,10134138,이란,2024-08
2024-08-31,10789299,23060063,-12270764,세르비아,2024-08
2024-08-31,10600892,6468787,4132105,에스토니아,2024-08
2024-08-31,9712876,11821897,-2109021,라오스,2024-08
2024-08-31,8635363,16788943,-8153580,에티오피아,2024-08
2024-08-31,8185914,974,8184940,앙골라,2024-08
2024-08-31,8022128,2377921,5644207,레바논,2024-08
2024-08-31,7829287,1813355,6015932,니카라과,2024-08
2024-08-31,7726156,60,7726096,자마이카,2024-08
2024-08-31,7274334,5877867,1396467,몰도바,2024-08
2024-08-31,7037254,7547189,-509935,세네갈,2024-08
2024-08-31,6733341,36107321,-29373980,모잠비크,2024-08
2024-08-31,6595387,2236796,4358591,크로아티아,2024-08
2024-08-31,5991450,11213304,-5221854,튀니지,2024-08
2024-08-31,5893882,17106742,-11212860,트리니다드 토바고,2024-08
2024-08-31,5714529,7399997,-1685468,라트비아,2024-08
2024-08-31,5323740,79805727,-74481987,콩고민주공화국,2024-08
2024-08-31,5267528,3523821,1743707,예맨,2024-08
2024-08-31,4993965,35340420,-30346455,기타국,2024-08
2024-08-31,4505889,18899,4486990,팔라우,2024-08
2024-08-31,4244673,28600,4216073,사모아,2024-08
2024-08-31,3771832,7866510,-4094678,룩셈부르그,2024-08
2024-08-31,3649237,259925,3389312,베네주엘라,2024-08
2024-08-31,3581243,231883,3349360,피지,2024-08
2024-08-31,3535817,207,3535610,가이아나,2024-08
2024-08-31,3095211,672385,2422826,모리셔스,2024-08
2024-08-31,3077146,10678297,-7601151,마다카스카르,2024-08
2024-08-31,3074084,372719,2701365,사이프러스,2024-08
2024-08-31,3073704,4526919,-1453215,아르메니아,2024-08
2024-08-31,3058138,714325,2343813,우간다,2024-08
2024-08-31,2936376,0,2936376,수단,2024-08
2024-08-31,2829808,0,2829808,지부티,2024-08
2024-08-31,2762761,19611,2743150,아루바,2024-08
2024-08-31,2589681,30,2589651,베닝,2024-08
2024-08-31,2589538,25,2589513,부르키나 파소,2024-08
2024-08-31,2428629,90617077,-88188448,파푸아 뉴기니,2024-08
2024-08-31,2391819,114847,2276972,아프카니스탄,2024-08
2024-08-31,2352539,165507,2187032,불령 폴리네시아,2024-08
2024-08-31,2334295,39518251,-37183956,카메룬,2024-08
2024-08-31,2305432,107732969,-105427537,브루나이,2024-08
2024-08-31,2235459,2934222,-698763,기니,2024-08
2024-08-31,2075103,26888,2048215,아이티,2024-08
2024-08-31,1952487,1001225,951262,토고,2024-08
2024-08-31,1923959,20513642,-18589683,볼리비아,2024-08
2024-08-31,1921646,0,1921646,불령 리유니온 코모도 제도,2024-08
2024-08-31,1856621,1841251,15370,아이슬란드,2024-08
2024-08-31,1733584,9000046,-7266462,가봉,2024-08
2024-08-31,1730823,973134,757689,짐바브웨,2024-08
2024-08-31,1677075,238116,1438959,콩고,2024-08
2024-08-31,1641975,397856,1244119,네팔,2024-08
2024-08-31,1573377,66019,1507358,솔로몬 군도,2024-08
2024-08-31,1469357,0,1469357,벨리제,2024-08
2024-08-31,1427990,1903345,-475355,잠비아,2024-08
2024-08-31,1277784,0,1277784,세인트 마틴,2024-08
2024-08-31,1271879,436627,835252,세이쉘,2024-08
2024-08-31,1253939,0,1253939,팔레스타인 해방기구,2024-08
2024-08-31,1230963,62846,1168117,북마리아나 군도,2024-08
2024-08-31,1093333,441,1092892,바베이도스,2024-08
2024-08-31,1073954,5218,1068736,소말리아,2024-08
2024-08-31,1054143,190902,863241,마카오,2024-08
2024-08-31,1053998,280,1053718,투르크멘,2024-08
2024-08-31,959520,2781577,-1822057,보스니아-헤르체고비나,2024-08
2024-08-31,946683,2107853,-1161170,모리타니,2024-08
2024-08-31,922086,126488,795598,말리,2024-08
2024-08-31,893507,220,893287,영령 캐이맨 군도,2024-08
2024-08-31,873729,3672,870057,르완다,2024-08
2024-08-31,852017,14127856,-13275839,뉴 칼레도니아,2024-08
2024-08-31,793105,1513524,-720419,리히텐슈타인,2024-08
2024-08-31,781433,2409543,-1628110,부탄,2024-08
2024-08-31,755992,170330,585662,아메리칸 사모아,2024-08
2024-08-31,710170,5676,704494,시리아,2024-08
2024-08-31,655812,311161,344651,수리남,2024-08
2024-08-31,633939,513658,120281,쿠바,2024-08
2024-08-31,631643,38702144,-38070501,적도 기니,2024-08
2024-08-31,616219,121697,494522,바누아투,2024-08
2024-08-31,601634,0,601634,불령 가이아나,2024-08
2024-08-31,599953,3394,596559,몰디브,2024-08
2024-08-31,593506,0,593506,과델로프,2024-08
2024-08-31,535335,6015,529320,스와질랜드,2024-08
2024-08-31,527090,596459,-69369,시에라 리온,2024-08
2024-08-31,495161,234421,260740,마세도니아,2024-08
2024-08-31,444877,0,444877,세인트 루시아,2024-08
2024-08-31,444515,0,444515,마티니크,2024-08
2024-08-31,428964,81766,347198,부룬디,2024-08
2024-08-31,393612,3607,390005,투발루,2024-08
2024-08-31,386255,0,386255,큐라소,2024-08
2024-08-31,366352,584,365768,세인트 키츠 네비스,2024-08
2024-08-31,361588,0,361588,키리바티,2024-08
2024-08-31,321620,0,321620,남수단,2024-08
2024-08-31,312870,424,312446,그레나다,2024-08
2024-08-31,261391,405174,-143783,감비아,2024-08
2024-08-31,259787,11807160,-11547373,에리트리아,2024-08
2024-08-31,256396,5322,251074,마이크로네시아,2024-08
2024-08-31,247311,11,247300,안티가 바부다,2024-08
2024-08-31,214230,142689,71541,도미니카,2024-08
2024-08-31,199570,0,199570,투르크 & 카이코스 군도,2024-08
2024-08-31,198834,1180,197654,티모르,2024-08
2024-08-31,173530,0,173530,기네비소,2024-08
2024-08-31,172631,168280,4351,나미비아,2024-08
2024-08-31,164152,393137,-228985,챠드,2024-08
2024-08-31,162624,0,162624,세인트 빈센트 그레나딘,2024-08
2024-08-31,138264,0,138264,메요트,2024-08
2024-08-31,91641,0,91641,안타티카,2024-08
2024-08-31,90779,277395,-186616,말라위,2024-08
2024-08-31,68127,2137,65990,네덜란드 열도,2024-08
2024-08-31,53752,104561,-50809,보츠와나,2024-08
2024-08-31,43706,16817,26889,미령 버진군도,2024-08
2024-08-31,43211,3671,39540,니제르,2024-08
2024-08-31,42020,0,42020,카보 베르데,2024-08
2024-08-31,38842,454,38388,몬테네그로,2024-08
2024-08-31,29000,457263,-428263,산마리노,2024-08
2024-08-31,23482,267856,-244374,모나코,2024-08
2024-08-31,21054,0,21054,세인트마틴(생마르탱),2024-08
2024-08-31,17041,0,17041,코모로스,2024-08
2024-08-31,12432,5291,7141,레소토,2024-08
2024-08-31,4064,77303,-73239,그린랜드,2024-08
2024-08-31,3941,40,3901,세인트 바르탤르미,2024-08
2024-08-31,3800,2523,1277,앙귈라,2024-08
2024-08-31,1439,0,1439,교황청,2024-08
2024-08-31,855,3074,-2219,몬트세라트,2024-08
2024-08-31,407,0,407,파로에 군도,2024-08
2024-08-31,283,2093,-1810,안도라,2024-08
2024-08-31,180,0,180,중앙아프리카공화국,2024-08
2024-08-31,156,0,156,영령 버진군도,2024-08
2024-08-31,133,2079,-1946,건지,2024-08
2024-08-31,110,0,110,저어지,2024-08
2024-08-31,0,625,-625,크리스마스 아일랜드,2024-08
2024-08-31,0,699,-699,나우루,2024-08
2024-08-31,0,549,-549,세인트 헬레나,2024-08
2024-08-31,0,48761,-48761,토켈라우,2024-08
2024-08-31,0,858,-858,남조지아 & 남샌드위치 군도,2024-08
2024-08-31,0,787,-787,불령 남부지역,2024-08
2024-08-31,0,697,-697,니우에,2024-08
2024-09-30,11626573036,11221399945,405173091,중국,2024-09
2024-09-30,10411876945,5457525183,4954351762,미국,2024-09
2024-09-30,4980949510,2447668647,2533280863,베트남,2024-09
2024-09-30,3719390333,2899512658,819877675,대만,2024-09
2024-09-30,3105512767,102314778,3003197989,홍콩,2024-09
2024-09-30,2478851054,4085613362,-1606762308,일본,2024-09
2024-09-30,1469018220,427292764,1041725456,인도,2024-09
2024-09-30,1401055131,2385705994,-984650863,호주,2024-09
2024-09-30,1297264310,816092560,481171750,싱가포르,2024-09
2024-09-30,1084324481,96161331,988163150,폴란드,2024-09
2024-09-30,1037904251,527226038,510678213,멕시코,2024-09
2024-09-30,986488207,379466999,607021208,필리핀,2024-09
2024-09-30,822185616,1039705882,-217520266,말레이시아,2024-09
2024-09-30,792902519,685893524,107008995,캐나다,2024-09
2024-09-30,722815580,23090,722792490,마샬군도,2024-09
2024-09-30,695852153,1893827865,-1197975712,독일,2024-09
2024-09-30,673266072,103926111,569339961,튀르키예,2024-09
2024-09-30,622578753,572101587,50477166,태국,2024-09
2024-09-30,616411700,1217287365,-600875665,네덜란드,2024-09
2024-09-30,593777197,1108702812,-514925615,인도네시아,2024-09
2024-09-30,521704936,533887609,-12182673,프랑스,2024-09
2024-09-30,519977489,482666057,37311432,영국,2024-09
2024-09-30,462474087,2581722957,-2119248870,사우디아라비아,2024-09
2024-09-30,440466855,636442703,-195975848,브라질,2024-09
2024-09-30,384127153,277356660,106770493,벨기에,2024-09
2024-09-30,373691738,508401,373183337,라이베리아,2024-09
2024-09-30,355496976,57918110,297578866,헝가리,2024-09
2024-09-30,355045919,599687574,-244641655,이탈리아,2024-09
2024-09-30,350112977,589950199,-239837222,러시아 연방,2024-09
2024-09-30,348644840,1325342989,-976698149,아랍에미리트 연합,2024-09
2024-09-30,295626919,139151232,156475687,체코공화국,2024-09
2024-09-30,244055317,103445951,140609366,뉴질랜드,2024-09
2024-09-30,240483817,48537552,191946265,슬로바키아,2024-09
2024-09-30,237242722,156260589,80982133,덴마크,2024-09
2024-09-30,227761577,224536710,3224867,스페인,2024-09
2024-09-30,220601717,64469588,156132129,카자흐스탄,2024-09
2024-09-30,209808423,0,209808423,버뮤다,2024-09
2024-09-30,202810846,37965396,164845450,포루투갈,2024-09
2024-09-30,200889642,5186088,195703554,몰타,2024-09
2024-09-30,174525634,85200,174440434,키르기스스탄,2024-09
2024-09-30,168300964,96931050,71369914,이스라엘,2024-09
2024-09-30,164516119,488236217,-323720098,칠레,2024-09
2024-09-30,147913704,5465841,142447863,이집트,2024-09
2024-09-30,141075446,1448500,139626946,우즈베키스탄,2024-09
2024-09-30,130696231,124857143,5839088,오스트리아,2024-09
2024-09-30,120903913,94825293,26078620,방글라데시,2024-09
2024-09-30,92741432,182693792,-89952360,스웨덴,2024-09
2024-09-30,82413341,29528869,52884472,파키스탄,2024-09
2024-09-30,81495929,158001453,-76505524,콜롬비아,2024-09
2024-09-30,81164609,643140558,-561975949,이라크,2024-09
2024-09-30,80225848,1039281436,-959055588,카타르,2024-09
2024-09-30,80066268,511691954,-431625686,오만,2024-09
2024-09-30,76150385,5244,76145141,앙골라,2024-09
2024-09-30,71031130,7053837,63977293,슬로베니아,2024-09
2024-09-30,66642957,123986223,-57343266,아일랜드,2024-09
2024-09-30,55192342,270847052,-215654710,스위스,2024-09
2024-09-30,53657876,71319219,-17661343,핀란드,2024-09
2024-09-30,52670662,202254031,-149583369,나이지리아,2024-09
2024-09-30,52318652,14353048,37965604,리투아니아,2024-09
2024-09-30,51943690,3436109,48507581,몽골,2024-09
2024-09-30,50298789,200656582,-150357793,남아프리카공화국,2024-09
2024-09-30,48472318,44486593,3985725,캄보디아,2024-09
2024-09-30,47984451,31727455,16256996,푸에르토리코,2024-09
2024-09-30,47794454,219787462,-171993008,페루,2024-09
2024-09-30,46969005,5253217,41715788,요르단,2024-09
2024-09-30,40170132,3331560,36838572,리비아,2024-09
2024-09-30,39228896,45750251,-6521355,루마니아,2024-09
2024-09-30,35213696,23096335,12117361,우크라이나,2024-09
2024-09-30,35047645,104137112,-69089467,그리스,2024-09
2024-09-30,32244916,91025138,-58780222,노르웨이,2024-09
2024-09-30,31971537,442903,31528634,피지,2024-09
2024-09-30,30530342,8348932,22181410,에쿠아도르,2024-09
2024-09-30,26884755,92448361,-65563606,미얀마,2024-09
2024-09-30,26576178,7162203,19413975,도미니카 공화국,2024-09
2024-09-30,25045013,661761420,-636716407,쿠웨이트,2024-09
2024-09-30,24486087,129648156,-105162069,아르헨티나,2024-09
2024-09-30,23951111,20139459,3811652,모로코,2024-09
2024-09-30,23087134,22809307,277827,세르비아,2024-09
2024-09-30,22866240,237064580,-214198340,알제리,2024-09
2024-09-30,21446982,694042,20752940,알바니아,2024-09
2024-09-30,21216117,4732,21211385,타지크,2024-09
2024-09-30,20865770,50963749,-30097979,파나마,2024-09
2024-09-30,17134106,16464704,669402,우루과이,2024-09
2024-09-30,17044896,3320706,13724190,엘살바도르,2024-09
2024-09-30,16263351,19428,16243923,아제르바이잔,2024-09
2024-09-30,15008334,15821552,-813218,코트디봐르,2024-09
2024-09-30,14163361,32064830,-17901469,불가리아,2024-09
2024-09-30,14162497,10858761,3303736,과테말라,2024-09
2024-09-30,13934422,3602220,10332202,온두라스,2024-09
2024-09-30,13751946,1560331,12191615,이란,2024-09
2024-09-30,13747802,8251357,5496445,스리랑카,2024-09
2024-09-30,13453406,13280216,173190,코스타리카,2024-09
2024-09-30,13131923,4042850,9089073,가나,2024-09
2024-09-30,12963900,844270,12119630,탄자니아,2024-09
2024-09-30,12145885,4225366,7920519,케냐,2024-09
2024-09-30,11764908,705663,11059245,파라과이,2024-09
2024-09-30,10971454,5075021,5896433,예맨,2024-09
2024-09-30,10855647,6029722,4825925,세네갈,2024-09
2024-09-30,10142485,5631591,4510894,에스토니아,2024-09
2024-09-30,9884057,121386356,-111502299,파푸아 뉴기니,2024-09
2024-09-30,9239849,10637342,-1397493,튀니지,2024-09
2024-09-30,8982042,314956,8667086,조지아,2024-09
2024-09-30,8914125,45046129,-36132004,바레인,2024-09
2024-09-30,8135461,5338057,2797404,라오스,2024-09
2024-09-30,7216024,1257917,5958107,니카라과,2024-09
2024-09-30,6675353,1828806,4846547,레바논,2024-09
2024-09-30,6346277,5665885,680392,크로아티아,2024-09
2024-09-30,6329603,4094190,2235413,몰도바,2024-09
2024-09-30,6319664,91585,6228079,수단,2024-09
2024-09-30,6094404,9284969,-3190565,에티오피아,2024-09
2024-09-30,5894996,45256957,-39361961,모잠비크,2024-09
2024-09-30,5868468,478237,5390231,모리셔스,2024-09
2024-09-30,5419726,462026,4957700,벨라루스,2024-09
2024-09-30,5364255,589363,4774892,괌,2024-09
2024-09-30,5056379,7984985,-2928606,라트비아,2024-09
2024-09-30,5009924,31073042,-26063118,기타국,2024-09
2024-09-30,4508479,77842,4430637,사모아,2024-09
2024-09-30,4451453,9639940,-5188487,트리니다드 토바고,2024-09
2024-09-30,4305368,7500,4297868,아루바,2024-09
2024-09-30,4051683,345019,3706664,사이프러스,2024-09
2024-09-30,3360185,491031,2869154,네팔,2024-09
2024-09-30,3101926,23336,3078590,아프카니스탄,2024-09
2024-09-30,3055298,4472665,-1417367,룩셈부르그,2024-09
2024-09-30,2995428,0,2995428,투르크멘,2024-09
2024-09-30,2970755,21222,2949533,솔로몬 군도,2024-09
2024-09-30,2961926,424,2961502,가이아나,2024-09
2024-09-30,2733991,76862466,-74128475,브루나이,2024-09
2024-09-30,2720613,626277,2094336,짐바브웨,2024-09
2024-09-30,2688206,193305,2494901,베네주엘라,2024-09
2024-09-30,2669174,2949545,-280371,벨리제,2024-09
2024-09-30,2568827,5277257,-2708430,마다카스카르,2024-09
2024-09-30,2538299,3143514,-605215,잠비아,2024-09
2024-09-30,2528959,1229618,1299341,우간다,2024-09
2024-09-30,2420527,538261,1882266,카메룬,2024-09
2024-09-30,2282922,3749,2279173,지부티,2024-09
2024-09-30,2250135,1821,2248314,자마이카,2024-09
2024-09-30,1973601,61383830,-59410229,콩고민주공화국,2024-09
2024-09-30,1959029,261632,1697397,팔레스타인 해방기구,2024-09
2024-09-30,1951780,1578919,372861,아이슬란드,2024-09
2024-09-30,1921771,159000,1762771,베닝,2024-09
2024-09-30,1859506,3859585,-2000079,토고,2024-09
2024-09-30,1850732,206652,1644080,르완다,2024-09
2024-09-30,1812408,196,1812212,부르키나 파소,2024-09
2024-09-30,1793432,57931,1735501,불령 폴리네시아,2024-09
2024-09-30,1732380,5029855,-3297475,아르메니아,2024-09
2024-09-30,1714194,84439,1629755,몰디브,2024-09
2024-09-30,1696298,1054,1695244,세인트 마틴,2024-09
2024-09-30,1682924,0,1682924,과델로프,2024-09
2024-09-30,1653232,1464428,188804,소말리아,2024-09
2024-09-30,1582088,114933,1467155,콩고,2024-09
2024-09-30,1570922,60491,1510431,가봉,2024-09
2024-09-30,1568852,25110,1543742,시리아,2024-09
2024-09-30,1485359,137279,1348080,마카오,2024-09
2024-09-30,1423149,1585056,-161907,기니,2024-09
2024-09-30,1385419,327,1385092,불령 리유니온 코모도 제도,2024-09
2024-09-30,1363715,15951983,-14588268,볼리비아,2024-09
2024-09-30,1322291,87384,1234907,아이티,2024-09
2024-09-30,1306654,85831,1220823,나미비아,2024-09
2024-09-30,1202082,582336,619746,쿠바,2024-09
2024-09-30,1114647,149934,964713,세이쉘,2024-09
2024-09-30,1061802,2630829,-1569027,모리타니,2024-09
2024-09-30,1048155,157818,890337,북마리아나 군도,2024-09
2024-09-30,1020278,3785409,-2765131,마세도니아,2024-09
2024-09-30,1011497,0,1011497,불령 가이아나,2024-09
2024-09-30,939933,1614209,-674276,리히텐슈타인,2024-09
2024-09-30,906509,1915,904594,바하마,2024-09
2024-09-30,878805,0,878805,적도 기니,2024-09
2024-09-30,798469,1069,797400,안타티카,2024-09
2024-09-30,726952,11242005,-10515053,몬테네그로,2024-09
2024-09-30,710338,47244,663094,키리바티,2024-09
2024-09-30,687912,17248683,-16560771,뉴 칼레도니아,2024-09
2024-09-30,676950,74,676876,니제르,2024-09
2024-09-30,639409,462,638947,큐라소,2024-09
2024-09-30,570618,0,570618,마티니크,2024-09
2024-09-30,539435,150,539285,영령 캐이맨 군도,2024-09
2024-09-30,496971,0,496971,투발루,2024-09
2024-09-30,401232,702915,-301683,바누아투,2024-09
2024-09-30,392089,1920,390169,마이크로네시아,2024-09
2024-09-30,377174,621963,-244789,아메리칸 사모아,2024-09
2024-09-30,371097,19478,351619,그레나다,2024-09
2024-09-30,354248,2324759,-1970511,보스니아-헤르체고비나,2024-09
2024-09-30,340270,703050,-362780,시에라 리온,2024-09
2024-09-30,325290,3172,322118,티모르,2024-09
2024-09-30,302435,714603,-412168,감비아,2024-09
2024-09-30,300045,0,300045,세인트 루시아,2024-09
2024-09-30,291280,0,291280,세인트 빈센트 그레나딘,2024-09
2024-09-30,265228,1594,263634,바베이도스,2024-09
2024-09-30,265121,0,265121,챠드,2024-09
2024-09-30,251121,599985,-348864,수리남,2024-09
2024-09-30,235794,2148389,-1912595,부탄,2024-09
2024-09-30,216684,0,216684,안티가 바부다,2024-09
2024-09-30,205184,710935,-505751,말라위,2024-09
2024-09-30,194310,0,194310,영령 버진군도,2024-09
2024-09-30,174662,28097472,-27922810,에리트리아,2024-09
2024-09-30,153426,0,153426,미령 버진군도,2024-09
2024-09-30,143093,31595,111498,팔라우,2024-09
2024-09-30,130738,19004,111734,세인트 키츠 네비스,2024-09
2024-09-30,125084,43045,82039,도미니카,2024-09
2024-09-30,98475,0,98475,투르크 & 카이코스 군도,2024-09
2024-09-30,87367,0,87367,메요트,2024-09
2024-09-30,73177,281,72896,카보 베르데,2024-09
2024-09-30,56308,229162,-172854,모나코,2024-09
2024-09-30,50700,0,50700,기네비소,2024-09
2024-09-30,48234,11972,36262,보츠와나,2024-09
2024-09-30,47154,2568,44586,부룬디,2024-09
2024-09-30,39344,301393,-262049,지브랄타,2024-09
2024-09-30,38987,65,38922,네덜란드 열도,2024-09
2024-09-30,33415,105895,-72480,말리,2024-09
2024-09-30,18426,34111,-15685,스와질랜드,2024-09
2024-09-30,11860,475433,-463573,산마리노,2024-09
2024-09-30,11780,0,11780,앙귈라,2024-09
2024-09-30,11682,0,11682,코모로스,2024-09
2024-09-30,9750,67182,-57432,그린랜드,2024-09
2024-09-30,6685,0,6685,세인트 바르탤르미,2024-09
2024-09-30,5775,1949,3826,안도라,2024-09
2024-09-30,4277,0,4277,포클랜드 군도,2024-09
2024-09-30,3450,50060,-46610,레소토,2024-09
2024-09-30,2314,0,2314,남수단,2024-09
2024-09-30,1251,0,1251,교황청,2024-09
2024-09-30,630,14514,-13884,중앙아프리카공화국,2024-09
2024-09-30,398,0,398,세인트마틴(생마르탱),2024-09
2024-09-30,66,0,66,쿡 아일랜드,2024-09
2024-09-30,23,14829,-14806,통가,2024-09
2024-09-30,13,223,-210,저어지,2024-09
2024-09-30,0,181,-181,마이너 아우틀링 합중국 군도,2024-09
2024-09-30,0,23,-23,토켈라우,2024-09
2024-09-30,0,250,-250,건지,2024-09
2024-09-30,0,4047922,-4047922,나우루,2024-09
2024-09-30,0,266,-266,왈라스 & 퓨투나 군도,2024-09
2024-09-30,0,56523,-56523,몬트세라트,2024-09
2024-09-30,0,55,-55,남조지아 & 남샌드위치 군도,2024-09
2024-09-30,0,7348,-7348,니우에,2024-09
2024-10-31,12172811021,12513915718,-341104697,중국,2024-10
2024-10-31,10394328403,5968730685,4425597718,미국,2024-10
2024-10-31,5231509318,2552260226,2679249092,베트남,2024-10
2024-10-31,3528892849,2680327177,848565672,대만,2024-10
2024-10-31,2423573394,4378338751,-1954765357,일본,2024-10
2024-10-31,2210876718,127382302,2083494416,홍콩,2024-10
2024-10-31,1511924530,544731122,967193408,인도,2024-10
2024-10-31,1397107395,1057251062,339856333,싱가포르,2024-10
2024-10-31,1125856477,569724607,556131870,멕시코,2024-10
2024-10-31,1074930291,2609693752,-1534763461,호주,2024-10
2024-10-31,1038698543,1215851047,-177152504,말레이시아,2024-10
2024-10-31,949449325,385335690,564113635,필리핀,2024-10
2024-10-31,913563510,557349350,356214160,캐나다,2024-10
2024-10-31,744202529,77026608,667175921,폴란드,2024-10
2024-10-31,743945469,92074200,651871269,튀르키예,2024-10
2024-10-31,717415475,987644091,-270228616,인도네시아,2024-10
2024-10-31,710472065,1938985953,-1228513888,독일,2024-10
2024-10-31,668609156,331396116,337213040,영국,2024-10
2024-10-31,622213563,574887887,47325676,태국,2024-10
2024-10-31,536974920,516058776,20916144,네덜란드,2024-10
2024-10-31,390073146,869201372,-479128226,브라질,2024-10
2024-10-31,366221353,685088018,-318866665,이탈리아,2024-10
2024-10-31,353563265,1496760173,-1143196908,아랍에미리트 연합,2024-10
2024-10-31,344072729,129898577,214174152,벨기에,2024-10
2024-10-31,333044936,552246312,-219201376,러시아 연방,2024-10
2024-10-31,332938386,2528232315,-2195293929,사우디아라비아,2024-10
2024-10-31,314771136,127449153,187321983,뉴질랜드,2024-10
2024-10-31,306747570,649011124,-342263554,프랑스,2024-10
2024-10-31,284653725,68489792,216163933,헝가리,2024-10
2024-10-31,283432645,200359565,83073080,스페인,2024-10
2024-10-31,280970633,141583660,139386973,체코공화국,2024-10
2024-10-31,255022134,99904,254922230,라이베리아,2024-10
2024-10-31,237567901,72464712,165103189,슬로바키아,2024-10
2024-10-31,231298775,101846530,129452245,덴마크,2024-10
2024-10-31,229927843,15459392,214468451,카자흐스탄,2024-10
2024-10-31,211565611,1002,211564609,버뮤다,2024-10
2024-10-31,197243913,298687,196945226,마샬군도,2024-10
2024-10-31,189095012,153450420,35644592,오스트리아,2024-10
2024-10-31,187377663,153377,187224286,키르기스스탄,2024-10
2024-10-31,180141409,81758230,98383179,이스라엘,2024-10
2024-10-31,169853911,33304537,136549374,몰타,2024-10
2024-10-31,151598989,1639155,149959834,우즈베키스탄,2024-10
2024-10-31,151429273,6301899,145127374,이집트,2024-10
2024-10-31,127960804,370215380,-242254576,칠레,2024-10
2024-10-31,104844712,62929703,41915009,방글라데시,2024-10
2024-10-31,103081362,12502824,90578538,그리스,2024-10
2024-10-31,102979993,149255910,-46275917,아일랜드,2024-10
2024-10-31,93108728,692114942,-599006214,이라크,2024-10
2024-10-31,92455333,3274932,89180401,파나마,2024-10
2024-10-31,91388906,115394833,-24005927,콜롬비아,2024-10
2024-10-31,77823841,300241790,-222417949,스위스,2024-10
2024-10-31,77552493,18313519,59238974,파키스탄,2024-10
2024-10-31,77521924,145040099,-67518175,스웨덴,2024-10
2024-10-31,76561532,437906557,-361345025,오만,2024-10
2024-10-31,71881156,1288562181,-1216681025,카타르,2024-10
2024-10-31,71559655,38731995,32827660,포루투갈,2024-10
2024-10-31,71303299,11266165,60037134,슬로베니아,2024-10
2024-10-31,67107315,366,67106949,앙골라,2024-10
2024-10-31,54714428,36705389,18009039,캄보디아,2024-10
2024-10-31,53209557,100682089,-47472532,핀란드,2024-10
2024-10-31,52206156,226468375,-174262219,나이지리아,2024-10
2024-10-31,50989207,4003441,46985766,몽골,2024-10
2024-10-31,49768051,212058553,-162290502,페루,2024-10
2024-10-31,49664041,800779,48863262,탄자니아,2024-10
2024-10-31,48436088,1934559,46501529,리비아,2024-10
2024-10-31,48183977,237094619,-188910642,남아프리카공화국,2024-10
2024-10-31,47523723,5780383,41743340,요르단,2024-10
2024-10-31,44066869,129056152,-84989283,아르헨티나,2024-10
2024-10-31,42253265,12480226,29773039,모로코,2024-10
2024-10-31,41653009,48471419,-6818410,루마니아,2024-10
2024-10-31,40688528,28031222,12657306,푸에르토리코,2024-10
2024-10-31,38915889,12427243,26488646,리투아니아,2024-10
2024-10-31,38770728,781849009,-743078281,쿠웨이트,2024-10
2024-10-31,35774182,100994320,-65220138,노르웨이,2024-10
2024-10-31,34062545,597494,33465051,괌,2024-10
2024-10-31,25715178,68075372,-42360194,미얀마,2024-10
2024-10-31,25654481,6045913,19608568,도미니카 공화국,2024-10
2024-10-31,24552829,3778,24549051,타지크,2024-10
2024-10-31,24142366,5980926,18161440,에쿠아도르,2024-10
2024-10-31,23278873,17951401,5327472,피지,2024-10
2024-10-31,23182358,1345642,21836716,알바니아,2024-10
2024-10-31,22780645,7454037,15326608,스리랑카,2024-10
2024-10-31,22132609,10613322,11519287,과테말라,2024-10
2024-10-31,21268690,4083635,17185055,엘살바도르,2024-10
2024-10-31,21062586,14015140,7047446,우크라이나,2024-10
2024-10-31,20881619,17636038,3245581,불가리아,2024-10
2024-10-31,20220405,26446047,-6225642,바레인,2024-10
2024-10-31,18881502,5323910,13557592,가나,2024-10
2024-10-31,18839860,226449336,-207609476,알제리,2024-10
2024-10-31,16584758,14265238,2319520,코스타리카,2024-10
2024-10-31,15715949,17030129,-1314180,코트디봐르,2024-10
2024-10-31,15086879,13455,15073424,아제르바이잔,2024-10
2024-10-31,14910934,13888118,1022816,트리니다드 토바고,2024-10
2024-10-31,13806403,961263,12845140,이란,2024-10
2024-10-31,12609290,2415706,10193584,온두라스,2024-10
2024-10-31,12524980,10768953,1756027,튀니지,2024-10
2024-10-31,12487052,13054174,-567122,우루과이,2024-10
2024-10-31,12328313,565618,11762695,조지아,2024-10
2024-10-31,11819155,17236558,-5417403,에티오피아,2024-10
2024-10-31,11093553,20313328,-9219775,세르비아,2024-10
2024-10-31,9791220,2495289,7295931,케냐,2024-10
2024-10-31,9525669,305144,9220525,파라과이,2024-10
2024-10-31,9481872,3942273,5539599,세네갈,2024-10
2024-10-31,9137755,2766423,6371332,니카라과,2024-10
2024-10-31,8787552,457881,8329671,벨라루스,2024-10
2024-10-31,8189620,5959864,2229756,라오스,2024-10
2024-10-31,8116149,169771,7946378,불령 폴리네시아,2024-10
2024-10-31,7930150,1889041,6041109,크로아티아,2024-10
2024-10-31,7489543,483147,7006396,모잠비크,2024-10
2024-10-31,7358156,7710659,-352503,에스토니아,2024-10
2024-10-31,6849045,225758,6623287,모리셔스,2024-10
2024-10-31,6757108,10338799,-3581691,라트비아,2024-10
2024-10-31,6199151,4046685,2152466,몰도바,2024-10
2024-10-31,6042144,230751,5811393,수단,2024-10
2024-10-31,5798987,38532932,-32733945,기타국,2024-10
2024-10-31,5522272,0,5522272,지부티,2024-10
2024-10-31,4768072,151698508,-146930436,파푸아 뉴기니,2024-10
2024-10-31,4589449,394448,4195001,사이프러스,2024-10
2024-10-31,4562468,4798541,-236073,레바논,2024-10
2024-10-31,4451920,3040,4448880,사모아,2024-10
2024-10-31,4415604,2935712,1479892,예맨,2024-10
2024-10-31,3785266,459988,3325278,베네주엘라,2024-10
2024-10-31,3768305,0,3768305,아루바,2024-10
2024-10-31,3649767,6316876,-2667109,룩셈부르그,2024-10
2024-10-31,3624569,0,3624569,가이아나,2024-10
2024-10-31,3585883,1125689,2460194,토고,2024-10
2024-10-31,3406856,11673844,-8266988,마다카스카르,2024-10
2024-10-31,3219539,191675,3027864,아프카니스탄,2024-10
2024-10-31,3209112,100,3209012,과델로프,2024-10
2024-10-31,3014778,2041036,973742,브루나이,2024-10
2024-10-31,2892728,7530555,-4637827,아르메니아,2024-10
2024-10-31,2794772,40,2794732,말리,2024-10
2024-10-31,2779161,43826,2735335,부르키나 파소,2024-10
2024-10-31,2749940,95256,2654684,팔레스타인 해방기구,2024-10
2024-10-31,2712201,495696,2216505,아메리칸 사모아,2024-10
2024-10-31,2419197,53862067,-51442870,카메룬,2024-10
2024-10-31,2404517,672666,1731851,네팔,2024-10
2024-10-31,2369824,2236985,132839,우간다,2024-10
2024-10-31,2322055,1241,2320814,자마이카,2024-10
2024-10-31,2314075,37943,2276132,시리아,2024-10
2024-10-31,2256493,1186110,1070383,기니,2024-10
2024-10-31,2220899,1255982,964917,짐바브웨,2024-10
2024-10-31,2157760,4452420,-2294660,가봉,2024-10
2024-10-31,2118012,4928636,-2810624,보스니아-헤르체고비나,2024-10
2024-10-31,2078845,53,2078792,니제르,2024-10
2024-10-31,2018656,97679382,-95660726,콩고민주공화국,2024-10
2024-10-31,1938912,1843026,95886,아이슬란드,2024-10
2024-10-31,1886681,94325785,-92439104,볼리비아,2024-10
2024-10-31,1859189,0,1859189,세인트 마틴,2024-10
2024-10-31,1836737,754,1835983,불령 리유니온 코모도 제도,2024-10
2024-10-31,1811959,711818,1100141,바누아투,2024-10
2024-10-31,1766844,62599,1704245,르완다,2024-10
2024-10-31,1736357,800,1735557,투르크멘,2024-10
2024-10-31,1642017,104990,1537027,북마리아나 군도,2024-10
2024-10-31,1581017,2373314,-792297,잠비아,2024-10
2024-10-31,1398755,344009,1054746,바하마,2024-10
2024-10-31,1320312,37322,1282990,베닝,2024-10
2024-10-31,1295745,50765,1244980,소말리아,2024-10
2024-10-31,1267857,103613,1164244,콩고,2024-10
2024-10-31,1264971,5725,1259246,나미비아,2024-10
2024-10-31,1144186,0,1144186,안타티카,2024-10
2024-10-31,1069933,19517911,-18447978,뉴 칼레도니아,2024-10
2024-10-31,981767,0,981767,벨리제,2024-10
2024-10-31,953233,728391,224842,마세도니아,2024-10
2024-10-31,928916,37232032,-36303116,적도 기니,2024-10
2024-10-31,898459,1083666,-185207,시에라 리온,2024-10
2024-10-31,860245,0,860245,챠드,2024-10
2024-10-31,805467,209014,596453,세이쉘,2024-10
2024-10-31,785868,260128,525740,마카오,2024-10
2024-10-31,785668,1920264,-1134596,솔로몬 군도,2024-10
2024-10-31,710614,0,710614,큐라소,2024-10
2024-10-31,694262,3174123,-2479861,모리타니,2024-10
2024-10-31,636902,675226,-38324,부탄,2024-10
2024-10-31,616926,1866870,-1249944,리히텐슈타인,2024-10
2024-10-31,579850,29,579821,몰디브,2024-10
2024-10-31,575696,0,575696,세인트 루시아,2024-10
2024-10-31,542339,2715,539624,키리바티,2024-10
2024-10-31,527792,0,527792,메요트,2024-10
2024-10-31,500253,452147,48106,쿠바,2024-10
2024-10-31,480441,435804,44637,감비아,2024-10
2024-10-31,462985,18910,444075,팔라우,2024-10
2024-10-31,440422,1441,438981,마이크로네시아,2024-10
2024-10-31,435639,991,434648,지브랄타,2024-10
2024-10-31,425102,0,425102,영령 캐이맨 군도,2024-10
2024-10-31,422293,0,422293,카보 베르데,2024-10
2024-10-31,421810,5937,415873,티모르,2024-10
2024-10-31,409650,553720,-144070,수리남,2024-10
2024-10-31,339806,31,339775,남수단,2024-10
2024-10-31,336239,1348,334891,그레나다,2024-10
2024-10-31,335455,0,335455,불령 가이아나,2024-10
2024-10-31,293275,312502,-19227,말라위,2024-10
2024-10-31,288108,0,288108,마티니크,2024-10
2024-10-31,280732,3875491,-3594759,몬테네그로,2024-10
2024-10-31,270582,0,270582,영령 버진군도,2024-10
2024-10-31,238400,1356,237044,네덜란드 열도,2024-10
2024-10-31,213873,0,213873,투발루,2024-10
2024-10-31,210603,13757,196846,바베이도스,2024-10
2024-10-31,209993,2271,207722,중앙아프리카공화국,2024-10
2024-10-31,197664,4907,192757,안도라,2024-10
2024-10-31,194434,28403,166031,아이티,2024-10
2024-10-31,139523,0,139523,투르크 & 카이코스 군도,2024-10
2024-10-31,137533,15482,122051,보츠와나,2024-10
2024-10-31,124251,21296919,-21172668,에리트리아,2024-10
2024-10-31,112547,66248,46299,도미니카,2024-10
2024-10-31,82802,12500,70302,세인트 키츠 네비스,2024-10
2024-10-31,78096,0,78096,세인트 빈센트 그레나딘,2024-10
2024-10-31,44531,0,44531,안티가 바부다,2024-10
2024-10-31,24720,279817,-255097,산마리노,2024-10
2024-10-31,23135,44560,-21425,스와질랜드,2024-10
2024-10-31,23093,14532,8561,통가,2024-10
2024-10-31,21809,280,21529,미령 버진군도,2024-10
2024-10-31,19814,10,19804,부룬디,2024-10
2024-10-31,16833,65,16768,상토메 프린스페,2024-10
2024-10-31,10604,83230,-72626,기네비소,2024-10
2024-10-31,9087,0,9087,나우루,2024-10
2024-10-31,7118,0,7118,세인트 바르탤르미,2024-10
2024-10-31,6113,255217,-249104,모나코,2024-10
2024-10-31,5726,0,5726,파로에 군도,2024-10
2024-10-31,4893,210839,-205946,그린랜드,2024-10
2024-10-31,4577,0,4577,코모로스,2024-10
2024-10-31,2792,0,2792,건지,2024-10
2024-10-31,1592,0,1592,교황청,2024-10
2024-10-31,925,0,925,세인트마틴(생마르탱),2024-10
2024-10-31,494,0,494,저어지,2024-10
2024-10-31,0,1483,-1483,크리스마스 아일랜드,2024-10
2024-10-31,0,220,-220,토켈라우,2024-10
2024-10-31,0,35,-35,몬트세라트,2024-10
2024-10-31,0,57536,-57536,니우에,2024-10
2024-10-31,0,1900,-1900,남조지아 & 남샌드위치 군도,2024-10
2024-10-31,0,57,-57,보네르 신트외스타티위스,2024-10
2024-10-31,0,12000,-12000,세인트 헬레나,2024-10
2024-10-31,0,53,-53,쿡 아일랜드,2024-10
2024-10-31,0,30376,-30376,레소토,2024-10
2024-10-31,0,1478,-1478,코스 군도,2024-10
2024-10-31,0,489,-489,마이너 아우틀링 합중국 군도,2024-10
2024-10-31,0,100,-100,맨섬,2024-10
2024-11-30,11290361844,11445746620,-155384776,중국,2024-11
2024-11-30,10370480931,5438200163,4932280768,미국,2024-11
2024-11-30,5142172671,2319318587,2822854084,베트남,2024-11
2024-11-30,3253132391,2821020214,432112177,대만,2024-11
2024-11-30,2491515068,3991867135,-1500352067,일본,2024-11
2024-11-30,2425722640,243628115,2182094525,홍콩,2024-11
2024-11-30,1565073149,732736920,832336229,싱가포르,2024-11
2024-11-30,1452203110,554598980,897604130,인도,2024-11
2024-11-30,1204183030,2386134182,-1181951152,호주,2024-11
2024-11-30,980571416,591079025,389492391,멕시코,2024-11
2024-11-30,855431907,1375506477,-520074570,말레이시아,2024-11
2024-11-30,841470794,294174008,547296786,필리핀,2024-11
2024-11-30,755267935,11316,755256619,라이베리아,2024-11
2024-11-30,736866366,624988613,111877753,프랑스,2024-11
2024-11-30,704287033,97458652,606828381,튀르키예,2024-11
2024-11-30,702082558,547839373,154243185,캐나다,2024-11
2024-11-30,655071581,1031878860,-376807279,인도네시아,2024-11
2024-11-30,642536876,587618076,54918800,태국,2024-11
2024-11-30,616667184,1626791095,-1010123911,독일,2024-11
2024-11-30,572575027,64471071,508103956,폴란드,2024-11
2024-11-30,567844688,1067267596,-499422908,네덜란드,2024-11
2024-11-30,492371652,305740157,186631495,영국,2024-11
2024-11-30,465304268,1435526004,-970221736,아랍에미리트 연합,2024-11
2024-11-30,453577044,2454789102,-2001212058,사우디아라비아,2024-11
2024-11-30,420550516,48800927,371749589,헝가리,2024-11
2024-11-30,415595462,547244628,-131649166,이탈리아,2024-11
2024-11-30,390274955,551540842,-161265887,브라질,2024-11
2024-11-30,382781286,80098085,302683201,벨기에,2024-11
2024-11-30,371129572,502982482,-131852910,러시아 연방,2024-11
2024-11-30,279951184,155799538,124151646,스페인,2024-11
2024-11-30,261341027,15013434,246327593,카자흐스탄,2024-11
2024-11-30,251712876,117724757,133988119,체코공화국,2024-11
2024-11-30,249801536,13466344,236335192,그리스,2024-11
2024-11-30,228084857,2700031,225384826,파나마,2024-11
2024-11-30,212081330,54495433,157585897,슬로바키아,2024-11
2024-11-30,211929701,632,211929069,버뮤다,2024-11
2024-11-30,209557954,130282307,79275647,이스라엘,2024-11
2024-11-30,184254220,187896057,-3641837,오스트리아,2024-11
2024-11-30,179467827,94439081,85028746,뉴질랜드,2024-11
2024-11-30,169206469,30180,169176289,키르기스스탄,2024-11
2024-11-30,143196728,1899059,141297669,우즈베키스탄,2024-11
2024-11-30,124503728,258609552,-134105824,칠레,2024-11
2024-11-30,116775044,58130174,58644870,방글라데시,2024-11
2024-11-30,98168121,134794509,-36626388,스웨덴,2024-11
2024-11-30,92187872,313520595,-221332723,스위스,2024-11
2024-11-30,89505624,3878642,85626982,이집트,2024-11
2024-11-30,86515688,147300045,-60784357,콜롬비아,2024-11
2024-11-30,83181863,698062131,-614880268,이라크,2024-11
2024-11-30,80115950,84250782,-4134832,아일랜드,2024-11
2024-11-30,78174485,20396071,57778414,포루투갈,2024-11
2024-11-30,64510004,974278801,-909768797,카타르,2024-11
2024-11-30,64130237,31485473,32644764,파키스탄,2024-11
2024-11-30,63545581,9569594,53975987,슬로베니아,2024-11
2024-11-30,60048836,96600139,-36551303,나이지리아,2024-11
2024-11-30,57409033,31621541,25787492,캄보디아,2024-11
2024-11-30,49450878,245825420,-196374542,남아프리카공화국,2024-11
2024-11-30,47283312,33251849,14031463,푸에르토리코,2024-11
2024-11-30,47111311,2358573,44752738,몽골,2024-11
2024-11-30,45522659,106209891,-60687232,덴마크,2024-11
2024-11-30,45031458,129141154,-84109696,페루,2024-11
2024-11-30,44939830,43538378,1401452,루마니아,2024-11
2024-11-30,43277308,660129965,-616852657,쿠웨이트,2024-11
2024-11-30,42588809,65680176,-23091367,핀란드,2024-11
2024-11-30,41515985,91611079,-50095094,아르헨티나,2024-11
2024-11-30,41324663,1002238,40322425,리비아,2024-11
2024-11-30,40801490,8889801,31911689,요르단,2024-11
2024-11-30,35155916,22127919,13027997,우크라이나,2024-11
2024-11-30,32913266,9240909,23672357,모로코,2024-11
2024-11-30,31839362,157361169,-125521807,노르웨이,2024-11
2024-11-30,31378160,7297236,24080924,리투아니아,2024-11
2024-11-30,27104441,42149508,-15045067,미얀마,2024-11
2024-11-30,24566024,467571542,-443005518,알제리,2024-11
2024-11-30,22537919,3189917,19348002,엘살바도르,2024-11
2024-11-30,21572458,522308299,-500735841,오만,2024-11
2024-11-30,20521112,9683662,10837450,과테말라,2024-11
2024-11-30,20277858,33,20277825,타지크,2024-11
2024-11-30,19652095,8459577,11192518,도미니카 공화국,2024-11
2024-11-30,19363816,902907,18460909,알바니아,2024-11
2024-11-30,19213356,22434226,-3220870,바레인,2024-11
2024-11-30,18999036,5966810,13032226,가나,2024-11
2024-11-30,18200440,9546853,8653587,에쿠아도르,2024-11
2024-11-30,18115392,685712,17429680,괌,2024-11
2024-11-30,18011650,32115908,-14104258,몰타,2024-11
2024-11-30,16464941,15516859,948082,불가리아,2024-11
2024-11-30,16098713,8193810,7904903,스리랑카,2024-11
2024-11-30,14925271,6423808,8501463,에티오피아,2024-11
2024-11-30,13955994,248274,13707720,아제르바이잔,2024-11
2024-11-30,13868022,21543996,-7675974,코스타리카,2024-11
2024-11-30,13019516,15646170,-2626654,코트디봐르,2024-11
2024-11-30,12403749,41965769,-29562020,세르비아,2024-11
2024-11-30,12310734,1494715,10816019,온두라스,2024-11
2024-11-30,11925506,4492755,7432751,라오스,2024-11
2024-11-30,11411155,132337,11278818,이란,2024-11
2024-11-30,11118549,10427435,691114,우루과이,2024-11
2024-11-30,11054601,779129,10275472,조지아,2024-11
2024-11-30,10720328,3725809,6994519,탄자니아,2024-11
2024-11-30,9791206,0,9791206,수단,2024-11
2024-11-30,9579059,4449310,5129749,케냐,2024-11
2024-11-30,9547778,2721988,6825790,세네갈,2024-11
2024-11-30,9471008,9740132,-269124,튀니지,2024-11
2024-11-30,8957951,46033867,-37075916,모잠비크,2024-11
2024-11-30,8844523,1193076,7651447,크로아티아,2024-11
2024-11-30,8796998,689551,8107447,파라과이,2024-11
2024-11-30,7842767,3686686,4156081,에스토니아,2024-11
2024-11-30,7835401,696971,7138430,벨라루스,2024-11
2024-11-30,6741516,6473058,268458,기타국,2024-11
2024-11-30,6477711,1458662,5019049,니카라과,2024-11
2024-11-30,6457973,9368466,-2910493,트리니다드 토바고,2024-11
2024-11-30,6231796,53382441,-47150645,브루나이,2024-11
2024-11-30,5762220,1832,5760388,앙골라,2024-11
2024-11-30,5549148,4030634,1518514,몰도바,2024-11
2024-11-30,5218692,102978,5115714,사이프러스,2024-11
2024-11-30,5058312,347983,4710329,모리셔스,2024-11
2024-11-30,4714624,2654646,2059978,피지,2024-11
2024-11-30,4557741,96840,4460901,아프카니스탄,2024-11
2024-11-30,4544475,72791,4471684,팔라우,2024-11
2024-11-30,4458440,2268967,2189473,레바논,2024-11
2024-11-30,4420950,5808,4415142,아루바,2024-11
2024-11-30,4412790,82696107,-78283317,파푸아 뉴기니,2024-11
2024-11-30,4407414,9594332,-5186918,라트비아,2024-11
2024-11-30,4261744,55780406,-51518662,콩고민주공화국,2024-11
2024-11-30,4217576,55446,4162130,사모아,2024-11
2024-11-30,4027632,76902,3950730,베닝,2024-11
2024-11-30,3881624,1322271,2559353,우간다,2024-11
2024-11-30,3814419,764882,3049537,예맨,2024-11
2024-11-30,3695782,0,3695782,지부티,2024-11
2024-11-30,3680042,6150897,-2470855,룩셈부르그,2024-11
2024-11-30,3149460,617402,2532058,베네주엘라,2024-11
2024-11-30,2893527,0,2893527,세인트 마틴,2024-11
2024-11-30,2871971,11338064,-8466093,마다카스카르,2024-11
2024-11-30,2864572,0,2864572,마티니크,2024-11
2024-11-30,2803908,0,2803908,불령 리유니온 코모도 제도,2024-11
2024-11-30,2564276,87127,2477149,팔레스타인 해방기구,2024-11
2024-11-30,2459629,39802791,-37343162,자마이카,2024-11
2024-11-30,2442665,3050114,-607449,가봉,2024-11
2024-11-30,2384760,734347,1650413,짐바브웨,2024-11
2024-11-30,2257309,3833,2253476,바베이도스,2024-11
2024-11-30,2209647,24023409,-21813762,볼리비아,2024-11
2024-11-30,2206001,397,2205604,시리아,2024-11
2024-11-30,2195221,37409,2157812,큐라소,2024-11
2024-11-30,2159788,42827,2116961,가이아나,2024-11
2024-11-30,2144137,289023,1855114,솔로몬 군도,2024-11
2024-11-30,2131713,4585916,-2454203,카메룬,2024-11
2024-11-30,2106287,5984813,-3878526,모리타니,2024-11
2024-11-30,2095169,10,2095159,부르키나 파소,2024-11
2024-11-30,2003342,791196,1212146,기니,2024-11
2024-11-30,1986635,4478302,-2491667,아르메니아,2024-11
2024-11-30,1936235,300668,1635567,세이쉘,2024-11
2024-11-30,1931815,1627318,304497,잠비아,2024-11
2024-11-30,1813898,2446209,-632311,토고,2024-11
2024-11-30,1780989,6521,1774468,불령 폴리네시아,2024-11
2024-11-30,1697610,484273,1213337,아메리칸 사모아,2024-11
2024-11-30,1629360,640,1628720,몰디브,2024-11
2024-11-30,1392938,170407,1222531,콩고,2024-11
2024-11-30,1384550,402066,982484,르완다,2024-11
2024-11-30,1362284,469791,892493,네팔,2024-11
2024-11-30,1273240,621117,652123,소말리아,2024-11
2024-11-30,1205258,52857,1152401,아이티,2024-11
2024-11-30,1202666,1446321,-243655,아이슬란드,2024-11
2024-11-30,1090546,4375,1086171,북마리아나 군도,2024-11
2024-11-30,1083016,643,1082373,과델로프,2024-11
2024-11-30,1052899,18467,1034432,벨리제,2024-11
2024-11-30,997334,1208621,-211287,쿠바,2024-11
2024-11-30,966990,171310,795680,마카오,2024-11
2024-11-30,935005,3041,931964,바하마,2024-11
2024-11-30,880425,28771,851654,투르크멘,2024-11
2024-11-30,849432,1446252,-596820,부탄,2024-11
2024-11-30,786418,2320273,-1533855,보스니아-헤르체고비나,2024-11
2024-11-30,781004,0,781004,적도 기니,2024-11
2024-11-30,749945,7363,742582,니제르,2024-11
2024-11-30,686356,1980619,-1294263,리히텐슈타인,2024-11
2024-11-30,637968,18978,618990,몬테네그로,2024-11
2024-11-30,592421,272,592149,영령 캐이맨 군도,2024-11
2024-11-30,585132,0,585132,안티가 바부다,2024-11
2024-11-30,573847,178700,395147,마세도니아,2024-11
2024-11-30,507495,0,507495,투발루,2024-11
2024-11-30,493821,36674624,-36180803,뉴 칼레도니아,2024-11
2024-11-30,483255,3,483252,카보 베르데,2024-11
2024-11-30,480131,364617,115514,시에라 리온,2024-11
2024-11-30,436522,76611,359911,키리바티,2024-11
2024-11-30,425159,0,425159,불령 가이아나,2024-11
2024-11-30,410559,2661,407898,마이크로네시아,2024-11
2024-11-30,405109,125287,279822,티모르,2024-11
2024-11-30,396982,721486,-324504,바누아투,2024-11
2024-11-30,390404,802,389602,지브랄타,2024-11
2024-11-30,376838,1558917,-1182079,수리남,2024-11
2024-11-30,363111,153056,210055,마샬군도,2024-11
2024-11-30,337974,0,337974,세인트 빈센트 그레나딘,2024-11
2024-11-30,268685,456604,-187919,감비아,2024-11
2024-11-30,215915,51167,164748,스와질랜드,2024-11
2024-11-30,209267,1281,207986,도미니카,2024-11
2024-11-30,204122,0,204122,메요트,2024-11
2024-11-30,180359,0,180359,세인트 루시아,2024-11
2024-11-30,137171,160,137011,투르크 & 카이코스 군도,2024-11
2024-11-30,107403,4203,103200,말리,2024-11
2024-11-30,101206,670,100536,세인트 키츠 네비스,2024-11
2024-11-30,85877,0,85877,그레나다,2024-11
2024-11-30,83283,241007,-157724,나미비아,2024-11
2024-11-30,66940,823280,-756340,말라위,2024-11
2024-11-30,60000,648929,-588929,기네비소,2024-11
2024-11-30,46827,0,46827,남수단,2024-11
2024-11-30,45333,161,45172,부룬디,2024-11
2024-11-30,42787,4,42783,코스 군도,2024-11
2024-11-30,40714,989,39725,통가,2024-11
2024-11-30,31210,0,31210,영령 버진군도,2024-11
2024-11-30,24574,0,24574,상토메 프린스페,2024-11
2024-11-30,22735,48867,-26132,안도라,2024-11
2024-11-30,22176,338,21838,코모로스,2024-11
2024-11-30,19840,66776,-46936,레소토,2024-11
2024-11-30,15967,0,15967,세인트마틴(생마르탱),2024-11
2024-11-30,10120,536203,-526083,산마리노,2024-11
2024-11-30,5384,10146,-4762,보츠와나,2024-11
2024-11-30,4951,0,4951,네덜란드 열도,2024-11
2024-11-30,4797,302695,-297898,그린랜드,2024-11
2024-11-30,3187,68055,-64868,세인트 바르탤르미,2024-11
2024-11-30,1768,0,1768,미령 버진군도,2024-11
2024-11-30,884,0,884,건지,2024-11
2024-11-30,588,110399,-109811,모나코,2024-11
2024-11-30,474,0,474,저어지,2024-11
2024-11-30,329,229403,-229074,파로에 군도,2024-11
2024-11-30,165,0,165,교황청,2024-11
2024-11-30,0,3681,-3681,몬트세라트,2024-11
2024-11-30,0,13871100,-13871100,에리트리아,2024-11
2024-11-30,0,614,-614,크리스마스 아일랜드,2024-11
2024-11-30,0,278,-278,남조지아 & 남샌드위치 군도,2024-11
2024-11-30,0,26,-26,영령 인도양,2024-11
2024-11-30,0,1176,-1176,토켈라우,2024-11
2024-11-30,0,995,-995,중앙아프리카공화국,2024-11
2024-11-30,0,33065,-33065,맨섬,2024-11
2024-11-30,0,672,-672,불령 남부지역,2024-11
2024-11-30,0,25750,-25750,세인트 헬레나,2024-11
2024-11-30,0,1008,-1008,마이너 아우틀링 합중국 군도,2024-11
2024-12-31,11893820362,5476549742,6417270620,미국,2024-12
2024-12-31,11772793118,12382339785,-609546667,중국,2024-12
2024-12-31,4930152806,2455077918,2475074888,베트남,2024-12
2024-12-31,4335693603,2911032294,1424661309,대만,2024-12
2024-12-31,3287665810,130955270,3156710540,홍콩,2024-12
2024-12-31,2644228071,4476094901,-1831866830,일본,2024-12
2024-12-31,1747126351,1048731507,698394844,싱가포르,2024-12
2024-12-31,1684866636,634573254,1050293382,인도,2024-12
2024-12-31,1153688525,2288927427,-1135238902,호주,2024-12
2024-12-31,1132939858,771043173,361896685,멕시코,2024-12
2024-12-31,865951826,493383358,372568468,캐나다,2024-12
2024-12-31,814824441,279186880,535637561,필리핀,2024-12
2024-12-31,803442164,108137468,695304696,폴란드,2024-12
2024-12-31,803342754,1320470573,-517127819,말레이시아,2024-12
2024-12-31,745666477,126345,745540132,라이베리아,2024-12
2024-12-31,737591245,86312574,651278671,튀르키예,2024-12
2024-12-31,630315792,868622956,-238307164,인도네시아,2024-12
2024-12-31,613189859,564965426,48224433,태국,2024-12
2024-12-31,612736167,1976129252,-1363393085,독일,2024-12
2024-12-31,521531483,1440374218,-918842735,네덜란드,2024-12
2024-12-31,515078849,1148633301,-633554452,프랑스,2024-12
2024-12-31,500559071,622574443,-122015372,이탈리아,2024-12
2024-12-31,491196722,397432784,93763938,영국,2024-12
2024-12-31,467446924,2681082870,-2213635946,사우디아라비아,2024-12
2024-12-31,460634475,30378659,430255816,몰타,2024-12
2024-12-31,409487853,819020977,-409533124,브라질,2024-12
2024-12-31,406276396,979743930,-573467534,아랍에미리트 연합,2024-12
2024-12-31,354642268,534549769,-179907501,러시아 연방,2024-12
2024-12-31,318253557,171732539,146521018,스페인,2024-12
2024-12-31,308604517,82354667,226249850,헝가리,2024-12
2024-12-31,281446189,134239679,147206510,벨기에,2024-12
2024-12-31,269489479,145699358,123790121,체코공화국,2024-12
2024-12-31,263552503,14355787,249196716,카자흐스탄,2024-12
2024-12-31,230394439,110195239,120199200,덴마크,2024-12
2024-12-31,229138911,64858897,164280014,슬로바키아,2024-12
2024-12-31,209241073,643,209240430,버뮤다,2024-12
2024-12-31,200703500,121440974,79262526,이스라엘,2024-12
2024-12-31,159223500,93982545,65240955,뉴질랜드,2024-12
2024-12-31,152994642,90148913,62845729,아일랜드,2024-12
2024-12-31,134280251,877848,133402403,우즈베키스탄,2024-12
2024-12-31,129784254,44917185,84867069,방글라데시,2024-12
2024-12-31,126824399,1189456,125634943,키르기스스탄,2024-12
2024-12-31,122180012,7076752,115103260,이집트,2024-12
2024-12-31,116077848,283457906,-167380058,스위스,2024-12
2024-12-31,105141024,940531450,-835390426,이라크,2024-12
2024-12-31,102205086,360750034,-258544948,칠레,2024-12
2024-12-31,100287721,205645576,-105357855,스웨덴,2024-12
2024-12-31,97275530,70214008,27061522,콜롬비아,2024-12
2024-12-31,95573138,131830121,-36256983,노르웨이,2024-12
2024-12-31,94220955,26584662,67636293,푸에르토리코,2024-12
2024-12-31,88168297,449792510,-361624213,오만,2024-12
2024-12-31,85710643,78628878,7081765,핀란드,2024-12
2024-12-31,81633970,12709910,68924060,슬로베니아,2024-12
2024-12-31,80478271,15849055,64629216,파키스탄,2024-12
2024-12-31,72863054,335605320,-262742266,남아프리카공화국,2024-12
2024-12-31,71918647,1189030699,-1117112052,카타르,2024-12
2024-12-31,71326746,173666506,-102339760,오스트리아,2024-12
2024-12-31,68360273,182216,68178057,르완다,2024-12
2024-12-31,66136182,142009288,-75873106,나이지리아,2024-12
2024-12-31,58800646,28370689,30429957,포루투갈,2024-12
2024-12-31,55734280,40919538,14814742,캄보디아,2024-12
2024-12-31,55733156,13076857,42656299,리투아니아,2024-12
2024-12-31,53540980,4132068,49408912,요르단,2024-12
2024-12-31,51700105,151619835,-99919730,페루,2024-12
2024-12-31,49939761,2589075,47350686,탄자니아,2024-12
2024-12-31,47954208,127558616,-79604408,그리스,2024-12
2024-12-31,45064807,600404166,-555339359,쿠웨이트,2024-12
2024-12-31,45013347,174113,44839234,마샬군도,2024-12
2024-12-31,45012264,2245406,42766858,몽골,2024-12
2024-12-31,44287104,49774558,-5487454,루마니아,2024-12
2024-12-31,40626238,2656502,37969736,리비아,2024-12
2024-12-31,34452185,126551474,-92099289,아르헨티나,2024-12
2024-12-31,30331004,287916236,-257585232,알제리,2024-12
2024-12-31,30212576,7255511,22957065,도미니카 공화국,2024-12
2024-12-31,29846663,21337755,8508908,모로코,2024-12
2024-12-31,28917160,14895038,14022122,피지,2024-12
2024-12-31,28749782,10213801,18535981,에쿠아도르,2024-12
2024-12-31,28651382,29960871,-1309489,파나마,2024-12
2024-12-31,27769226,56581575,-28812349,바레인,2024-12
2024-12-31,27622392,36681564,-9059172,우크라이나,2024-12
2024-12-31,26980793,30350519,-3369726,미얀마,2024-12
2024-12-31,23582386,6675889,16906497,가나,2024-12
2024-12-31,22198610,3295637,18902973,엘살바도르,2024-12
2024-12-31,19540472,6744906,12795566,과테말라,2024-12
2024-12-31,18854080,186,18853894,타지크,2024-12
2024-12-31,18519351,9946361,8572990,튀니지,2024-12
2024-12-31,18107039,3262903,14844136,케냐,2024-12
2024-12-31,17527889,580820,16947069,알바니아,2024-12
2024-12-31,17384872,14180557,3204315,불가리아,2024-12
2024-12-31,17002108,25498415,-8496307,코스타리카,2024-12
2024-12-31,16023988,19686501,-3662513,코트디봐르,2024-12
2024-12-31,15481048,82408729,-66927681,브루나이,2024-12
2024-12-31,15107579,266670,14840909,이란,2024-12
2024-12-31,14806418,8759488,6046930,우루과이,2024-12
2024-12-31,14654959,302223,14352736,파라과이,2024-12
2024-12-31,14291061,5920,14285141,아제르바이잔,2024-12
2024-12-31,14105270,8135871,5969399,스리랑카,2024-12
2024-12-31,13216406,0,13216406,투르크멘,2024-12
2024-12-31,13103163,1553044,11550119,온두라스,2024-12
2024-12-31,12205025,2108369,10096656,세네갈,2024-12
2024-12-31,12097226,3953172,8144054,크로아티아,2024-12
2024-12-31,12050844,9045156,3005688,세르비아,2024-12
2024-12-31,11793756,6833752,4960004,기타국,2024-12
2024-12-31,11740787,8747707,2993080,라오스,2024-12
2024-12-31,10417822,14175726,-3757904,에티오피아,2024-12
2024-12-31,9693611,1309470,8384141,조지아,2024-12
2024-12-31,8485795,390468,8095327,괌,2024-12
2024-12-31,8163483,229809,7933674,사이프러스,2024-12
2024-12-31,8160386,670087,7490299,네팔,2024-12
2024-12-31,7406359,77840786,-70434427,모잠비크,2024-12
2024-12-31,7223665,1393111,5830554,니카라과,2024-12
2024-12-31,6450617,4295184,2155433,레바논,2024-12
2024-12-31,6257659,4904918,1352741,몰도바,2024-12
2024-12-31,6117237,165,6117072,지부티,2024-12
2024-12-31,5962278,0,5962278,마티니크,2024-12
2024-12-31,5944461,7091302,-1146841,에스토니아,2024-12
2024-12-31,5872010,2915,5869095,불령 폴리네시아,2024-12
2024-12-31,5747862,2077567,3670295,예맨,2024-12
2024-12-31,5529431,17255,5512176,사모아,2024-12
2024-12-31,5189633,4611562,578071,벨라루스,2024-12
2024-12-31,5003669,176485099,-171481430,파푸아 뉴기니,2024-12
2024-12-31,4628974,20,4628954,앙골라,2024-12
2024-12-31,4407979,457938,3950041,모리셔스,2024-12
2024-12-31,4346582,0,4346582,남수단,2024-12
2024-12-31,3980416,3802307,178109,아프카니스탄,2024-12
2024-12-31,3765883,2227124,1538759,카메룬,2024-12
2024-12-31,3749715,1301243,2448472,아이슬란드,2024-12
2024-12-31,3635213,9467155,-5831942,라트비아,2024-12
2024-12-31,3536750,8859927,-5323177,룩셈부르그,2024-12
2024-12-31,3535948,91912337,-88376389,볼리비아,2024-12
2024-12-31,3287992,167169,3120823,베네주엘라,2024-12
2024-12-31,2962932,8991076,-6028144,트리니다드 토바고,2024-12
2024-12-31,2947548,2059,2945489,콩고,2024-12
2024-12-31,2808227,0,2808227,수단,2024-12
2024-12-31,2787447,207411,2580036,말라위,2024-12
2024-12-31,2701483,57290,2644193,짐바브웨,2024-12
2024-12-31,2681792,25,2681767,가이아나,2024-12
2024-12-31,2641490,1195877,1445613,토고,2024-12
2024-12-31,2629114,50753,2578361,부르키나 파소,2024-12
2024-12-31,2585246,603,2584643,자마이카,2024-12
2024-12-31,2308208,8712971,-6404763,마다카스카르,2024-12
2024-12-31,2304797,5799,2298998,아루바,2024-12
2024-12-31,2208278,85737776,-83529498,콩고민주공화국,2024-12
2024-12-31,2183782,0,2183782,가봉,2024-12
2024-12-31,2026709,609656,1417053,쿠바,2024-12
2024-12-31,1962012,4613580,-2651568,아르메니아,2024-12
2024-12-31,1945892,4069661,-2123769,잠비아,2024-12
2024-12-31,1776734,260054,1516680,벨리제,2024-12
2024-12-31,1773370,155556,1617814,불령 리유니온 코모도 제도,2024-12
2024-12-31,1730717,4019,1726698,몰디브,2024-12
2024-12-31,1659583,0,1659583,적도 기니,2024-12
2024-12-31,1608126,37276,1570850,베닝,2024-12
2024-12-31,1543302,57,1543245,과델로프,2024-12
2024-12-31,1536969,958291,578678,시에라 리온,2024-12
2024-12-31,1361869,632128,729741,아이티,2024-12
2024-12-31,1361144,158526,1202618,세이쉘,2024-12
2024-12-31,1342471,423562,918909,마카오,2024-12
2024-12-31,1327690,0,1327690,세인트 마틴,2024-12
2024-12-31,1289891,84706,1205185,북마리아나 군도,2024-12
2024-12-31,1259018,3968208,-2709190,모리타니,2024-12
2024-12-31,1191850,617383,574467,아메리칸 사모아,2024-12
2024-12-31,1099049,2279262,-1180213,보스니아-헤르체고비나,2024-12
2024-12-31,1035490,50,1035440,안티가 바부다,2024-12
2024-12-31,997007,195335,801672,바누아투,2024-12
2024-12-31,931187,1506785,-575598,리히텐슈타인,2024-12
2024-12-31,877219,88084,789135,우간다,2024-12
2024-12-31,865690,2167315,-1301625,기니,2024-12
2024-12-31,863976,201308,662668,큐라소,2024-12
2024-12-31,818126,13480239,-12662113,뉴 칼레도니아,2024-12
2024-12-31,794185,5545,788640,바베이도스,2024-12
2024-12-31,657792,0,657792,불령 가이아나,2024-12
2024-12-31,631373,2535,628838,시리아,2024-12
2024-12-31,631194,53838,577356,솔로몬 군도,2024-12
2024-12-31,627907,153487,474420,소말리아,2024-12
2024-12-31,625269,3038,622231,바하마,2024-12
2024-12-31,608282,41082,567200,몬테네그로,2024-12
2024-12-31,602283,710952,-108669,부탄,2024-12
2024-12-31,539275,139879,399396,마세도니아,2024-12
2024-12-31,503300,12960579,-12457279,에리트리아,2024-12
2024-12-31,499141,862,498279,마이크로네시아,2024-12
2024-12-31,495827,21,495806,챠드,2024-12
2024-12-31,466755,0,466755,키리바티,2024-12
2024-12-31,456323,0,456323,그레나다,2024-12
2024-12-31,430327,153,430174,지브랄타,2024-12
2024-12-31,382617,0,382617,카보 베르데,2024-12
2024-12-31,374514,9118,365396,말리,2024-12
2024-12-31,354449,252662,101787,수리남,2024-12
2024-12-31,335856,4218,331638,세인트 루시아,2024-12
2024-12-31,335398,466,334932,세인트 키츠 네비스,2024-12
2024-12-31,330630,16,330614,팔라우,2024-12
2024-12-31,326298,0,326298,투르크 & 카이코스 군도,2024-12
2024-12-31,315593,0,315593,상토메 프린스페,2024-12
2024-12-31,286756,0,286756,세인트 빈센트 그레나딘,2024-12
2024-12-31,269862,2134,267728,투발루,2024-12
2024-12-31,263550,82303,181247,보츠와나,2024-12
2024-12-31,248665,210,248455,영령 캐이맨 군도,2024-12
2024-12-31,235543,34141,201402,나미비아,2024-12
2024-12-31,215926,455648,-239722,감비아,2024-12
2024-12-31,215623,0,215623,영령 버진군도,2024-12
2024-12-31,195215,92630,102585,티모르,2024-12
2024-12-31,192544,15,192529,부룬디,2024-12
2024-12-31,138087,181725,-43638,네덜란드 열도,2024-12
2024-12-31,90348,113489,-23141,팔레스타인 해방기구,2024-12
2024-12-31,74380,0,74380,세인트마틴(생마르탱),2024-12
2024-12-31,69552,243,69309,코스 군도,2024-12
2024-12-31,63215,35673,27542,도미니카,2024-12
2024-12-31,52731,7252,45479,니제르,2024-12
2024-12-31,50047,40628,9419,스와질랜드,2024-12
2024-12-31,47912,16100,31812,통가,2024-12
2024-12-31,23149,909307,-886158,산마리노,2024-12
2024-12-31,13301,886960,-873659,모나코,2024-12
2024-12-31,7821,398377,-390556,세인트 바르탤르미,2024-12
2024-12-31,4500,0,4500,기네비소,2024-12
2024-12-31,4254,0,4254,알랜드 군도,2024-12
2024-12-31,2190,2864,-674,안도라,2024-12
2024-12-31,1963,0,1963,메요트,2024-12
2024-12-31,1904,0,1904,파로에 군도,2024-12
2024-12-31,1417,0,1417,왈라스 & 퓨투나 군도,2024-12
2024-12-31,1380,0,1380,미령 버진군도,2024-12
2024-12-31,1054,264653,-263599,그린랜드,2024-12
2024-12-31,896,0,896,교황청,2024-12
2024-12-31,537,303,234,건지,2024-12
2024-12-31,501,760,-259,저어지,2024-12
2024-12-31,376,0,376,쿡 아일랜드,2024-12
2024-12-31,263,0,263,앙귈라,2024-12
2024-12-31,1,4,-3,중앙아프리카공화국,2024-12
2024-12-31,0,11981,-11981,코모로스,2024-12
2024-12-31,0,26878,-26878,몬트세라트,2024-12
2024-12-31,0,3340,-3340,니우에,2024-12
2024-12-31,0,39659,-39659,레소토,2024-12
2024-12-31,0,774,-774,보네르 신트외스타티위스,2024-12
2024-12-31,0,272,-272,남조지아 & 남샌드위치 군도,2024-12
2024-12-31,0,200,-200,맨섬,2024-12
2024-12-31,0,1042,-1042,토켈라우,2024-12
2024-12-31,0,906,-906,불령 남부지역,2024-12
2025-01-31,9282884244,5831623976,3451260268,미국,2025-01
2025-01-31,9208869400,11203444066,-1994574666,중국,2025-01
2025-01-31,4357900895,2563681858,1794219037,베트남,2025-01
2025-01-31,2438052494,2227897674,210154820,대만,2025-01
2025-01-31,2364098803,3584534093,-1220435290,일본,2025-01
2025-01-31,1685460560,183371412,1502089148,홍콩,2025-01
2025-01-31,1463986007,535979670,928006337,인도,2025-01
2025-01-31,1161135699,1023240339,137895360,싱가포르,2025-01
2025-01-31,947284654,767518759,179765895,멕시코,2025-01
2025-01-31,921789172,1346302377,-424513205,말레이시아,2025-01
2025-01-31,909464787,2871592832,-1962128045,호주,2025-01
2025-01-31,880781271,228880073,651901198,필리핀,2025-01
2025-01-31,768193715,1388299865,-620106150,독일,2025-01
2025-01-31,765216342,80378211,684838131,폴란드,2025-01
2025-01-31,734862421,533457579,201404842,캐나다,2025-01
2025-01-31,726259429,57178,726202251,마샬군도,2025-01
2025-01-31,662360710,108296574,554064136,튀르키예,2025-01
2025-01-31,624391815,460173080,164218735,태국,2025-01
2025-01-31,556944223,332359322,224584901,영국,2025-01
2025-01-31,551737717,1100678276,-548940559,인도네시아,2025-01
2025-01-31,476490329,483010646,-6520317,프랑스,2025-01
2025-01-31,459093729,484340431,-25246702,네덜란드,2025-01
2025-01-31,447796224,9669,447786555,라이베리아,2025-01
2025-01-31,405480648,682165432,-276684784,브라질,2025-01
2025-01-31,337060008,460736956,-123676948,이탈리아,2025-01
2025-01-31,330219886,1455673615,-1125453729,아랍에미리트 연합,2025-01
2025-01-31,312278959,124659732,187619227,벨기에,2025-01
2025-01-31,292075007,2469551989,-2177476982,사우디아라비아,2025-01
2025-01-31,277637969,78007468,199630501,체코공화국,2025-01
2025-01-31,254592142,56943365,197648777,헝가리,2025-01
2025-01-31,253412744,137884497,115528247,덴마크,2025-01
2025-01-31,242339752,223357038,18982714,스페인,2025-01
2025-01-31,223317090,501751723,-278434633,러시아 연방,2025-01
2025-01-31,194239466,12231589,182007877,카자흐스탄,2025-01
2025-01-31,181194201,16983396,164210805,몰타,2025-01
2025-01-31,175279257,136281501,38997756,이스라엘,2025-01
2025-01-31,170915959,55337658,115578301,슬로바키아,2025-01
2025-01-31,139317541,102233000,37084541,뉴질랜드,2025-01
2025-01-31,123920056,363364246,-239444190,칠레,2025-01
2025-01-31,114575984,1225930,113350054,키르기스스탄,2025-01
2025-01-31,113267669,493,113267176,바하마,2025-01
2025-01-31,110162860,1165748,108997112,우즈베키스탄,2025-01
2025-01-31,107113732,38195311,68918421,파키스탄,2025-01
2025-01-31,101217683,284239227,-183021544,스위스,2025-01
2025-01-31,100162200,785939228,-685777028,이라크,2025-01
2025-01-31,99213420,52151465,47061955,방글라데시,2025-01
2025-01-31,96082640,155135979,-59053339,스웨덴,2025-01
2025-01-31,91563384,5991887,85571497,이집트,2025-01
2025-01-31,77923646,2934683,74988963,파나마,2025-01
2025-01-31,76319889,107078765,-30758876,아일랜드,2025-01
2025-01-31,73034059,1414140754,-1341106695,카타르,2025-01
2025-01-31,71835461,279446,71556015,르완다,2025-01
2025-01-31,66485795,95535662,-29049867,콜롬비아,2025-01
2025-01-31,65079443,497410490,-432331047,오만,2025-01
2025-01-31,63883078,6415479,57467599,슬로베니아,2025-01
2025-01-31,62081514,112954629,-50873115,오스트리아,2025-01
2025-01-31,58354480,541987,57812493,파라과이,2025-01
2025-01-31,56927732,37219196,19708536,포루투갈,2025-01
2025-01-31,55771413,4649557,51121856,요르단,2025-01
2025-01-31,49607846,41940463,7667383,캄보디아,2025-01
2025-01-31,45115522,70487126,-25371604,핀란드,2025-01
2025-01-31,43488239,479617,43008622,괌,2025-01
2025-01-31,41323267,47190810,-5867543,루마니아,2025-01
2025-01-31,41095541,80148041,-39052500,나이지리아,2025-01
2025-01-31,40437898,253237260,-212799362,페루,2025-01
2025-01-31,39934581,263243845,-223309264,남아프리카공화국,2025-01
2025-01-31,35760358,777272323,-741511965,쿠웨이트,2025-01
2025-01-31,34938711,124203275,-89264564,노르웨이,2025-01
2025-01-31,34893762,11965025,22928737,푸에르토리코,2025-01
2025-01-31,33059806,31658759,1401047,우크라이나,2025-01
2025-01-31,31764060,1662380,30101680,리비아,2025-01
2025-01-31,31667145,2670991,28996154,몽골,2025-01
2025-01-31,29925131,25029264,4895867,라오스,2025-01
2025-01-31,29687011,6627039,23059972,리투아니아,2025-01
2025-01-31,27196412,93660330,-66463918,그리스,2025-01
2025-01-31,27035269,121319417,-94284148,아르헨티나,2025-01
2025-01-31,23377802,41897623,-18519821,미얀마,2025-01
2025-01-31,21227350,453800829,-432573479,알제리,2025-01
2025-01-31,21025634,3379847,17645787,엘살바도르,2025-01
2025-01-31,20647031,13151716,7495315,모로코,2025-01
2025-01-31,20629980,10092885,10537095,에쿠아도르,2025-01
2025-01-31,18323773,7336809,10986964,과테말라,2025-01
2025-01-31,18174871,8750727,9424144,도미니카 공화국,2025-01
2025-01-31,17109357,6487175,10622182,가나,2025-01
2025-01-31,16795993,9967194,6828799,스리랑카,2025-01
2025-01-31,15875114,0,15875114,타지크,2025-01
2025-01-31,15066022,865578,14200444,알바니아,2025-01
2025-01-31,13521226,9131377,4389849,코스타리카,2025-01
2025-01-31,12897979,25735002,-12837023,불가리아,2025-01
2025-01-31,12106161,1361763,10744398,시에라 리온,2025-01
2025-01-31,11511870,1749881,9761989,온두라스,2025-01
2025-01-31,11469888,8240157,3229731,탄자니아,2025-01
2025-01-31,11039680,394096,10645584,아제르바이잔,2025-01
2025-01-31,10638341,3422542,7215799,케냐,2025-01
2025-01-31,10506655,17156806,-6650151,코트디봐르,2025-01
2025-01-31,10497990,8113634,2384356,세르비아,2025-01
2025-01-31,10208189,20242535,-10034346,우루과이,2025-01
2025-01-31,9882905,614955,9267950,조지아,2025-01
2025-01-31,9342246,7307849,2034397,튀니지,2025-01
2025-01-31,8821420,216916,8604504,이란,2025-01
2025-01-31,8576826,7518179,1058647,에티오피아,2025-01
2025-01-31,8412290,28380209,-19967919,기타국,2025-01
2025-01-31,8313154,1495593,6817561,크로아티아,2025-01
2025-01-31,8239363,40885,8198478,지부티,2025-01
2025-01-31,8048919,225,8048694,투르크멘,2025-01
2025-01-31,8044113,30704,8013409,앙골라,2025-01
2025-01-31,7672612,7484779,187833,에스토니아,2025-01
2025-01-31,7582455,2360221,5222234,브루나이,2025-01
2025-01-31,6331708,1257668,5074040,레바논,2025-01
2025-01-31,6323911,3045884,3278027,세네갈,2025-01
2025-01-31,6289946,146002411,-139712465,파푸아 뉴기니,2025-01
2025-01-31,5795514,5201606,593908,몰도바,2025-01
2025-01-31,5667394,37752956,-32085562,모잠비크,2025-01
2025-01-31,5434438,4,5434434,수단,2025-01
2025-01-31,5241635,73454788,-68213153,바레인,2025-01
2025-01-31,4547326,48584,4498742,가이아나,2025-01
2025-01-31,4260668,13590736,-9330068,트리니다드 토바고,2025-01
2025-01-31,4245481,915772,3329709,벨라루스,2025-01
2025-01-31,4146123,9372516,-5226393,라트비아,2025-01
2025-01-31,4109352,1270411,2838941,니카라과,2025-01
2025-01-31,4080380,832183,3248197,아이슬란드,2025-01
2025-01-31,3797888,10065113,-6267225,룩셈부르그,2025-01
2025-01-31,3370274,0,3370274,사모아,2025-01
2025-01-31,3367276,613710,2753566,콩고,2025-01
2025-01-31,3236658,187953,3048705,모리셔스,2025-01
2025-01-31,3218520,107,3218413,남수단,2025-01
2025-01-31,3125394,6531842,-3406448,예맨,2025-01
2025-01-31,2996571,159869,2836702,피지,2025-01
2025-01-31,2955140,3972423,-1017283,기니,2025-01
2025-01-31,2841178,76946,2764232,자마이카,2025-01
2025-01-31,2698909,1233967,1464942,사이프러스,2025-01
2025-01-31,2638295,439434,2198861,베네주엘라,2025-01
2025-01-31,2509851,0,2509851,불령 리유니온 코모도 제도,2025-01
2025-01-31,2489683,71151031,-68661348,볼리비아,2025-01
2025-01-31,2427495,98401,2329094,아프카니스탄,2025-01
2025-01-31,2042283,6102,2036181,시리아,2025-01
2025-01-31,2027227,0,2027227,아루바,2025-01
2025-01-31,1974005,563676,1410329,네팔,2025-01
2025-01-31,1797690,6260365,-4462675,마다카스카르,2025-01
2025-01-31,1769183,5596,1763587,마티니크,2025-01
2025-01-31,1763130,0,1763130,벨리제,2025-01
2025-01-31,1735501,885656,849845,토고,2025-01
2025-01-31,1651009,481343,1169666,카메룬,2025-01
2025-01-31,1573205,37203,1536002,베닝,2025-01
2025-01-31,1513439,5843,1507596,니제르,2025-01
2025-01-31,1472226,56054,1416172,부르키나 파소,2025-01
2025-01-31,1382028,78541,1303487,가봉,2025-01
2025-01-31,1310088,4784396,-3474308,아르메니아,2025-01
2025-01-31,1272981,1761,1271220,아이티,2025-01
2025-01-31,1168280,4424263,-3255983,잠비아,2025-01
2025-01-31,1145046,26098,1118948,북마리아나 군도,2025-01
2025-01-31,1098225,160152,938073,불령 폴리네시아,2025-01
2025-01-31,1056132,672640,383492,짐바브웨,2025-01
2025-01-31,1054358,374192,680166,소말리아,2025-01
2025-01-31,1046520,103806,942714,말리,2025-01
2025-01-31,1037382,87405813,-86368431,콩고민주공화국,2025-01
2025-01-31,1025609,18420,1007189,큐라소,2025-01
2025-01-31,1005869,0,1005869,세인트 마틴,2025-01
2025-01-31,1005741,0,1005741,과델로프,2025-01
2025-01-31,918079,0,918079,팔레스타인 해방기구,2025-01
2025-01-31,913833,776873,136960,수리남,2025-01
2025-01-31,867392,93301,774091,마카오,2025-01
2025-01-31,784597,680,783917,버뮤다,2025-01
2025-01-31,706057,29158,676899,마이크로네시아,2025-01
2025-01-31,649491,625211,24280,바누아투,2025-01
2025-01-31,623073,763114,-140041,우간다,2025-01
2025-01-31,610241,2078,608163,투발루,2025-01
2025-01-31,604874,17,604857,솔로몬 군도,2025-01
2025-01-31,596642,24367,572275,팔라우,2025-01
2025-01-31,594150,14,594136,부룬디,2025-01
2025-01-31,590179,1579932,-989753,부탄,2025-01
2025-01-31,537616,0,537616,키리바티,2025-01
2025-01-31,527820,962335,-434515,리히텐슈타인,2025-01
2025-01-31,503244,51349,451895,보츠와나,2025-01
2025-01-31,479940,2383,477557,몬테네그로,2025-01
2025-01-31,461957,1502965,-1041008,모리타니,2025-01
2025-01-31,461052,2822743,-2361691,보스니아-헤르체고비나,2025-01
2025-01-31,424095,83503,340592,바베이도스,2025-01
2025-01-31,411643,1691,409952,몰디브,2025-01
2025-01-31,395190,151841,243349,아메리칸 사모아,2025-01
2025-01-31,366571,735,365836,그레나다,2025-01
2025-01-31,316669,82,316587,카보 베르데,2025-01
2025-01-31,298322,66695,231627,나미비아,2025-01
2025-01-31,275362,0,275362,세인트 루시아,2025-01
2025-01-31,275187,0,275187,안티가 바부다,2025-01
2025-01-31,257178,887314,-630136,감비아,2025-01
2025-01-31,241773,845125,-603352,마세도니아,2025-01
2025-01-31,240809,0,240809,영령 캐이맨 군도,2025-01
2025-01-31,236782,81506,155276,적도 기니,2025-01
2025-01-31,229399,927508,-698109,쿠바,2025-01
2025-01-31,181643,20047202,-19865559,뉴 칼레도니아,2025-01
2025-01-31,171448,0,171448,불령 가이아나,2025-01
2025-01-31,162401,0,162401,영령 버진군도,2025-01
2025-01-31,162149,203019,-40870,세이쉘,2025-01
2025-01-31,152943,0,152943,세인트 빈센트 그레나딘,2025-01
2025-01-31,150628,51912,98716,스와질랜드,2025-01
2025-01-31,123810,18268,105542,도미니카,2025-01
2025-01-31,108139,0,108139,투르크 & 카이코스 군도,2025-01
2025-01-31,89413,0,89413,메요트,2025-01
2025-01-31,72617,149211,-76594,기네비소,2025-01
2025-01-31,68980,1549716,-1480736,말라위,2025-01
2025-01-31,60178,599,59579,세인트 키츠 네비스,2025-01
2025-01-31,27765,2457,25308,티모르,2025-01
2025-01-31,26982,52,26930,네덜란드 열도,2025-01
2025-01-31,20891,215193,-194302,모나코,2025-01
2025-01-31,19864,27872,-8008,중앙아프리카공화국,2025-01
2025-01-31,18022,89,17933,챠드,2025-01
2025-01-31,15869,0,15869,지브랄타,2025-01
2025-01-31,11966,14932,-2966,통가,2025-01
2025-01-31,8827,0,8827,알랜드 군도,2025-01
2025-01-31,7845,37,7808,세인트마틴(생마르탱),2025-01
2025-01-31,5937,13834,-7897,세인트 바르탤르미,2025-01
2025-01-31,2506,282235,-279729,그린랜드,2025-01
2025-01-31,1854,0,1854,교황청,2025-01
2025-01-31,1731,1913,-182,코모로스,2025-01
2025-01-31,1160,0,1160,앙귈라,2025-01
2025-01-31,1084,0,1084,에리트리아,2025-01
2025-01-31,1019,0,1019,미령 버진군도,2025-01
2025-01-31,557,0,557,몬트세라트,2025-01
2025-01-31,415,0,415,건지,2025-01
2025-01-31,246,480,-234,저어지,2025-01
2025-01-31,4,0,4,왈라스 & 퓨투나 군도,2025-01
2025-01-31,0,1100,-1100,쿡 아일랜드,2025-01
2025-01-31,0,98,-98,코스 군도,2025-01
2025-01-31,0,148,-148,니우에,2025-01
2025-01-31,0,5697,-5697,레소토,2025-01
2025-01-31,0,4750524,-4750524,나우루,2025-01
2025-01-31,0,74,-74,상토메 프린스페,2025-01
2025-01-31,0,46,-46,불령 남부지역,2025-01
2025-01-31,0,91,-91,영령 인도양,2025-01
2025-01-31,0,8408,-8408,보네르 신트외스타티위스,2025-01
2025-01-31,0,12,-12,맨섬,2025-01
2025-01-31,0,1619,-1619,안도라,2025-01
2025-01-31,0,1174,-1174,크리스마스 아일랜드,2025-01
2025-01-31,0,129094,-129094,토켈라우,2025-01
2025-01-31,0,210054,-210054,산마리노,2025-01
2025-01-31,0,13348,-13348,피트카이른,2025-01
2025-02-28,9891774317,5734014097,4157760220,미국,2025-02
2025-02-28,9503748182,9483428627,20319555,중국,2025-02
2025-02-28,4734724917,2264073016,2470651901,베트남,2025-02
2025-02-28,2751811017,2396228596,355582421,대만,2025-02
2025-02-28,2264992300,4191423802,-1926431502,일본,2025-02
2025-02-28,1891156460,451354168,1439802292,홍콩,2025-02
2025-02-28,1627986899,870690254,757296645,싱가포르,2025-02
2025-02-28,1596027208,537890366,1058136842,인도,2025-02
2025-02-28,1034404108,1378272072,-343867964,말레이시아,2025-02
2025-02-28,991924640,2327017132,-1335092492,호주,2025-02
2025-02-28,961661508,638232654,323428854,멕시코,2025-02
2025-02-28,853076887,84718512,768358375,튀르키예,2025-02
2025-02-28,817333889,439766445,377567444,캐나다,2025-02
2025-02-28,727950651,271365554,456585097,필리핀,2025-02
2025-02-28,724892534,67288075,657604459,폴란드,2025-02
2025-02-28,708484143,1658053568,-949569425,독일,2025-02
2025-02-28,674959550,984109544,-309149994,인도네시아,2025-02
2025-02-28,668664446,609732713,58931733,태국,2025-02
2025-02-28,580924708,747060603,-166135895,네덜란드,2025-02
2025-02-28,501346843,1379852518,-878505675,아랍에미리트 연합,2025-02
2025-02-28,481857830,357629409,124228421,영국,2025-02
2025-02-28,427296841,477819474,-50522633,브라질,2025-02
2025-02-28,375852947,587954633,-212101686,이탈리아,2025-02
2025-02-28,358436083,2363482053,-2005045970,사우디아라비아,2025-02
2025-02-28,355701444,212756,355488688,마샬군도,2025-02
2025-02-28,334477404,85489921,248987483,벨기에,2025-02
2025-02-28,331977042,85893101,246083941,헝가리,2025-02
2025-02-28,304920309,90191737,214728572,체코공화국,2025-02
2025-02-28,297379774,485325418,-187945644,러시아 연방,2025-02
2025-02-28,291192534,818291634,-527099100,프랑스,2025-02
2025-02-28,280959279,171452085,109507194,스페인,2025-02
2025-02-28,254829979,118440947,136389032,덴마크,2025-02
2025-02-28,247644812,15354674,232290138,카자흐스탄,2025-02
2025-02-28,235857175,629837,235227338,라이베리아,2025-02
2025-02-28,226645903,57432943,169212960,슬로바키아,2025-02
2025-02-28,218569507,102588308,115981199,이스라엘,2025-02
2025-02-28,215910794,125468918,90441876,뉴질랜드,2025-02
2025-02-28,211180119,35119,211145000,키르기스스탄,2025-02
2025-02-28,208775051,349,208774702,버뮤다,2025-02
2025-02-28,156217100,64308212,91908888,방글라데시,2025-02
2025-02-28,144965153,2296585,142668568,우즈베키스탄,2025-02
2025-02-28,137286128,350859533,-213573405,스위스,2025-02
2025-02-28,125266092,927865648,-802599556,이라크,2025-02
2025-02-28,120286362,259033242,-138746880,칠레,2025-02
2025-02-28,117222928,5044896,112178032,이집트,2025-02
2025-02-28,95916574,20905030,75011544,파키스탄,2025-02
2025-02-28,95111722,41599357,53512365,포루투갈,2025-02
2025-02-28,94032338,152383284,-58350946,스웨덴,2025-02
2025-02-28,93073646,2371769,90701877,파나마,2025-02
2025-02-28,88572384,123551781,-34979397,아일랜드,2025-02
2025-02-28,81092053,158326382,-77234329,콜롬비아,2025-02
2025-02-28,80398723,116504433,-36105710,오스트리아,2025-02
2025-02-28,77890594,827646333,-749755739,카타르,2025-02
2025-02-28,74104516,11766305,62338211,슬로베니아,2025-02
2025-02-28,62758726,583066326,-520307600,쿠웨이트,2025-02
2025-02-28,60350369,2114080,58236289,요르단,2025-02
2025-02-28,53392996,39979911,13413085,캄보디아,2025-02
2025-02-28,52077611,230130028,-178052417,페루,2025-02
2025-02-28,48734151,36472808,12261343,루마니아,2025-02
2025-02-28,48657193,1233634,47423559,몽골,2025-02
2025-02-28,48244666,13753778,34490888,그리스,2025-02
2025-02-28,46712817,69541131,-22828314,나이지리아,2025-02
2025-02-28,45008101,247910593,-202902492,남아프리카공화국,2025-02
2025-02-28,44989831,8526587,36463244,우크라이나,2025-02
2025-02-28,42616849,1627023,40989826,리비아,2025-02
2025-02-28,39480719,7671238,31809481,리투아니아,2025-02
2025-02-28,37395787,29103061,8292726,푸에르토리코,2025-02
2025-02-28,33668613,295859826,-262191213,알제리,2025-02
2025-02-28,33454792,77899150,-44444358,아르헨티나,2025-02
2025-02-28,33202906,82859836,-49656930,핀란드,2025-02
2025-02-28,32766776,6729667,26037109,에쿠아도르,2025-02
2025-02-28,32212456,23828485,8383971,모로코,2025-02
2025-02-28,30083979,14199295,15884684,가나,2025-02
2025-02-28,29822913,22630931,7191982,코스타리카,2025-02
2025-02-28,29798612,331934,29466678,피지,2025-02
2025-02-28,26418423,7724,26410699,타지크,2025-02
2025-02-28,25659970,114473542,-88813572,노르웨이,2025-02
2025-02-28,23598303,3061906,20536397,케냐,2025-02
2025-02-28,23401991,58360088,-34958097,미얀마,2025-02
2025-02-28,22228627,582744,21645883,알바니아,2025-02
2025-02-28,20730788,199252749,-178521961,오만,2025-02
2025-02-28,18929210,5763514,13165696,과테말라,2025-02
2025-02-28,18433233,9999165,8434068,세르비아,2025-02
2025-02-28,17895215,2935906,14959309,엘살바도르,2025-02
2025-02-28,17716579,14661781,3054798,코트디봐르,2025-02
2025-02-28,16926485,10230055,6696430,스리랑카,2025-02
2025-02-28,16583819,4728481,11855338,탄자니아,2025-02
2025-02-28,16311127,5325937,10985190,도미니카 공화국,2025-02
2025-02-28,15960190,8669939,7290251,튀니지,2025-02
2025-02-28,14347752,26975,14320777,아제르바이잔,2025-02
2025-02-28,14305809,66153004,-51847195,바레인,2025-02
2025-02-28,14142564,9630348,4512216,불가리아,2025-02
2025-02-28,13379878,523484,12856394,조지아,2025-02
2025-02-28,11964049,44308,11919741,이란,2025-02
2025-02-28,11739751,4820611,6919140,우루과이,2025-02
2025-02-28,11312902,2225193,9087709,세네갈,2025-02
2025-02-28,10721791,8341029,2380762,라오스,2025-02
2025-02-28,9868796,1554538,8314258,파라과이,2025-02
2025-02-28,9714263,4471471,5242792,온두라스,2025-02
2025-02-28,9279874,1264133,8015741,크로아티아,2025-02
2025-02-28,9096205,14677855,-5581650,몰타,2025-02
2025-02-28,8919053,5006,8914047,시리아,2025-02
2025-02-28,8676032,8810640,-134608,에티오피아,2025-02
2025-02-28,8208713,1733603,6475110,레바논,2025-02
2025-02-28,8050825,765359,7285466,아이슬란드,2025-02
2025-02-28,7765857,657,7765200,나미비아,2025-02
2025-02-28,7556355,335141,7221214,사이프러스,2025-02
2025-02-28,7533483,8931174,-1397691,에스토니아,2025-02
2025-02-28,7382910,721250,6661660,괌,2025-02
2025-02-28,6724968,1394699,5330269,벨라루스,2025-02
2025-02-28,6576225,4667373,1908852,몰도바,2025-02
2025-02-28,6202711,22246718,-16044007,파푸아 뉴기니,2025-02
2025-02-28,5724546,12761279,-7036733,기타국,2025-02
2025-02-28,5542818,301012,5241806,콩고,2025-02
2025-02-28,5182029,8703703,-3521674,예맨,2025-02
2025-02-28,5051079,8698780,-3647701,라트비아,2025-02
2025-02-28,5036010,6018400,-982390,니카라과,2025-02
2025-02-28,4940966,20331,4920635,브루나이,2025-02
2025-02-28,4852585,100,4852485,사모아,2025-02
2025-02-28,4220469,0,4220469,투르크멘,2025-02
2025-02-28,3765290,21,3765269,베닝,2025-02
2025-02-28,3502203,230726,3271477,베네주엘라,2025-02
2025-02-28,3484920,326362,3158558,모리셔스,2025-02
2025-02-28,3354132,37,3354095,앙골라,2025-02
2025-02-28,3293125,52603320,-49310195,모잠비크,2025-02
2025-02-28,3231760,8931149,-5699389,룩셈부르그,2025-02
2025-02-28,3201844,36687013,-33485169,트리니다드 토바고,2025-02
2025-02-28,3055394,448095,2607299,자마이카,2025-02
2025-02-28,2920225,99812165,-96891940,볼리비아,2025-02
2025-02-28,2837586,18232,2819354,남수단,2025-02
2025-02-28,2697066,0,2697066,수단,2025-02
2025-02-28,2640384,95,2640289,부르키나 파소,2025-02
2025-02-28,2553934,24074,2529860,아루바,2025-02
2025-02-28,2544691,591173,1953518,토고,2025-02
2025-02-28,2518752,11441092,-8922340,마다카스카르,2025-02
2025-02-28,2352179,3491448,-1139269,카메룬,2025-02
2025-02-28,2346649,0,2346649,지부티,2025-02
2025-02-28,2325322,731368,1593954,네팔,2025-02
2025-02-28,2063586,3275092,-1211506,우간다,2025-02
2025-02-28,2032550,0,2032550,그레나다,2025-02
2025-02-28,2019549,0,2019549,적도 기니,2025-02
2025-02-28,2013441,267080,1746361,르완다,2025-02
2025-02-28,2010820,0,2010820,불령 폴리네시아,2025-02
2025-02-28,1916021,137801,1778220,가이아나,2025-02
2025-02-28,1862742,17920,1844822,불령 리유니온 코모도 제도,2025-02
2025-02-28,1778377,3450,1774927,바하마,2025-02
2025-02-28,1711404,6475528,-4764124,잠비아,2025-02
2025-02-28,1687917,351699,1336218,아메리칸 사모아,2025-02
2025-02-28,1668665,5229278,-3560613,아르메니아,2025-02
2025-02-28,1605072,228,1604844,벨리제,2025-02
2025-02-28,1586273,0,1586273,세인트 마틴,2025-02
2025-02-28,1510962,0,1510962,큐라소,2025-02
2025-02-28,1494578,96147,1398431,아프카니스탄,2025-02
2025-02-28,1469331,3965792,-2496461,짐바브웨,2025-02
2025-02-28,1451850,4228576,-2776726,기니,2025-02
2025-02-28,1381870,396677,985193,소말리아,2025-02
2025-02-28,1308510,35948,1272562,아이티,2025-02
2025-02-28,1274419,15430,1258989,세이쉘,2025-02
2025-02-28,1229125,6205415,-4976290,가봉,2025-02
2025-02-28,1180573,1108935,71638,보스니아-헤르체고비나,2025-02
2025-02-28,1057453,183285,874168,북마리아나 군도,2025-02
2025-02-28,1025641,604,1025037,마티니크,2025-02
2025-02-28,913119,1614689,-701570,부탄,2025-02
2025-02-28,804360,420847,383513,수리남,2025-02
2025-02-28,803624,169176,634448,솔로몬 군도,2025-02
2025-02-28,779098,71298345,-70519247,콩고민주공화국,2025-02
2025-02-28,775547,92542,683005,마카오,2025-02
2025-02-28,742765,10104,732661,몬테네그로,2025-02
2025-02-28,738518,101280,637238,팔레스타인 해방기구,2025-02
2025-02-28,736807,1288444,-551637,모리타니,2025-02
2025-02-28,720500,568753,151747,마세도니아,2025-02
2025-02-28,719063,1782,717281,영령 캐이맨 군도,2025-02
2025-02-28,706629,1115715,-409086,시에라 리온,2025-02
2025-02-28,665264,1932347,-1267083,리히텐슈타인,2025-02
2025-02-28,640309,1150,639159,몰디브,2025-02
2025-02-28,634347,0,634347,과델로프,2025-02
2025-02-28,603249,4580602,-3977353,뉴 칼레도니아,2025-02
2025-02-28,575710,19063,556647,마이크로네시아,2025-02
2025-02-28,554300,0,554300,키리바티,2025-02
2025-02-28,554070,159,553911,티모르,2025-02
2025-02-28,552371,0,552371,중앙아프리카공화국,2025-02
2025-02-28,535978,1209097,-673119,바누아투,2025-02
2025-02-28,527859,31616,496243,바베이도스,2025-02
2025-02-28,513253,0,513253,안티가 바부다,2025-02
2025-02-28,453734,0,453734,불령 가이아나,2025-02
2025-02-28,445049,714080,-269031,감비아,2025-02
2025-02-28,426038,0,426038,영령 버진군도,2025-02
2025-02-28,330044,0,330044,세인트 루시아,2025-02
2025-02-28,231668,224527,7141,쿠바,2025-02
2025-02-28,174518,173,174345,투르크 & 카이코스 군도,2025-02
2025-02-28,166440,186,166254,도미니카,2025-02
2025-02-28,160514,1,160513,니제르,2025-02
2025-02-28,153358,1944,151414,부룬디,2025-02
2025-02-28,136787,33095,103692,팔라우,2025-02
2025-02-28,129150,18568,110582,코모로스,2025-02
2025-02-28,117441,3010,114431,세인트 키츠 네비스,2025-02
2025-02-28,82689,0,82689,카보 베르데,2025-02
2025-02-28,80101,0,80101,세인트 빈센트 그레나딘,2025-02
2025-02-28,77624,28518,49106,스와질랜드,2025-02
2025-02-28,75755,523,75232,말리,2025-02
2025-02-28,75500,852,74648,통가,2025-02
2025-02-28,68800,127097,-58297,기네비소,2025-02
2025-02-28,64337,19851,44486,보츠와나,2025-02
2025-02-28,44884,617793,-572909,산마리노,2025-02
2025-02-28,41135,0,41135,챠드,2025-02
2025-02-28,38273,52,38221,네덜란드 열도,2025-02
2025-02-28,33466,98,33368,지브랄타,2025-02
2025-02-28,31818,4414,27404,안도라,2025-02
2025-02-28,11431,35237,-23806,나우루,2025-02
2025-02-28,10981,0,10981,남조지아 & 남샌드위치 군도,2025-02
2025-02-28,9404,0,9404,세인트마틴(생마르탱),2025-02
2025-02-28,9101,7272455,-7263354,말라위,2025-02
2025-02-28,6904,239,6665,앙귈라,2025-02
2025-02-28,5410,0,5410,상토메 프린스페,2025-02
2025-02-28,4283,361873,-357590,모나코,2025-02
2025-02-28,3883,555,3328,세인트 바르탤르미,2025-02
2025-02-28,3000,60355,-57355,레소토,2025-02
2025-02-28,3000,0,3000,투발루,2025-02
2025-02-28,2614,1285,1329,건지,2025-02
2025-02-28,1961,49747,-47786,그린랜드,2025-02
2025-02-28,1733,0,1733,메요트,2025-02
2025-02-28,1010,1183,-173,교황청,2025-02
2025-02-28,763,1206,-443,미령 버진군도,2025-02
2025-02-28,497,0,497,저어지,2025-02
2025-02-28,180,0,180,포클랜드 군도,2025-02
2025-02-28,155,0,155,파로에 군도,2025-02
2025-02-28,70,0,70,왈라스 & 퓨투나 군도,2025-02
2025-02-28,1,0,1,에리트리아,2025-02
2025-02-28,0,193,-193,피트카이른,2025-02
2025-02-28,0,922,-922,보네르 신트외스타티위스,2025-02
2025-02-28,0,319,-319,쿡 아일랜드,2025-02
2025-02-28,0,248,-248,코스 군도,2025-02
2025-02-28,0,284,-284,니우에,2025-02
2025-02-28,0,572,-572,영령 인도양,2025-02
2025-02-28,0,544,-544,토켈라우,2025-02
2025-02-28,0,17,-17,맨섬,2025-02
2025-02-28,0,2525,-2525,몬트세라트,2025-02
2025-02-28,0,9777,-9777,마이너 아우틀링 합중국 군도,2025-02
2025-03-31,11116711388,5387978622,5728732766,미국,2025-03
2025-03-31,10058345068,11373753071,-1315408003,중국,2025-03
2025-03-31,5028728043,2603728819,2424999224,베트남,2025-03
2025-03-31,3824789119,2912509615,912279504,대만,2025-03
2025-03-31,2679064264,328493315,2350570949,홍콩,2025-03
2025-03-31,2161824209,4577957709,-2416133500,일본,2025-03
2025-03-31,1896033709,940282305,955751404,싱가포르,2025-03
2025-03-31,1502877216,592835099,910042117,인도,2025-03
2025-03-31,1051356033,325414087,725941946,필리핀,2025-03
2025-03-31,983548668,1184540595,-200991927,말레이시아,2025-03
2025-03-31,942629831,699048344,243581487,멕시코,2025-03
2025-03-31,902266458,2538672557,-1636406099,호주,2025-03
2025-03-31,895502388,528835384,366667004,캐나다,2025-03
2025-03-31,894802795,1834601519,-939798724,독일,2025-03
2025-03-31,877751869,68360810,809391059,폴란드,2025-03
2025-03-31,834171654,132842898,701328756,튀르키예,2025-03
2025-03-31,658910005,603187975,55722030,태국,2025-03
2025-03-31,655267599,1609364697,-954097098,네덜란드,2025-03
2025-03-31,632845195,180280,632664915,라이베리아,2025-03
2025-03-31,543499907,25417238,518082669,몰타,2025-03
2025-03-31,537177473,800887826,-263710353,인도네시아,2025-03
2025-03-31,504750787,370413525,134337262,영국,2025-03
2025-03-31,478602385,665098649,-186496264,프랑스,2025-03
2025-03-31,445792904,2406771031,-1960978127,사우디아라비아,2025-03
2025-03-31,441301458,1628697095,-1187395637,아랍에미리트 연합,2025-03
2025-03-31,425876838,614030829,-188153991,브라질,2025-03
2025-03-31,424828031,64898252,359929779,헝가리,2025-03
2025-03-31,393680664,565395701,-171715037,이탈리아,2025-03
2025-03-31,298359780,436277134,-137917354,러시아 연방,2025-03
2025-03-31,295105547,91835729,203269818,체코공화국,2025-03
2025-03-31,282187807,100745624,181442183,벨기에,2025-03
2025-03-31,278973597,206187206,72786391,스페인,2025-03
2025-03-31,274089735,13681466,260408269,카자흐스탄,2025-03
2025-03-31,271806692,115390583,156416109,뉴질랜드,2025-03
2025-03-31,253968519,28049,253940470,키르기스스탄,2025-03
2025-03-31,251957728,79189454,172768274,덴마크,2025-03
2025-03-31,211388313,155652722,55735591,이스라엘,2025-03
2025-03-31,201493684,93982393,107511291,슬로바키아,2025-03
2025-03-31,180489362,63951697,116537665,방글라데시,2025-03
2025-03-31,157369256,469002225,-311632969,칠레,2025-03
2025-03-31,139766619,402189208,-262422589,스위스,2025-03
2025-03-31,130386643,666107,129720536,우즈베키스탄,2025-03
2025-03-31,129770314,5113365,124656949,이집트,2025-03
2025-03-31,126636573,2148315,124488258,파나마,2025-03
2025-03-31,122796428,60973402,61823026,마샬군도,2025-03
2025-03-31,120908108,737725814,-616817706,이라크,2025-03
2025-03-31,116827986,1932,116826054,바하마,2025-03
2025-03-31,116529748,13568523,102961225,파키스탄,2025-03
2025-03-31,113413744,101734983,11678761,아일랜드,2025-03
2025-03-31,108357209,37427036,70930173,콜롬비아,2025-03
2025-03-31,99071286,196266102,-97194816,스웨덴,2025-03
2025-03-31,97352638,133189516,-35836878,오스트리아,2025-03
2025-03-31,83001905,43082338,39919567,포루투갈,2025-03
2025-03-31,75519475,350984389,-275464914,오만,2025-03
2025-03-31,70529249,950354312,-879825063,카타르,2025-03
2025-03-31,67854228,113963991,-46109763,남아프리카공화국,2025-03
2025-03-31,67259028,14441,67244587,앙골라,2025-03
2025-03-31,60808046,37531481,23276565,루마니아,2025-03
2025-03-31,60517047,15726816,44790231,슬로베니아,2025-03
2025-03-31,54690105,926367,53763738,몽골,2025-03
2025-03-31,53321743,45244663,8077080,캄보디아,2025-03
2025-03-31,50745613,245410,50500203,파라과이,2025-03
2025-03-31,48209611,2447517,45762094,요르단,2025-03
2025-03-31,45888660,384014508,-338125848,페루,2025-03
2025-03-31,44568156,48253542,-3685386,우크라이나,2025-03
2025-03-31,44564383,55478448,-10914065,그리스,2025-03
2025-03-31,44307173,68622297,-24315124,아르헨티나,2025-03
2025-03-31,42124199,27862403,14261796,푸에르토리코,2025-03
2025-03-31,41624137,6433176,35190961,나이지리아,2025-03
2025-03-31,41078682,680264925,-639186243,쿠웨이트,2025-03
2025-03-31,40640631,18023109,22617522,리비아,2025-03
2025-03-31,40517837,92087789,-51569952,핀란드,2025-03
2025-03-31,34931761,190723690,-155791929,노르웨이,2025-03
2025-03-31,33005468,606656,32398812,괌,2025-03
2025-03-31,31936515,19062223,12874292,모로코,2025-03
2025-03-31,30651334,11848471,18802863,리투아니아,2025-03
2025-03-31,29324226,285836834,-256512608,알제리,2025-03
2025-03-31,28904008,430087,28473921,피지,2025-03
2025-03-31,28436986,7542031,20894955,에쿠아도르,2025-03
2025-03-31,27091278,7775229,19316049,과테말라,2025-03
2025-03-31,26545762,123961,26421801,이란,2025-03
2025-03-31,24279030,60282115,-36003085,미얀마,2025-03
2025-03-31,23186808,9963367,13223441,가나,2025-03
2025-03-31,21355807,517903,20837904,알바니아,2025-03
2025-03-31,20637338,7973284,12664054,도미니카 공화국,2025-03
2025-03-31,20122142,5618785,14503357,엘살바도르,2025-03
2025-03-31,19602159,200,19601959,타지크,2025-03
2025-03-31,18375788,3061,18372727,아제르바이잔,2025-03
2025-03-31,17760406,15769842,1990564,코스타리카,2025-03
2025-03-31,17218338,3593927,13624411,탄자니아,2025-03
2025-03-31,17030761,35631,16995130,시리아,2025-03
2025-03-31,16344826,20479769,-4134943,불가리아,2025-03
2025-03-31,15900122,17289429,-1389307,코트디봐르,2025-03
2025-03-31,15064305,5096936,9967369,케냐,2025-03
2025-03-31,14944949,9842470,5102479,스리랑카,2025-03
2025-03-31,13664998,13656379,8619,기타국,2025-03
2025-03-31,13051081,6468749,6582332,세르비아,2025-03
2025-03-31,11169704,1038295,10131409,조지아,2025-03
2025-03-31,10581380,11116764,-535384,우루과이,2025-03
2025-03-31,10524395,905516,9618879,크로아티아,2025-03
2025-03-31,10079919,8955600,1124319,튀니지,2025-03
2025-03-31,9959914,5786714,4173200,에티오피아,2025-03
2025-03-31,9704638,6598162,3106476,라오스,2025-03
2025-03-31,9679806,5864943,3814863,에스토니아,2025-03
2025-03-31,9481707,5761749,3719958,온두라스,2025-03
2025-03-31,8822605,1334764,7487841,아이슬란드,2025-03
2025-03-31,8155488,2417017,5738471,레바논,2025-03
2025-03-31,7819923,186348001,-178528078,모잠비크,2025-03
2025-03-31,7604000,78331293,-70727293,브루나이,2025-03
2025-03-31,6539276,3008641,3530635,세네갈,2025-03
2025-03-31,5744857,654145,5090712,사이프러스,2025-03
2025-03-31,5572890,2217316,3355574,몰도바,2025-03
2025-03-31,5458373,950155,4508218,벨라루스,2025-03
2025-03-31,5269136,2176379,3092757,예맨,2025-03
2025-03-31,5111301,31575477,-26464176,니카라과,2025-03
2025-03-31,4957553,49909977,-44952424,트리니다드 토바고,2025-03
2025-03-31,4882446,98088,4784358,아프카니스탄,2025-03
2025-03-31,4769674,8910730,-4141056,라트비아,2025-03
2025-03-31,4583133,1202,4581931,투르크멘,2025-03
2025-03-31,4443317,10046819,-5603502,룩셈부르그,2025-03
2025-03-31,4274316,16071538,-11797222,바레인,2025-03
2025-03-31,4045886,2786113,1259773,기니,2025-03
2025-03-31,3975035,35365366,-31390331,파푸아 뉴기니,2025-03
2025-03-31,3738542,76102,3662440,사모아,2025-03
2025-03-31,3616094,0,3616094,수단,2025-03
2025-03-31,3510088,370921,3139167,모리셔스,2025-03
2025-03-31,3422242,146531,3275711,가이아나,2025-03
2025-03-31,3381364,238053,3143311,자마이카,2025-03
2025-03-31,3240153,3949444,-709291,아르메니아,2025-03
2025-03-31,3211442,1571353,1640089,부르키나 파소,2025-03
2025-03-31,3180215,113512,3066703,르완다,2025-03
2025-03-31,3121738,13576,3108162,남수단,2025-03
2025-03-31,3008225,1162606,1845619,베네주엘라,2025-03
2025-03-31,2951488,812131,2139357,네팔,2025-03
2025-03-31,2759681,163906571,-161146890,콩고민주공화국,2025-03
2025-03-31,2488402,5015534,-2527132,마다카스카르,2025-03
2025-03-31,2303502,0,2303502,벨리제,2025-03
2025-03-31,2276188,4512255,-2236067,짐바브웨,2025-03
2025-03-31,2252651,153143,2099508,불령 폴리네시아,2025-03
2025-03-31,2239532,0,2239532,베닝,2025-03
2025-03-31,2237810,108438,2129372,카메룬,2025-03
2025-03-31,2237060,293154,1943906,토고,2025-03
2025-03-31,2070155,6787726,-4717571,볼리비아,2025-03
2025-03-31,2051233,27,2051206,불령 리유니온 코모도 제도,2025-03
2025-03-31,1952453,172679,1779774,가봉,2025-03
2025-03-31,1780796,870095,910701,쿠바,2025-03
2025-03-31,1577299,0,1577299,아루바,2025-03
2025-03-31,1575856,52,1575804,과델로프,2025-03
2025-03-31,1570271,32405395,-30835124,잠비아,2025-03
2025-03-31,1458782,35640,1423142,큐라소,2025-03
2025-03-31,1348706,633,1348073,버뮤다,2025-03
2025-03-31,1326920,696650,630270,지부티,2025-03
2025-03-31,1269104,2606310,-1337206,우간다,2025-03
2025-03-31,1242011,309,1241702,몰디브,2025-03
2025-03-31,1226053,246629,979424,팔레스타인 해방기구,2025-03
2025-03-31,1203958,19798,1184160,바베이도스,2025-03
2025-03-31,1135237,77981,1057256,세이쉘,2025-03
2025-03-31,1044169,0,1044169,세인트 마틴,2025-03
2025-03-31,1024134,205831,818303,몬테네그로,2025-03
2025-03-31,1007830,1735,1006095,아이티,2025-03
2025-03-31,984823,52463,932360,키리바티,2025-03
2025-03-31,917179,397,916782,말리,2025-03
2025-03-31,878415,58068,820347,북마리아나 군도,2025-03
2025-03-31,866764,646045,220719,콩고,2025-03
2025-03-31,807411,630891,176520,마세도니아,2025-03
2025-03-31,790662,223630,567032,아메리칸 사모아,2025-03
2025-03-31,737853,1892412,-1154559,리히텐슈타인,2025-03
2025-03-31,677288,890528,-213240,보스니아-헤르체고비나,2025-03
2025-03-31,651754,1694787,-1043033,바누아투,2025-03
2025-03-31,625744,1263117,-637373,시에라 리온,2025-03
2025-03-31,616589,3500,613089,영령 캐이맨 군도,2025-03
2025-03-31,599211,235583,363628,마카오,2025-03
2025-03-31,574622,0,574622,마티니크,2025-03
2025-03-31,541701,16743407,-16201706,뉴 칼레도니아,2025-03
2025-03-31,527202,1382649,-855447,모리타니,2025-03
2025-03-31,513983,0,513983,투발루,2025-03
2025-03-31,491739,0,491739,안티가 바부다,2025-03
2025-03-31,472675,0,472675,불령 가이아나,2025-03
2025-03-31,390053,338892,51161,수리남,2025-03
2025-03-31,379399,291953,87446,부탄,2025-03
2025-03-31,333797,220936,112861,소말리아,2025-03
2025-03-31,330791,43667,287124,팔라우,2025-03
2025-03-31,317123,0,317123,세인트 루시아,2025-03
2025-03-31,308930,0,308930,그레나다,2025-03
2025-03-31,285816,298914,-13098,솔로몬 군도,2025-03
2025-03-31,230159,58,230101,지브랄타,2025-03
2025-03-31,222935,0,222935,영령 버진군도,2025-03
2025-03-31,217264,284659,-67395,마이크로네시아,2025-03
2025-03-31,169541,359644,-190103,감비아,2025-03
2025-03-31,149023,1214,147809,세인트 빈센트 그레나딘,2025-03
2025-03-31,135510,45795,89715,적도 기니,2025-03
2025-03-31,128222,2844,125378,티모르,2025-03
2025-03-31,117922,61461,56461,스와질랜드,2025-03
2025-03-31,114261,59737,54524,나미비아,2025-03
2025-03-31,100174,53,100121,부룬디,2025-03
2025-03-31,94252,0,94252,투르크 & 카이코스 군도,2025-03
2025-03-31,78204,0,78204,도미니카,2025-03
2025-03-31,72359,0,72359,카보 베르데,2025-03
2025-03-31,48884,114352,-65468,보츠와나,2025-03
2025-03-31,42317,446031,-403714,모나코,2025-03
2025-03-31,40279,1898,38381,세인트 키츠 네비스,2025-03
2025-03-31,34218,10321982,-10287764,말라위,2025-03
2025-03-31,25448,0,25448,메요트,2025-03
2025-03-31,25000,0,25000,앙귈라,2025-03
2025-03-31,22660,663,21997,코스 군도,2025-03
2025-03-31,19577,19643,-66,네덜란드 열도,2025-03
2025-03-31,17000,42134,-25134,산마리노,2025-03
2025-03-31,13467,0,13467,왈라스 & 퓨투나 군도,2025-03
2025-03-31,7345,0,7345,세인트마틴(생마르탱),2025-03
2025-03-31,7104,0,7104,세인트 바르탤르미,2025-03
2025-03-31,5956,435,5521,미령 버진군도,2025-03
2025-03-31,5395,0,5395,챠드,2025-03
2025-03-31,5178,0,5178,코모로스,2025-03
2025-03-31,4323,186573,-182250,그린랜드,2025-03
2025-03-31,1862,0,1862,교황청,2025-03
2025-03-31,1107,698,409,안도라,2025-03
2025-03-31,345,0,345,건지,2025-03
2025-03-31,305,0,305,포클랜드 군도,2025-03
2025-03-31,252,0,252,저어지,2025-03
2025-03-31,87,0,87,중앙아프리카공화국,2025-03
2025-03-31,50,53194,-53144,니제르,2025-03
2025-03-31,27,753,-726,몬트세라트,2025-03
2025-03-31,8,0,8,기네비소,2025-03
2025-03-31,0,1268,-1268,파로에 군도,2025-03
2025-03-31,0,314,-314,쿡 아일랜드,2025-03
2025-03-31,0,797,-797,불령 남부지역,2025-03
2025-03-31,0,7,-7,안타티카,2025-03
2025-03-31,0,83,-83,상토메 프린스페,2025-03
2025-03-31,0,294,-294,크리스마스 아일랜드,2025-03
2025-03-31,0,101198,-101198,니우에,2025-03
2025-03-31,0,3695,-3695,레소토,2025-03
2025-03-31,0,15477,-15477,토켈라우,2025-03
2025-04-30,10878157796,12502367789,-1624209993,중국,2025-04
2025-04-30,10603220336,6145398568,4457821768,미국,2025-04
2025-04-30,4838642832,2494314301,2344328531,베트남,2025-04
2025-04-30,3301295237,2317861228,983434009,대만,2025-04
2025-04-30,2518043461,201408393,2316635068,홍콩,2025-04
2025-04-30,2305494938,4478617231,-2173122293,일본,2025-04
2025-04-30,1703547862,504494774,1199053088,인도,2025-04
2025-04-30,1466658116,980351905,486306211,싱가포르,2025-04
2025-04-30,1313736925,2768357553,-1454620628,호주,2025-04
2025-04-30,1044136463,600067250,444069213,멕시코,2025-04
2025-04-30,957599351,73490196,884109155,폴란드,2025-04
2025-04-30,942858981,1708409472,-765550491,독일,2025-04
2025-04-30,890746455,515501218,375245237,캐나다,2025-04
2025-04-30,872122002,1308470952,-436348950,말레이시아,2025-04
2025-04-30,855248921,127342989,727905932,튀르키예,2025-04
2025-04-30,828183462,548634008,279549454,네덜란드,2025-04
2025-04-30,736393461,335709928,400683533,필리핀,2025-04
2025-04-30,708092797,878707564,-170614767,인도네시아,2025-04
2025-04-30,696101543,661497457,34604086,태국,2025-04
2025-04-30,653666143,698049317,-44383174,브라질,2025-04
2025-04-30,583203165,521892619,61310546,영국,2025-04
2025-04-30,494059655,929989521,-435929866,아랍에미리트 연합,2025-04
2025-04-30,448450389,120001097,328449292,벨기에,2025-04
2025-04-30,447711164,736041781,-288330617,프랑스,2025-04
2025-04-30,420075261,543674406,-123599145,이탈리아,2025-04
2025-04-30,416240461,8043019,408197442,몰타,2025-04
2025-04-30,387199815,186331192,200868623,스페인,2025-04
2025-04-30,372355089,2117188125,-1744833036,사우디아라비아,2025-04
2025-04-30,367115990,69144245,297971745,헝가리,2025-04
2025-04-30,360329059,621267060,-260938001,러시아 연방,2025-04
2025-04-30,340877482,131704110,209173372,체코공화국,2025-04
2025-04-30,286325063,55509,286269554,키르기스스탄,2025-04
2025-04-30,271672450,97628710,174043740,슬로바키아,2025-04
2025-04-30,256011889,99880631,156131258,카자흐스탄,2025-04
2025-04-30,238030586,203695933,34334653,뉴질랜드,2025-04
2025-04-30,211356245,782,211355463,버뮤다,2025-04
2025-04-30,193283188,147772612,45510576,이스라엘,2025-04
2025-04-30,187459559,13439,187446120,라이베리아,2025-04
2025-04-30,180049604,159124,179890480,마샬군도,2025-04
2025-04-30,142654700,2675897,139978803,우즈베키스탄,2025-04
2025-04-30,136729464,540259163,-403529699,칠레,2025-04
2025-04-30,134104306,141812835,-7708529,스웨덴,2025-04
2025-04-30,121222569,52950715,68271854,방글라데시,2025-04
2025-04-30,120804822,156708472,-35903650,아일랜드,2025-04
2025-04-30,115624896,27315029,88309867,파키스탄,2025-04
2025-04-30,110522587,285892056,-175369469,스위스,2025-04
2025-04-30,110208301,130975376,-20767075,오스트리아,2025-04
2025-04-30,109581210,39880197,69701013,콜롬비아,2025-04
2025-04-30,102604102,13174812,89429290,슬로베니아,2025-04
2025-04-30,102470936,11992786,90478150,이집트,2025-04
2025-04-30,100068467,916565489,-816497022,이라크,2025-04
2025-04-30,96860488,646878,96213610,괌,2025-04
2025-04-30,79949129,83959821,-4010692,파나마,2025-04
2025-04-30,75951472,28530932,47420540,포루투갈,2025-04
2025-04-30,72995610,213804917,-140809307,남아프리카공화국,2025-04
2025-04-30,71483378,37583614,33899764,루마니아,2025-04
2025-04-30,71187599,1973829,69213770,요르단,2025-04
2025-04-30,66084123,939972013,-873887890,카타르,2025-04
2025-04-30,63204245,132350976,-69146731,덴마크,2025-04
2025-04-30,61767066,79786,61687280,르완다,2025-04
2025-04-30,61336665,343255102,-281918437,페루,2025-04
2025-04-30,58701225,40658520,18042705,캄보디아,2025-04
2025-04-30,57089889,602168791,-545078902,쿠웨이트,2025-04
2025-04-30,54892496,1350692,53541804,몽골,2025-04
2025-04-30,53696082,30503606,23192476,그리스,2025-04
2025-04-30,52032563,229342614,-177310051,알제리,2025-04
2025-04-30,48735359,49677403,-942044,우크라이나,2025-04
2025-04-30,44790938,40072244,4718694,나이지리아,2025-04
2025-04-30,44561745,195354489,-150792744,노르웨이,2025-04
2025-04-30,39953550,19577692,20375858,리비아,2025-04
2025-04-30,39813397,8033937,31779460,리투아니아,2025-04
2025-04-30,34905533,24434421,10471112,푸에르토리코,2025-04
2025-04-30,34697057,24194937,10502120,모로코,2025-04
2025-04-30,34417913,7240623,27177290,도미니카 공화국,2025-04
2025-04-30,34018167,359574290,-325556123,오만,2025-04
2025-04-30,33540016,63447510,-29907494,아르헨티나,2025-04
2025-04-30,32936088,57396179,-24460091,에쿠아도르,2025-04
2025-04-30,31329430,1007899,30321531,알바니아,2025-04
2025-04-30,28315390,17774006,10541384,가나,2025-04
2025-04-30,28000134,45935258,-17935124,미얀마,2025-04
2025-04-30,27825780,96885416,-69059636,핀란드,2025-04
2025-04-30,27476524,11029905,16446619,과테말라,2025-04
2025-04-30,26688950,14268432,12420518,코스타리카,2025-04
2025-04-30,22107968,4875,22103093,타지크,2025-04
2025-04-30,21357754,10045630,11312124,엘살바도르,2025-04
2025-04-30,18557386,10252644,8304742,스리랑카,2025-04
2025-04-30,17984845,15983664,2001181,불가리아,2025-04
2025-04-30,17763820,140193,17623627,아제르바이잔,2025-04
2025-04-30,16780330,12470,16767860,시리아,2025-04
2025-04-30,16224169,5371511,10852658,세르비아,2025-04
2025-04-30,15317767,5206534,10111233,케냐,2025-04
2025-04-30,14934247,2089707,12844540,세네갈,2025-04
2025-04-30,14743654,25320904,-10577250,바레인,2025-04
2025-04-30,13883367,14210344,-326977,에티오피아,2025-04
2025-04-30,13688767,16953929,-3265162,온두라스,2025-04
2025-04-30,13637852,17167689,-3529837,코트디봐르,2025-04
2025-04-30,13088267,7610028,5478239,탄자니아,2025-04
2025-04-30,12280712,14567922,-2287210,우루과이,2025-04
2025-04-30,11825669,977459,10848210,조지아,2025-04
2025-04-30,11482893,73645641,-62162748,모잠비크,2025-04
2025-04-30,10777758,2109858,8667900,레바논,2025-04
2025-04-30,10529589,8398410,2131179,튀니지,2025-04
2025-04-30,10506153,7452999,3053154,에스토니아,2025-04
2025-04-30,10480889,2062010,8418879,크로아티아,2025-04
2025-04-30,10268480,6247930,4020550,라오스,2025-04
2025-04-30,10065060,0,10065060,앙골라,2025-04
2025-04-30,9868351,450748,9417603,파라과이,2025-04
2025-04-30,8315480,119434,8196046,이란,2025-04
2025-04-30,7169727,313102,6856625,사이프러스,2025-04
2025-04-30,6954204,3373247,3580957,니카라과,2025-04
2025-04-30,6317502,6745363,-427861,라트비아,2025-04
2025-04-30,6220461,8002384,-1781923,마다카스카르,2025-04
2025-04-30,5398921,3071091,2327830,몰도바,2025-04
2025-04-30,5302968,116849,5186119,북마리아나 군도,2025-04
2025-04-30,5298640,218925686,-213627046,파푸아 뉴기니,2025-04
2025-04-30,5217679,33776625,-28558946,트리니다드 토바고,2025-04
2025-04-30,5104335,485706,4618629,나미비아,2025-04
2025-04-30,5096975,431182,4665793,모리셔스,2025-04
2025-04-30,5031239,1478560,3552679,모리타니,2025-04
2025-04-30,4996898,11497493,-6500595,룩셈부르그,2025-04
2025-04-30,4611201,13948,4597253,브루나이,2025-04
2025-04-30,4591564,2094067,2497497,벨라루스,2025-04
2025-04-30,4525597,19,4525578,사모아,2025-04
2025-04-30,4379700,1276947,3102753,아이슬란드,2025-04
2025-04-30,4330633,388200,3942433,팔레스타인 해방기구,2025-04
2025-04-30,4129297,229060,3900237,아프카니스탄,2025-04
2025-04-30,4031201,29,4031172,수단,2025-04
2025-04-30,3982288,8974,3973314,부르키나 파소,2025-04
2025-04-30,3972953,43302,3929651,팔라우,2025-04
2025-04-30,3877717,61271163,-57393446,볼리비아,2025-04
2025-04-30,3873716,17392008,-13518292,기타국,2025-04
2025-04-30,3802850,23,3802827,투르크멘,2025-04
2025-04-30,3740001,2906514,833487,예맨,2025-04
2025-04-30,3708138,47107,3661031,가이아나,2025-04
2025-04-30,3532060,2936095,595965,기니,2025-04
2025-04-30,3496264,683684,2812580,지부티,2025-04
2025-04-30,3376814,88975,3287839,베네주엘라,2025-04
2025-04-30,2901845,237843,2664002,피지,2025-04
2025-04-30,2865221,0,2865221,베닝,2025-04
2025-04-30,2546970,2822315,-275345,아르메니아,2025-04
2025-04-30,2540118,3611407,-1071289,짐바브웨,2025-04
2025-04-30,2467633,0,2467633,불령 리유니온 코모도 제도,2025-04
2025-04-30,2392820,0,2392820,벨리제,2025-04
2025-04-30,2310822,116592,2194230,자마이카,2025-04
2025-04-30,2281617,403745,1877872,네팔,2025-04
2025-04-30,2253478,193343,2060135,쿠바,2025-04
2025-04-30,2075595,6632434,-4556839,잠비아,2025-04
2025-04-30,1888080,10268,1877812,몬테네그로,2025-04
2025-04-30,1774358,468039,1306319,가봉,2025-04
2025-04-30,1769298,703472,1065826,우간다,2025-04
2025-04-30,1534375,3048,1531327,카메룬,2025-04
2025-04-30,1513692,0,1513692,아루바,2025-04
2025-04-30,1439490,1170,1438320,바하마,2025-04
2025-04-30,1391999,1226802,165197,키리바티,2025-04
2025-04-30,1365974,693967,672007,시에라 리온,2025-04
2025-04-30,1336278,14651,1321627,불령 폴리네시아,2025-04
2025-04-30,1314582,177052,1137530,마카오,2025-04
2025-04-30,1271014,254485,1016529,소말리아,2025-04
2025-04-30,1219207,5616,1213591,아이티,2025-04
2025-04-30,1144567,2365127,-1220560,솔로몬 군도,2025-04
2025-04-30,1129190,24711,1104479,콩고,2025-04
2025-04-30,1128202,144389,983813,토고,2025-04
2025-04-30,1103127,271,1102856,과델로프,2025-04
2025-04-30,1081752,537392,544360,바누아투,2025-04
2025-04-30,1057867,1040529,17338,보스니아-헤르체고비나,2025-04
2025-04-30,1050804,0,1050804,세인트 마틴,2025-04
2025-04-30,1014752,126177,888575,말리,2025-04
2025-04-30,996921,0,996921,큐라소,2025-04
2025-04-30,973779,7993377,-7019598,뉴 칼레도니아,2025-04
2025-04-30,966901,259702,707199,아메리칸 사모아,2025-04
2025-04-30,959935,1785302,-825367,리히텐슈타인,2025-04
2025-04-30,864790,0,864790,마티니크,2025-04
2025-04-30,854848,113938222,-113083374,콩고민주공화국,2025-04
2025-04-30,810767,458676,352091,마세도니아,2025-04
2025-04-30,802292,266779,535513,세이쉘,2025-04
2025-04-30,792990,86300,706690,니제르,2025-04
2025-04-30,781928,579569,202359,부탄,2025-04
2025-04-30,749461,95852438,-95102977,적도 기니,2025-04
2025-04-30,740843,297,740546,카보 베르데,2025-04
2025-04-30,642406,616,641790,몰디브,2025-04
2025-04-30,599400,49981,549419,기네비소,2025-04
2025-04-30,556432,0,556432,안티가 바부다,2025-04
2025-04-30,527392,17188,510204,마이크로네시아,2025-04
2025-04-30,496821,157879,338942,바베이도스,2025-04
2025-04-30,396739,0,396739,챠드,2025-04
2025-04-30,370943,0,370943,불령 가이아나,2025-04
2025-04-30,349109,0,349109,세인트 빈센트 그레나딘,2025-04
2025-04-30,326170,0,326170,남수단,2025-04
2025-04-30,310809,0,310809,영령 버진군도,2025-04
2025-04-30,298362,755201,-456839,수리남,2025-04
2025-04-30,290195,2318,287877,영령 캐이맨 군도,2025-04
2025-04-30,280091,1831181,-1551090,말라위,2025-04
2025-04-30,270607,125,270482,투발루,2025-04
2025-04-30,234814,0,234814,앙귈라,2025-04
2025-04-30,193129,17074,176055,티모르,2025-04
2025-04-30,181539,924391,-742852,감비아,2025-04
2025-04-30,160607,29240,131367,보츠와나,2025-04
2025-04-30,147905,81,147824,세인트 루시아,2025-04
2025-04-30,138290,0,138290,투르크 & 카이코스 군도,2025-04
2025-04-30,82943,0,82943,그레나다,2025-04
2025-04-30,71040,540,70500,세인트 키츠 네비스,2025-04
2025-04-30,53390,4770,48620,부룬디,2025-04
2025-04-30,50980,190415,-139435,스와질랜드,2025-04
2025-04-30,37327,160450,-123123,도미니카,2025-04
2025-04-30,35588,0,35588,네덜란드 열도,2025-04
2025-04-30,30274,533,29741,에리트리아,2025-04
2025-04-30,29430,421232,-391802,산마리노,2025-04
2025-04-30,25290,14609,10681,통가,2025-04
2025-04-30,20216,4838074,-4817858,나우루,2025-04
2025-04-30,13512,14,13498,미령 버진군도,2025-04
2025-04-30,13088,0,13088,세인트마틴(생마르탱),2025-04
2025-04-30,11620,293709,-282089,그린랜드,2025-04
2025-04-30,6465,0,6465,코모로스,2025-04
2025-04-30,6203,108,6095,파로에 군도,2025-04
2025-04-30,5384,1149,4235,안도라,2025-04
2025-04-30,2386,0,2386,상토메 프린스페,2025-04
2025-04-30,2283,264,2019,지브랄타,2025-04
2025-04-30,969,392,577,교황청,2025-04
2025-04-30,875,82,793,중앙아프리카공화국,2025-04
2025-04-30,592,0,592,건지,2025-04
2025-04-30,134,0,134,저어지,2025-04
2025-04-30,78,50906,-50828,모나코,2025-04
2025-04-30,0,3138,-3138,코스 군도,2025-04
2025-04-30,0,13944,-13944,토켈라우,2025-04
2025-04-30,0,191,-191,허드 앤 맥도날드 군도,2025-04
2025-04-30,0,486859,-486859,안타티카,2025-04
2025-04-30,0,13300,-13300,세인트 헬레나,2025-04
2025-04-30,0,21443,-21443,니우에,2025-04
2025-04-30,0,31,-31,쿡 아일랜드,2025-04
2025-04-30,0,9390,-9390,세인트 바르탤르미,2025-04
2025-04-30,0,9722,-9722,마이너 아우틀링 합중국 군도,2025-04
2025-04-30,0,2774,-2774,불령 남부지역,2025-04
2025-04-30,0,13,-13,크리스마스 아일랜드,2025-04
2025-04-30,0,42343,-42343,맨섬,2025-04
2025-04-30,0,10265,-10265,레소토,2025-04
2025-05-31,10423215375,11342436436,-919221061,중국,2025-05
2025-05-31,10046557209,6767900185,3278657024,미국,2025-05
2025-05-31,5240352747,2363446507,2876906240,베트남,2025-05
2025-05-31,3765450102,2433163916,1332286186,대만,2025-05
2025-05-31,2854116875,121471331,2732645544,홍콩,2025-05
2025-05-31,2372318862,3557016712,-1184697850,일본,2025-05
2025-05-31,1616493882,628228181,988265701,인도,2025-05
2025-05-31,1580007718,864028589,715979129,싱가포르,2025-05
2025-05-31,1134121493,2470488825,-1336367332,호주,2025-05
2025-05-31,1072323041,1974910933,-902587892,독일,2025-05
2025-05-31,1069183753,702733674,366450079,멕시코,2025-05
2025-05-31,1026199150,1103650141,-77450991,말레이시아,2025-05
2025-05-31,964622911,547249858,417373053,캐나다,2025-05
2025-05-31,864099901,277639157,586460744,필리핀,2025-05
2025-05-31,837419358,633609418,203809940,네덜란드,2025-05
2025-05-31,682438342,144835005,537603337,튀르키예,2025-05
2025-05-31,654942779,82052853,572889926,폴란드,2025-05
2025-05-31,637087536,565499810,71587726,태국,2025-05
2025-05-31,606869333,341275561,265593772,영국,2025-05
2025-05-31,566977727,860630936,-293653209,인도네시아,2025-05
2025-05-31,498700267,603788549,-105088282,프랑스,2025-05
2025-05-31,411721139,790820357,-379099218,아랍에미리트 연합,2025-05
2025-05-31,406212368,534960030,-128747662,브라질,2025-05
2025-05-31,396522129,578756558,-182234429,이탈리아,2025-05
2025-05-31,392226519,8446,392218073,라이베리아,2025-05
2025-05-31,389978591,54184081,335794510,헝가리,2025-05
2025-05-31,377579911,510781265,-133201354,러시아 연방,2025-05
2025-05-31,312148307,93030616,219117691,벨기에,2025-05
2025-05-31,293234767,2040605456,-1747370689,사우디아라비아,2025-05
2025-05-31,278003840,85065,277918775,마샬군도,2025-05
2025-05-31,272515457,319792672,-47277215,카자흐스탄,2025-05
2025-05-31,265660117,225348340,40311777,스페인,2025-05
2025-05-31,264682750,78194,264604556,키르기스스탄,2025-05
2025-05-31,252867688,99358532,153509156,덴마크,2025-05
2025-05-31,252324482,191043140,61281342,뉴질랜드,2025-05
2025-05-31,243591810,78526911,165064899,슬로바키아,2025-05
2025-05-31,231886132,97093287,134792845,체코공화국,2025-05
2025-05-31,194392526,1604363,192788163,파나마,2025-05
2025-05-31,163719600,339446557,-175726957,스위스,2025-05
2025-05-31,145343872,1164368,144179504,몽골,2025-05
2025-05-31,143881892,30254856,113627036,방글라데시,2025-05
2025-05-31,141261733,149137119,-7875386,이스라엘,2025-05
2025-05-31,139366012,7871709,131494303,그리스,2025-05
2025-05-31,138308194,8118545,130189649,몰타,2025-05
2025-05-31,129090670,95359345,33731325,콜롬비아,2025-05
2025-05-31,122736384,1048675,121687709,우즈베키스탄,2025-05
2025-05-31,107693031,357055326,-249362295,칠레,2025-05
2025-05-31,100419695,168505783,-68086088,스웨덴,2025-05
2025-05-31,98079966,807184139,-709104173,이라크,2025-05
2025-05-31,93652175,12918056,80734119,파키스탄,2025-05
2025-05-31,91351912,150383851,-59031939,오스트리아,2025-05
2025-05-31,88642032,12106727,76535305,슬로베니아,2025-05
2025-05-31,87574207,4849034,82725173,이집트,2025-05
2025-05-31,86919116,140565799,-53646683,아일랜드,2025-05
2025-05-31,61925617,26726148,35199469,포루투갈,2025-05
2025-05-31,58353480,121254,58232226,르완다,2025-05
2025-05-31,57183142,118427256,-61244114,노르웨이,2025-05
2025-05-31,56563353,14172953,42390400,우크라이나,2025-05
2025-05-31,56231544,129693161,-73461617,남아프리카공화국,2025-05
2025-05-31,52914396,37356742,15557654,루마니아,2025-05
2025-05-31,50624687,104719654,-54094967,오만,2025-05
2025-05-31,49757319,32370896,17386423,캄보디아,2025-05
2025-05-31,49139269,178394939,-129255670,페루,2025-05
2025-05-31,48376147,806842044,-758465897,쿠웨이트,2025-05
2025-05-31,45325702,39651996,5673706,아르헨티나,2025-05
2025-05-31,43313792,7667944,35645848,요르단,2025-05
2025-05-31,41662308,47394330,-5732022,나이지리아,2025-05
2025-05-31,40968790,113139464,-72170674,핀란드,2025-05
2025-05-31,40115032,1772886,38342146,리비아,2025-05
2025-05-31,36982784,21521455,15461329,모로코,2025-05
2025-05-31,32914716,28048728,4865988,푸에르토리코,2025-05
2025-05-31,32126178,336551,31789627,알바니아,2025-05
2025-05-31,30764875,7944267,22820608,리투아니아,2025-05
2025-05-31,28734736,18780961,9953775,미얀마,2025-05
2025-05-31,28108495,855457271,-827348776,카타르,2025-05
2025-05-31,25407236,8258986,17148250,에쿠아도르,2025-05
2025-05-31,24512699,305280,24207419,피지,2025-05
2025-05-31,23798671,454032194,-430233523,알제리,2025-05
2025-05-31,23301398,20861312,2440086,코스타리카,2025-05
2025-05-31,21948923,4331106,17617817,케냐,2025-05
2025-05-31,21252788,4836946,16415842,엘살바도르,2025-05
2025-05-31,20648665,18602283,2046382,불가리아,2025-05
2025-05-31,19863529,55655,19807874,타지크,2025-05
2025-05-31,18798474,0,18798474,시리아,2025-05
2025-05-31,17495597,15924982,1570615,과테말라,2025-05
2025-05-31,17168712,8410829,8757883,도미니카 공화국,2025-05
2025-05-31,16971275,26228941,-9257666,코트디봐르,2025-05
2025-05-31,16087071,6515775,9571296,튀니지,2025-05
2025-05-31,15812739,3240289,12572450,탄자니아,2025-05
2025-05-31,15397628,148266,15249362,아제르바이잔,2025-05
2025-05-31,15027629,9394065,5633564,세르비아,2025-05
2025-05-31,14198675,8335961,5862714,스리랑카,2025-05
2025-05-31,13791712,234195,13557517,이란,2025-05
2025-05-31,13775507,10583551,3191956,가나,2025-05
2025-05-31,13700588,1572630,12127958,크로아티아,2025-05
2025-05-31,13243842,367769,12876073,괌,2025-05
2025-05-31,13178854,1687677,11491177,기니,2025-05
2025-05-31,13042973,1740171,11302802,세네갈,2025-05
2025-05-31,12522966,7435138,5087828,에스토니아,2025-05
2025-05-31,12402228,706800,11695428,지부티,2025-05
2025-05-31,12222422,12469843,-247421,우루과이,2025-05
2025-05-31,11788662,9395434,2393228,온두라스,2025-05
2025-05-31,11151066,506261,10644805,조지아,2025-05
2025-05-31,9229356,7643047,1586309,라오스,2025-05
2025-05-31,9134356,1708309,7426047,레바논,2025-05
2025-05-31,8329628,12237240,-3907612,에티오피아,2025-05
2025-05-31,8089526,599239,7490287,파라과이,2025-05
2025-05-31,7785139,34,7785105,수단,2025-05
2025-05-31,7465934,5819700,1646234,기타국,2025-05
2025-05-31,6843633,42201185,-35357552,모잠비크,2025-05
2025-05-31,6768776,30591904,-23823128,트리니다드 토바고,2025-05
2025-05-31,6189542,2727995,3461547,벨라루스,2025-05
2025-05-31,5826267,20053116,-14226849,니카라과,2025-05
2025-05-31,5249061,10816719,-5567658,룩셈부르그,2025-05
2025-05-31,5129209,300,5128909,앙골라,2025-05
2025-05-31,5038587,2749630,2288957,몰도바,2025-05
2025-05-31,4523293,17730,4505563,사모아,2025-05
2025-05-31,4200110,375090,3825020,콩고,2025-05
2025-05-31,4099467,143465,3956002,아프카니스탄,2025-05
2025-05-31,4090395,257612,3832783,사이프러스,2025-05
2025-05-31,3976518,268,3976250,벨리제,2025-05
2025-05-31,3904012,114603101,-110699089,파푸아 뉴기니,2025-05
2025-05-31,3837891,9501496,-5663605,라트비아,2025-05
2025-05-31,3741552,114961110,-111219558,브루나이,2025-05
2025-05-31,3588659,2108740,1479919,예맨,2025-05
2025-05-31,3568045,0,3568045,베닝,2025-05
2025-05-31,3510534,1575,3508959,가이아나,2025-05
2025-05-31,3455235,100782753,-97327518,바레인,2025-05
2025-05-31,3447268,90721,3356547,팔레스타인 해방기구,2025-05
2025-05-31,3433732,0,3433732,불령 리유니온 코모도 제도,2025-05
2025-05-31,3295787,97806,3197981,모리셔스,2025-05
2025-05-31,3241887,70378394,-67136507,볼리비아,2025-05
2025-05-31,3136897,578173,2558724,우간다,2025-05
2025-05-31,2968255,611687,2356568,네팔,2025-05
2025-05-31,2787436,419276,2368160,토고,2025-05
2025-05-31,2554853,7860543,-5305690,마다카스카르,2025-05
2025-05-31,2511012,17,2510995,투르크멘,2025-05
2025-05-31,2312597,4882492,-2569895,자마이카,2025-05
2025-05-31,2309745,487380,1822365,베네주엘라,2025-05
2025-05-31,2282847,652479,1630368,짐바브웨,2025-05
2025-05-31,2234737,1463725,771012,부르키나 파소,2025-05
2025-05-31,1997552,5670624,-3673072,아르메니아,2025-05
2025-05-31,1704501,112000956,-110296455,콩고민주공화국,2025-05
2025-05-31,1610997,71001170,-69390173,가봉,2025-05
2025-05-31,1602901,127249,1475652,마카오,2025-05
2025-05-31,1570536,12331,1558205,아루바,2025-05
2025-05-31,1464504,94559,1369945,아이티,2025-05
2025-05-31,1306467,10405641,-9099174,잠비아,2025-05
2025-05-31,1205420,17117262,-15911842,뉴 칼레도니아,2025-05
2025-05-31,1157688,1538674,-380986,아이슬란드,2025-05
2025-05-31,1150661,1173,1149488,몬테네그로,2025-05
2025-05-31,1142108,0,1142108,챠드,2025-05
2025-05-31,1112816,740745,372071,모리타니,2025-05
2025-05-31,1074722,3779206,-2704484,보스니아-헤르체고비나,2025-05
2025-05-31,1037667,353764,683903,큐라소,2025-05
2025-05-31,1011307,0,1011307,마티니크,2025-05
2025-05-31,959461,3569,955892,바하마,2025-05
2025-05-31,942923,20290,922633,바베이도스,2025-05
2025-05-31,878607,1667,876940,투발루,2025-05
2025-05-31,866821,556041,310780,마세도니아,2025-05
2025-05-31,866109,80301,785808,북마리아나 군도,2025-05
2025-05-31,865761,965046,-99285,쿠바,2025-05
2025-05-31,825328,288221,537107,세이쉘,2025-05
2025-05-31,810186,73578,736608,마이크로네시아,2025-05
2025-05-31,793937,597672,196265,부탄,2025-05
2025-05-31,792217,185247,606970,불령 폴리네시아,2025-05
2025-05-31,777606,18368,759238,적도 기니,2025-05
2025-05-31,768863,0,768863,과델로프,2025-05
2025-05-31,759253,116,759137,몰디브,2025-05
2025-05-31,715880,123655,592225,카메룬,2025-05
2025-05-31,663800,1330,662470,키리바티,2025-05
2025-05-31,642779,1899041,-1256262,리히텐슈타인,2025-05
2025-05-31,622120,78288,543832,아메리칸 사모아,2025-05
2025-05-31,619143,3555658,-2936515,바누아투,2025-05
2025-05-31,568335,0,568335,세인트 마틴,2025-05
2025-05-31,549454,1350,548104,영령 캐이맨 군도,2025-05
2025-05-31,539374,2176,537198,버뮤다,2025-05
2025-05-31,533832,0,533832,메요트,2025-05
2025-05-31,512665,67777,444888,남수단,2025-05
2025-05-31,480255,145962,334293,솔로몬 군도,2025-05
2025-05-31,369400,0,369400,투르크 & 카이코스 군도,2025-05
2025-05-31,351898,72443,279455,나미비아,2025-05
2025-05-31,295838,0,295838,영령 버진군도,2025-05
2025-05-31,277099,708519,-431420,시에라 리온,2025-05
2025-05-31,247665,523,247142,중앙아프리카공화국,2025-05
2025-05-31,230668,1627460,-1396792,감비아,2025-05
2025-05-31,227599,0,227599,티모르,2025-05
2025-05-31,223116,0,223116,세인트 루시아,2025-05
2025-05-31,207356,47291,160065,팔라우,2025-05
2025-05-31,183767,5,183762,카보 베르데,2025-05
2025-05-31,183491,519456,-335965,도미니카,2025-05
2025-05-31,180617,702931,-522314,수리남,2025-05
2025-05-31,179434,0,179434,지브랄타,2025-05
2025-05-31,175427,0,175427,그레나다,2025-05
2025-05-31,167202,295322,-128120,모나코,2025-05
2025-05-31,159197,3192540,-3033343,스와질랜드,2025-05
2025-05-31,146377,302144,-155767,소말리아,2025-05
2025-05-31,102365,44126,58239,안티가 바부다,2025-05
2025-05-31,97496,443315,-345819,말라위,2025-05
2025-05-31,80748,47,80701,네덜란드 열도,2025-05
2025-05-31,72022,0,72022,세인트 빈센트 그레나딘,2025-05
2025-05-31,64000,0,64000,에리트리아,2025-05
2025-05-31,59248,2557,56691,니제르,2025-05
2025-05-31,59079,0,59079,불령 가이아나,2025-05
2025-05-31,54651,126666,-72015,말리,2025-05
2025-05-31,29445,759,28686,부룬디,2025-05
2025-05-31,23400,417739,-394339,산마리노,2025-05
2025-05-31,21953,269,21684,토켈라우,2025-05
2025-05-31,21473,0,21473,세인트마틴(생마르탱),2025-05
2025-05-31,18502,528,17974,레소토,2025-05
2025-05-31,17070,0,17070,상토메 프린스페,2025-05
2025-05-31,14486,4228,10258,세인트 바르탤르미,2025-05
2025-05-31,11916,52164,-40248,보츠와나,2025-05
2025-05-31,9178,0,9178,코모로스,2025-05
2025-05-31,6793,6033,760,안도라,2025-05
2025-05-31,5860,44210,-38350,기네비소,2025-05
2025-05-31,5402,1460,3942,세인트 키츠 네비스,2025-05
2025-05-31,4291,0,4291,건지,2025-05
2025-05-31,3592,48,3544,미령 버진군도,2025-05
2025-05-31,3522,262668,-259146,그린랜드,2025-05
2025-05-31,1711,0,1711,교황청,2025-05
2025-05-31,1500,0,1500,앙귈라,2025-05
2025-05-31,169,0,169,저어지,2025-05
2025-05-31,56,0,56,파로에 군도,2025-05
2025-05-31,0,322,-322,코스 군도,2025-05
2025-05-31,0,36,-36,쿡 아일랜드,2025-05
2025-05-31,0,2237,-2237,해외교포,2025-05
2025-05-31,0,64308,-64308,크리스마스 아일랜드,2025-05
2025-05-31,0,220,-220,포클랜드 군도,2025-05
2025-05-31,0,85,-85,마이너 아우틀링 합중국 군도,2025-05
2025-05-31,0,49652,-49652,세인트 헬레나,2025-05
2025-05-31,0,47,-47,스발비드 군도,2025-05
2025-05-31,0,14735,-14735,통가,2025-05
2025-05-31,0,275,-275,불령 남부지역,2025-05
2025-05-31,0,1941,-1941,남조지아 & 남샌드위치 군도,2025-05
2025-05-31,0,452,-452,국제통화기금,2025-05
2025-05-31,0,7758,-7758,몬트세라트,2025-05
2025-05-31,0,7146,-7146,니우에,2025-05
2000-01-31,12162424632,12594622951,-432198319,총합,2000-01
2000-02-29,12676042304,12023652340,652389964,총합,2000-02
2000-03-31,14429703086,14212010950,217692136,총합,2000-03
2000-04-30,13522040017,13344532361,177507656,총합,2000-04
2000-05-31,14636754971,13283355868,1353399103,총합,2000-05
2000-06-30,15250939656,13177511346,2073428310,총합,2000-06
2000-07-31,14455655854,13671875974,783779880,총합,2000-07
2000-08-31,14786880244,13441139154,1345741090,총합,2000-08
2000-09-30,15133379448,13291802853,1841576595,총합,2000-09
2000-10-31,15248067735,14104212460,1143855275,총합,2000-10
2000-11-30,14989067774,14160417535,828650239,총합,2000-11
2000-12-31,14976554592,13175884505,1800670087,총합,2000-12
2001-01-31,12644929017,12431023265,213905752,총합,2001-01
2001-02-28,13354073762,12732257752,621816010,총합,2001-02
2001-03-31,14124891326,12951885920,1173005406,총합,2001-03
2001-04-30,12121109771,11212191603,908918168,총합,2001-04
2001-05-31,13306959164,11554834256,1752124908,총합,2001-05
2001-06-30,12931941025,11718965562,1212975463,총합,2001-06
2001-07-31,11392256710,11107563960,284692750,총합,2001-07
2001-08-31,11766192458,11337826455,428366003,총합,2001-08
2001-09-30,12447323670,11709659052,737664618,총합,2001-09
2001-10-31,12086028283,11506884216,579144067,총합,2001-10
2001-11-30,12348966889,11532770841,816196048,총합,2001-11
2001-12-31,11914472044,11301957824,612514220,총합,2001-12
2002-01-31,11381879453,11326429503,55449950,총합,2002-01
2002-02-28,11023036912,10471161473,551875439,총합,2002-02
2002-03-31,13251322898,11990096560,1261226338,총합,2002-03
2002-04-30,13184534346,12559695940,624838406,총합,2002-04
2002-05-31,14173176611,12698101146,1475075465,총합,2002-05
2002-06-30,12894088493,11934221152,959867341,총합,2002-06
2002-07-31,13395178905,13031772817,363406088,총합,2002-07
2002-08-31,13959109880,12860751255,1098358625,총합,2002-08
2002-09-30,13900763481,12991556974,909206507,총합,2002-09
2002-10-31,15084658742,13817061264,1267597478,총합,2002-10
2002-11-30,15196561477,13993430939,1203130538,총합,2002-11
2002-12-31,15026216602,14451873658,574342944,총합,2002-12
2003-01-31,14319930962,14494967095,-175036133,총합,2003-01
2003-02-28,13337144558,13858273532,-521128974,총합,2003-02
2003-03-31,15378850237,15870217081,-491366844,총합,2003-03
2003-04-30,15720592277,14758747261,961845016,총합,2003-04
2003-05-31,14676091579,13523641960,1152449619,총합,2003-05
2003-06-30,15656327385,13428140976,2228186409,총합,2003-06
2003-07-31,15431714254,14898002767,533711487,총합,2003-07
2003-08-31,15375268390,13541359852,1833908538,총합,2003-08
2003-09-30,17021082330,14531443629,2489638701,총합,2003-09
2003-10-31,18929664626,16536627563,2393037063,총합,2003-10
2003-11-30,18242088134,15760750117,2481338017,총합,2003-11
2003-12-31,19728688098,17624484995,2104203103,총합,2003-12
2004-01-31,18987120155,16208878984,2778241171,총합,2004-01
2004-02-29,19136967537,17468564274,1668403263,총합,2004-02
2004-03-31,21174854848,19120077557,2054777291,총합,2004-03
2004-04-30,21483356558,18829951950,2653404608,총합,2004-04
2004-05-31,20834258911,17895383933,2938874978,총합,2004-05
2004-06-30,21657111358,18544350319,3112761039,총합,2004-06
2004-07-31,21003794339,18390091238,2613703101,총합,2004-07
2004-08-31,19798968731,18124364252,1674604479,총합,2004-08
2004-09-30,20831133275,18193347220,2637786055,총합,2004-09
2004-10-31,22663288550,20408215578,2255072972,총합,2004-10
2004-11-30,23076611989,20311965265,2764646724,총합,2004-11
2004-12-31,23197205701,20967496582,2229709119,총합,2004-12
2005-01-31,22454025470,19450002565,3004022905,총합,2005-01
2005-02-28,20401096466,18396908232,2004188234,총합,2005-02
2005-03-31,23952499856,22779865562,1172634294,총합,2005-03
2005-04-30,22872504728,21244490305,1628014423,총합,2005-04
2005-05-31,23122703254,21161778310,1960924944,총합,2005-05
2005-06-30,23707576151,21288597136,2418979015,총합,2005-06
2005-07-31,23235522474,21508824279,1726698195,총합,2005-07
2005-08-31,23342966614,22000828395,1342138219,총합,2005-08
2005-09-30,24519190675,22718656801,1800533874,총합,2005-09
2005-10-31,25352747930,22652734595,2700013335,총합,2005-10
2005-11-30,25826192398,23849551801,1976640597,총합,2005-11
2005-12-31,25631716487,24186025712,1445690775,총합,2005-12
2006-01-31,23257866107,23089303902,168562205,총합,2006-01
2006-02-28,23786955697,23507779778,279175919,총합,2006-02
2006-03-31,26840145449,25945006577,895138872,총합,2006-03
2006-04-30,25590122639,24485819704,1104302935,총합,2006-04
2006-05-31,27934507286,26210365788,1724141498,총합,2006-05
2006-06-30,27948805195,26023464339,1925340856,총합,2006-06
2006-07-31,25774350220,25549715314,224634906,총합,2006-07
2006-08-31,27287194510,27029461493,257733017,총합,2006-08
2006-09-30,29651247374,27636644300,2014603074,총합,2006-09
2006-10-31,28015958595,25621762171,2394196424,총합,2006-10
2006-11-30,30602312825,26765115252,3837197573,총합,2006-11
2006-12-31,28775382516,27518193849,1257188667,총합,2006-12
2007-01-31,28092560584,27560101371,532459213,총합,2007-01
2007-02-28,26225124995,25406152348,818972647,총합,2007-02
2007-03-31,30385840023,29295459795,1090380228,총합,2007-03
2007-04-30,29944456214,29596881973,347574241,총합,2007-04
2007-05-31,31039900633,29856936901,1182963732,총합,2007-05
2007-06-30,32000108762,28508097938,3492010824,총합,2007-06
2007-07-31,30207443864,29223200901,984242963,총합,2007-07
2007-08-31,30998134234,29642049553,1356084681,총합,2007-08
2007-09-30,29323535026,27193582182,2129952844,총합,2007-09
2007-10-31,34433812739,32741232017,1692580722,총합,2007-10
2007-11-30,35807892835,33926123532,1881769303,총합,2007-11
2007-12-31,33030275842,33895914764,-865638922,총합,2007-12
2008-01-31,32274574545,36318030381,-4043455836,총합,2008-01
2008-02-29,31178189869,32624333870,-1446144001,총합,2008-02
2008-03-31,35991775719,37110561085,-1118785366,총합,2008-03
2008-04-30,37850247110,38260401219,-410154109,총합,2008-04
2008-05-31,39383158044,38704467916,678690128,총합,2008-05
2008-06-30,37258607851,37827931015,-569323164,총합,2008-06
2008-07-31,40961223381,42952490651,-1991267270,총합,2008-07
2008-08-31,36610602764,40420447474,-3809844710,총합,2008-08
2008-09-30,37428302796,39528072583,-2099769787,총합,2008-09
2008-10-31,37111139902,36098774481,1012365421,총합,2008-10
2008-11-30,28841617185,28853646431,-12029246,총합,2008-11
2008-12-31,27117888786,26575579734,542309052,총합,2008-12
2009-01-31,21133405214,24898820926,-3765415712,총합,2009-01
2009-02-28,25397149528,22598093992,2799055536,총합,2009-02
2009-03-31,27890830606,23920621668,3970208938,총합,2009-03
2009-04-30,30326508694,24873845211,5452663483,총합,2009-04
2009-05-31,27823838875,23407032805,4416806070,총합,2009-05
2009-06-30,32210047824,25689292771,6520755053,총합,2009-06
2009-07-31,31908462074,27679764354,4228697720,총합,2009-07
2009-08-31,28949627324,27408190674,1541436650,총합,2009-08
2009-09-30,33922428618,29757140363,4165288255,총합,2009-09
2009-10-31,33970032167,30396531766,3573500401,총합,2009-10
2009-11-30,33991607471,29534690103,4456917368,총합,2009-11
2009-12-31,36009622532,32920496650,3089125882,총합,2009-12
2010-01-31,30735415239,31535995488,-800580249,총합,2010-01
2010-02-28,33039402331,31044126289,1995276042,총합,2010-02
2010-03-31,37308940314,35575753750,1733186564,총합,2010-03
2010-04-30,39301013507,35522367415,3778646092,총합,2010-04
2010-05-31,38887929677,34853569952,4034359725,총합,2010-05
2010-06-30,42049044611,35254772716,6794271895,총합,2010-06
2010-07-31,40423610784,35421717812,5001892972,총합,2010-07
2010-08-31,36480955462,35274964404,1205991058,총합,2010-08
2010-09-30,39410882408,35001779867,4409102541,총합,2010-09
2010-10-31,43340335313,37001094541,6339240772,총합,2010-10
2010-11-30,41260912134,38669304038,2591608096,총합,2010-11
2010-12-31,44145319927,40056713978,4088605949,총합,2010-12
2011-01-31,44465366339,41981323101,2484043238,총합,2011-01
2011-02-28,38467411994,36401587637,2065824357,총합,2011-02
2011-03-31,48052991328,45565952139,2487039189,총합,2011-03
2011-04-30,48536725405,44188521904,4348203501,총합,2011-04
2011-05-31,47331328872,45284932153,2046396719,총합,2011-05
2011-06-30,46736892626,44824772026,1912120600,총합,2011-06
2011-07-31,48950113013,44296128937,4653984076,총합,2011-07
2011-08-31,45792060934,45381680275,410380659,총합,2011-08
2011-09-30,46510964789,45279468844,1231495945,총합,2011-09
2011-10-31,46613479836,42709770457,3903709379,총합,2011-10
2011-11-30,46012595310,43010481212,3002114098,총합,2011-11
2011-12-31,47743725397,45488471169,2255254228,총합,2011-12
2012-01-31,41200357940,43517290617,-2316932677,총합,2012-01
2012-02-29,46316183638,45099984295,1216199343,총합,2012-02
2012-03-31,47329816570,45053405629,2276410941,총합,2012-03
2012-04-30,46094754124,43957175504,2137578620,총합,2012-04
2012-05-31,46872357095,44480338601,2392018494,총합,2012-05
2012-06-30,47162604994,41993629221,5168975773,총합,2012-06
2012-07-31,44667681428,41976900097,2690781331,총합,2012-07
2012-08-31,43045181248,41115675023,1929506225,총합,2012-08
2012-09-30,45412538010,42559535172,2853002838,총합,2012-09
2012-10-31,47087760006,43379892882,3707867124,총합,2012-10
2012-11-30,47805245779,43381536728,4423709051,총합,2012-11
2012-12-31,44875311309,43069108906,1806202403,총합,2012-12
2013-01-31,45673108992,45296942393,376166599,총합,2013-01
2013-02-28,42331836668,40458471528,1873365140,총합,2013-02
2013-03-31,47312703650,43976738918,3335964732,총합,2013-03
2013-04-30,46157925207,43648240730,2509684477,총합,2013-04
2013-05-31,48307560429,42389874292,5917686137,총합,2013-05
2013-06-30,46690983225,40719393779,5971589446,총합,2013-06
2013-07-31,45829520579,43384403453,2445117126,총합,2013-07
2013-08-31,46311340570,41593821429,4717519141,총합,2013-08
2013-09-30,44650485857,41055405226,3595080631,총합,2013-09
2013-10-31,50480484208,45604963423,4875520785,총합,2013-10
2013-11-30,47905028162,43106074255,4798953907,총합,2013-11
2013-12-31,47981456248,44351185613,3630270635,총합,2013-12
2014-01-31,45559632455,44746013067,813619388,총합,2014-01
2014-02-28,42911734549,42061553951,850180598,총합,2014-02
2014-03-31,49064391958,45558674670,3505717288,총합,2014-03
2014-04-30,50267447896,45873332924,4394114972,총합,2014-04
2014-05-31,47577182544,42607482640,4969699904,총합,2014-05
2014-06-30,47827709150,42476380665,5351328485,총합,2014-06
2014-07-31,48204545437,45863915730,2340629707,총합,2014-07
2014-08-31,46108369810,42791869289,3316500521,총합,2014-08
2014-09-30,47446217249,44184711623,3261505626,총합,2014-09
2014-10-31,51630656639,44097421222,7533235417,총합,2014-10
2014-11-30,46605342145,41343254092,5262088053,총합,2014-11
2014-12-31,49461377231,43909895859,5551481372,총합,2014-12
2015-01-31,45105389265,39283024626,5822364639,총합,2015-01
2015-02-28,41472190637,33998316032,7473874605,총합,2015-02
2015-03-31,46822771337,38485935068,8336836269,총합,2015-03
2015-04-30,46221931023,37858797981,8363133042,총합,2015-04
2015-05-31,42327311014,36039799633,6287511381,총합,2015-05
2015-06-30,46554511646,36598397721,9956113925,총합,2015-06
2015-07-31,45695746774,38647066671,7048680103,총합,2015-07
2015-08-31,39107399172,34772163390,4335235782,총합,2015-08
2015-09-30,43432312357,34540503816,8891808541,총합,2015-09
2015-10-31,43352045560,36762974692,6589070868,총합,2015-10
2015-11-30,44285051775,34049681859,10235369916,총합,2015-11
2015-12-31,42379842806,35462311136,6917531670,총합,2015-12
2016-01-31,36260420221,31321900755,4938519466,총합,2016-01
2016-02-29,35924540736,29163323250,6761217486,총합,2016-02
2016-03-31,43002467958,33344422648,9658045310,총합,2016-03
2016-04-30,41081552585,32388783069,8692769516,총합,2016-04
2016-05-31,39733793730,33025444474,6708349256,총합,2016-05
2016-06-30,45209071390,33890230717,11318840673,총합,2016-06
2016-07-31,40881700213,33371801921,7509898292,총합,2016-07
2016-08-31,40124791131,35103610718,5021180413,총합,2016-08
2016-09-30,40846251917,33988442821,6857809096,총합,2016-09
2016-10-31,41983329283,35050111654,6933217629,총합,2016-10
2016-11-30,45309140839,37240857984,8068282855,총합,2016-11
2016-12-31,45068879634,38303957084,6764922550,총합,2016-12
2017-01-31,40256999916,37645402844,2611597072,총합,2017-01
2017-02-28,43166536042,36203282097,6963253945,총합,2017-02
2017-03-31,48637831863,42579491534,6058340329,총합,2017-03
2017-04-30,50843799013,37959391334,12884407679,총합,2017-04
2017-05-31,44926979168,39287764130,5639215038,총합,2017-05
2017-06-30,51272451919,40551012440,10721439479,총합,2017-06
2017-07-31,48830439652,38607156599,10223283053,총합,2017-07
2017-08-31,47105568514,40549771657,6555796857,총합,2017-08
2017-09-30,55115239696,41695883517,13419356179,총합,2017-09
2017-10-31,44791238727,37856561572,6934677155,총합,2017-10
2017-11-30,49707196884,42013512269,7693684615,총합,2017-11
2017-12-31,49040139428,43529066002,5511073426,총합,2017-12
2018-01-31,49221290908,45805321803,3415969105,총합,2018-01
2018-02-28,44523529594,41722153612,2801375982,총합,2018-02
2018-03-31,51309931550,44897837550,6412094000,총합,2018-03
2018-04-30,49850235277,43693962593,6156272684,총합,2018-04
2018-05-31,50687749864,44458729052,6229020812,총합,2018-05
2018-06-30,51079375327,45000163698,6079211629,총합,2018-06
2018-07-31,51810254527,44917043970,6893210557,총합,2018-07
2018-08-31,51180449254,44360777913,6819671341,총합,2018-08
2018-09-30,50650208140,41032927952,9617280188,총합,2018-09
2018-10-31,54860309595,48480617998,6379691597,총합,2018-10
2018-11-30,51479529532,46808198655,4671330877,총합,2018-11
2018-12-31,48206793082,44024693595,4182099487,총합,2018-12
2019-01-31,46168934249,45153389095,1015545154,총합,2019-01
2019-02-28,39481803311,36651437378,2830365933,총합,2019-02
2019-03-31,47003206185,41992348876,5010857309,총합,2019-03
2019-04-30,48781156049,45047163825,3733992224,총합,2019-04
2019-05-31,45703948228,43619667298,2084280930,총합,2019-05
2019-06-30,44008404018,40104811661,3903592357,총합,2019-06
2019-07-31,46078221134,43762245132,2315976002,총합,2019-07
2019-08-31,44020065156,42457250491,1562814665,총합,2019-08
2019-09-30,44629052707,38741472840,5887579867,총합,2019-09
2019-10-31,46648756033,41396516696,5252239337,총합,2019-10
2019-11-30,44040721772,40729214640,3311507132,총합,2019-11
2019-12-31,45668341127,43687429503,1980911624,총합,2019-12
2020-01-31,43103060857,42718100490,384960367,총합,2020-01
2020-02-29,40911818805,36977247225,3934571580,총합,2020-02
2020-03-31,46167203855,41803860118,4363343737,총합,2020-03
2020-04-30,36270182837,37932611485,-1662428648,총합,2020-04
2020-05-31,34854511400,34661974379,192537021,총합,2020-05
2020-06-30,39214070630,35794860130,3419210500,총합,2020-06
2020-07-31,42785144050,38849185276,3935958774,총합,2020-07
2020-08-31,39469230580,35817928845,3651301735,총합,2020-08
2020-09-30,47819947522,39400189613,8419757909,총합,2020-09
2020-10-31,44818534427,39093795482,5724738945,총합,2020-10
2020-11-30,45751883232,39944763402,5807119830,총합,2020-11
2020-12-31,51332449396,44638246184,6694203212,총합,2020-12
2021-01-31,48006973697,44456822075,3550151622,총합,2021-01
2021-02-28,44706906918,42404636049,2302270869,총합,2021-02
2021-03-31,53690914321,49742554865,3948359456,총합,2021-03
2021-04-30,51225991397,50891151895,334839502,총합,2021-04
2021-05-31,50725161248,47910521600,2814639648,총합,2021-05
2021-06-30,54778904949,50429026829,4349878120,총합,2021-06
2021-07-31,55461518159,53676255790,1785262369,총합,2021-07
2021-08-31,53165103786,51581092948,1584010838,총합,2021-08
2021-09-30,55913862375,51636341037,4277521338,총합,2021-09
2021-10-31,55660372637,53847824499,1812548138,총합,2021-10
2021-11-30,60330542263,57357549236,2972993027,총합,2021-11
2021-12-31,60734116670,61159670671,-425554001,총합,2021-12
2022-01-31,55455375923,60606720651,-5151344728,총합,2022-01
2022-02-28,54155835174,53482053658,673781516,총합,2022-02
2022-03-31,63786834790,63811102159,-24267369,총합,2022-03
2022-04-30,57842816378,60213185138,-2370368760,총합,2022-04
2022-05-31,61591326414,63168379870,-1577053456,총합,2022-05
2022-06-30,57679934233,60149905944,-2469971711,총합,2022-06
2022-07-31,60241774055,65259837773,-5018063718,총합,2022-07
2022-08-31,56605950185,66027733092,-9421782907,총합,2022-08
2022-09-30,57176299956,61012837107,-3836537151,총합,2022-09
2022-10-31,52428091564,59167185294,-6739093730,총합,2022-10
2022-11-30,51771855225,58847654502,-7075799277,총합,2022-11
2022-12-31,54848665929,59623061690,-4774395761,총합,2022-12
2023-01-31,46339145202,59037258670,-12698113468,총합,2023-01
2023-02-28,49994592894,55370497927,-5375905033,총합,2023-02
2023-03-31,54882484169,59635920268,-4753436099,총합,2023-03
2023-04-30,49430879351,51940136654,-2509257303,총합,2023-04
2023-05-31,52054194622,54251194151,-2196999529,총합,2023-05
2023-06-30,54297753717,53055480023,1242273694,총합,2023-06
2023-07-31,50457775880,48738113632,1719662248,총합,2023-07
2023-08-31,51994073841,51009758152,984315689,총합,2023-08
2023-09-30,54650691297,50972524564,3678166733,총합,2023-09
2023-10-31,54989950051,53440582476,1549367575,총합,2023-10
2023-11-30,55561090016,51997805276,3563284740,총합,2023-11
2023-12-31,57573192986,53122854463,4450338523,총합,2023-12
2024-01-31,54709823073,54474610524,235212549,총합,2024-01
2024-02-29,52076389862,48221860363,3854529499,총합,2024-02
2024-03-31,56518308769,52112904954,4405403815,총합,2024-03
2024-04-30,56148299060,54821181339,1327117721,총합,2024-04
2024-05-31,58020557065,53132937272,4887619793,총합,2024-05
2024-06-30,57341633896,49090193125,8251440771,총합,2024-06
2024-07-31,57458787682,53838741739,3620045943,총합,2024-07
2024-08-31,57642924137,54054893987,3588030150,총합,2024-08
2024-09-30,58544693213,52102924796,6441768417,총합,2024-09
2024-10-31,57500192431,54331588594,3168603837,총합,2024-10
2024-11-30,56288629120,50718992333,5569636787,총합,2024-11
2024-12-31,61359249829,54866379965,6492869864,총합,2024-12
2025-01-31,49161061450,51012633000,-1851571550,총합,2025-01
2025-02-28,52288470867,48297480733,3990990134,총합,2025-02
2025-03-31,58090110978,53287069754,4803041224,총합,2025-03
2025-04-30,58122862336,53303236945,4819625391,총합,2025-04
2025-05-31,57253878689,50322784441,6931094248,총합,2025-05
